Date,Agent Name,District,Area,Province,NLB Sales Ticket,DLB Sales Ticket,Total Sales Ticket,NLB LKR,DLB LKR,Total LKR
3/25/2024,Nimal Abesekara,Hambantota,Hambantota,Southern,7442,998,8440,297680,39920,337600
3/26/2024,Nimal Abesekara,Hambantota,Hambantota,Southern,728,3547,4275,29120,141880,171000
3/27/2024,Nimal Abesekara,Hambantota,Hambantota,Southern,4686,7247,11933,187440,289880,477320
3/28/2024,Nimal Abesekara,Hambantota,Hambantota,Southern,7582,986,8568,303280,39440,342720
3/29/2024,Nimal Abesekara,Hambantota,Hambantota,Southern,6508,6704,13212,260320,268160,528480
3/30/2024,Nimal Abesekara,Hambantota,Hambantota,Southern,9791,3741,13532,391640,149640,541280
3/31/2024,Nimal Abesekara,Hambantota,Hambantota,Southern,7124,5531,12655,284960,221240,506200
4/1/2024,Nimal Abesekara,Hambantota,Hambantota,Southern,1108,3154,4262,44320,126160,170480
4/2/2024,Nimal Abesekara,Hambantota,Hambantota,Southern,766,5938,6704,30640,237520,268160
4/3/2024,Nimal Abesekara,Hambantota,Hambantota,Southern,9739,3686,13425,389560,147440,537000
4/4/2024,Nimal Abesekara,Hambantota,Hambantota,Southern,2501,4855,7356,100040,194200,294240
4/5/2024,Nimal Abesekara,Hambantota,Hambantota,Southern,4919,8697,13616,196760,347880,544640
4/6/2024,Nimal Abesekara,Hambantota,Hambantota,Southern,2054,6218,8272,82160,248720,330880
4/7/2024,Nimal Abesekara,Hambantota,Hambantota,Southern,6923,5606,12529,276920,224240,501160
4/8/2024,Nimal Abesekara,Hambantota,Hambantota,Southern,6249,9320,15569,249960,372800,622760
4/9/2024,Nimal Abesekara,Hambantota,Hambantota,Southern,768,3733,4501,30720,149320,180040
4/10/2024,Nimal Abesekara,Hambantota,Hambantota,Southern,9234,6272,15506,369360,250880,620240
4/11/2024,Nimal Abesekara,Hambantota,Hambantota,Southern,1948,6843,8791,77920,273720,351640
4/19/2024,Nimal Abesekara,Hambantota,Hambantota,Southern,1505,2402,3907,60200,96080,156280
4/20/2024,Nimal Abesekara,Hambantota,Hambantota,Southern,4662,9307,13969,186480,372280,558760
4/21/2024,Nimal Abesekara,Hambantota,Hambantota,Southern,9237,9643,18880,369480,385720,755200
4/22/2024,Nimal Abesekara,Hambantota,Hambantota,Southern,6465,3142,9607,258600,125680,384280
4/23/2024,Nimal Abesekara,Hambantota,Hambantota,Southern,3178,5772,8950,127120,230880,358000
4/24/2024,Nimal Abesekara,Hambantota,Hambantota,Southern,4896,1217,6113,195840,48680,244520
4/25/2024,Nimal Abesekara,Hambantota,Hambantota,Southern,4168,459,4627,166720,18360,185080
4/26/2024,Nimal Abesekara,Hambantota,Hambantota,Southern,5322,5386,10708,212880,215440,428320
4/27/2024,Nimal Abesekara,Hambantota,Hambantota,Southern,8551,105,8656,342040,4200,346240
4/28/2024,Nimal Abesekara,Hambantota,Hambantota,Southern,5073,9711,14784,202920,388440,591360
4/29/2024,Nimal Abesekara,Hambantota,Hambantota,Southern,8789,5850,14639,351560,234000,585560
4/30/2024,Nimal Abesekara,Hambantota,Hambantota,Southern,9152,2807,11959,366080,112280,478360
5/1/2024,Nimal Abesekara,Hambantota,Hambantota,Southern,2250,3775,6025,90000,151000,241000
5/2/2024,Nimal Abesekara,Hambantota,Hambantota,Southern,3772,7513,11285,150880,300520,451400
5/3/2024,Nimal Abesekara,Hambantota,Hambantota,Southern,948,1804,2752,37920,72160,110080
5/4/2024,Nimal Abesekara,Hambantota,Hambantota,Southern,5417,9450,14867,216680,378000,594680
5/5/2024,Nimal Abesekara,Hambantota,Hambantota,Southern,8279,8205,16484,331160,328200,659360
5/6/2024,Nimal Abesekara,Hambantota,Hambantota,Southern,8395,4609,13004,335800,184360,520160
5/7/2024,Nimal Abesekara,Hambantota,Hambantota,Southern,7093,4380,11473,283720,175200,458920
5/8/2024,Nimal Abesekara,Hambantota,Hambantota,Southern,5211,1509,6720,208440,60360,268800
5/9/2024,Nimal Abesekara,Hambantota,Hambantota,Southern,7662,4639,12301,306480,185560,492040
5/10/2024,Nimal Abesekara,Hambantota,Hambantota,Southern,3291,4432,7723,131640,177280,308920
5/11/2024,Nimal Abesekara,Hambantota,Hambantota,Southern,8833,6691,15524,353320,267640,620960
5/12/2024,Nimal Abesekara,Hambantota,Hambantota,Southern,6643,232,6875,265720,9280,275000
5/13/2024,Nimal Abesekara,Hambantota,Hambantota,Southern,8324,2729,11053,332960,109160,442120
5/14/2024,Nimal Abesekara,Hambantota,Hambantota,Southern,558,4720,5278,22320,188800,211120
5/15/2024,Nimal Abesekara,Hambantota,Hambantota,Southern,6791,927,7718,271640,37080,308720
5/16/2024,Nimal Abesekara,Hambantota,Hambantota,Southern,3843,2086,5929,153720,83440,237160
5/17/2024,Nimal Abesekara,Hambantota,Hambantota,Southern,2254,6342,8596,90160,253680,343840
5/18/2024,Nimal Abesekara,Hambantota,Hambantota,Southern,5169,7038,12207,206760,281520,488280
5/19/2024,Nimal Abesekara,Hambantota,Hambantota,Southern,7802,1385,9187,312080,55400,367480
5/20/2024,Nimal Abesekara,Hambantota,Hambantota,Southern,1216,8977,10193,48640,359080,407720
5/21/2024,Nimal Abesekara,Hambantota,Hambantota,Southern,726,6067,6793,29040,242680,271720
5/22/2024,Nimal Abesekara,Hambantota,Hambantota,Southern,7178,225,7403,287120,9000,296120
5/24/2024,Nimal Abesekara,Hambantota,Hambantota,Southern,3687,8280,11967,147480,331200,478680
5/25/2024,Nimal Abesekara,Hambantota,Hambantota,Southern,8063,799,8862,322520,31960,354480
5/26/2024,Nimal Abesekara,Hambantota,Hambantota,Southern,1509,9490,10999,60360,379600,439960
5/27/2024,Nimal Abesekara,Hambantota,Hambantota,Southern,2945,1157,4102,117800,46280,164080
5/28/2024,Nimal Abesekara,Hambantota,Hambantota,Southern,9232,6687,15919,369280,267480,636760
5/29/2024,Nimal Abesekara,Hambantota,Hambantota,Southern,1906,1023,2929,76240,40920,117160
5/30/2024,Nimal Abesekara,Hambantota,Hambantota,Southern,7736,9895,17631,309440,395800,705240
5/31/2024,Nimal Abesekara,Hambantota,Hambantota,Southern,2063,7153,9216,82520,286120,368640
6/1/2024,Nimal Abesekara,Hambantota,Hambantota,Southern,2145,2979,5124,85800,119160,204960
6/2/2024,Nimal Abesekara,Hambantota,Hambantota,Southern,644,2158,2802,25760,86320,112080
6/3/2024,Nimal Abesekara,Hambantota,Hambantota,Southern,1007,9797,10804,40280,391880,432160
6/4/2024,Nimal Abesekara,Hambantota,Hambantota,Southern,2927,9255,12182,117080,370200,487280
6/5/2024,Nimal Abesekara,Hambantota,Hambantota,Southern,1372,938,2310,54880,37520,92400
6/6/2024,Nimal Abesekara,Hambantota,Hambantota,Southern,4998,9232,14230,199920,369280,569200
6/7/2024,Nimal Abesekara,Hambantota,Hambantota,Southern,6286,203,6489,251440,8120,259560
6/8/2024,Nimal Abesekara,Hambantota,Hambantota,Southern,6406,2730,9136,256240,109200,365440
6/9/2024,Nimal Abesekara,Hambantota,Hambantota,Southern,3199,7915,11114,127960,316600,444560
6/10/2024,Nimal Abesekara,Hambantota,Hambantota,Southern,2109,577,2686,84360,23080,107440
6/11/2024,Nimal Abesekara,Hambantota,Hambantota,Southern,275,9350,9625,11000,374000,385000
6/12/2024,Nimal Abesekara,Hambantota,Hambantota,Southern,1893,8696,10589,75720,347840,423560
6/13/2024,Nimal Abesekara,Hambantota,Hambantota,Southern,3011,7816,10827,120440,312640,433080
6/14/2024,Nimal Abesekara,Hambantota,Hambantota,Southern,7249,5546,12795,289960,221840,511800
6/15/2024,Nimal Abesekara,Hambantota,Hambantota,Southern,3510,7381,10891,140400,295240,435640
6/16/2024,Nimal Abesekara,Hambantota,Hambantota,Southern,9525,6052,15577,381000,242080,623080
6/17/2024,Nimal Abesekara,Hambantota,Hambantota,Southern,6007,584,6591,240280,23360,263640
6/18/2024,Nimal Abesekara,Hambantota,Hambantota,Southern,2457,2417,4874,98280,96680,194960
6/19/2024,Nimal Abesekara,Hambantota,Hambantota,Southern,8288,2434,10722,331520,97360,428880
6/20/2024,Nimal Abesekara,Hambantota,Hambantota,Southern,322,7540,7862,12880,301600,314480
6/21/2024,Nimal Abesekara,Hambantota,Hambantota,Southern,2208,9066,11274,88320,362640,450960
6/22/2024,Nimal Abesekara,Hambantota,Hambantota,Southern,2009,69,2078,80360,2760,83120
6/23/2024,Nimal Abesekara,Hambantota,Hambantota,Southern,3826,9326,13152,153040,373040,526080
6/24/2024,Nimal Abesekara,Hambantota,Hambantota,Southern,5635,4125,9760,225400,165000,390400
6/25/2024,Nimal Abesekara,Hambantota,Hambantota,Southern,714,49,763,28560,1960,30520
6/26/2024,Nimal Abesekara,Hambantota,Hambantota,Southern,4013,2466,6479,160520,98640,259160
6/27/2024,Nimal Abesekara,Hambantota,Hambantota,Southern,8529,752,9281,341160,30080,371240
6/28/2024,Nimal Abesekara,Hambantota,Hambantota,Southern,4996,4386,9382,199840,175440,375280
6/29/2024,Nimal Abesekara,Hambantota,Hambantota,Southern,5614,9582,15196,224560,383280,607840
6/30/2024,Nimal Abesekara,Hambantota,Hambantota,Southern,600,8930,9530,24000,357200,381200
7/1/2024,Nimal Abesekara,Hambantota,Hambantota,Southern,3175,5584,8759,127000,223360,350360
7/2/2024,Nimal Abesekara,Hambantota,Hambantota,Southern,4973,8828,13801,198920,353120,552040
7/3/2024,Nimal Abesekara,Hambantota,Hambantota,Southern,7320,7476,14796,292800,299040,591840
7/4/2024,Nimal Abesekara,Hambantota,Hambantota,Southern,1352,9574,10926,54080,382960,437040
7/5/2024,Nimal Abesekara,Hambantota,Hambantota,Southern,1355,3679,5034,54200,147160,201360
7/6/2024,Nimal Abesekara,Hambantota,Hambantota,Southern,9230,8887,18117,369200,355480,724680
7/7/2024,Nimal Abesekara,Hambantota,Hambantota,Southern,1028,1569,2597,41120,62760,103880
7/8/2024,Nimal Abesekara,Hambantota,Hambantota,Southern,2154,5237,7391,86160,209480,295640
7/9/2024,Nimal Abesekara,Hambantota,Hambantota,Southern,3300,4792,8092,132000,191680,323680
7/10/2024,Nimal Abesekara,Hambantota,Hambantota,Southern,9649,4479,14128,385960,179160,565120
7/11/2024,Nimal Abesekara,Hambantota,Hambantota,Southern,4431,5789,10220,177240,231560,408800
7/12/2024,Nimal Abesekara,Hambantota,Hambantota,Southern,3809,1307,5116,152360,52280,204640
7/13/2024,Nimal Abesekara,Hambantota,Hambantota,Southern,605,4929,5534,24200,197160,221360
7/14/2024,Nimal Abesekara,Hambantota,Hambantota,Southern,2639,5019,7658,105560,200760,306320
7/15/2024,Nimal Abesekara,Hambantota,Hambantota,Southern,1905,1732,3637,76200,69280,145480
7/16/2024,Nimal Abesekara,Hambantota,Hambantota,Southern,2016,1104,3120,80640,44160,124800
7/17/2024,Nimal Abesekara,Hambantota,Hambantota,Southern,1910,9778,11688,76400,391120,467520
7/18/2024,Nimal Abesekara,Hambantota,Hambantota,Southern,7554,4046,11600,302160,161840,464000
7/19/2024,Nimal Abesekara,Hambantota,Hambantota,Southern,1218,3973,5191,48720,158920,207640
7/20/2024,Nimal Abesekara,Hambantota,Hambantota,Southern,3845,9714,13559,153800,388560,542360
7/21/2024,Nimal Abesekara,Hambantota,Hambantota,Southern,4009,730,4739,160360,29200,189560
7/22/2024,Nimal Abesekara,Hambantota,Hambantota,Southern,4503,969,5472,180120,38760,218880
7/23/2024,Nimal Abesekara,Hambantota,Hambantota,Southern,8707,5140,13847,348280,205600,553880
7/24/2024,Nimal Abesekara,Hambantota,Hambantota,Southern,7258,1306,8564,290320,52240,342560
7/25/2024,Nimal Abesekara,Hambantota,Hambantota,Southern,8953,4610,13563,358120,184400,542520
7/26/2024,Nimal Abesekara,Hambantota,Hambantota,Southern,5891,4956,10847,235640,198240,433880
7/27/2024,Nimal Abesekara,Hambantota,Hambantota,Southern,4456,728,5184,178240,29120,207360
7/28/2024,Nimal Abesekara,Hambantota,Hambantota,Southern,3195,170,3365,127800,6800,134600
7/29/2024,Nimal Abesekara,Hambantota,Hambantota,Southern,7893,8243,16136,315720,329720,645440
7/30/2024,Nimal Abesekara,Hambantota,Hambantota,Southern,5284,3316,8600,211360,132640,344000
7/31/2024,Nimal Abesekara,Hambantota,Hambantota,Southern,2427,2993,5420,97080,119720,216800
8/1/2024,Nimal Abesekara,Hambantota,Hambantota,Southern,7212,3267,10479,288480,130680,419160
8/2/2024,Nimal Abesekara,Hambantota,Hambantota,Southern,3405,9326,12731,136200,373040,509240
8/3/2024,Nimal Abesekara,Hambantota,Hambantota,Southern,4781,2164,6945,191240,86560,277800
8/4/2024,Nimal Abesekara,Hambantota,Hambantota,Southern,6600,5597,12197,264000,223880,487880
8/5/2024,Nimal Abesekara,Hambantota,Hambantota,Southern,7398,1664,9062,295920,66560,362480
8/6/2024,Nimal Abesekara,Hambantota,Hambantota,Southern,9581,2229,11810,383240,89160,472400
8/7/2024,Nimal Abesekara,Hambantota,Hambantota,Southern,9066,7588,16654,362640,303520,666160
8/8/2024,Nimal Abesekara,Hambantota,Hambantota,Southern,3134,1181,4315,125360,47240,172600
8/9/2024,Nimal Abesekara,Hambantota,Hambantota,Southern,2267,3569,5836,90680,142760,233440
8/10/2024,Nimal Abesekara,Hambantota,Hambantota,Southern,3371,6512,9883,134840,260480,395320
8/11/2024,Nimal Abesekara,Hambantota,Hambantota,Southern,9064,8437,17501,362560,337480,700040
8/12/2024,Nimal Abesekara,Hambantota,Hambantota,Southern,750,5752,6502,30000,230080,260080
8/13/2024,Nimal Abesekara,Hambantota,Hambantota,Southern,8715,4861,13576,348600,194440,543040
8/14/2024,Nimal Abesekara,Hambantota,Hambantota,Southern,3718,58,3776,148720,2320,151040
8/15/2024,Nimal Abesekara,Hambantota,Hambantota,Southern,1527,5496,7023,61080,219840,280920
8/16/2024,Nimal Abesekara,Hambantota,Hambantota,Southern,2880,7425,10305,115200,297000,412200
8/17/2024,Nimal Abesekara,Hambantota,Hambantota,Southern,2403,3314,5717,96120,132560,228680
8/18/2024,Nimal Abesekara,Hambantota,Hambantota,Southern,5753,3236,8989,230120,129440,359560
8/19/2024,Nimal Abesekara,Hambantota,Hambantota,Southern,4306,6024,10330,172240,240960,413200
8/20/2024,Nimal Abesekara,Hambantota,Hambantota,Southern,7936,233,8169,317440,9320,326760
8/21/2024,Nimal Abesekara,Hambantota,Hambantota,Southern,3027,2164,5191,121080,86560,207640
8/22/2024,Nimal Abesekara,Hambantota,Hambantota,Southern,7292,3895,11187,291680,155800,447480
8/23/2024,Nimal Abesekara,Hambantota,Hambantota,Southern,4415,7386,11801,176600,295440,472040
8/24/2024,Nimal Abesekara,Hambantota,Hambantota,Southern,5082,9190,14272,203280,367600,570880
8/25/2024,Nimal Abesekara,Hambantota,Hambantota,Southern,3996,8426,12422,159840,337040,496880
8/26/2024,Nimal Abesekara,Hambantota,Hambantota,Southern,7551,2091,9642,302040,83640,385680
8/27/2024,Nimal Abesekara,Hambantota,Hambantota,Southern,1629,7992,9621,65160,319680,384840
8/28/2024,Nimal Abesekara,Hambantota,Hambantota,Southern,6866,8415,15281,274640,336600,611240
8/29/2024,Nimal Abesekara,Hambantota,Hambantota,Southern,2676,826,3502,107040,33040,140080
8/30/2024,Nimal Abesekara,Hambantota,Hambantota,Southern,5883,9422,15305,235320,376880,612200
8/31/2024,Nimal Abesekara,Hambantota,Hambantota,Southern,330,2492,2822,13200,99680,112880
9/1/2024,Nimal Abesekara,Hambantota,Hambantota,Southern,4246,6853,11099,169840,274120,443960
9/2/2024,Nimal Abesekara,Hambantota,Hambantota,Southern,3394,4123,7517,135760,164920,300680
9/3/2024,Nimal Abesekara,Hambantota,Hambantota,Southern,2497,3550,6047,99880,142000,241880
9/4/2024,Nimal Abesekara,Hambantota,Hambantota,Southern,7894,5911,13805,315760,236440,552200
9/5/2024,Nimal Abesekara,Hambantota,Hambantota,Southern,6271,663,6934,250840,26520,277360
9/6/2024,Nimal Abesekara,Hambantota,Hambantota,Southern,7776,2612,10388,311040,104480,415520
9/7/2024,Nimal Abesekara,Hambantota,Hambantota,Southern,3676,6002,9678,147040,240080,387120
9/8/2024,Nimal Abesekara,Hambantota,Hambantota,Southern,9575,8905,18480,383000,356200,739200
9/9/2024,Nimal Abesekara,Hambantota,Hambantota,Southern,7298,1935,9233,291920,77400,369320
9/10/2024,Nimal Abesekara,Hambantota,Hambantota,Southern,5446,680,6126,217840,27200,245040
9/11/2024,Nimal Abesekara,Hambantota,Hambantota,Southern,3951,4144,8095,158040,165760,323800
9/12/2024,Nimal Abesekara,Hambantota,Hambantota,Southern,5852,7099,12951,234080,283960,518040
9/13/2024,Nimal Abesekara,Hambantota,Hambantota,Southern,1944,5004,6948,77760,200160,277920
9/14/2024,Nimal Abesekara,Hambantota,Hambantota,Southern,3553,6977,10530,142120,279080,421200
9/15/2024,Nimal Abesekara,Hambantota,Hambantota,Southern,1544,3916,5460,61760,156640,218400
9/16/2024,Nimal Abesekara,Hambantota,Hambantota,Southern,6539,9205,15744,261560,368200,629760
9/17/2024,Nimal Abesekara,Hambantota,Hambantota,Southern,7056,7075,14131,282240,283000,565240
9/18/2024,Nimal Abesekara,Hambantota,Hambantota,Southern,985,8691,9676,39400,347640,387040
9/19/2024,Nimal Abesekara,Hambantota,Hambantota,Southern,4278,7398,11676,171120,295920,467040
9/20/2024,Nimal Abesekara,Hambantota,Hambantota,Southern,3126,6652,9778,125040,266080,391120
9/21/2024,Nimal Abesekara,Hambantota,Hambantota,Southern,9239,9582,18821,369560,383280,752840
9/22/2024,Nimal Abesekara,Hambantota,Hambantota,Southern,3666,8413,12079,146640,336520,483160
9/23/2024,Nimal Abesekara,Hambantota,Hambantota,Southern,4772,2799,7571,190880,111960,302840
9/24/2024,Nimal Abesekara,Hambantota,Hambantota,Southern,5373,9582,14955,214920,383280,598200
9/25/2024,Nimal Abesekara,Hambantota,Hambantota,Southern,7339,5092,12431,293560,203680,497240
9/26/2024,Nimal Abesekara,Hambantota,Hambantota,Southern,5201,7787,12988,208040,311480,519520
9/27/2024,Nimal Abesekara,Hambantota,Hambantota,Southern,8621,3665,12286,344840,146600,491440
9/28/2024,Nimal Abesekara,Hambantota,Hambantota,Southern,7314,3319,10633,292560,132760,425320
9/29/2024,Nimal Abesekara,Hambantota,Hambantota,Southern,5476,2141,7617,219040,85640,304680
9/30/2024,Nimal Abesekara,Hambantota,Hambantota,Southern,700,2702,3402,28000,108080,136080
10/1/2024,Nimal Abesekara,Hambantota,Hambantota,Southern,4186,7381,11567,167440,295240,462680
10/2/2024,Nimal Abesekara,Hambantota,Hambantota,Southern,9043,8053,17096,361720,322120,683840
10/3/2024,Nimal Abesekara,Hambantota,Hambantota,Southern,3380,4709,8089,135200,188360,323560
10/4/2024,Nimal Abesekara,Hambantota,Hambantota,Southern,8444,1855,10299,337760,74200,411960
10/5/2024,Nimal Abesekara,Hambantota,Hambantota,Southern,8702,4253,12955,348080,170120,518200
10/6/2024,Nimal Abesekara,Hambantota,Hambantota,Southern,7190,8272,15462,287600,330880,618480
10/7/2024,Nimal Abesekara,Hambantota,Hambantota,Southern,8072,5267,13339,322880,210680,533560
10/8/2024,Nimal Abesekara,Hambantota,Hambantota,Southern,3058,8196,11254,122320,327840,450160
10/9/2024,Nimal Abesekara,Hambantota,Hambantota,Southern,1869,7628,9497,74760,305120,379880
10/10/2024,Nimal Abesekara,Hambantota,Hambantota,Southern,8529,2176,10705,341160,87040,428200
10/11/2024,Nimal Abesekara,Hambantota,Hambantota,Southern,3968,9667,13635,158720,386680,545400
10/12/2024,Nimal Abesekara,Hambantota,Hambantota,Southern,8393,9201,17594,335720,368040,703760
10/13/2024,Nimal Abesekara,Hambantota,Hambantota,Southern,7956,8563,16519,318240,342520,660760
10/14/2024,Nimal Abesekara,Hambantota,Hambantota,Southern,6620,973,7593,264800,38920,303720
10/15/2024,Nimal Abesekara,Hambantota,Hambantota,Southern,597,4328,4925,23880,173120,197000
10/16/2024,Nimal Abesekara,Hambantota,Hambantota,Southern,2983,3561,6544,119320,142440,261760
10/17/2024,Nimal Abesekara,Hambantota,Hambantota,Southern,6722,6511,13233,268880,260440,529320
10/18/2024,Nimal Abesekara,Hambantota,Hambantota,Southern,6746,2549,9295,269840,101960,371800
10/19/2024,Nimal Abesekara,Hambantota,Hambantota,Southern,5469,3295,8764,218760,131800,350560
10/20/2024,Nimal Abesekara,Hambantota,Hambantota,Southern,2968,401,3369,118720,16040,134760
10/21/2024,Nimal Abesekara,Hambantota,Hambantota,Southern,151,4522,4673,6040,180880,186920
10/22/2024,Nimal Abesekara,Hambantota,Hambantota,Southern,7210,5205,12415,288400,208200,496600
10/23/2024,Nimal Abesekara,Hambantota,Hambantota,Southern,7921,7114,15035,316840,284560,601400
10/24/2024,Nimal Abesekara,Hambantota,Hambantota,Southern,1241,5086,6327,49640,203440,253080
10/25/2024,Nimal Abesekara,Hambantota,Hambantota,Southern,9601,7340,16941,384040,293600,677640
10/26/2024,Nimal Abesekara,Hambantota,Hambantota,Southern,8789,1065,9854,351560,42600,394160
10/27/2024,Nimal Abesekara,Hambantota,Hambantota,Southern,723,8077,8800,28920,323080,352000
10/28/2024,Nimal Abesekara,Hambantota,Hambantota,Southern,1291,2483,3774,51640,99320,150960
10/29/2024,Nimal Abesekara,Hambantota,Hambantota,Southern,6426,3327,9753,257040,133080,390120
10/30/2024,Nimal Abesekara,Hambantota,Hambantota,Southern,1649,7714,9363,65960,308560,374520
10/31/2024,Nimal Abesekara,Hambantota,Hambantota,Southern,3037,9302,12339,121480,372080,493560
11/1/2024,Nimal Abesekara,Hambantota,Hambantota,Southern,787,7105,7892,31480,284200,315680
11/2/2024,Nimal Abesekara,Hambantota,Hambantota,Southern,6968,4687,11655,278720,187480,466200
11/3/2024,Nimal Abesekara,Hambantota,Hambantota,Southern,9313,3032,12345,372520,121280,493800
11/4/2024,Nimal Abesekara,Hambantota,Hambantota,Southern,2789,2954,5743,111560,118160,229720
11/5/2024,Nimal Abesekara,Hambantota,Hambantota,Southern,6118,8133,14251,244720,325320,570040
11/6/2024,Nimal Abesekara,Hambantota,Hambantota,Southern,3983,5582,9565,159320,223280,382600
11/7/2024,Nimal Abesekara,Hambantota,Hambantota,Southern,8776,4225,13001,351040,169000,520040
11/8/2024,Nimal Abesekara,Hambantota,Hambantota,Southern,9550,7786,17336,382000,311440,693440
11/9/2024,Nimal Abesekara,Hambantota,Hambantota,Southern,8875,3264,12139,355000,130560,485560
11/10/2024,Nimal Abesekara,Hambantota,Hambantota,Southern,7655,3999,11654,306200,159960,466160
11/11/2024,Nimal Abesekara,Hambantota,Hambantota,Southern,8154,7324,15478,326160,292960,619120
11/12/2024,Nimal Abesekara,Hambantota,Hambantota,Southern,406,8680,9086,16240,347200,363440
11/13/2024,Nimal Abesekara,Hambantota,Hambantota,Southern,1988,842,2830,79520,33680,113200
11/14/2024,Nimal Abesekara,Hambantota,Hambantota,Southern,4089,6541,10630,163560,261640,425200
11/15/2024,Nimal Abesekara,Hambantota,Hambantota,Southern,7520,1169,8689,300800,46760,347560
11/16/2024,Nimal Abesekara,Hambantota,Hambantota,Southern,7144,1556,8700,285760,62240,348000
11/17/2024,Nimal Abesekara,Hambantota,Hambantota,Southern,5134,1056,6190,205360,42240,247600
11/18/2024,Nimal Abesekara,Hambantota,Hambantota,Southern,4591,4521,9112,183640,180840,364480
11/19/2024,Nimal Abesekara,Hambantota,Hambantota,Southern,4475,1502,5977,179000,60080,239080
11/20/2024,Nimal Abesekara,Hambantota,Hambantota,Southern,3384,5832,9216,135360,233280,368640
11/21/2024,Nimal Abesekara,Hambantota,Hambantota,Southern,7739,4286,12025,309560,171440,481000
11/22/2024,Nimal Abesekara,Hambantota,Hambantota,Southern,696,4945,5641,27840,197800,225640
11/23/2024,Nimal Abesekara,Hambantota,Hambantota,Southern,6454,2759,9213,258160,110360,368520
11/24/2024,Nimal Abesekara,Hambantota,Hambantota,Southern,1121,4570,5691,44840,182800,227640
11/25/2024,Nimal Abesekara,Hambantota,Hambantota,Southern,3634,4043,7677,145360,161720,307080
11/26/2024,Nimal Abesekara,Hambantota,Hambantota,Southern,9017,7927,16944,360680,317080,677760
11/27/2024,Nimal Abesekara,Hambantota,Hambantota,Southern,5098,8234,13332,203920,329360,533280
11/28/2024,Nimal Abesekara,Hambantota,Hambantota,Southern,2550,9305,11855,102000,372200,474200
11/29/2024,Nimal Abesekara,Hambantota,Hambantota,Southern,2490,3948,6438,99600,157920,257520
11/30/2024,Nimal Abesekara,Hambantota,Hambantota,Southern,8445,4978,13423,337800,199120,536920
12/1/2024,Nimal Abesekara,Hambantota,Hambantota,Southern,9377,91,9468,375080,3640,378720
12/2/2024,Nimal Abesekara,Hambantota,Hambantota,Southern,8856,6549,15405,354240,261960,616200
12/3/2024,Nimal Abesekara,Hambantota,Hambantota,Southern,3353,1485,4838,134120,59400,193520
12/4/2024,Nimal Abesekara,Hambantota,Hambantota,Southern,4570,5360,9930,182800,214400,397200
12/5/2024,Nimal Abesekara,Hambantota,Hambantota,Southern,3925,4612,8537,157000,184480,341480
12/6/2024,Nimal Abesekara,Hambantota,Hambantota,Southern,886,6159,7045,35440,246360,281800
12/7/2024,Nimal Abesekara,Hambantota,Hambantota,Southern,9247,8507,17754,369880,340280,710160
12/8/2024,Nimal Abesekara,Hambantota,Hambantota,Southern,7647,8565,16212,305880,342600,648480
12/9/2024,Nimal Abesekara,Hambantota,Hambantota,Southern,3538,4125,7663,141520,165000,306520
12/10/2024,Nimal Abesekara,Hambantota,Hambantota,Southern,4422,8285,12707,176880,331400,508280
12/11/2024,Nimal Abesekara,Hambantota,Hambantota,Southern,7369,9876,17245,294760,395040,689800
12/12/2024,Nimal Abesekara,Hambantota,Hambantota,Southern,1898,2893,4791,75920,115720,191640
12/13/2024,Nimal Abesekara,Hambantota,Hambantota,Southern,2441,8640,11081,97640,345600,443240
12/14/2024,Nimal Abesekara,Hambantota,Hambantota,Southern,2101,1285,3386,84040,51400,135440
12/15/2024,Nimal Abesekara,Hambantota,Hambantota,Southern,7360,778,8138,294400,31120,325520
12/16/2024,Nimal Abesekara,Hambantota,Hambantota,Southern,5684,9347,15031,227360,373880,601240
12/17/2024,Nimal Abesekara,Hambantota,Hambantota,Southern,3567,4669,8236,142680,186760,329440
12/18/2024,Nimal Abesekara,Hambantota,Hambantota,Southern,9677,4512,14189,387080,180480,567560
12/19/2024,Nimal Abesekara,Hambantota,Hambantota,Southern,2197,3346,5543,87880,133840,221720
12/20/2024,Nimal Abesekara,Hambantota,Hambantota,Southern,3868,7953,11821,154720,318120,472840
12/21/2024,Nimal Abesekara,Hambantota,Hambantota,Southern,2335,3119,5454,93400,124760,218160
12/22/2024,Nimal Abesekara,Hambantota,Hambantota,Southern,6049,765,6814,241960,30600,272560
12/23/2024,Nimal Abesekara,Hambantota,Hambantota,Southern,2088,4696,6784,83520,187840,271360
12/24/2024,Nimal Abesekara,Hambantota,Hambantota,Southern,1325,5323,6648,53000,212920,265920
12/25/2024,Nimal Abesekara,Hambantota,Hambantota,Southern,5634,5283,10917,225360,211320,436680
12/26/2024,Nimal Abesekara,Hambantota,Hambantota,Southern,5750,5700,11450,230000,228000,458000
12/27/2024,Nimal Abesekara,Hambantota,Hambantota,Southern,1024,9927,10951,40960,397080,438040
12/28/2024,Nimal Abesekara,Hambantota,Hambantota,Southern,6744,5609,12353,269760,224360,494120
12/29/2024,Nimal Abesekara,Hambantota,Hambantota,Southern,9497,8760,18257,379880,350400,730280
12/30/2024,Nimal Abesekara,Hambantota,Hambantota,Southern,8119,2694,10813,324760,107760,432520
12/31/2024,Nimal Abesekara,Hambantota,Hambantota,Southern,6374,1253,7627,254960,50120,305080
1/1/2025,Nimal Abesekara,Hambantota,Hambantota,Southern,7880,8981,16861,315200,359240,674440
1/2/2025,Nimal Abesekara,Hambantota,Hambantota,Southern,4328,4128,8456,173120,165120,338240
1/3/2025,Nimal Abesekara,Hambantota,Hambantota,Southern,786,8221,9007,31440,328840,360280
1/4/2025,Nimal Abesekara,Hambantota,Hambantota,Southern,4347,9777,14124,173880,391080,564960
1/5/2025,Nimal Abesekara,Hambantota,Hambantota,Southern,282,8943,9225,11280,357720,369000
1/6/2025,Nimal Abesekara,Hambantota,Hambantota,Southern,1944,3469,5413,77760,138760,216520
1/7/2025,Nimal Abesekara,Hambantota,Hambantota,Southern,8090,3115,11205,323600,124600,448200
1/8/2025,Nimal Abesekara,Hambantota,Hambantota,Southern,6466,4031,10497,258640,161240,419880
1/9/2025,Nimal Abesekara,Hambantota,Hambantota,Southern,8763,104,8867,350520,4160,354680
1/10/2025,Nimal Abesekara,Hambantota,Hambantota,Southern,3187,1266,4453,127480,50640,178120
1/11/2025,Nimal Abesekara,Hambantota,Hambantota,Southern,7126,3905,11031,285040,156200,441240
1/12/2025,Nimal Abesekara,Hambantota,Hambantota,Southern,128,824,952,5120,32960,38080
1/13/2025,Nimal Abesekara,Hambantota,Hambantota,Southern,920,5360,6280,36800,214400,251200
1/14/2025,Nimal Abesekara,Hambantota,Hambantota,Southern,1266,964,2230,50640,38560,89200
1/15/2025,Nimal Abesekara,Hambantota,Hambantota,Southern,7680,5267,12947,307200,210680,517880
1/16/2025,Nimal Abesekara,Hambantota,Hambantota,Southern,3478,8377,11855,139120,335080,474200
1/17/2025,Nimal Abesekara,Hambantota,Hambantota,Southern,8303,8533,16836,332120,341320,673440
1/18/2025,Nimal Abesekara,Hambantota,Hambantota,Southern,6775,6855,13630,271000,274200,545200
1/19/2025,Nimal Abesekara,Hambantota,Hambantota,Southern,4371,6878,11249,174840,275120,449960
1/20/2025,Nimal Abesekara,Hambantota,Hambantota,Southern,3313,6092,9405,132520,243680,376200
1/21/2025,Nimal Abesekara,Hambantota,Hambantota,Southern,2427,4368,6795,97080,174720,271800
1/22/2025,Nimal Abesekara,Hambantota,Hambantota,Southern,9601,4862,14463,384040,194480,578520
1/23/2025,Nimal Abesekara,Hambantota,Hambantota,Southern,8868,5104,13972,354720,204160,558880
1/24/2025,Nimal Abesekara,Hambantota,Hambantota,Southern,6225,2028,8253,249000,81120,330120
1/25/2025,Nimal Abesekara,Hambantota,Hambantota,Southern,1468,3773,5241,58720,150920,209640
1/26/2025,Nimal Abesekara,Hambantota,Hambantota,Southern,3374,8574,11948,134960,342960,477920
1/27/2025,Nimal Abesekara,Hambantota,Hambantota,Southern,7911,6656,14567,316440,266240,582680
1/28/2025,Nimal Abesekara,Hambantota,Hambantota,Southern,4928,4364,9292,197120,174560,371680
1/29/2025,Nimal Abesekara,Hambantota,Hambantota,Southern,6135,9519,15654,245400,380760,626160
1/30/2025,Nimal Abesekara,Hambantota,Hambantota,Southern,767,8110,8877,30680,324400,355080
1/31/2025,Nimal Abesekara,Hambantota,Hambantota,Southern,5212,4807,10019,208480,192280,400760
2/1/2025,Nimal Abesekara,Hambantota,Hambantota,Southern,8841,1630,10471,353640,65200,418840
2/2/2025,Nimal Abesekara,Hambantota,Hambantota,Southern,3242,17,3259,129680,680,130360
2/3/2025,Nimal Abesekara,Hambantota,Hambantota,Southern,4225,6485,10710,169000,259400,428400
2/4/2025,Nimal Abesekara,Hambantota,Hambantota,Southern,2156,7818,9974,86240,312720,398960
2/5/2025,Nimal Abesekara,Hambantota,Hambantota,Southern,982,9372,10354,39280,374880,414160
2/6/2025,Nimal Abesekara,Hambantota,Hambantota,Southern,2988,3517,6505,119520,140680,260200
2/7/2025,Nimal Abesekara,Hambantota,Hambantota,Southern,638,692,1330,25520,27680,53200
2/8/2025,Nimal Abesekara,Hambantota,Hambantota,Southern,6298,5006,11304,251920,200240,452160
2/9/2025,Nimal Abesekara,Hambantota,Hambantota,Southern,2840,9986,12826,113600,399440,513040
2/10/2025,Nimal Abesekara,Hambantota,Hambantota,Southern,2620,4089,6709,104800,163560,268360
2/11/2025,Nimal Abesekara,Hambantota,Hambantota,Southern,4212,6173,10385,168480,246920,415400
2/12/2025,Nimal Abesekara,Hambantota,Hambantota,Southern,1474,191,1665,58960,7640,66600
2/13/2025,Nimal Abesekara,Hambantota,Hambantota,Southern,8934,1548,10482,357360,61920,419280
2/14/2025,Nimal Abesekara,Hambantota,Hambantota,Southern,5531,9709,15240,221240,388360,609600
2/15/2025,Nimal Abesekara,Hambantota,Hambantota,Southern,5424,6833,12257,216960,273320,490280
2/16/2025,Nimal Abesekara,Hambantota,Hambantota,Southern,7801,3399,11200,312040,135960,448000
2/17/2025,Nimal Abesekara,Hambantota,Hambantota,Southern,6920,5248,12168,276800,209920,486720
2/18/2025,Nimal Abesekara,Hambantota,Hambantota,Southern,573,6576,7149,22920,263040,285960
2/19/2025,Nimal Abesekara,Hambantota,Hambantota,Southern,279,1313,1592,11160,52520,63680
2/20/2025,Nimal Abesekara,Hambantota,Hambantota,Southern,2736,6798,9534,109440,271920,381360
2/21/2025,Nimal Abesekara,Hambantota,Hambantota,Southern,1983,4220,6203,79320,168800,248120
2/22/2025,Nimal Abesekara,Hambantota,Hambantota,Southern,3428,6398,9826,137120,255920,393040
2/23/2025,Nimal Abesekara,Hambantota,Hambantota,Southern,6853,3838,10691,274120,153520,427640
2/24/2025,Nimal Abesekara,Hambantota,Hambantota,Southern,5691,6913,12604,227640,276520,504160
2/25/2025,Nimal Abesekara,Hambantota,Hambantota,Southern,4241,6528,10769,169640,261120,430760
2/26/2025,Nimal Abesekara,Hambantota,Hambantota,Southern,6091,7990,14081,243640,319600,563240
2/27/2025,Nimal Abesekara,Hambantota,Hambantota,Southern,6066,8976,15042,242640,359040,601680
2/28/2025,Nimal Abesekara,Hambantota,Hambantota,Southern,2039,9437,11476,81560,377480,459040
3/1/2025,Nimal Abesekara,Hambantota,Hambantota,Southern,6226,1526,7752,249040,61040,310080
3/2/2025,Nimal Abesekara,Hambantota,Hambantota,Southern,6371,3825,10196,254840,153000,407840
3/3/2025,Nimal Abesekara,Hambantota,Hambantota,Southern,2413,434,2847,96520,17360,113880
3/4/2025,Nimal Abesekara,Hambantota,Hambantota,Southern,1585,9432,11017,63400,377280,440680
3/5/2025,Nimal Abesekara,Hambantota,Hambantota,Southern,6953,652,7605,278120,26080,304200
3/6/2025,Nimal Abesekara,Hambantota,Hambantota,Southern,7570,2554,10124,302800,102160,404960
3/7/2025,Nimal Abesekara,Hambantota,Hambantota,Southern,2925,4580,7505,117000,183200,300200
3/8/2025,Nimal Abesekara,Hambantota,Hambantota,Southern,4042,8662,12704,161680,346480,508160
3/9/2025,Nimal Abesekara,Hambantota,Hambantota,Southern,8526,5877,14403,341040,235080,576120
3/10/2025,Nimal Abesekara,Hambantota,Hambantota,Southern,5954,5708,11662,238160,228320,466480
3/11/2025,Nimal Abesekara,Hambantota,Hambantota,Southern,6237,6886,13123,249480,275440,524920
3/12/2025,Nimal Abesekara,Hambantota,Hambantota,Southern,3870,5924,9794,154800,236960,391760
3/13/2025,Nimal Abesekara,Hambantota,Hambantota,Southern,5873,3912,9785,234920,156480,391400
3/14/2025,Nimal Abesekara,Hambantota,Hambantota,Southern,256,1551,1807,10240,62040,72280
3/15/2025,Nimal Abesekara,Hambantota,Hambantota,Southern,3207,8039,11246,128280,321560,449840
3/16/2025,Nimal Abesekara,Hambantota,Hambantota,Southern,5220,6136,11356,208800,245440,454240
3/17/2025,Nimal Abesekara,Hambantota,Hambantota,Southern,8567,4420,12987,342680,176800,519480
3/18/2025,Nimal Abesekara,Hambantota,Hambantota,Southern,230,465,695,9200,18600,27800
3/19/2025,Nimal Abesekara,Hambantota,Hambantota,Southern,8787,4001,12788,351480,160040,511520
3/20/2025,Nimal Abesekara,Hambantota,Hambantota,Southern,9431,3808,13239,377240,152320,529560
3/21/2025,Nimal Abesekara,Hambantota,Hambantota,Southern,3470,3171,6641,138800,126840,265640
3/22/2025,Nimal Abesekara,Hambantota,Hambantota,Southern,4867,7681,12548,194680,307240,501920
3/23/2025,Nimal Abesekara,Hambantota,Hambantota,Southern,1479,3542,5021,59160,141680,200840
3/25/2024,Kamal Sahabandu,Moneragala,Kataragama,Uva,1317,5172,6489,52680,206880,259560
3/26/2024,Kamal Sahabandu,Moneragala,Kataragama,Uva,1653,3008,4661,66120,120320,186440
3/27/2024,Kamal Sahabandu,Moneragala,Kataragama,Uva,2843,2615,5458,113720,104600,218320
3/28/2024,Kamal Sahabandu,Moneragala,Kataragama,Uva,3323,3367,6690,132920,134680,267600
3/29/2024,Kamal Sahabandu,Moneragala,Kataragama,Uva,1385,4088,5473,55400,163520,218920
3/30/2024,Kamal Sahabandu,Moneragala,Kataragama,Uva,4195,7510,11705,167800,300400,468200
3/31/2024,Kamal Sahabandu,Moneragala,Kataragama,Uva,19,4317,4336,760,172680,173440
4/1/2024,Kamal Sahabandu,Moneragala,Kataragama,Uva,9506,5550,15056,380240,222000,602240
4/2/2024,Kamal Sahabandu,Moneragala,Kataragama,Uva,6921,2101,9022,276840,84040,360880
4/3/2024,Kamal Sahabandu,Moneragala,Kataragama,Uva,54,3747,3801,2160,149880,152040
4/4/2024,Kamal Sahabandu,Moneragala,Kataragama,Uva,659,1931,2590,26360,77240,103600
4/5/2024,Kamal Sahabandu,Moneragala,Kataragama,Uva,5164,3689,8853,206560,147560,354120
4/6/2024,Kamal Sahabandu,Moneragala,Kataragama,Uva,4720,4653,9373,188800,186120,374920
4/7/2024,Kamal Sahabandu,Moneragala,Kataragama,Uva,8251,7087,15338,330040,283480,613520
4/8/2024,Kamal Sahabandu,Moneragala,Kataragama,Uva,165,9395,9560,6600,375800,382400
4/9/2024,Kamal Sahabandu,Moneragala,Kataragama,Uva,7651,6402,14053,306040,256080,562120
4/10/2024,Kamal Sahabandu,Moneragala,Kataragama,Uva,3477,5063,8540,139080,202520,341600
4/11/2024,Kamal Sahabandu,Moneragala,Kataragama,Uva,4278,4561,8839,171120,182440,353560
4/19/2024,Kamal Sahabandu,Moneragala,Kataragama,Uva,8760,6025,14785,350400,241000,591400
4/20/2024,Kamal Sahabandu,Moneragala,Kataragama,Uva,8230,3215,11445,329200,128600,457800
4/21/2024,Kamal Sahabandu,Moneragala,Kataragama,Uva,8963,9545,18508,358520,381800,740320
4/22/2024,Kamal Sahabandu,Moneragala,Kataragama,Uva,1699,5458,7157,67960,218320,286280
4/23/2024,Kamal Sahabandu,Moneragala,Kataragama,Uva,6116,9891,16007,244640,395640,640280
4/24/2024,Kamal Sahabandu,Moneragala,Kataragama,Uva,9297,5992,15289,371880,239680,611560
4/25/2024,Kamal Sahabandu,Moneragala,Kataragama,Uva,8978,6116,15094,359120,244640,603760
4/26/2024,Kamal Sahabandu,Moneragala,Kataragama,Uva,6429,6838,13267,257160,273520,530680
4/27/2024,Kamal Sahabandu,Moneragala,Kataragama,Uva,3116,2442,5558,124640,97680,222320
4/28/2024,Kamal Sahabandu,Moneragala,Kataragama,Uva,689,1252,1941,27560,50080,77640
4/29/2024,Kamal Sahabandu,Moneragala,Kataragama,Uva,8188,6210,14398,327520,248400,575920
4/30/2024,Kamal Sahabandu,Moneragala,Kataragama,Uva,7054,8185,15239,282160,327400,609560
5/1/2024,Kamal Sahabandu,Moneragala,Kataragama,Uva,2157,951,3108,86280,38040,124320
5/2/2024,Kamal Sahabandu,Moneragala,Kataragama,Uva,9096,4017,13113,363840,160680,524520
5/3/2024,Kamal Sahabandu,Moneragala,Kataragama,Uva,5236,3712,8948,209440,148480,357920
5/4/2024,Kamal Sahabandu,Moneragala,Kataragama,Uva,3784,7511,11295,151360,300440,451800
5/5/2024,Kamal Sahabandu,Moneragala,Kataragama,Uva,4514,4734,9248,180560,189360,369920
5/6/2024,Kamal Sahabandu,Moneragala,Kataragama,Uva,2804,8160,10964,112160,326400,438560
5/7/2024,Kamal Sahabandu,Moneragala,Kataragama,Uva,9238,7318,16556,369520,292720,662240
5/8/2024,Kamal Sahabandu,Moneragala,Kataragama,Uva,4002,4615,8617,160080,184600,344680
5/9/2024,Kamal Sahabandu,Moneragala,Kataragama,Uva,9179,6142,15321,367160,245680,612840
5/10/2024,Kamal Sahabandu,Moneragala,Kataragama,Uva,3433,3072,6505,137320,122880,260200
5/11/2024,Kamal Sahabandu,Moneragala,Kataragama,Uva,7399,9204,16603,295960,368160,664120
5/12/2024,Kamal Sahabandu,Moneragala,Kataragama,Uva,1012,1767,2779,40480,70680,111160
5/13/2024,Kamal Sahabandu,Moneragala,Kataragama,Uva,2932,2220,5152,117280,88800,206080
5/14/2024,Kamal Sahabandu,Moneragala,Kataragama,Uva,2056,9135,11191,82240,365400,447640
5/15/2024,Kamal Sahabandu,Moneragala,Kataragama,Uva,1393,9680,11073,55720,387200,442920
5/16/2024,Kamal Sahabandu,Moneragala,Kataragama,Uva,5445,6919,12364,217800,276760,494560
5/17/2024,Kamal Sahabandu,Moneragala,Kataragama,Uva,5180,3563,8743,207200,142520,349720
5/18/2024,Kamal Sahabandu,Moneragala,Kataragama,Uva,851,9314,10165,34040,372560,406600
5/19/2024,Kamal Sahabandu,Moneragala,Kataragama,Uva,5603,2083,7686,224120,83320,307440
5/20/2024,Kamal Sahabandu,Moneragala,Kataragama,Uva,5690,6300,11990,227600,252000,479600
5/21/2024,Kamal Sahabandu,Moneragala,Kataragama,Uva,2164,2709,4873,86560,108360,194920
5/22/2024,Kamal Sahabandu,Moneragala,Kataragama,Uva,5088,1600,6688,203520,64000,267520
5/24/2024,Kamal Sahabandu,Moneragala,Kataragama,Uva,7560,4621,12181,302400,184840,487240
5/25/2024,Kamal Sahabandu,Moneragala,Kataragama,Uva,5280,7593,12873,211200,303720,514920
5/26/2024,Kamal Sahabandu,Moneragala,Kataragama,Uva,8339,5425,13764,333560,217000,550560
5/27/2024,Kamal Sahabandu,Moneragala,Kataragama,Uva,9929,9148,19077,397160,365920,763080
5/28/2024,Kamal Sahabandu,Moneragala,Kataragama,Uva,9681,3551,13232,387240,142040,529280
5/29/2024,Kamal Sahabandu,Moneragala,Kataragama,Uva,4269,1003,5272,170760,40120,210880
5/30/2024,Kamal Sahabandu,Moneragala,Kataragama,Uva,9228,3829,13057,369120,153160,522280
5/31/2024,Kamal Sahabandu,Moneragala,Kataragama,Uva,7461,1839,9300,298440,73560,372000
6/1/2024,Kamal Sahabandu,Moneragala,Kataragama,Uva,1928,9299,11227,77120,371960,449080
6/2/2024,Kamal Sahabandu,Moneragala,Kataragama,Uva,9537,5073,14610,381480,202920,584400
6/3/2024,Kamal Sahabandu,Moneragala,Kataragama,Uva,9522,9037,18559,380880,361480,742360
6/4/2024,Kamal Sahabandu,Moneragala,Kataragama,Uva,2201,2565,4766,88040,102600,190640
6/5/2024,Kamal Sahabandu,Moneragala,Kataragama,Uva,1579,9501,11080,63160,380040,443200
6/6/2024,Kamal Sahabandu,Moneragala,Kataragama,Uva,8643,5068,13711,345720,202720,548440
6/7/2024,Kamal Sahabandu,Moneragala,Kataragama,Uva,3722,2820,6542,148880,112800,261680
6/8/2024,Kamal Sahabandu,Moneragala,Kataragama,Uva,7691,6751,14442,307640,270040,577680
6/9/2024,Kamal Sahabandu,Moneragala,Kataragama,Uva,3833,6505,10338,153320,260200,413520
6/10/2024,Kamal Sahabandu,Moneragala,Kataragama,Uva,7982,7083,15065,319280,283320,602600
6/11/2024,Kamal Sahabandu,Moneragala,Kataragama,Uva,6696,2654,9350,267840,106160,374000
6/12/2024,Kamal Sahabandu,Moneragala,Kataragama,Uva,7196,9076,16272,287840,363040,650880
6/13/2024,Kamal Sahabandu,Moneragala,Kataragama,Uva,4799,3464,8263,191960,138560,330520
6/14/2024,Kamal Sahabandu,Moneragala,Kataragama,Uva,6550,5458,12008,262000,218320,480320
6/15/2024,Kamal Sahabandu,Moneragala,Kataragama,Uva,3368,3837,7205,134720,153480,288200
6/16/2024,Kamal Sahabandu,Moneragala,Kataragama,Uva,4886,9622,14508,195440,384880,580320
6/17/2024,Kamal Sahabandu,Moneragala,Kataragama,Uva,8735,6524,15259,349400,260960,610360
6/18/2024,Kamal Sahabandu,Moneragala,Kataragama,Uva,1088,8373,9461,43520,334920,378440
6/19/2024,Kamal Sahabandu,Moneragala,Kataragama,Uva,135,7243,7378,5400,289720,295120
6/20/2024,Kamal Sahabandu,Moneragala,Kataragama,Uva,5720,3643,9363,228800,145720,374520
6/21/2024,Kamal Sahabandu,Moneragala,Kataragama,Uva,3162,852,4014,126480,34080,160560
6/22/2024,Kamal Sahabandu,Moneragala,Kataragama,Uva,3310,8487,11797,132400,339480,471880
6/23/2024,Kamal Sahabandu,Moneragala,Kataragama,Uva,2665,7248,9913,106600,289920,396520
6/24/2024,Kamal Sahabandu,Moneragala,Kataragama,Uva,8137,1841,9978,325480,73640,399120
6/25/2024,Kamal Sahabandu,Moneragala,Kataragama,Uva,2974,1140,4114,118960,45600,164560
6/26/2024,Kamal Sahabandu,Moneragala,Kataragama,Uva,6148,4068,10216,245920,162720,408640
6/27/2024,Kamal Sahabandu,Moneragala,Kataragama,Uva,7613,5597,13210,304520,223880,528400
6/28/2024,Kamal Sahabandu,Moneragala,Kataragama,Uva,6512,7387,13899,260480,295480,555960
6/29/2024,Kamal Sahabandu,Moneragala,Kataragama,Uva,2029,8022,10051,81160,320880,402040
6/30/2024,Kamal Sahabandu,Moneragala,Kataragama,Uva,889,7743,8632,35560,309720,345280
7/1/2024,Kamal Sahabandu,Moneragala,Kataragama,Uva,7305,7272,14577,292200,290880,583080
7/2/2024,Kamal Sahabandu,Moneragala,Kataragama,Uva,6807,5852,12659,272280,234080,506360
7/3/2024,Kamal Sahabandu,Moneragala,Kataragama,Uva,1154,8167,9321,46160,326680,372840
7/4/2024,Kamal Sahabandu,Moneragala,Kataragama,Uva,3534,1142,4676,141360,45680,187040
7/5/2024,Kamal Sahabandu,Moneragala,Kataragama,Uva,4477,9719,14196,179080,388760,567840
7/6/2024,Kamal Sahabandu,Moneragala,Kataragama,Uva,8832,6785,15617,353280,271400,624680
7/7/2024,Kamal Sahabandu,Moneragala,Kataragama,Uva,5955,5679,11634,238200,227160,465360
7/8/2024,Kamal Sahabandu,Moneragala,Kataragama,Uva,8253,6487,14740,330120,259480,589600
7/9/2024,Kamal Sahabandu,Moneragala,Kataragama,Uva,2057,7273,9330,82280,290920,373200
7/10/2024,Kamal Sahabandu,Moneragala,Kataragama,Uva,7597,53,7650,303880,2120,306000
7/11/2024,Kamal Sahabandu,Moneragala,Kataragama,Uva,4967,9681,14648,198680,387240,585920
7/12/2024,Kamal Sahabandu,Moneragala,Kataragama,Uva,5866,720,6586,234640,28800,263440
7/13/2024,Kamal Sahabandu,Moneragala,Kataragama,Uva,3761,5372,9133,150440,214880,365320
7/14/2024,Kamal Sahabandu,Moneragala,Kataragama,Uva,166,2104,2270,6640,84160,90800
7/15/2024,Kamal Sahabandu,Moneragala,Kataragama,Uva,1769,3620,5389,70760,144800,215560
7/16/2024,Kamal Sahabandu,Moneragala,Kataragama,Uva,9281,7899,17180,371240,315960,687200
7/17/2024,Kamal Sahabandu,Moneragala,Kataragama,Uva,4153,9215,13368,166120,368600,534720
7/18/2024,Kamal Sahabandu,Moneragala,Kataragama,Uva,9803,8316,18119,392120,332640,724760
7/19/2024,Kamal Sahabandu,Moneragala,Kataragama,Uva,9649,2734,12383,385960,109360,495320
7/20/2024,Kamal Sahabandu,Moneragala,Kataragama,Uva,543,2622,3165,21720,104880,126600
7/21/2024,Kamal Sahabandu,Moneragala,Kataragama,Uva,6849,9153,16002,273960,366120,640080
7/22/2024,Kamal Sahabandu,Moneragala,Kataragama,Uva,3768,4413,8181,150720,176520,327240
7/23/2024,Kamal Sahabandu,Moneragala,Kataragama,Uva,1627,8462,10089,65080,338480,403560
7/24/2024,Kamal Sahabandu,Moneragala,Kataragama,Uva,5824,2168,7992,232960,86720,319680
7/25/2024,Kamal Sahabandu,Moneragala,Kataragama,Uva,5479,9123,14602,219160,364920,584080
7/26/2024,Kamal Sahabandu,Moneragala,Kataragama,Uva,9429,1558,10987,377160,62320,439480
7/27/2024,Kamal Sahabandu,Moneragala,Kataragama,Uva,1970,1374,3344,78800,54960,133760
7/28/2024,Kamal Sahabandu,Moneragala,Kataragama,Uva,6756,818,7574,270240,32720,302960
7/29/2024,Kamal Sahabandu,Moneragala,Kataragama,Uva,6177,9378,15555,247080,375120,622200
7/30/2024,Kamal Sahabandu,Moneragala,Kataragama,Uva,6775,4172,10947,271000,166880,437880
7/31/2024,Kamal Sahabandu,Moneragala,Kataragama,Uva,1086,6807,7893,43440,272280,315720
8/1/2024,Kamal Sahabandu,Moneragala,Kataragama,Uva,7220,4395,11615,288800,175800,464600
8/2/2024,Kamal Sahabandu,Moneragala,Kataragama,Uva,7725,90,7815,309000,3600,312600
8/3/2024,Kamal Sahabandu,Moneragala,Kataragama,Uva,710,9333,10043,28400,373320,401720
8/4/2024,Kamal Sahabandu,Moneragala,Kataragama,Uva,9299,8320,17619,371960,332800,704760
8/5/2024,Kamal Sahabandu,Moneragala,Kataragama,Uva,9040,2542,11582,361600,101680,463280
8/6/2024,Kamal Sahabandu,Moneragala,Kataragama,Uva,4602,1775,6377,184080,71000,255080
8/7/2024,Kamal Sahabandu,Moneragala,Kataragama,Uva,2546,8054,10600,101840,322160,424000
8/8/2024,Kamal Sahabandu,Moneragala,Kataragama,Uva,7871,5917,13788,314840,236680,551520
8/9/2024,Kamal Sahabandu,Moneragala,Kataragama,Uva,2623,1793,4416,104920,71720,176640
8/10/2024,Kamal Sahabandu,Moneragala,Kataragama,Uva,6007,8689,14696,240280,347560,587840
8/11/2024,Kamal Sahabandu,Moneragala,Kataragama,Uva,448,2616,3064,17920,104640,122560
8/12/2024,Kamal Sahabandu,Moneragala,Kataragama,Uva,3719,1924,5643,148760,76960,225720
8/13/2024,Kamal Sahabandu,Moneragala,Kataragama,Uva,1354,7575,8929,54160,303000,357160
8/14/2024,Kamal Sahabandu,Moneragala,Kataragama,Uva,3367,8883,12250,134680,355320,490000
8/15/2024,Kamal Sahabandu,Moneragala,Kataragama,Uva,8189,679,8868,327560,27160,354720
8/16/2024,Kamal Sahabandu,Moneragala,Kataragama,Uva,5179,4318,9497,207160,172720,379880
8/17/2024,Kamal Sahabandu,Moneragala,Kataragama,Uva,342,5353,5695,13680,214120,227800
8/18/2024,Kamal Sahabandu,Moneragala,Kataragama,Uva,7352,545,7897,294080,21800,315880
8/19/2024,Kamal Sahabandu,Moneragala,Kataragama,Uva,9871,5947,15818,394840,237880,632720
8/20/2024,Kamal Sahabandu,Moneragala,Kataragama,Uva,3612,832,4444,144480,33280,177760
8/21/2024,Kamal Sahabandu,Moneragala,Kataragama,Uva,5838,4342,10180,233520,173680,407200
8/22/2024,Kamal Sahabandu,Moneragala,Kataragama,Uva,6399,2341,8740,255960,93640,349600
8/23/2024,Kamal Sahabandu,Moneragala,Kataragama,Uva,3266,4316,7582,130640,172640,303280
8/24/2024,Kamal Sahabandu,Moneragala,Kataragama,Uva,5529,9864,15393,221160,394560,615720
8/25/2024,Kamal Sahabandu,Moneragala,Kataragama,Uva,51,9596,9647,2040,383840,385880
8/26/2024,Kamal Sahabandu,Moneragala,Kataragama,Uva,8793,9980,18773,351720,399200,750920
8/27/2024,Kamal Sahabandu,Moneragala,Kataragama,Uva,8969,7298,16267,358760,291920,650680
8/28/2024,Kamal Sahabandu,Moneragala,Kataragama,Uva,8621,8466,17087,344840,338640,683480
8/29/2024,Kamal Sahabandu,Moneragala,Kataragama,Uva,9838,7995,17833,393520,319800,713320
8/30/2024,Kamal Sahabandu,Moneragala,Kataragama,Uva,4437,9235,13672,177480,369400,546880
8/31/2024,Kamal Sahabandu,Moneragala,Kataragama,Uva,2206,5960,8166,88240,238400,326640
9/1/2024,Kamal Sahabandu,Moneragala,Kataragama,Uva,8349,8083,16432,333960,323320,657280
9/2/2024,Kamal Sahabandu,Moneragala,Kataragama,Uva,2083,8291,10374,83320,331640,414960
9/3/2024,Kamal Sahabandu,Moneragala,Kataragama,Uva,8685,3397,12082,347400,135880,483280
9/4/2024,Kamal Sahabandu,Moneragala,Kataragama,Uva,1945,1099,3044,77800,43960,121760
9/5/2024,Kamal Sahabandu,Moneragala,Kataragama,Uva,1827,1780,3607,73080,71200,144280
9/6/2024,Kamal Sahabandu,Moneragala,Kataragama,Uva,8208,4728,12936,328320,189120,517440
9/7/2024,Kamal Sahabandu,Moneragala,Kataragama,Uva,985,4243,5228,39400,169720,209120
9/8/2024,Kamal Sahabandu,Moneragala,Kataragama,Uva,9054,3432,12486,362160,137280,499440
9/9/2024,Kamal Sahabandu,Moneragala,Kataragama,Uva,8651,7889,16540,346040,315560,661600
9/10/2024,Kamal Sahabandu,Moneragala,Kataragama,Uva,1436,7787,9223,57440,311480,368920
9/11/2024,Kamal Sahabandu,Moneragala,Kataragama,Uva,4356,7404,11760,174240,296160,470400
9/12/2024,Kamal Sahabandu,Moneragala,Kataragama,Uva,4884,915,5799,195360,36600,231960
9/13/2024,Kamal Sahabandu,Moneragala,Kataragama,Uva,6153,2156,8309,246120,86240,332360
9/14/2024,Kamal Sahabandu,Moneragala,Kataragama,Uva,5235,7145,12380,209400,285800,495200
9/15/2024,Kamal Sahabandu,Moneragala,Kataragama,Uva,2922,5280,8202,116880,211200,328080
9/16/2024,Kamal Sahabandu,Moneragala,Kataragama,Uva,9286,7876,17162,371440,315040,686480
9/17/2024,Kamal Sahabandu,Moneragala,Kataragama,Uva,138,8658,8796,5520,346320,351840
9/18/2024,Kamal Sahabandu,Moneragala,Kataragama,Uva,667,1113,1780,26680,44520,71200
9/19/2024,Kamal Sahabandu,Moneragala,Kataragama,Uva,6336,385,6721,253440,15400,268840
9/20/2024,Kamal Sahabandu,Moneragala,Kataragama,Uva,8734,8095,16829,349360,323800,673160
9/21/2024,Kamal Sahabandu,Moneragala,Kataragama,Uva,5961,2306,8267,238440,92240,330680
9/22/2024,Kamal Sahabandu,Moneragala,Kataragama,Uva,3254,4496,7750,130160,179840,310000
9/23/2024,Kamal Sahabandu,Moneragala,Kataragama,Uva,7493,5871,13364,299720,234840,534560
9/24/2024,Kamal Sahabandu,Moneragala,Kataragama,Uva,7106,8802,15908,284240,352080,636320
9/25/2024,Kamal Sahabandu,Moneragala,Kataragama,Uva,9352,1487,10839,374080,59480,433560
9/26/2024,Kamal Sahabandu,Moneragala,Kataragama,Uva,4106,8252,12358,164240,330080,494320
9/27/2024,Kamal Sahabandu,Moneragala,Kataragama,Uva,5998,2800,8798,239920,112000,351920
9/28/2024,Kamal Sahabandu,Moneragala,Kataragama,Uva,9510,6578,16088,380400,263120,643520
9/29/2024,Kamal Sahabandu,Moneragala,Kataragama,Uva,2102,3555,5657,84080,142200,226280
9/30/2024,Kamal Sahabandu,Moneragala,Kataragama,Uva,9457,743,10200,378280,29720,408000
10/1/2024,Kamal Sahabandu,Moneragala,Kataragama,Uva,1418,9372,10790,56720,374880,431600
10/2/2024,Kamal Sahabandu,Moneragala,Kataragama,Uva,1748,1194,2942,69920,47760,117680
10/3/2024,Kamal Sahabandu,Moneragala,Kataragama,Uva,8540,5711,14251,341600,228440,570040
10/4/2024,Kamal Sahabandu,Moneragala,Kataragama,Uva,9311,3324,12635,372440,132960,505400
10/5/2024,Kamal Sahabandu,Moneragala,Kataragama,Uva,6680,9996,16676,267200,399840,667040
10/6/2024,Kamal Sahabandu,Moneragala,Kataragama,Uva,1718,2526,4244,68720,101040,169760
10/7/2024,Kamal Sahabandu,Moneragala,Kataragama,Uva,3706,934,4640,148240,37360,185600
10/8/2024,Kamal Sahabandu,Moneragala,Kataragama,Uva,5246,1039,6285,209840,41560,251400
10/9/2024,Kamal Sahabandu,Moneragala,Kataragama,Uva,8979,1138,10117,359160,45520,404680
10/10/2024,Kamal Sahabandu,Moneragala,Kataragama,Uva,6377,4536,10913,255080,181440,436520
10/11/2024,Kamal Sahabandu,Moneragala,Kataragama,Uva,8015,8309,16324,320600,332360,652960
10/12/2024,Kamal Sahabandu,Moneragala,Kataragama,Uva,2191,795,2986,87640,31800,119440
10/13/2024,Kamal Sahabandu,Moneragala,Kataragama,Uva,196,8674,8870,7840,346960,354800
10/14/2024,Kamal Sahabandu,Moneragala,Kataragama,Uva,4841,1199,6040,193640,47960,241600
10/15/2024,Kamal Sahabandu,Moneragala,Kataragama,Uva,17,3197,3214,680,127880,128560
10/16/2024,Kamal Sahabandu,Moneragala,Kataragama,Uva,2178,2856,5034,87120,114240,201360
10/17/2024,Kamal Sahabandu,Moneragala,Kataragama,Uva,3793,1723,5516,151720,68920,220640
10/18/2024,Kamal Sahabandu,Moneragala,Kataragama,Uva,9291,2795,12086,371640,111800,483440
10/19/2024,Kamal Sahabandu,Moneragala,Kataragama,Uva,996,2600,3596,39840,104000,143840
10/20/2024,Kamal Sahabandu,Moneragala,Kataragama,Uva,2482,1049,3531,99280,41960,141240
10/21/2024,Kamal Sahabandu,Moneragala,Kataragama,Uva,4386,8297,12683,175440,331880,507320
10/22/2024,Kamal Sahabandu,Moneragala,Kataragama,Uva,30,94,124,1200,3760,4960
10/23/2024,Kamal Sahabandu,Moneragala,Kataragama,Uva,4186,3057,7243,167440,122280,289720
10/24/2024,Kamal Sahabandu,Moneragala,Kataragama,Uva,2479,8694,11173,99160,347760,446920
10/25/2024,Kamal Sahabandu,Moneragala,Kataragama,Uva,3715,7303,11018,148600,292120,440720
10/26/2024,Kamal Sahabandu,Moneragala,Kataragama,Uva,183,6330,6513,7320,253200,260520
10/27/2024,Kamal Sahabandu,Moneragala,Kataragama,Uva,6298,5865,12163,251920,234600,486520
10/28/2024,Kamal Sahabandu,Moneragala,Kataragama,Uva,1467,5761,7228,58680,230440,289120
10/29/2024,Kamal Sahabandu,Moneragala,Kataragama,Uva,5270,7582,12852,210800,303280,514080
10/30/2024,Kamal Sahabandu,Moneragala,Kataragama,Uva,2953,9717,12670,118120,388680,506800
10/31/2024,Kamal Sahabandu,Moneragala,Kataragama,Uva,5232,3229,8461,209280,129160,338440
11/1/2024,Kamal Sahabandu,Moneragala,Kataragama,Uva,5576,4070,9646,223040,162800,385840
11/2/2024,Kamal Sahabandu,Moneragala,Kataragama,Uva,9234,7295,16529,369360,291800,661160
11/3/2024,Kamal Sahabandu,Moneragala,Kataragama,Uva,5696,2344,8040,227840,93760,321600
11/4/2024,Kamal Sahabandu,Moneragala,Kataragama,Uva,5947,8842,14789,237880,353680,591560
11/5/2024,Kamal Sahabandu,Moneragala,Kataragama,Uva,4249,5926,10175,169960,237040,407000
11/6/2024,Kamal Sahabandu,Moneragala,Kataragama,Uva,9983,5297,15280,399320,211880,611200
11/7/2024,Kamal Sahabandu,Moneragala,Kataragama,Uva,8228,7403,15631,329120,296120,625240
11/8/2024,Kamal Sahabandu,Moneragala,Kataragama,Uva,2740,3600,6340,109600,144000,253600
11/9/2024,Kamal Sahabandu,Moneragala,Kataragama,Uva,6466,4446,10912,258640,177840,436480
11/10/2024,Kamal Sahabandu,Moneragala,Kataragama,Uva,1091,7723,8814,43640,308920,352560
11/11/2024,Kamal Sahabandu,Moneragala,Kataragama,Uva,8231,6863,15094,329240,274520,603760
11/12/2024,Kamal Sahabandu,Moneragala,Kataragama,Uva,6434,4184,10618,257360,167360,424720
11/13/2024,Kamal Sahabandu,Moneragala,Kataragama,Uva,2992,8629,11621,119680,345160,464840
11/14/2024,Kamal Sahabandu,Moneragala,Kataragama,Uva,5290,9421,14711,211600,376840,588440
11/15/2024,Kamal Sahabandu,Moneragala,Kataragama,Uva,7185,6367,13552,287400,254680,542080
11/16/2024,Kamal Sahabandu,Moneragala,Kataragama,Uva,1230,5162,6392,49200,206480,255680
11/17/2024,Kamal Sahabandu,Moneragala,Kataragama,Uva,9601,7214,16815,384040,288560,672600
11/18/2024,Kamal Sahabandu,Moneragala,Kataragama,Uva,4679,2850,7529,187160,114000,301160
11/19/2024,Kamal Sahabandu,Moneragala,Kataragama,Uva,204,8486,8690,8160,339440,347600
11/20/2024,Kamal Sahabandu,Moneragala,Kataragama,Uva,576,4610,5186,23040,184400,207440
11/21/2024,Kamal Sahabandu,Moneragala,Kataragama,Uva,3674,3627,7301,146960,145080,292040
11/22/2024,Kamal Sahabandu,Moneragala,Kataragama,Uva,2770,3225,5995,110800,129000,239800
11/23/2024,Kamal Sahabandu,Moneragala,Kataragama,Uva,5533,3785,9318,221320,151400,372720
11/24/2024,Kamal Sahabandu,Moneragala,Kataragama,Uva,527,4507,5034,21080,180280,201360
11/25/2024,Kamal Sahabandu,Moneragala,Kataragama,Uva,3683,2488,6171,147320,99520,246840
11/26/2024,Kamal Sahabandu,Moneragala,Kataragama,Uva,6681,6473,13154,267240,258920,526160
11/27/2024,Kamal Sahabandu,Moneragala,Kataragama,Uva,3055,9226,12281,122200,369040,491240
11/28/2024,Kamal Sahabandu,Moneragala,Kataragama,Uva,914,5021,5935,36560,200840,237400
11/29/2024,Kamal Sahabandu,Moneragala,Kataragama,Uva,4370,8807,13177,174800,352280,527080
11/30/2024,Kamal Sahabandu,Moneragala,Kataragama,Uva,2925,7105,10030,117000,284200,401200
12/1/2024,Kamal Sahabandu,Moneragala,Kataragama,Uva,6318,3233,9551,252720,129320,382040
12/2/2024,Kamal Sahabandu,Moneragala,Kataragama,Uva,7021,7794,14815,280840,311760,592600
12/3/2024,Kamal Sahabandu,Moneragala,Kataragama,Uva,6650,5476,12126,266000,219040,485040
12/4/2024,Kamal Sahabandu,Moneragala,Kataragama,Uva,1732,9344,11076,69280,373760,443040
12/5/2024,Kamal Sahabandu,Moneragala,Kataragama,Uva,6456,1662,8118,258240,66480,324720
12/6/2024,Kamal Sahabandu,Moneragala,Kataragama,Uva,2697,7865,10562,107880,314600,422480
12/7/2024,Kamal Sahabandu,Moneragala,Kataragama,Uva,7626,9488,17114,305040,379520,684560
12/8/2024,Kamal Sahabandu,Moneragala,Kataragama,Uva,6599,1952,8551,263960,78080,342040
12/9/2024,Kamal Sahabandu,Moneragala,Kataragama,Uva,7132,2808,9940,285280,112320,397600
12/10/2024,Kamal Sahabandu,Moneragala,Kataragama,Uva,3058,6856,9914,122320,274240,396560
12/11/2024,Kamal Sahabandu,Moneragala,Kataragama,Uva,8879,3103,11982,355160,124120,479280
12/12/2024,Kamal Sahabandu,Moneragala,Kataragama,Uva,3802,6954,10756,152080,278160,430240
12/13/2024,Kamal Sahabandu,Moneragala,Kataragama,Uva,8210,899,9109,328400,35960,364360
12/14/2024,Kamal Sahabandu,Moneragala,Kataragama,Uva,4852,3971,8823,194080,158840,352920
12/15/2024,Kamal Sahabandu,Moneragala,Kataragama,Uva,9192,8327,17519,367680,333080,700760
12/16/2024,Kamal Sahabandu,Moneragala,Kataragama,Uva,3071,1648,4719,122840,65920,188760
12/17/2024,Kamal Sahabandu,Moneragala,Kataragama,Uva,5454,1818,7272,218160,72720,290880
12/18/2024,Kamal Sahabandu,Moneragala,Kataragama,Uva,3158,1604,4762,126320,64160,190480
12/19/2024,Kamal Sahabandu,Moneragala,Kataragama,Uva,9069,6064,15133,362760,242560,605320
12/20/2024,Kamal Sahabandu,Moneragala,Kataragama,Uva,8583,8439,17022,343320,337560,680880
12/21/2024,Kamal Sahabandu,Moneragala,Kataragama,Uva,5892,8922,14814,235680,356880,592560
12/22/2024,Kamal Sahabandu,Moneragala,Kataragama,Uva,5415,5251,10666,216600,210040,426640
12/23/2024,Kamal Sahabandu,Moneragala,Kataragama,Uva,6537,1542,8079,261480,61680,323160
12/24/2024,Kamal Sahabandu,Moneragala,Kataragama,Uva,7315,5164,12479,292600,206560,499160
12/25/2024,Kamal Sahabandu,Moneragala,Kataragama,Uva,2241,510,2751,89640,20400,110040
12/26/2024,Kamal Sahabandu,Moneragala,Kataragama,Uva,2540,2940,5480,101600,117600,219200
12/27/2024,Kamal Sahabandu,Moneragala,Kataragama,Uva,2639,2512,5151,105560,100480,206040
12/28/2024,Kamal Sahabandu,Moneragala,Kataragama,Uva,7377,829,8206,295080,33160,328240
12/29/2024,Kamal Sahabandu,Moneragala,Kataragama,Uva,8920,4611,13531,356800,184440,541240
12/30/2024,Kamal Sahabandu,Moneragala,Kataragama,Uva,2165,2555,4720,86600,102200,188800
12/31/2024,Kamal Sahabandu,Moneragala,Kataragama,Uva,2533,3537,6070,101320,141480,242800
1/1/2025,Kamal Sahabandu,Moneragala,Kataragama,Uva,3667,1495,5162,146680,59800,206480
1/2/2025,Kamal Sahabandu,Moneragala,Kataragama,Uva,4283,4188,8471,171320,167520,338840
1/3/2025,Kamal Sahabandu,Moneragala,Kataragama,Uva,7900,431,8331,316000,17240,333240
1/4/2025,Kamal Sahabandu,Moneragala,Kataragama,Uva,5562,3125,8687,222480,125000,347480
1/5/2025,Kamal Sahabandu,Moneragala,Kataragama,Uva,5258,4828,10086,210320,193120,403440
1/6/2025,Kamal Sahabandu,Moneragala,Kataragama,Uva,7189,767,7956,287560,30680,318240
1/7/2025,Kamal Sahabandu,Moneragala,Kataragama,Uva,1606,5335,6941,64240,213400,277640
1/8/2025,Kamal Sahabandu,Moneragala,Kataragama,Uva,7565,4504,12069,302600,180160,482760
1/9/2025,Kamal Sahabandu,Moneragala,Kataragama,Uva,9953,9837,19790,398120,393480,791600
1/10/2025,Kamal Sahabandu,Moneragala,Kataragama,Uva,2151,6645,8796,86040,265800,351840
1/11/2025,Kamal Sahabandu,Moneragala,Kataragama,Uva,1618,4434,6052,64720,177360,242080
1/12/2025,Kamal Sahabandu,Moneragala,Kataragama,Uva,9918,9816,19734,396720,392640,789360
1/13/2025,Kamal Sahabandu,Moneragala,Kataragama,Uva,448,2840,3288,17920,113600,131520
1/14/2025,Kamal Sahabandu,Moneragala,Kataragama,Uva,2199,6179,8378,87960,247160,335120
1/15/2025,Kamal Sahabandu,Moneragala,Kataragama,Uva,5940,4545,10485,237600,181800,419400
1/16/2025,Kamal Sahabandu,Moneragala,Kataragama,Uva,1983,6607,8590,79320,264280,343600
1/17/2025,Kamal Sahabandu,Moneragala,Kataragama,Uva,3371,5408,8779,134840,216320,351160
1/18/2025,Kamal Sahabandu,Moneragala,Kataragama,Uva,5216,9312,14528,208640,372480,581120
1/19/2025,Kamal Sahabandu,Moneragala,Kataragama,Uva,521,3584,4105,20840,143360,164200
1/20/2025,Kamal Sahabandu,Moneragala,Kataragama,Uva,6047,2458,8505,241880,98320,340200
1/21/2025,Kamal Sahabandu,Moneragala,Kataragama,Uva,8295,5642,13937,331800,225680,557480
1/22/2025,Kamal Sahabandu,Moneragala,Kataragama,Uva,384,8915,9299,15360,356600,371960
1/23/2025,Kamal Sahabandu,Moneragala,Kataragama,Uva,6717,9417,16134,268680,376680,645360
1/24/2025,Kamal Sahabandu,Moneragala,Kataragama,Uva,3949,4606,8555,157960,184240,342200
1/25/2025,Kamal Sahabandu,Moneragala,Kataragama,Uva,1974,9122,11096,78960,364880,443840
1/26/2025,Kamal Sahabandu,Moneragala,Kataragama,Uva,254,9857,10111,10160,394280,404440
1/27/2025,Kamal Sahabandu,Moneragala,Kataragama,Uva,6267,3102,9369,250680,124080,374760
1/28/2025,Kamal Sahabandu,Moneragala,Kataragama,Uva,373,8697,9070,14920,347880,362800
1/29/2025,Kamal Sahabandu,Moneragala,Kataragama,Uva,7274,2865,10139,290960,114600,405560
1/30/2025,Kamal Sahabandu,Moneragala,Kataragama,Uva,7506,6659,14165,300240,266360,566600
1/31/2025,Kamal Sahabandu,Moneragala,Kataragama,Uva,9908,7809,17717,396320,312360,708680
2/1/2025,Kamal Sahabandu,Moneragala,Kataragama,Uva,1238,2724,3962,49520,108960,158480
2/2/2025,Kamal Sahabandu,Moneragala,Kataragama,Uva,3279,8650,11929,131160,346000,477160
2/3/2025,Kamal Sahabandu,Moneragala,Kataragama,Uva,3057,6881,9938,122280,275240,397520
2/4/2025,Kamal Sahabandu,Moneragala,Kataragama,Uva,5899,4924,10823,235960,196960,432920
2/5/2025,Kamal Sahabandu,Moneragala,Kataragama,Uva,8397,4435,12832,335880,177400,513280
2/6/2025,Kamal Sahabandu,Moneragala,Kataragama,Uva,993,489,1482,39720,19560,59280
2/7/2025,Kamal Sahabandu,Moneragala,Kataragama,Uva,4060,5071,9131,162400,202840,365240
2/8/2025,Kamal Sahabandu,Moneragala,Kataragama,Uva,7162,6837,13999,286480,273480,559960
2/9/2025,Kamal Sahabandu,Moneragala,Kataragama,Uva,8003,2004,10007,320120,80160,400280
2/10/2025,Kamal Sahabandu,Moneragala,Kataragama,Uva,5163,7205,12368,206520,288200,494720
2/11/2025,Kamal Sahabandu,Moneragala,Kataragama,Uva,8826,3083,11909,353040,123320,476360
2/12/2025,Kamal Sahabandu,Moneragala,Kataragama,Uva,646,6997,7643,25840,279880,305720
2/13/2025,Kamal Sahabandu,Moneragala,Kataragama,Uva,1249,674,1923,49960,26960,76920
2/14/2025,Kamal Sahabandu,Moneragala,Kataragama,Uva,871,6385,7256,34840,255400,290240
2/15/2025,Kamal Sahabandu,Moneragala,Kataragama,Uva,3995,1395,5390,159800,55800,215600
2/16/2025,Kamal Sahabandu,Moneragala,Kataragama,Uva,6036,8284,14320,241440,331360,572800
2/17/2025,Kamal Sahabandu,Moneragala,Kataragama,Uva,3056,5986,9042,122240,239440,361680
2/18/2025,Kamal Sahabandu,Moneragala,Kataragama,Uva,8030,84,8114,321200,3360,324560
2/19/2025,Kamal Sahabandu,Moneragala,Kataragama,Uva,2388,9080,11468,95520,363200,458720
2/20/2025,Kamal Sahabandu,Moneragala,Kataragama,Uva,6294,7964,14258,251760,318560,570320
2/21/2025,Kamal Sahabandu,Moneragala,Kataragama,Uva,5371,8594,13965,214840,343760,558600
2/22/2025,Kamal Sahabandu,Moneragala,Kataragama,Uva,9769,5897,15666,390760,235880,626640
2/23/2025,Kamal Sahabandu,Moneragala,Kataragama,Uva,2850,6838,9688,114000,273520,387520
2/24/2025,Kamal Sahabandu,Moneragala,Kataragama,Uva,7096,8726,15822,283840,349040,632880
2/25/2025,Kamal Sahabandu,Moneragala,Kataragama,Uva,1554,1310,2864,62160,52400,114560
2/26/2025,Kamal Sahabandu,Moneragala,Kataragama,Uva,4769,7200,11969,190760,288000,478760
2/27/2025,Kamal Sahabandu,Moneragala,Kataragama,Uva,2323,8329,10652,92920,333160,426080
2/28/2025,Kamal Sahabandu,Moneragala,Kataragama,Uva,5462,6939,12401,218480,277560,496040
3/1/2025,Kamal Sahabandu,Moneragala,Kataragama,Uva,2209,5909,8118,88360,236360,324720
3/2/2025,Kamal Sahabandu,Moneragala,Kataragama,Uva,1094,7281,8375,43760,291240,335000
3/3/2025,Kamal Sahabandu,Moneragala,Kataragama,Uva,3439,394,3833,137560,15760,153320
3/4/2025,Kamal Sahabandu,Moneragala,Kataragama,Uva,635,8887,9522,25400,355480,380880
3/5/2025,Kamal Sahabandu,Moneragala,Kataragama,Uva,1924,8018,9942,76960,320720,397680
3/6/2025,Kamal Sahabandu,Moneragala,Kataragama,Uva,2185,5420,7605,87400,216800,304200
3/7/2025,Kamal Sahabandu,Moneragala,Kataragama,Uva,5471,9362,14833,218840,374480,593320
3/8/2025,Kamal Sahabandu,Moneragala,Kataragama,Uva,6465,671,7136,258600,26840,285440
3/9/2025,Kamal Sahabandu,Moneragala,Kataragama,Uva,9318,4534,13852,372720,181360,554080
3/10/2025,Kamal Sahabandu,Moneragala,Kataragama,Uva,9399,8676,18075,375960,347040,723000
3/11/2025,Kamal Sahabandu,Moneragala,Kataragama,Uva,2668,3392,6060,106720,135680,242400
3/12/2025,Kamal Sahabandu,Moneragala,Kataragama,Uva,2224,4896,7120,88960,195840,284800
3/13/2025,Kamal Sahabandu,Moneragala,Kataragama,Uva,7003,7970,14973,280120,318800,598920
3/14/2025,Kamal Sahabandu,Moneragala,Kataragama,Uva,9177,1473,10650,367080,58920,426000
3/15/2025,Kamal Sahabandu,Moneragala,Kataragama,Uva,7812,6588,14400,312480,263520,576000
3/16/2025,Kamal Sahabandu,Moneragala,Kataragama,Uva,5943,1534,7477,237720,61360,299080
3/17/2025,Kamal Sahabandu,Moneragala,Kataragama,Uva,3293,3531,6824,131720,141240,272960
3/18/2025,Kamal Sahabandu,Moneragala,Kataragama,Uva,4579,8946,13525,183160,357840,541000
3/19/2025,Kamal Sahabandu,Moneragala,Kataragama,Uva,511,5305,5816,20440,212200,232640
3/20/2025,Kamal Sahabandu,Moneragala,Kataragama,Uva,4885,3153,8038,195400,126120,321520
3/21/2025,Kamal Sahabandu,Moneragala,Kataragama,Uva,487,6562,7049,19480,262480,281960
3/22/2025,Kamal Sahabandu,Moneragala,Kataragama,Uva,356,9818,10174,14240,392720,406960
3/23/2025,Kamal Sahabandu,Moneragala,Kataragama,Uva,4370,6916,11286,174800,276640,451440
3/25/2024,Jayanthi Weeraccon,Puttalam,Puttalam,North Western,7886,1747,9633,315440,69880,385320
3/26/2024,Jayanthi Weeraccon,Puttalam,Puttalam,North Western,4647,7186,11833,185880,287440,473320
3/27/2024,Jayanthi Weeraccon,Puttalam,Puttalam,North Western,8045,2147,10192,321800,85880,407680
3/28/2024,Jayanthi Weeraccon,Puttalam,Puttalam,North Western,3316,9693,13009,132640,387720,520360
3/29/2024,Jayanthi Weeraccon,Puttalam,Puttalam,North Western,3566,6527,10093,142640,261080,403720
3/30/2024,Jayanthi Weeraccon,Puttalam,Puttalam,North Western,3917,6790,10707,156680,271600,428280
3/31/2024,Jayanthi Weeraccon,Puttalam,Puttalam,North Western,4278,915,5193,171120,36600,207720
4/1/2024,Jayanthi Weeraccon,Puttalam,Puttalam,North Western,155,4893,5048,6200,195720,201920
4/2/2024,Jayanthi Weeraccon,Puttalam,Puttalam,North Western,1225,7881,9106,49000,315240,364240
4/3/2024,Jayanthi Weeraccon,Puttalam,Puttalam,North Western,3028,7347,10375,121120,293880,415000
4/4/2024,Jayanthi Weeraccon,Puttalam,Puttalam,North Western,602,784,1386,24080,31360,55440
4/5/2024,Jayanthi Weeraccon,Puttalam,Puttalam,North Western,6988,7375,14363,279520,295000,574520
4/6/2024,Jayanthi Weeraccon,Puttalam,Puttalam,North Western,7757,4500,12257,310280,180000,490280
4/7/2024,Jayanthi Weeraccon,Puttalam,Puttalam,North Western,1622,3370,4992,64880,134800,199680
4/8/2024,Jayanthi Weeraccon,Puttalam,Puttalam,North Western,9333,6824,16157,373320,272960,646280
4/9/2024,Jayanthi Weeraccon,Puttalam,Puttalam,North Western,7347,2464,9811,293880,98560,392440
4/10/2024,Jayanthi Weeraccon,Puttalam,Puttalam,North Western,3986,7740,11726,159440,309600,469040
4/11/2024,Jayanthi Weeraccon,Puttalam,Puttalam,North Western,2869,9315,12184,114760,372600,487360
4/19/2024,Jayanthi Weeraccon,Puttalam,Puttalam,North Western,1171,3175,4346,46840,127000,173840
4/20/2024,Jayanthi Weeraccon,Puttalam,Puttalam,North Western,8906,2444,11350,356240,97760,454000
4/21/2024,Jayanthi Weeraccon,Puttalam,Puttalam,North Western,1289,9283,10572,51560,371320,422880
4/22/2024,Jayanthi Weeraccon,Puttalam,Puttalam,North Western,2456,1563,4019,98240,62520,160760
4/23/2024,Jayanthi Weeraccon,Puttalam,Puttalam,North Western,1870,5304,7174,74800,212160,286960
4/24/2024,Jayanthi Weeraccon,Puttalam,Puttalam,North Western,4201,6804,11005,168040,272160,440200
4/25/2024,Jayanthi Weeraccon,Puttalam,Puttalam,North Western,9938,2008,11946,397520,80320,477840
4/26/2024,Jayanthi Weeraccon,Puttalam,Puttalam,North Western,6118,1143,7261,244720,45720,290440
4/27/2024,Jayanthi Weeraccon,Puttalam,Puttalam,North Western,6698,8322,15020,267920,332880,600800
4/28/2024,Jayanthi Weeraccon,Puttalam,Puttalam,North Western,7263,8937,16200,290520,357480,648000
4/29/2024,Jayanthi Weeraccon,Puttalam,Puttalam,North Western,2172,7143,9315,86880,285720,372600
4/30/2024,Jayanthi Weeraccon,Puttalam,Puttalam,North Western,1038,2599,3637,41520,103960,145480
5/1/2024,Jayanthi Weeraccon,Puttalam,Puttalam,North Western,4587,3178,7765,183480,127120,310600
5/2/2024,Jayanthi Weeraccon,Puttalam,Puttalam,North Western,5194,9592,14786,207760,383680,591440
5/3/2024,Jayanthi Weeraccon,Puttalam,Puttalam,North Western,5690,9015,14705,227600,360600,588200
5/4/2024,Jayanthi Weeraccon,Puttalam,Puttalam,North Western,873,3371,4244,34920,134840,169760
5/5/2024,Jayanthi Weeraccon,Puttalam,Puttalam,North Western,6926,1779,8705,277040,71160,348200
5/6/2024,Jayanthi Weeraccon,Puttalam,Puttalam,North Western,9473,7542,17015,378920,301680,680600
5/7/2024,Jayanthi Weeraccon,Puttalam,Puttalam,North Western,2452,6391,8843,98080,255640,353720
5/8/2024,Jayanthi Weeraccon,Puttalam,Puttalam,North Western,2407,745,3152,96280,29800,126080
5/9/2024,Jayanthi Weeraccon,Puttalam,Puttalam,North Western,8334,3165,11499,333360,126600,459960
5/10/2024,Jayanthi Weeraccon,Puttalam,Puttalam,North Western,7738,2973,10711,309520,118920,428440
5/11/2024,Jayanthi Weeraccon,Puttalam,Puttalam,North Western,3810,9942,13752,152400,397680,550080
5/12/2024,Jayanthi Weeraccon,Puttalam,Puttalam,North Western,5915,4336,10251,236600,173440,410040
5/13/2024,Jayanthi Weeraccon,Puttalam,Puttalam,North Western,7676,4956,12632,307040,198240,505280
5/14/2024,Jayanthi Weeraccon,Puttalam,Puttalam,North Western,5104,235,5339,204160,9400,213560
5/15/2024,Jayanthi Weeraccon,Puttalam,Puttalam,North Western,4675,1921,6596,187000,76840,263840
5/16/2024,Jayanthi Weeraccon,Puttalam,Puttalam,North Western,2808,158,2966,112320,6320,118640
5/17/2024,Jayanthi Weeraccon,Puttalam,Puttalam,North Western,5025,6005,11030,201000,240200,441200
5/18/2024,Jayanthi Weeraccon,Puttalam,Puttalam,North Western,2506,2745,5251,100240,109800,210040
5/19/2024,Jayanthi Weeraccon,Puttalam,Puttalam,North Western,6813,1159,7972,272520,46360,318880
5/20/2024,Jayanthi Weeraccon,Puttalam,Puttalam,North Western,1307,8534,9841,52280,341360,393640
5/21/2024,Jayanthi Weeraccon,Puttalam,Puttalam,North Western,5269,8783,14052,210760,351320,562080
5/22/2024,Jayanthi Weeraccon,Puttalam,Puttalam,North Western,4544,3634,8178,181760,145360,327120
5/24/2024,Jayanthi Weeraccon,Puttalam,Puttalam,North Western,2048,5367,7415,81920,214680,296600
5/25/2024,Jayanthi Weeraccon,Puttalam,Puttalam,North Western,6149,8563,14712,245960,342520,588480
5/26/2024,Jayanthi Weeraccon,Puttalam,Puttalam,North Western,2853,6760,9613,114120,270400,384520
5/27/2024,Jayanthi Weeraccon,Puttalam,Puttalam,North Western,4636,5533,10169,185440,221320,406760
5/28/2024,Jayanthi Weeraccon,Puttalam,Puttalam,North Western,7484,8309,15793,299360,332360,631720
5/29/2024,Jayanthi Weeraccon,Puttalam,Puttalam,North Western,8419,1644,10063,336760,65760,402520
5/30/2024,Jayanthi Weeraccon,Puttalam,Puttalam,North Western,4196,833,5029,167840,33320,201160
5/31/2024,Jayanthi Weeraccon,Puttalam,Puttalam,North Western,5185,4554,9739,207400,182160,389560
6/1/2024,Jayanthi Weeraccon,Puttalam,Puttalam,North Western,575,2783,3358,23000,111320,134320
6/2/2024,Jayanthi Weeraccon,Puttalam,Puttalam,North Western,1389,2575,3964,55560,103000,158560
6/3/2024,Jayanthi Weeraccon,Puttalam,Puttalam,North Western,5637,5710,11347,225480,228400,453880
6/4/2024,Jayanthi Weeraccon,Puttalam,Puttalam,North Western,603,39,642,24120,1560,25680
6/5/2024,Jayanthi Weeraccon,Puttalam,Puttalam,North Western,7985,4851,12836,319400,194040,513440
6/6/2024,Jayanthi Weeraccon,Puttalam,Puttalam,North Western,9873,3401,13274,394920,136040,530960
6/7/2024,Jayanthi Weeraccon,Puttalam,Puttalam,North Western,9001,7354,16355,360040,294160,654200
6/8/2024,Jayanthi Weeraccon,Puttalam,Puttalam,North Western,29,5071,5100,1160,202840,204000
6/9/2024,Jayanthi Weeraccon,Puttalam,Puttalam,North Western,2969,4901,7870,118760,196040,314800
6/10/2024,Jayanthi Weeraccon,Puttalam,Puttalam,North Western,8817,2938,11755,352680,117520,470200
6/11/2024,Jayanthi Weeraccon,Puttalam,Puttalam,North Western,7231,8790,16021,289240,351600,640840
6/12/2024,Jayanthi Weeraccon,Puttalam,Puttalam,North Western,6465,2262,8727,258600,90480,349080
6/13/2024,Jayanthi Weeraccon,Puttalam,Puttalam,North Western,969,3552,4521,38760,142080,180840
6/14/2024,Jayanthi Weeraccon,Puttalam,Puttalam,North Western,2463,6644,9107,98520,265760,364280
6/15/2024,Jayanthi Weeraccon,Puttalam,Puttalam,North Western,1839,3828,5667,73560,153120,226680
6/16/2024,Jayanthi Weeraccon,Puttalam,Puttalam,North Western,3520,9077,12597,140800,363080,503880
6/17/2024,Jayanthi Weeraccon,Puttalam,Puttalam,North Western,7399,1920,9319,295960,76800,372760
6/18/2024,Jayanthi Weeraccon,Puttalam,Puttalam,North Western,3436,240,3676,137440,9600,147040
6/19/2024,Jayanthi Weeraccon,Puttalam,Puttalam,North Western,5467,2723,8190,218680,108920,327600
6/20/2024,Jayanthi Weeraccon,Puttalam,Puttalam,North Western,6392,6652,13044,255680,266080,521760
6/21/2024,Jayanthi Weeraccon,Puttalam,Puttalam,North Western,3525,8709,12234,141000,348360,489360
6/22/2024,Jayanthi Weeraccon,Puttalam,Puttalam,North Western,9133,2323,11456,365320,92920,458240
6/23/2024,Jayanthi Weeraccon,Puttalam,Puttalam,North Western,1002,9388,10390,40080,375520,415600
6/24/2024,Jayanthi Weeraccon,Puttalam,Puttalam,North Western,7013,5683,12696,280520,227320,507840
6/25/2024,Jayanthi Weeraccon,Puttalam,Puttalam,North Western,6710,5407,12117,268400,216280,484680
6/26/2024,Jayanthi Weeraccon,Puttalam,Puttalam,North Western,7316,751,8067,292640,30040,322680
6/27/2024,Jayanthi Weeraccon,Puttalam,Puttalam,North Western,7915,7147,15062,316600,285880,602480
6/28/2024,Jayanthi Weeraccon,Puttalam,Puttalam,North Western,4945,4206,9151,197800,168240,366040
6/29/2024,Jayanthi Weeraccon,Puttalam,Puttalam,North Western,1322,3936,5258,52880,157440,210320
6/30/2024,Jayanthi Weeraccon,Puttalam,Puttalam,North Western,2063,6073,8136,82520,242920,325440
7/1/2024,Jayanthi Weeraccon,Puttalam,Puttalam,North Western,2591,6168,8759,103640,246720,350360
7/2/2024,Jayanthi Weeraccon,Puttalam,Puttalam,North Western,4170,2371,6541,166800,94840,261640
7/3/2024,Jayanthi Weeraccon,Puttalam,Puttalam,North Western,2087,7596,9683,83480,303840,387320
7/4/2024,Jayanthi Weeraccon,Puttalam,Puttalam,North Western,2300,8049,10349,92000,321960,413960
7/5/2024,Jayanthi Weeraccon,Puttalam,Puttalam,North Western,7289,6165,13454,291560,246600,538160
7/6/2024,Jayanthi Weeraccon,Puttalam,Puttalam,North Western,4003,7046,11049,160120,281840,441960
7/7/2024,Jayanthi Weeraccon,Puttalam,Puttalam,North Western,3101,6283,9384,124040,251320,375360
7/8/2024,Jayanthi Weeraccon,Puttalam,Puttalam,North Western,4212,9353,13565,168480,374120,542600
7/9/2024,Jayanthi Weeraccon,Puttalam,Puttalam,North Western,1330,7261,8591,53200,290440,343640
7/10/2024,Jayanthi Weeraccon,Puttalam,Puttalam,North Western,5429,4176,9605,217160,167040,384200
7/11/2024,Jayanthi Weeraccon,Puttalam,Puttalam,North Western,9156,8131,17287,366240,325240,691480
7/12/2024,Jayanthi Weeraccon,Puttalam,Puttalam,North Western,4055,3844,7899,162200,153760,315960
7/13/2024,Jayanthi Weeraccon,Puttalam,Puttalam,North Western,1401,6219,7620,56040,248760,304800
7/14/2024,Jayanthi Weeraccon,Puttalam,Puttalam,North Western,3464,7691,11155,138560,307640,446200
7/15/2024,Jayanthi Weeraccon,Puttalam,Puttalam,North Western,9225,6750,15975,369000,270000,639000
7/16/2024,Jayanthi Weeraccon,Puttalam,Puttalam,North Western,9228,6667,15895,369120,266680,635800
7/17/2024,Jayanthi Weeraccon,Puttalam,Puttalam,North Western,5032,344,5376,201280,13760,215040
7/18/2024,Jayanthi Weeraccon,Puttalam,Puttalam,North Western,1033,6985,8018,41320,279400,320720
7/19/2024,Jayanthi Weeraccon,Puttalam,Puttalam,North Western,8024,8923,16947,320960,356920,677880
7/20/2024,Jayanthi Weeraccon,Puttalam,Puttalam,North Western,9435,124,9559,377400,4960,382360
7/21/2024,Jayanthi Weeraccon,Puttalam,Puttalam,North Western,5422,8844,14266,216880,353760,570640
7/22/2024,Jayanthi Weeraccon,Puttalam,Puttalam,North Western,6985,5953,12938,279400,238120,517520
7/23/2024,Jayanthi Weeraccon,Puttalam,Puttalam,North Western,5194,1215,6409,207760,48600,256360
7/24/2024,Jayanthi Weeraccon,Puttalam,Puttalam,North Western,6348,9472,15820,253920,378880,632800
7/25/2024,Jayanthi Weeraccon,Puttalam,Puttalam,North Western,1032,7314,8346,41280,292560,333840
7/26/2024,Jayanthi Weeraccon,Puttalam,Puttalam,North Western,6993,7053,14046,279720,282120,561840
7/27/2024,Jayanthi Weeraccon,Puttalam,Puttalam,North Western,2989,751,3740,119560,30040,149600
7/28/2024,Jayanthi Weeraccon,Puttalam,Puttalam,North Western,8855,9354,18209,354200,374160,728360
7/29/2024,Jayanthi Weeraccon,Puttalam,Puttalam,North Western,8205,866,9071,328200,34640,362840
7/30/2024,Jayanthi Weeraccon,Puttalam,Puttalam,North Western,5,7215,7220,200,288600,288800
7/31/2024,Jayanthi Weeraccon,Puttalam,Puttalam,North Western,5024,1337,6361,200960,53480,254440
8/1/2024,Jayanthi Weeraccon,Puttalam,Puttalam,North Western,662,3313,3975,26480,132520,159000
8/2/2024,Jayanthi Weeraccon,Puttalam,Puttalam,North Western,5320,4891,10211,212800,195640,408440
8/3/2024,Jayanthi Weeraccon,Puttalam,Puttalam,North Western,4624,5028,9652,184960,201120,386080
8/4/2024,Jayanthi Weeraccon,Puttalam,Puttalam,North Western,986,4007,4993,39440,160280,199720
8/5/2024,Jayanthi Weeraccon,Puttalam,Puttalam,North Western,1725,8977,10702,69000,359080,428080
8/6/2024,Jayanthi Weeraccon,Puttalam,Puttalam,North Western,9344,6133,15477,373760,245320,619080
8/7/2024,Jayanthi Weeraccon,Puttalam,Puttalam,North Western,216,8088,8304,8640,323520,332160
8/8/2024,Jayanthi Weeraccon,Puttalam,Puttalam,North Western,5886,2595,8481,235440,103800,339240
8/9/2024,Jayanthi Weeraccon,Puttalam,Puttalam,North Western,5714,2290,8004,228560,91600,320160
8/10/2024,Jayanthi Weeraccon,Puttalam,Puttalam,North Western,4392,3977,8369,175680,159080,334760
8/11/2024,Jayanthi Weeraccon,Puttalam,Puttalam,North Western,9459,6846,16305,378360,273840,652200
8/12/2024,Jayanthi Weeraccon,Puttalam,Puttalam,North Western,416,6317,6733,16640,252680,269320
8/13/2024,Jayanthi Weeraccon,Puttalam,Puttalam,North Western,843,5007,5850,33720,200280,234000
8/14/2024,Jayanthi Weeraccon,Puttalam,Puttalam,North Western,5098,7597,12695,203920,303880,507800
8/15/2024,Jayanthi Weeraccon,Puttalam,Puttalam,North Western,1351,5267,6618,54040,210680,264720
8/16/2024,Jayanthi Weeraccon,Puttalam,Puttalam,North Western,561,522,1083,22440,20880,43320
8/17/2024,Jayanthi Weeraccon,Puttalam,Puttalam,North Western,266,5687,5953,10640,227480,238120
8/18/2024,Jayanthi Weeraccon,Puttalam,Puttalam,North Western,456,3479,3935,18240,139160,157400
8/19/2024,Jayanthi Weeraccon,Puttalam,Puttalam,North Western,5298,5294,10592,211920,211760,423680
8/20/2024,Jayanthi Weeraccon,Puttalam,Puttalam,North Western,7300,2920,10220,292000,116800,408800
8/21/2024,Jayanthi Weeraccon,Puttalam,Puttalam,North Western,5402,4578,9980,216080,183120,399200
8/22/2024,Jayanthi Weeraccon,Puttalam,Puttalam,North Western,4459,1314,5773,178360,52560,230920
8/23/2024,Jayanthi Weeraccon,Puttalam,Puttalam,North Western,8472,1384,9856,338880,55360,394240
8/24/2024,Jayanthi Weeraccon,Puttalam,Puttalam,North Western,8,6219,6227,320,248760,249080
8/25/2024,Jayanthi Weeraccon,Puttalam,Puttalam,North Western,8016,4244,12260,320640,169760,490400
8/26/2024,Jayanthi Weeraccon,Puttalam,Puttalam,North Western,2193,2117,4310,87720,84680,172400
8/27/2024,Jayanthi Weeraccon,Puttalam,Puttalam,North Western,6244,5335,11579,249760,213400,463160
8/28/2024,Jayanthi Weeraccon,Puttalam,Puttalam,North Western,5354,834,6188,214160,33360,247520
8/29/2024,Jayanthi Weeraccon,Puttalam,Puttalam,North Western,603,9648,10251,24120,385920,410040
8/30/2024,Jayanthi Weeraccon,Puttalam,Puttalam,North Western,9510,2525,12035,380400,101000,481400
8/31/2024,Jayanthi Weeraccon,Puttalam,Puttalam,North Western,6193,3433,9626,247720,137320,385040
9/1/2024,Jayanthi Weeraccon,Puttalam,Puttalam,North Western,5375,2487,7862,215000,99480,314480
9/2/2024,Jayanthi Weeraccon,Puttalam,Puttalam,North Western,177,8719,8896,7080,348760,355840
9/3/2024,Jayanthi Weeraccon,Puttalam,Puttalam,North Western,1246,9059,10305,49840,362360,412200
9/4/2024,Jayanthi Weeraccon,Puttalam,Puttalam,North Western,9197,6730,15927,367880,269200,637080
9/5/2024,Jayanthi Weeraccon,Puttalam,Puttalam,North Western,4932,6225,11157,197280,249000,446280
9/6/2024,Jayanthi Weeraccon,Puttalam,Puttalam,North Western,7828,4874,12702,313120,194960,508080
9/7/2024,Jayanthi Weeraccon,Puttalam,Puttalam,North Western,4914,9256,14170,196560,370240,566800
9/8/2024,Jayanthi Weeraccon,Puttalam,Puttalam,North Western,4797,7880,12677,191880,315200,507080
9/9/2024,Jayanthi Weeraccon,Puttalam,Puttalam,North Western,891,4213,5104,35640,168520,204160
9/10/2024,Jayanthi Weeraccon,Puttalam,Puttalam,North Western,6965,9749,16714,278600,389960,668560
9/11/2024,Jayanthi Weeraccon,Puttalam,Puttalam,North Western,2696,3033,5729,107840,121320,229160
9/12/2024,Jayanthi Weeraccon,Puttalam,Puttalam,North Western,9762,5692,15454,390480,227680,618160
9/13/2024,Jayanthi Weeraccon,Puttalam,Puttalam,North Western,5899,3896,9795,235960,155840,391800
9/14/2024,Jayanthi Weeraccon,Puttalam,Puttalam,North Western,2279,5165,7444,91160,206600,297760
9/15/2024,Jayanthi Weeraccon,Puttalam,Puttalam,North Western,8865,7505,16370,354600,300200,654800
9/16/2024,Jayanthi Weeraccon,Puttalam,Puttalam,North Western,6760,9963,16723,270400,398520,668920
9/17/2024,Jayanthi Weeraccon,Puttalam,Puttalam,North Western,1231,9903,11134,49240,396120,445360
9/18/2024,Jayanthi Weeraccon,Puttalam,Puttalam,North Western,254,5893,6147,10160,235720,245880
9/19/2024,Jayanthi Weeraccon,Puttalam,Puttalam,North Western,7151,2625,9776,286040,105000,391040
9/20/2024,Jayanthi Weeraccon,Puttalam,Puttalam,North Western,3543,3341,6884,141720,133640,275360
9/21/2024,Jayanthi Weeraccon,Puttalam,Puttalam,North Western,5434,8526,13960,217360,341040,558400
9/22/2024,Jayanthi Weeraccon,Puttalam,Puttalam,North Western,8129,281,8410,325160,11240,336400
9/23/2024,Jayanthi Weeraccon,Puttalam,Puttalam,North Western,1064,9858,10922,42560,394320,436880
9/24/2024,Jayanthi Weeraccon,Puttalam,Puttalam,North Western,3920,6115,10035,156800,244600,401400
9/25/2024,Jayanthi Weeraccon,Puttalam,Puttalam,North Western,8178,6662,14840,327120,266480,593600
9/26/2024,Jayanthi Weeraccon,Puttalam,Puttalam,North Western,9015,8821,17836,360600,352840,713440
9/27/2024,Jayanthi Weeraccon,Puttalam,Puttalam,North Western,5638,9523,15161,225520,380920,606440
9/28/2024,Jayanthi Weeraccon,Puttalam,Puttalam,North Western,207,9935,10142,8280,397400,405680
9/29/2024,Jayanthi Weeraccon,Puttalam,Puttalam,North Western,1913,9890,11803,76520,395600,472120
9/30/2024,Jayanthi Weeraccon,Puttalam,Puttalam,North Western,1100,6616,7716,44000,264640,308640
10/1/2024,Jayanthi Weeraccon,Puttalam,Puttalam,North Western,8413,4261,12674,336520,170440,506960
10/2/2024,Jayanthi Weeraccon,Puttalam,Puttalam,North Western,1592,4668,6260,63680,186720,250400
10/3/2024,Jayanthi Weeraccon,Puttalam,Puttalam,North Western,7723,4778,12501,308920,191120,500040
10/4/2024,Jayanthi Weeraccon,Puttalam,Puttalam,North Western,9409,4014,13423,376360,160560,536920
10/5/2024,Jayanthi Weeraccon,Puttalam,Puttalam,North Western,6274,5324,11598,250960,212960,463920
10/6/2024,Jayanthi Weeraccon,Puttalam,Puttalam,North Western,8772,8350,17122,350880,334000,684880
10/7/2024,Jayanthi Weeraccon,Puttalam,Puttalam,North Western,9341,7,9348,373640,280,373920
10/8/2024,Jayanthi Weeraccon,Puttalam,Puttalam,North Western,2519,8622,11141,100760,344880,445640
10/9/2024,Jayanthi Weeraccon,Puttalam,Puttalam,North Western,5028,3969,8997,201120,158760,359880
10/10/2024,Jayanthi Weeraccon,Puttalam,Puttalam,North Western,3918,136,4054,156720,5440,162160
10/11/2024,Jayanthi Weeraccon,Puttalam,Puttalam,North Western,7856,1056,8912,314240,42240,356480
10/12/2024,Jayanthi Weeraccon,Puttalam,Puttalam,North Western,3170,1242,4412,126800,49680,176480
10/13/2024,Jayanthi Weeraccon,Puttalam,Puttalam,North Western,5633,6338,11971,225320,253520,478840
10/14/2024,Jayanthi Weeraccon,Puttalam,Puttalam,North Western,634,9249,9883,25360,369960,395320
10/15/2024,Jayanthi Weeraccon,Puttalam,Puttalam,North Western,3353,9801,13154,134120,392040,526160
10/16/2024,Jayanthi Weeraccon,Puttalam,Puttalam,North Western,5322,9395,14717,212880,375800,588680
10/17/2024,Jayanthi Weeraccon,Puttalam,Puttalam,North Western,9083,7890,16973,363320,315600,678920
10/18/2024,Jayanthi Weeraccon,Puttalam,Puttalam,North Western,5662,1619,7281,226480,64760,291240
10/19/2024,Jayanthi Weeraccon,Puttalam,Puttalam,North Western,8077,5722,13799,323080,228880,551960
10/20/2024,Jayanthi Weeraccon,Puttalam,Puttalam,North Western,4659,1083,5742,186360,43320,229680
10/21/2024,Jayanthi Weeraccon,Puttalam,Puttalam,North Western,1028,5965,6993,41120,238600,279720
10/22/2024,Jayanthi Weeraccon,Puttalam,Puttalam,North Western,1677,1647,3324,67080,65880,132960
10/23/2024,Jayanthi Weeraccon,Puttalam,Puttalam,North Western,7688,8874,16562,307520,354960,662480
10/24/2024,Jayanthi Weeraccon,Puttalam,Puttalam,North Western,9028,8819,17847,361120,352760,713880
10/25/2024,Jayanthi Weeraccon,Puttalam,Puttalam,North Western,3585,7703,11288,143400,308120,451520
10/26/2024,Jayanthi Weeraccon,Puttalam,Puttalam,North Western,6745,4641,11386,269800,185640,455440
10/27/2024,Jayanthi Weeraccon,Puttalam,Puttalam,North Western,3528,2448,5976,141120,97920,239040
10/28/2024,Jayanthi Weeraccon,Puttalam,Puttalam,North Western,3575,619,4194,143000,24760,167760
10/29/2024,Jayanthi Weeraccon,Puttalam,Puttalam,North Western,1523,6352,7875,60920,254080,315000
10/30/2024,Jayanthi Weeraccon,Puttalam,Puttalam,North Western,5673,9498,15171,226920,379920,606840
10/31/2024,Jayanthi Weeraccon,Puttalam,Puttalam,North Western,6347,2405,8752,253880,96200,350080
11/1/2024,Jayanthi Weeraccon,Puttalam,Puttalam,North Western,7391,9823,17214,295640,392920,688560
11/2/2024,Jayanthi Weeraccon,Puttalam,Puttalam,North Western,2791,7570,10361,111640,302800,414440
11/3/2024,Jayanthi Weeraccon,Puttalam,Puttalam,North Western,7845,4596,12441,313800,183840,497640
11/4/2024,Jayanthi Weeraccon,Puttalam,Puttalam,North Western,9278,7342,16620,371120,293680,664800
11/5/2024,Jayanthi Weeraccon,Puttalam,Puttalam,North Western,1402,3373,4775,56080,134920,191000
11/6/2024,Jayanthi Weeraccon,Puttalam,Puttalam,North Western,736,1323,2059,29440,52920,82360
11/7/2024,Jayanthi Weeraccon,Puttalam,Puttalam,North Western,3181,9109,12290,127240,364360,491600
11/8/2024,Jayanthi Weeraccon,Puttalam,Puttalam,North Western,6872,5111,11983,274880,204440,479320
11/9/2024,Jayanthi Weeraccon,Puttalam,Puttalam,North Western,6971,8623,15594,278840,344920,623760
11/10/2024,Jayanthi Weeraccon,Puttalam,Puttalam,North Western,132,8441,8573,5280,337640,342920
11/11/2024,Jayanthi Weeraccon,Puttalam,Puttalam,North Western,2040,7641,9681,81600,305640,387240
11/12/2024,Jayanthi Weeraccon,Puttalam,Puttalam,North Western,6418,5834,12252,256720,233360,490080
11/13/2024,Jayanthi Weeraccon,Puttalam,Puttalam,North Western,1679,5676,7355,67160,227040,294200
11/14/2024,Jayanthi Weeraccon,Puttalam,Puttalam,North Western,8248,669,8917,329920,26760,356680
11/15/2024,Jayanthi Weeraccon,Puttalam,Puttalam,North Western,480,8870,9350,19200,354800,374000
11/16/2024,Jayanthi Weeraccon,Puttalam,Puttalam,North Western,705,4597,5302,28200,183880,212080
11/17/2024,Jayanthi Weeraccon,Puttalam,Puttalam,North Western,7950,7640,15590,318000,305600,623600
11/18/2024,Jayanthi Weeraccon,Puttalam,Puttalam,North Western,2407,3010,5417,96280,120400,216680
11/19/2024,Jayanthi Weeraccon,Puttalam,Puttalam,North Western,6529,3012,9541,261160,120480,381640
11/20/2024,Jayanthi Weeraccon,Puttalam,Puttalam,North Western,975,1108,2083,39000,44320,83320
11/21/2024,Jayanthi Weeraccon,Puttalam,Puttalam,North Western,631,7645,8276,25240,305800,331040
11/22/2024,Jayanthi Weeraccon,Puttalam,Puttalam,North Western,3705,6984,10689,148200,279360,427560
11/23/2024,Jayanthi Weeraccon,Puttalam,Puttalam,North Western,4256,2646,6902,170240,105840,276080
11/24/2024,Jayanthi Weeraccon,Puttalam,Puttalam,North Western,213,9214,9427,8520,368560,377080
11/25/2024,Jayanthi Weeraccon,Puttalam,Puttalam,North Western,2539,3305,5844,101560,132200,233760
11/26/2024,Jayanthi Weeraccon,Puttalam,Puttalam,North Western,4356,9726,14082,174240,389040,563280
11/27/2024,Jayanthi Weeraccon,Puttalam,Puttalam,North Western,2506,8351,10857,100240,334040,434280
11/28/2024,Jayanthi Weeraccon,Puttalam,Puttalam,North Western,5708,9555,15263,228320,382200,610520
11/29/2024,Jayanthi Weeraccon,Puttalam,Puttalam,North Western,8486,5745,14231,339440,229800,569240
11/30/2024,Jayanthi Weeraccon,Puttalam,Puttalam,North Western,6430,4287,10717,257200,171480,428680
12/1/2024,Jayanthi Weeraccon,Puttalam,Puttalam,North Western,1122,5602,6724,44880,224080,268960
12/2/2024,Jayanthi Weeraccon,Puttalam,Puttalam,North Western,2993,9143,12136,119720,365720,485440
12/3/2024,Jayanthi Weeraccon,Puttalam,Puttalam,North Western,7461,8116,15577,298440,324640,623080
12/4/2024,Jayanthi Weeraccon,Puttalam,Puttalam,North Western,9472,9848,19320,378880,393920,772800
12/5/2024,Jayanthi Weeraccon,Puttalam,Puttalam,North Western,1715,657,2372,68600,26280,94880
12/6/2024,Jayanthi Weeraccon,Puttalam,Puttalam,North Western,668,9590,10258,26720,383600,410320
12/7/2024,Jayanthi Weeraccon,Puttalam,Puttalam,North Western,4330,378,4708,173200,15120,188320
12/8/2024,Jayanthi Weeraccon,Puttalam,Puttalam,North Western,4791,9736,14527,191640,389440,581080
12/9/2024,Jayanthi Weeraccon,Puttalam,Puttalam,North Western,5802,9020,14822,232080,360800,592880
12/10/2024,Jayanthi Weeraccon,Puttalam,Puttalam,North Western,830,7704,8534,33200,308160,341360
12/11/2024,Jayanthi Weeraccon,Puttalam,Puttalam,North Western,3495,13,3508,139800,520,140320
12/12/2024,Jayanthi Weeraccon,Puttalam,Puttalam,North Western,7118,7889,15007,284720,315560,600280
12/13/2024,Jayanthi Weeraccon,Puttalam,Puttalam,North Western,8384,2126,10510,335360,85040,420400
12/14/2024,Jayanthi Weeraccon,Puttalam,Puttalam,North Western,3080,4000,7080,123200,160000,283200
12/15/2024,Jayanthi Weeraccon,Puttalam,Puttalam,North Western,421,9446,9867,16840,377840,394680
12/16/2024,Jayanthi Weeraccon,Puttalam,Puttalam,North Western,2830,1105,3935,113200,44200,157400
12/17/2024,Jayanthi Weeraccon,Puttalam,Puttalam,North Western,48,6594,6642,1920,263760,265680
12/18/2024,Jayanthi Weeraccon,Puttalam,Puttalam,North Western,5238,2241,7479,209520,89640,299160
12/19/2024,Jayanthi Weeraccon,Puttalam,Puttalam,North Western,6743,7012,13755,269720,280480,550200
12/20/2024,Jayanthi Weeraccon,Puttalam,Puttalam,North Western,7503,1379,8882,300120,55160,355280
12/21/2024,Jayanthi Weeraccon,Puttalam,Puttalam,North Western,1306,2649,3955,52240,105960,158200
12/22/2024,Jayanthi Weeraccon,Puttalam,Puttalam,North Western,4668,3863,8531,186720,154520,341240
12/23/2024,Jayanthi Weeraccon,Puttalam,Puttalam,North Western,6244,9442,15686,249760,377680,627440
12/24/2024,Jayanthi Weeraccon,Puttalam,Puttalam,North Western,2428,7689,10117,97120,307560,404680
12/25/2024,Jayanthi Weeraccon,Puttalam,Puttalam,North Western,4578,5029,9607,183120,201160,384280
12/26/2024,Jayanthi Weeraccon,Puttalam,Puttalam,North Western,8362,9225,17587,334480,369000,703480
12/27/2024,Jayanthi Weeraccon,Puttalam,Puttalam,North Western,6707,1378,8085,268280,55120,323400
12/28/2024,Jayanthi Weeraccon,Puttalam,Puttalam,North Western,8296,47,8343,331840,1880,333720
12/29/2024,Jayanthi Weeraccon,Puttalam,Puttalam,North Western,5272,9584,14856,210880,383360,594240
12/30/2024,Jayanthi Weeraccon,Puttalam,Puttalam,North Western,6820,1680,8500,272800,67200,340000
12/31/2024,Jayanthi Weeraccon,Puttalam,Puttalam,North Western,4553,240,4793,182120,9600,191720
1/1/2025,Jayanthi Weeraccon,Puttalam,Puttalam,North Western,9329,193,9522,373160,7720,380880
1/2/2025,Jayanthi Weeraccon,Puttalam,Puttalam,North Western,1692,1880,3572,67680,75200,142880
1/3/2025,Jayanthi Weeraccon,Puttalam,Puttalam,North Western,491,2953,3444,19640,118120,137760
1/4/2025,Jayanthi Weeraccon,Puttalam,Puttalam,North Western,6782,4278,11060,271280,171120,442400
1/5/2025,Jayanthi Weeraccon,Puttalam,Puttalam,North Western,2288,6726,9014,91520,269040,360560
1/6/2025,Jayanthi Weeraccon,Puttalam,Puttalam,North Western,6252,1207,7459,250080,48280,298360
1/7/2025,Jayanthi Weeraccon,Puttalam,Puttalam,North Western,5370,3917,9287,214800,156680,371480
1/8/2025,Jayanthi Weeraccon,Puttalam,Puttalam,North Western,9104,4337,13441,364160,173480,537640
1/9/2025,Jayanthi Weeraccon,Puttalam,Puttalam,North Western,4769,1276,6045,190760,51040,241800
1/10/2025,Jayanthi Weeraccon,Puttalam,Puttalam,North Western,1509,4133,5642,60360,165320,225680
1/11/2025,Jayanthi Weeraccon,Puttalam,Puttalam,North Western,8109,9466,17575,324360,378640,703000
1/12/2025,Jayanthi Weeraccon,Puttalam,Puttalam,North Western,1209,1181,2390,48360,47240,95600
1/13/2025,Jayanthi Weeraccon,Puttalam,Puttalam,North Western,1000,9982,10982,40000,399280,439280
1/14/2025,Jayanthi Weeraccon,Puttalam,Puttalam,North Western,5547,5790,11337,221880,231600,453480
1/15/2025,Jayanthi Weeraccon,Puttalam,Puttalam,North Western,3152,330,3482,126080,13200,139280
1/16/2025,Jayanthi Weeraccon,Puttalam,Puttalam,North Western,7997,5113,13110,319880,204520,524400
1/17/2025,Jayanthi Weeraccon,Puttalam,Puttalam,North Western,8091,6683,14774,323640,267320,590960
1/18/2025,Jayanthi Weeraccon,Puttalam,Puttalam,North Western,2443,4040,6483,97720,161600,259320
1/19/2025,Jayanthi Weeraccon,Puttalam,Puttalam,North Western,4854,6679,11533,194160,267160,461320
1/20/2025,Jayanthi Weeraccon,Puttalam,Puttalam,North Western,4133,9751,13884,165320,390040,555360
1/21/2025,Jayanthi Weeraccon,Puttalam,Puttalam,North Western,4695,4474,9169,187800,178960,366760
1/22/2025,Jayanthi Weeraccon,Puttalam,Puttalam,North Western,162,3881,4043,6480,155240,161720
1/23/2025,Jayanthi Weeraccon,Puttalam,Puttalam,North Western,3736,8364,12100,149440,334560,484000
1/24/2025,Jayanthi Weeraccon,Puttalam,Puttalam,North Western,8240,19,8259,329600,760,330360
1/25/2025,Jayanthi Weeraccon,Puttalam,Puttalam,North Western,9094,4035,13129,363760,161400,525160
1/26/2025,Jayanthi Weeraccon,Puttalam,Puttalam,North Western,1638,7370,9008,65520,294800,360320
1/27/2025,Jayanthi Weeraccon,Puttalam,Puttalam,North Western,3886,53,3939,155440,2120,157560
1/28/2025,Jayanthi Weeraccon,Puttalam,Puttalam,North Western,5010,9056,14066,200400,362240,562640
1/29/2025,Jayanthi Weeraccon,Puttalam,Puttalam,North Western,4910,280,5190,196400,11200,207600
1/30/2025,Jayanthi Weeraccon,Puttalam,Puttalam,North Western,9086,1984,11070,363440,79360,442800
1/31/2025,Jayanthi Weeraccon,Puttalam,Puttalam,North Western,1281,8395,9676,51240,335800,387040
2/1/2025,Jayanthi Weeraccon,Puttalam,Puttalam,North Western,2750,3283,6033,110000,131320,241320
2/2/2025,Jayanthi Weeraccon,Puttalam,Puttalam,North Western,8680,8038,16718,347200,321520,668720
2/3/2025,Jayanthi Weeraccon,Puttalam,Puttalam,North Western,5923,7261,13184,236920,290440,527360
2/4/2025,Jayanthi Weeraccon,Puttalam,Puttalam,North Western,3115,7840,10955,124600,313600,438200
2/5/2025,Jayanthi Weeraccon,Puttalam,Puttalam,North Western,4466,9014,13480,178640,360560,539200
2/6/2025,Jayanthi Weeraccon,Puttalam,Puttalam,North Western,7157,2506,9663,286280,100240,386520
2/7/2025,Jayanthi Weeraccon,Puttalam,Puttalam,North Western,8636,2414,11050,345440,96560,442000
2/8/2025,Jayanthi Weeraccon,Puttalam,Puttalam,North Western,3758,2818,6576,150320,112720,263040
2/9/2025,Jayanthi Weeraccon,Puttalam,Puttalam,North Western,9986,5605,15591,399440,224200,623640
2/10/2025,Jayanthi Weeraccon,Puttalam,Puttalam,North Western,4666,6693,11359,186640,267720,454360
2/11/2025,Jayanthi Weeraccon,Puttalam,Puttalam,North Western,355,350,705,14200,14000,28200
2/12/2025,Jayanthi Weeraccon,Puttalam,Puttalam,North Western,190,8745,8935,7600,349800,357400
2/13/2025,Jayanthi Weeraccon,Puttalam,Puttalam,North Western,2219,9471,11690,88760,378840,467600
2/14/2025,Jayanthi Weeraccon,Puttalam,Puttalam,North Western,3279,4067,7346,131160,162680,293840
2/15/2025,Jayanthi Weeraccon,Puttalam,Puttalam,North Western,7031,4074,11105,281240,162960,444200
2/16/2025,Jayanthi Weeraccon,Puttalam,Puttalam,North Western,7320,8798,16118,292800,351920,644720
2/17/2025,Jayanthi Weeraccon,Puttalam,Puttalam,North Western,7741,7094,14835,309640,283760,593400
2/18/2025,Jayanthi Weeraccon,Puttalam,Puttalam,North Western,3610,1138,4748,144400,45520,189920
2/19/2025,Jayanthi Weeraccon,Puttalam,Puttalam,North Western,5438,1156,6594,217520,46240,263760
2/20/2025,Jayanthi Weeraccon,Puttalam,Puttalam,North Western,6525,7418,13943,261000,296720,557720
2/21/2025,Jayanthi Weeraccon,Puttalam,Puttalam,North Western,3371,3828,7199,134840,153120,287960
2/22/2025,Jayanthi Weeraccon,Puttalam,Puttalam,North Western,7910,4636,12546,316400,185440,501840
2/23/2025,Jayanthi Weeraccon,Puttalam,Puttalam,North Western,6454,5671,12125,258160,226840,485000
2/24/2025,Jayanthi Weeraccon,Puttalam,Puttalam,North Western,2933,4138,7071,117320,165520,282840
2/25/2025,Jayanthi Weeraccon,Puttalam,Puttalam,North Western,2763,2744,5507,110520,109760,220280
2/26/2025,Jayanthi Weeraccon,Puttalam,Puttalam,North Western,3277,4838,8115,131080,193520,324600
2/27/2025,Jayanthi Weeraccon,Puttalam,Puttalam,North Western,5072,5715,10787,202880,228600,431480
2/28/2025,Jayanthi Weeraccon,Puttalam,Puttalam,North Western,4499,7572,12071,179960,302880,482840
3/1/2025,Jayanthi Weeraccon,Puttalam,Puttalam,North Western,8510,9269,17779,340400,370760,711160
3/2/2025,Jayanthi Weeraccon,Puttalam,Puttalam,North Western,3182,5782,8964,127280,231280,358560
3/3/2025,Jayanthi Weeraccon,Puttalam,Puttalam,North Western,7476,753,8229,299040,30120,329160
3/4/2025,Jayanthi Weeraccon,Puttalam,Puttalam,North Western,9193,347,9540,367720,13880,381600
3/5/2025,Jayanthi Weeraccon,Puttalam,Puttalam,North Western,3558,1939,5497,142320,77560,219880
3/6/2025,Jayanthi Weeraccon,Puttalam,Puttalam,North Western,7292,4081,11373,291680,163240,454920
3/7/2025,Jayanthi Weeraccon,Puttalam,Puttalam,North Western,1417,3744,5161,56680,149760,206440
3/8/2025,Jayanthi Weeraccon,Puttalam,Puttalam,North Western,3486,4393,7879,139440,175720,315160
3/9/2025,Jayanthi Weeraccon,Puttalam,Puttalam,North Western,4812,2775,7587,192480,111000,303480
3/10/2025,Jayanthi Weeraccon,Puttalam,Puttalam,North Western,6724,6731,13455,268960,269240,538200
3/11/2025,Jayanthi Weeraccon,Puttalam,Puttalam,North Western,8169,9472,17641,326760,378880,705640
3/12/2025,Jayanthi Weeraccon,Puttalam,Puttalam,North Western,908,1934,2842,36320,77360,113680
3/13/2025,Jayanthi Weeraccon,Puttalam,Puttalam,North Western,7674,1699,9373,306960,67960,374920
3/14/2025,Jayanthi Weeraccon,Puttalam,Puttalam,North Western,336,1225,1561,13440,49000,62440
3/15/2025,Jayanthi Weeraccon,Puttalam,Puttalam,North Western,972,6847,7819,38880,273880,312760
3/16/2025,Jayanthi Weeraccon,Puttalam,Puttalam,North Western,9968,2964,12932,398720,118560,517280
3/17/2025,Jayanthi Weeraccon,Puttalam,Puttalam,North Western,1548,925,2473,61920,37000,98920
3/18/2025,Jayanthi Weeraccon,Puttalam,Puttalam,North Western,5326,9205,14531,213040,368200,581240
3/19/2025,Jayanthi Weeraccon,Puttalam,Puttalam,North Western,8155,2414,10569,326200,96560,422760
3/20/2025,Jayanthi Weeraccon,Puttalam,Puttalam,North Western,939,8748,9687,37560,349920,387480
3/21/2025,Jayanthi Weeraccon,Puttalam,Puttalam,North Western,8848,8465,17313,353920,338600,692520
3/22/2025,Jayanthi Weeraccon,Puttalam,Puttalam,North Western,7851,6494,14345,314040,259760,573800
3/23/2025,Jayanthi Weeraccon,Puttalam,Puttalam,North Western,7746,7949,15695,309840,317960,627800
3/25/2024,Malakanthi,Nuwara Eliya,Balangoda,Central,2411,6108,8519,96440,244320,340760
3/26/2024,Malakanthi,Nuwara Eliya,Balangoda,Central,4946,8380,13326,197840,335200,533040
3/27/2024,Malakanthi,Nuwara Eliya,Balangoda,Central,9749,6278,16027,389960,251120,641080
3/28/2024,Malakanthi,Nuwara Eliya,Balangoda,Central,3847,8371,12218,153880,334840,488720
3/29/2024,Malakanthi,Nuwara Eliya,Balangoda,Central,6615,3642,10257,264600,145680,410280
3/30/2024,Malakanthi,Nuwara Eliya,Balangoda,Central,1303,2554,3857,52120,102160,154280
3/31/2024,Malakanthi,Nuwara Eliya,Balangoda,Central,5123,3699,8822,204920,147960,352880
4/1/2024,Malakanthi,Nuwara Eliya,Balangoda,Central,3333,1119,4452,133320,44760,178080
4/2/2024,Malakanthi,Nuwara Eliya,Balangoda,Central,2711,4966,7677,108440,198640,307080
4/3/2024,Malakanthi,Nuwara Eliya,Balangoda,Central,8682,1539,10221,347280,61560,408840
4/4/2024,Malakanthi,Nuwara Eliya,Balangoda,Central,7887,4342,12229,315480,173680,489160
4/5/2024,Malakanthi,Nuwara Eliya,Balangoda,Central,8625,8028,16653,345000,321120,666120
4/6/2024,Malakanthi,Nuwara Eliya,Balangoda,Central,2944,7947,10891,117760,317880,435640
4/7/2024,Malakanthi,Nuwara Eliya,Balangoda,Central,7898,6192,14090,315920,247680,563600
4/8/2024,Malakanthi,Nuwara Eliya,Balangoda,Central,3682,4522,8204,147280,180880,328160
4/9/2024,Malakanthi,Nuwara Eliya,Balangoda,Central,9515,2735,12250,380600,109400,490000
4/10/2024,Malakanthi,Nuwara Eliya,Balangoda,Central,5987,1603,7590,239480,64120,303600
4/11/2024,Malakanthi,Nuwara Eliya,Balangoda,Central,7758,5481,13239,310320,219240,529560
4/19/2024,Malakanthi,Nuwara Eliya,Balangoda,Central,3348,3299,6647,133920,131960,265880
4/20/2024,Malakanthi,Nuwara Eliya,Balangoda,Central,1395,1022,2417,55800,40880,96680
4/21/2024,Malakanthi,Nuwara Eliya,Balangoda,Central,4980,779,5759,199200,31160,230360
4/22/2024,Malakanthi,Nuwara Eliya,Balangoda,Central,3071,4043,7114,122840,161720,284560
4/23/2024,Malakanthi,Nuwara Eliya,Balangoda,Central,8488,2726,11214,339520,109040,448560
4/24/2024,Malakanthi,Nuwara Eliya,Balangoda,Central,1342,8012,9354,53680,320480,374160
4/25/2024,Malakanthi,Nuwara Eliya,Balangoda,Central,8580,2998,11578,343200,119920,463120
4/26/2024,Malakanthi,Nuwara Eliya,Balangoda,Central,8026,6402,14428,321040,256080,577120
4/27/2024,Malakanthi,Nuwara Eliya,Balangoda,Central,5755,9221,14976,230200,368840,599040
4/28/2024,Malakanthi,Nuwara Eliya,Balangoda,Central,3265,7451,10716,130600,298040,428640
4/29/2024,Malakanthi,Nuwara Eliya,Balangoda,Central,9991,6167,16158,399640,246680,646320
4/30/2024,Malakanthi,Nuwara Eliya,Balangoda,Central,5885,2571,8456,235400,102840,338240
5/1/2024,Malakanthi,Nuwara Eliya,Balangoda,Central,3258,2019,5277,130320,80760,211080
5/2/2024,Malakanthi,Nuwara Eliya,Balangoda,Central,46,5921,5967,1840,236840,238680
5/3/2024,Malakanthi,Nuwara Eliya,Balangoda,Central,5835,2406,8241,233400,96240,329640
5/4/2024,Malakanthi,Nuwara Eliya,Balangoda,Central,162,9824,9986,6480,392960,399440
5/5/2024,Malakanthi,Nuwara Eliya,Balangoda,Central,603,5555,6158,24120,222200,246320
5/6/2024,Malakanthi,Nuwara Eliya,Balangoda,Central,3439,4045,7484,137560,161800,299360
5/7/2024,Malakanthi,Nuwara Eliya,Balangoda,Central,6965,6873,13838,278600,274920,553520
5/8/2024,Malakanthi,Nuwara Eliya,Balangoda,Central,3985,4566,8551,159400,182640,342040
5/9/2024,Malakanthi,Nuwara Eliya,Balangoda,Central,2339,597,2936,93560,23880,117440
5/10/2024,Malakanthi,Nuwara Eliya,Balangoda,Central,5663,3490,9153,226520,139600,366120
5/11/2024,Malakanthi,Nuwara Eliya,Balangoda,Central,4496,4661,9157,179840,186440,366280
5/12/2024,Malakanthi,Nuwara Eliya,Balangoda,Central,6830,7929,14759,273200,317160,590360
5/13/2024,Malakanthi,Nuwara Eliya,Balangoda,Central,6573,5307,11880,262920,212280,475200
5/14/2024,Malakanthi,Nuwara Eliya,Balangoda,Central,4370,8841,13211,174800,353640,528440
5/15/2024,Malakanthi,Nuwara Eliya,Balangoda,Central,865,7225,8090,34600,289000,323600
5/16/2024,Malakanthi,Nuwara Eliya,Balangoda,Central,4513,1029,5542,180520,41160,221680
5/17/2024,Malakanthi,Nuwara Eliya,Balangoda,Central,1860,4672,6532,74400,186880,261280
5/18/2024,Malakanthi,Nuwara Eliya,Balangoda,Central,6064,5325,11389,242560,213000,455560
5/19/2024,Malakanthi,Nuwara Eliya,Balangoda,Central,1785,6735,8520,71400,269400,340800
5/20/2024,Malakanthi,Nuwara Eliya,Balangoda,Central,2076,4363,6439,83040,174520,257560
5/21/2024,Malakanthi,Nuwara Eliya,Balangoda,Central,8845,8995,17840,353800,359800,713600
5/22/2024,Malakanthi,Nuwara Eliya,Balangoda,Central,6731,4764,11495,269240,190560,459800
5/24/2024,Malakanthi,Nuwara Eliya,Balangoda,Central,4756,1804,6560,190240,72160,262400
5/25/2024,Malakanthi,Nuwara Eliya,Balangoda,Central,4018,9180,13198,160720,367200,527920
5/26/2024,Malakanthi,Nuwara Eliya,Balangoda,Central,6814,6153,12967,272560,246120,518680
5/27/2024,Malakanthi,Nuwara Eliya,Balangoda,Central,3733,8429,12162,149320,337160,486480
5/28/2024,Malakanthi,Nuwara Eliya,Balangoda,Central,3287,2857,6144,131480,114280,245760
5/29/2024,Malakanthi,Nuwara Eliya,Balangoda,Central,6941,4910,11851,277640,196400,474040
5/30/2024,Malakanthi,Nuwara Eliya,Balangoda,Central,9004,6036,15040,360160,241440,601600
5/31/2024,Malakanthi,Nuwara Eliya,Balangoda,Central,9269,4686,13955,370760,187440,558200
6/1/2024,Malakanthi,Nuwara Eliya,Balangoda,Central,9234,2693,11927,369360,107720,477080
6/2/2024,Malakanthi,Nuwara Eliya,Balangoda,Central,1092,5222,6314,43680,208880,252560
6/3/2024,Malakanthi,Nuwara Eliya,Balangoda,Central,5770,2634,8404,230800,105360,336160
6/4/2024,Malakanthi,Nuwara Eliya,Balangoda,Central,5792,1991,7783,231680,79640,311320
6/5/2024,Malakanthi,Nuwara Eliya,Balangoda,Central,4895,4727,9622,195800,189080,384880
6/6/2024,Malakanthi,Nuwara Eliya,Balangoda,Central,5758,5302,11060,230320,212080,442400
6/7/2024,Malakanthi,Nuwara Eliya,Balangoda,Central,6400,4912,11312,256000,196480,452480
6/8/2024,Malakanthi,Nuwara Eliya,Balangoda,Central,3249,4712,7961,129960,188480,318440
6/9/2024,Malakanthi,Nuwara Eliya,Balangoda,Central,1786,6237,8023,71440,249480,320920
6/10/2024,Malakanthi,Nuwara Eliya,Balangoda,Central,774,6836,7610,30960,273440,304400
6/11/2024,Malakanthi,Nuwara Eliya,Balangoda,Central,3092,7505,10597,123680,300200,423880
6/12/2024,Malakanthi,Nuwara Eliya,Balangoda,Central,2453,577,3030,98120,23080,121200
6/13/2024,Malakanthi,Nuwara Eliya,Balangoda,Central,9988,7539,17527,399520,301560,701080
6/14/2024,Malakanthi,Nuwara Eliya,Balangoda,Central,9095,7658,16753,363800,306320,670120
6/15/2024,Malakanthi,Nuwara Eliya,Balangoda,Central,3395,9364,12759,135800,374560,510360
6/16/2024,Malakanthi,Nuwara Eliya,Balangoda,Central,3436,4013,7449,137440,160520,297960
6/17/2024,Malakanthi,Nuwara Eliya,Balangoda,Central,9441,9081,18522,377640,363240,740880
6/18/2024,Malakanthi,Nuwara Eliya,Balangoda,Central,4203,4364,8567,168120,174560,342680
6/19/2024,Malakanthi,Nuwara Eliya,Balangoda,Central,2935,9457,12392,117400,378280,495680
6/20/2024,Malakanthi,Nuwara Eliya,Balangoda,Central,7616,5002,12618,304640,200080,504720
6/21/2024,Malakanthi,Nuwara Eliya,Balangoda,Central,1351,1048,2399,54040,41920,95960
6/22/2024,Malakanthi,Nuwara Eliya,Balangoda,Central,6672,5965,12637,266880,238600,505480
6/23/2024,Malakanthi,Nuwara Eliya,Balangoda,Central,3596,9932,13528,143840,397280,541120
6/24/2024,Malakanthi,Nuwara Eliya,Balangoda,Central,12,645,657,480,25800,26280
6/25/2024,Malakanthi,Nuwara Eliya,Balangoda,Central,5020,944,5964,200800,37760,238560
6/26/2024,Malakanthi,Nuwara Eliya,Balangoda,Central,6566,9049,15615,262640,361960,624600
6/27/2024,Malakanthi,Nuwara Eliya,Balangoda,Central,6231,5455,11686,249240,218200,467440
6/28/2024,Malakanthi,Nuwara Eliya,Balangoda,Central,4680,9363,14043,187200,374520,561720
6/29/2024,Malakanthi,Nuwara Eliya,Balangoda,Central,903,5080,5983,36120,203200,239320
6/30/2024,Malakanthi,Nuwara Eliya,Balangoda,Central,7761,2140,9901,310440,85600,396040
7/1/2024,Malakanthi,Nuwara Eliya,Balangoda,Central,8950,3781,12731,358000,151240,509240
7/2/2024,Malakanthi,Nuwara Eliya,Balangoda,Central,9870,9051,18921,394800,362040,756840
7/3/2024,Malakanthi,Nuwara Eliya,Balangoda,Central,6825,59,6884,273000,2360,275360
7/4/2024,Malakanthi,Nuwara Eliya,Balangoda,Central,4256,9870,14126,170240,394800,565040
7/5/2024,Malakanthi,Nuwara Eliya,Balangoda,Central,481,7847,8328,19240,313880,333120
7/6/2024,Malakanthi,Nuwara Eliya,Balangoda,Central,5365,6755,12120,214600,270200,484800
7/7/2024,Malakanthi,Nuwara Eliya,Balangoda,Central,8158,7619,15777,326320,304760,631080
7/8/2024,Malakanthi,Nuwara Eliya,Balangoda,Central,5388,8475,13863,215520,339000,554520
7/9/2024,Malakanthi,Nuwara Eliya,Balangoda,Central,5624,5803,11427,224960,232120,457080
7/10/2024,Malakanthi,Nuwara Eliya,Balangoda,Central,5126,7829,12955,205040,313160,518200
7/11/2024,Malakanthi,Nuwara Eliya,Balangoda,Central,3018,2200,5218,120720,88000,208720
7/12/2024,Malakanthi,Nuwara Eliya,Balangoda,Central,2646,99,2745,105840,3960,109800
7/13/2024,Malakanthi,Nuwara Eliya,Balangoda,Central,6953,1342,8295,278120,53680,331800
7/14/2024,Malakanthi,Nuwara Eliya,Balangoda,Central,9599,3753,13352,383960,150120,534080
7/15/2024,Malakanthi,Nuwara Eliya,Balangoda,Central,4948,1171,6119,197920,46840,244760
7/16/2024,Malakanthi,Nuwara Eliya,Balangoda,Central,497,3131,3628,19880,125240,145120
7/17/2024,Malakanthi,Nuwara Eliya,Balangoda,Central,5934,4491,10425,237360,179640,417000
7/18/2024,Malakanthi,Nuwara Eliya,Balangoda,Central,5387,3393,8780,215480,135720,351200
7/19/2024,Malakanthi,Nuwara Eliya,Balangoda,Central,2616,1595,4211,104640,63800,168440
7/20/2024,Malakanthi,Nuwara Eliya,Balangoda,Central,9947,1425,11372,397880,57000,454880
7/21/2024,Malakanthi,Nuwara Eliya,Balangoda,Central,687,8308,8995,27480,332320,359800
7/22/2024,Malakanthi,Nuwara Eliya,Balangoda,Central,5607,1866,7473,224280,74640,298920
7/23/2024,Malakanthi,Nuwara Eliya,Balangoda,Central,6445,2252,8697,257800,90080,347880
7/24/2024,Malakanthi,Nuwara Eliya,Balangoda,Central,9199,6672,15871,367960,266880,634840
7/25/2024,Malakanthi,Nuwara Eliya,Balangoda,Central,4933,8677,13610,197320,347080,544400
7/26/2024,Malakanthi,Nuwara Eliya,Balangoda,Central,3030,1285,4315,121200,51400,172600
7/27/2024,Malakanthi,Nuwara Eliya,Balangoda,Central,9083,5669,14752,363320,226760,590080
7/28/2024,Malakanthi,Nuwara Eliya,Balangoda,Central,7840,4558,12398,313600,182320,495920
7/29/2024,Malakanthi,Nuwara Eliya,Balangoda,Central,111,2089,2200,4440,83560,88000
7/30/2024,Malakanthi,Nuwara Eliya,Balangoda,Central,5675,9370,15045,227000,374800,601800
7/31/2024,Malakanthi,Nuwara Eliya,Balangoda,Central,8752,4778,13530,350080,191120,541200
8/1/2024,Malakanthi,Nuwara Eliya,Balangoda,Central,6388,530,6918,255520,21200,276720
8/2/2024,Malakanthi,Nuwara Eliya,Balangoda,Central,6011,4003,10014,240440,160120,400560
8/3/2024,Malakanthi,Nuwara Eliya,Balangoda,Central,1061,9850,10911,42440,394000,436440
8/4/2024,Malakanthi,Nuwara Eliya,Balangoda,Central,5123,7716,12839,204920,308640,513560
8/5/2024,Malakanthi,Nuwara Eliya,Balangoda,Central,7661,9488,17149,306440,379520,685960
8/6/2024,Malakanthi,Nuwara Eliya,Balangoda,Central,6912,9420,16332,276480,376800,653280
8/7/2024,Malakanthi,Nuwara Eliya,Balangoda,Central,6961,8168,15129,278440,326720,605160
8/8/2024,Malakanthi,Nuwara Eliya,Balangoda,Central,6749,1731,8480,269960,69240,339200
8/9/2024,Malakanthi,Nuwara Eliya,Balangoda,Central,7338,6073,13411,293520,242920,536440
8/10/2024,Malakanthi,Nuwara Eliya,Balangoda,Central,1210,6330,7540,48400,253200,301600
8/11/2024,Malakanthi,Nuwara Eliya,Balangoda,Central,1734,7972,9706,69360,318880,388240
8/12/2024,Malakanthi,Nuwara Eliya,Balangoda,Central,4624,2496,7120,184960,99840,284800
8/13/2024,Malakanthi,Nuwara Eliya,Balangoda,Central,1464,1266,2730,58560,50640,109200
8/14/2024,Malakanthi,Nuwara Eliya,Balangoda,Central,7322,9461,16783,292880,378440,671320
8/15/2024,Malakanthi,Nuwara Eliya,Balangoda,Central,4946,4033,8979,197840,161320,359160
8/16/2024,Malakanthi,Nuwara Eliya,Balangoda,Central,2174,7770,9944,86960,310800,397760
8/17/2024,Malakanthi,Nuwara Eliya,Balangoda,Central,6861,3423,10284,274440,136920,411360
8/18/2024,Malakanthi,Nuwara Eliya,Balangoda,Central,1443,1812,3255,57720,72480,130200
8/19/2024,Malakanthi,Nuwara Eliya,Balangoda,Central,7689,3199,10888,307560,127960,435520
8/20/2024,Malakanthi,Nuwara Eliya,Balangoda,Central,8464,7761,16225,338560,310440,649000
8/21/2024,Malakanthi,Nuwara Eliya,Balangoda,Central,6829,4372,11201,273160,174880,448040
8/22/2024,Malakanthi,Nuwara Eliya,Balangoda,Central,6765,535,7300,270600,21400,292000
8/23/2024,Malakanthi,Nuwara Eliya,Balangoda,Central,7642,9720,17362,305680,388800,694480
8/24/2024,Malakanthi,Nuwara Eliya,Balangoda,Central,34,2561,2595,1360,102440,103800
8/25/2024,Malakanthi,Nuwara Eliya,Balangoda,Central,6105,7685,13790,244200,307400,551600
8/26/2024,Malakanthi,Nuwara Eliya,Balangoda,Central,7205,9845,17050,288200,393800,682000
8/27/2024,Malakanthi,Nuwara Eliya,Balangoda,Central,2984,2221,5205,119360,88840,208200
8/28/2024,Malakanthi,Nuwara Eliya,Balangoda,Central,5391,9742,15133,215640,389680,605320
8/29/2024,Malakanthi,Nuwara Eliya,Balangoda,Central,1645,676,2321,65800,27040,92840
8/30/2024,Malakanthi,Nuwara Eliya,Balangoda,Central,572,4623,5195,22880,184920,207800
8/31/2024,Malakanthi,Nuwara Eliya,Balangoda,Central,5576,842,6418,223040,33680,256720
9/1/2024,Malakanthi,Nuwara Eliya,Balangoda,Central,218,7764,7982,8720,310560,319280
9/2/2024,Malakanthi,Nuwara Eliya,Balangoda,Central,7485,2469,9954,299400,98760,398160
9/3/2024,Malakanthi,Nuwara Eliya,Balangoda,Central,1694,8023,9717,67760,320920,388680
9/4/2024,Malakanthi,Nuwara Eliya,Balangoda,Central,2905,9667,12572,116200,386680,502880
9/5/2024,Malakanthi,Nuwara Eliya,Balangoda,Central,1964,9703,11667,78560,388120,466680
9/6/2024,Malakanthi,Nuwara Eliya,Balangoda,Central,2160,8207,10367,86400,328280,414680
9/7/2024,Malakanthi,Nuwara Eliya,Balangoda,Central,8196,6537,14733,327840,261480,589320
9/8/2024,Malakanthi,Nuwara Eliya,Balangoda,Central,9450,1595,11045,378000,63800,441800
9/9/2024,Malakanthi,Nuwara Eliya,Balangoda,Central,3679,5958,9637,147160,238320,385480
9/10/2024,Malakanthi,Nuwara Eliya,Balangoda,Central,669,8791,9460,26760,351640,378400
9/11/2024,Malakanthi,Nuwara Eliya,Balangoda,Central,3057,6495,9552,122280,259800,382080
9/12/2024,Malakanthi,Nuwara Eliya,Balangoda,Central,6093,6384,12477,243720,255360,499080
9/13/2024,Malakanthi,Nuwara Eliya,Balangoda,Central,7758,3994,11752,310320,159760,470080
9/14/2024,Malakanthi,Nuwara Eliya,Balangoda,Central,4842,1121,5963,193680,44840,238520
9/15/2024,Malakanthi,Nuwara Eliya,Balangoda,Central,4658,5677,10335,186320,227080,413400
9/16/2024,Malakanthi,Nuwara Eliya,Balangoda,Central,2351,4817,7168,94040,192680,286720
9/17/2024,Malakanthi,Nuwara Eliya,Balangoda,Central,2898,3645,6543,115920,145800,261720
9/18/2024,Malakanthi,Nuwara Eliya,Balangoda,Central,850,8284,9134,34000,331360,365360
9/19/2024,Malakanthi,Nuwara Eliya,Balangoda,Central,1425,7575,9000,57000,303000,360000
9/20/2024,Malakanthi,Nuwara Eliya,Balangoda,Central,856,4953,5809,34240,198120,232360
9/21/2024,Malakanthi,Nuwara Eliya,Balangoda,Central,5422,2365,7787,216880,94600,311480
9/22/2024,Malakanthi,Nuwara Eliya,Balangoda,Central,1515,4373,5888,60600,174920,235520
9/23/2024,Malakanthi,Nuwara Eliya,Balangoda,Central,3982,1968,5950,159280,78720,238000
9/24/2024,Malakanthi,Nuwara Eliya,Balangoda,Central,4974,4705,9679,198960,188200,387160
9/25/2024,Malakanthi,Nuwara Eliya,Balangoda,Central,4900,8809,13709,196000,352360,548360
9/26/2024,Malakanthi,Nuwara Eliya,Balangoda,Central,634,7437,8071,25360,297480,322840
9/27/2024,Malakanthi,Nuwara Eliya,Balangoda,Central,869,5398,6267,34760,215920,250680
9/28/2024,Malakanthi,Nuwara Eliya,Balangoda,Central,5027,5099,10126,201080,203960,405040
9/29/2024,Malakanthi,Nuwara Eliya,Balangoda,Central,1803,1772,3575,72120,70880,143000
9/30/2024,Malakanthi,Nuwara Eliya,Balangoda,Central,1274,7775,9049,50960,311000,361960
10/1/2024,Malakanthi,Nuwara Eliya,Balangoda,Central,205,4718,4923,8200,188720,196920
10/2/2024,Malakanthi,Nuwara Eliya,Balangoda,Central,5504,4116,9620,220160,164640,384800
10/3/2024,Malakanthi,Nuwara Eliya,Balangoda,Central,4808,9876,14684,192320,395040,587360
10/4/2024,Malakanthi,Nuwara Eliya,Balangoda,Central,560,8625,9185,22400,345000,367400
10/5/2024,Malakanthi,Nuwara Eliya,Balangoda,Central,6467,1037,7504,258680,41480,300160
10/6/2024,Malakanthi,Nuwara Eliya,Balangoda,Central,5900,7014,12914,236000,280560,516560
10/7/2024,Malakanthi,Nuwara Eliya,Balangoda,Central,1883,3432,5315,75320,137280,212600
10/8/2024,Malakanthi,Nuwara Eliya,Balangoda,Central,6218,4105,10323,248720,164200,412920
10/9/2024,Malakanthi,Nuwara Eliya,Balangoda,Central,7626,615,8241,305040,24600,329640
10/10/2024,Malakanthi,Nuwara Eliya,Balangoda,Central,1801,5329,7130,72040,213160,285200
10/11/2024,Malakanthi,Nuwara Eliya,Balangoda,Central,6056,2857,8913,242240,114280,356520
10/12/2024,Malakanthi,Nuwara Eliya,Balangoda,Central,1347,3705,5052,53880,148200,202080
10/13/2024,Malakanthi,Nuwara Eliya,Balangoda,Central,1653,2763,4416,66120,110520,176640
10/14/2024,Malakanthi,Nuwara Eliya,Balangoda,Central,5168,5415,10583,206720,216600,423320
10/15/2024,Malakanthi,Nuwara Eliya,Balangoda,Central,6513,3158,9671,260520,126320,386840
10/16/2024,Malakanthi,Nuwara Eliya,Balangoda,Central,5043,3091,8134,201720,123640,325360
10/17/2024,Malakanthi,Nuwara Eliya,Balangoda,Central,830,2196,3026,33200,87840,121040
10/18/2024,Malakanthi,Nuwara Eliya,Balangoda,Central,3913,1883,5796,156520,75320,231840
10/19/2024,Malakanthi,Nuwara Eliya,Balangoda,Central,7836,9097,16933,313440,363880,677320
10/20/2024,Malakanthi,Nuwara Eliya,Balangoda,Central,9495,1065,10560,379800,42600,422400
10/21/2024,Malakanthi,Nuwara Eliya,Balangoda,Central,2767,7852,10619,110680,314080,424760
10/22/2024,Malakanthi,Nuwara Eliya,Balangoda,Central,3388,6204,9592,135520,248160,383680
10/23/2024,Malakanthi,Nuwara Eliya,Balangoda,Central,1027,9941,10968,41080,397640,438720
10/24/2024,Malakanthi,Nuwara Eliya,Balangoda,Central,735,8758,9493,29400,350320,379720
10/25/2024,Malakanthi,Nuwara Eliya,Balangoda,Central,6277,9625,15902,251080,385000,636080
10/26/2024,Malakanthi,Nuwara Eliya,Balangoda,Central,4112,3451,7563,164480,138040,302520
10/27/2024,Malakanthi,Nuwara Eliya,Balangoda,Central,3386,7733,11119,135440,309320,444760
10/28/2024,Malakanthi,Nuwara Eliya,Balangoda,Central,2127,2272,4399,85080,90880,175960
10/29/2024,Malakanthi,Nuwara Eliya,Balangoda,Central,6429,5812,12241,257160,232480,489640
10/30/2024,Malakanthi,Nuwara Eliya,Balangoda,Central,8179,1115,9294,327160,44600,371760
10/31/2024,Malakanthi,Nuwara Eliya,Balangoda,Central,4322,3010,7332,172880,120400,293280
11/1/2024,Malakanthi,Nuwara Eliya,Balangoda,Central,2897,4088,6985,115880,163520,279400
11/2/2024,Malakanthi,Nuwara Eliya,Balangoda,Central,3664,7966,11630,146560,318640,465200
11/3/2024,Malakanthi,Nuwara Eliya,Balangoda,Central,1098,7140,8238,43920,285600,329520
11/4/2024,Malakanthi,Nuwara Eliya,Balangoda,Central,4601,9964,14565,184040,398560,582600
11/5/2024,Malakanthi,Nuwara Eliya,Balangoda,Central,6522,3972,10494,260880,158880,419760
11/6/2024,Malakanthi,Nuwara Eliya,Balangoda,Central,1978,6529,8507,79120,261160,340280
11/7/2024,Malakanthi,Nuwara Eliya,Balangoda,Central,9506,475,9981,380240,19000,399240
11/8/2024,Malakanthi,Nuwara Eliya,Balangoda,Central,2022,9595,11617,80880,383800,464680
11/9/2024,Malakanthi,Nuwara Eliya,Balangoda,Central,8781,4421,13202,351240,176840,528080
11/10/2024,Malakanthi,Nuwara Eliya,Balangoda,Central,7179,7902,15081,287160,316080,603240
11/11/2024,Malakanthi,Nuwara Eliya,Balangoda,Central,4812,6199,11011,192480,247960,440440
11/12/2024,Malakanthi,Nuwara Eliya,Balangoda,Central,3322,2909,6231,132880,116360,249240
11/13/2024,Malakanthi,Nuwara Eliya,Balangoda,Central,3136,8218,11354,125440,328720,454160
11/14/2024,Malakanthi,Nuwara Eliya,Balangoda,Central,3778,7667,11445,151120,306680,457800
11/15/2024,Malakanthi,Nuwara Eliya,Balangoda,Central,3667,9893,13560,146680,395720,542400
11/16/2024,Malakanthi,Nuwara Eliya,Balangoda,Central,1985,8958,10943,79400,358320,437720
11/17/2024,Malakanthi,Nuwara Eliya,Balangoda,Central,9310,149,9459,372400,5960,378360
11/18/2024,Malakanthi,Nuwara Eliya,Balangoda,Central,8990,3396,12386,359600,135840,495440
11/19/2024,Malakanthi,Nuwara Eliya,Balangoda,Central,5819,4488,10307,232760,179520,412280
11/20/2024,Malakanthi,Nuwara Eliya,Balangoda,Central,1072,5320,6392,42880,212800,255680
11/21/2024,Malakanthi,Nuwara Eliya,Balangoda,Central,4017,7488,11505,160680,299520,460200
11/22/2024,Malakanthi,Nuwara Eliya,Balangoda,Central,9241,4196,13437,369640,167840,537480
11/23/2024,Malakanthi,Nuwara Eliya,Balangoda,Central,7839,7916,15755,313560,316640,630200
11/24/2024,Malakanthi,Nuwara Eliya,Balangoda,Central,3245,8704,11949,129800,348160,477960
11/25/2024,Malakanthi,Nuwara Eliya,Balangoda,Central,8944,5969,14913,357760,238760,596520
11/26/2024,Malakanthi,Nuwara Eliya,Balangoda,Central,1670,3478,5148,66800,139120,205920
11/27/2024,Malakanthi,Nuwara Eliya,Balangoda,Central,1010,6509,7519,40400,260360,300760
11/28/2024,Malakanthi,Nuwara Eliya,Balangoda,Central,9919,906,10825,396760,36240,433000
11/29/2024,Malakanthi,Nuwara Eliya,Balangoda,Central,5744,191,5935,229760,7640,237400
11/30/2024,Malakanthi,Nuwara Eliya,Balangoda,Central,57,192,249,2280,7680,9960
12/1/2024,Malakanthi,Nuwara Eliya,Balangoda,Central,8187,607,8794,327480,24280,351760
12/2/2024,Malakanthi,Nuwara Eliya,Balangoda,Central,9737,1136,10873,389480,45440,434920
12/3/2024,Malakanthi,Nuwara Eliya,Balangoda,Central,8874,7874,16748,354960,314960,669920
12/4/2024,Malakanthi,Nuwara Eliya,Balangoda,Central,1351,4128,5479,54040,165120,219160
12/5/2024,Malakanthi,Nuwara Eliya,Balangoda,Central,5178,6109,11287,207120,244360,451480
12/6/2024,Malakanthi,Nuwara Eliya,Balangoda,Central,9542,2033,11575,381680,81320,463000
12/7/2024,Malakanthi,Nuwara Eliya,Balangoda,Central,4852,918,5770,194080,36720,230800
12/8/2024,Malakanthi,Nuwara Eliya,Balangoda,Central,7199,3309,10508,287960,132360,420320
12/9/2024,Malakanthi,Nuwara Eliya,Balangoda,Central,5525,6028,11553,221000,241120,462120
12/10/2024,Malakanthi,Nuwara Eliya,Balangoda,Central,4398,5755,10153,175920,230200,406120
12/11/2024,Malakanthi,Nuwara Eliya,Balangoda,Central,6365,6543,12908,254600,261720,516320
12/12/2024,Malakanthi,Nuwara Eliya,Balangoda,Central,4149,939,5088,165960,37560,203520
12/13/2024,Malakanthi,Nuwara Eliya,Balangoda,Central,7853,4579,12432,314120,183160,497280
12/14/2024,Malakanthi,Nuwara Eliya,Balangoda,Central,5176,3420,8596,207040,136800,343840
12/15/2024,Malakanthi,Nuwara Eliya,Balangoda,Central,6448,3827,10275,257920,153080,411000
12/16/2024,Malakanthi,Nuwara Eliya,Balangoda,Central,1712,3769,5481,68480,150760,219240
12/17/2024,Malakanthi,Nuwara Eliya,Balangoda,Central,1616,6733,8349,64640,269320,333960
12/18/2024,Malakanthi,Nuwara Eliya,Balangoda,Central,8520,7662,16182,340800,306480,647280
12/19/2024,Malakanthi,Nuwara Eliya,Balangoda,Central,2433,989,3422,97320,39560,136880
12/20/2024,Malakanthi,Nuwara Eliya,Balangoda,Central,2569,262,2831,102760,10480,113240
12/21/2024,Malakanthi,Nuwara Eliya,Balangoda,Central,1647,914,2561,65880,36560,102440
12/22/2024,Malakanthi,Nuwara Eliya,Balangoda,Central,4017,7957,11974,160680,318280,478960
12/23/2024,Malakanthi,Nuwara Eliya,Balangoda,Central,2834,4094,6928,113360,163760,277120
12/24/2024,Malakanthi,Nuwara Eliya,Balangoda,Central,1673,1270,2943,66920,50800,117720
12/25/2024,Malakanthi,Nuwara Eliya,Balangoda,Central,7351,4732,12083,294040,189280,483320
12/26/2024,Malakanthi,Nuwara Eliya,Balangoda,Central,2482,7302,9784,99280,292080,391360
12/27/2024,Malakanthi,Nuwara Eliya,Balangoda,Central,3594,8561,12155,143760,342440,486200
12/28/2024,Malakanthi,Nuwara Eliya,Balangoda,Central,5301,9855,15156,212040,394200,606240
12/29/2024,Malakanthi,Nuwara Eliya,Balangoda,Central,5093,8875,13968,203720,355000,558720
12/30/2024,Malakanthi,Nuwara Eliya,Balangoda,Central,6113,3810,9923,244520,152400,396920
12/31/2024,Malakanthi,Nuwara Eliya,Balangoda,Central,2412,1105,3517,96480,44200,140680
1/1/2025,Malakanthi,Nuwara Eliya,Balangoda,Central,5337,7527,12864,213480,301080,514560
1/2/2025,Malakanthi,Nuwara Eliya,Balangoda,Central,808,7023,7831,32320,280920,313240
1/3/2025,Malakanthi,Nuwara Eliya,Balangoda,Central,2411,8262,10673,96440,330480,426920
1/4/2025,Malakanthi,Nuwara Eliya,Balangoda,Central,7945,515,8460,317800,20600,338400
1/5/2025,Malakanthi,Nuwara Eliya,Balangoda,Central,5698,1318,7016,227920,52720,280640
1/6/2025,Malakanthi,Nuwara Eliya,Balangoda,Central,4427,3087,7514,177080,123480,300560
1/7/2025,Malakanthi,Nuwara Eliya,Balangoda,Central,8707,4698,13405,348280,187920,536200
1/8/2025,Malakanthi,Nuwara Eliya,Balangoda,Central,7828,4223,12051,313120,168920,482040
1/9/2025,Malakanthi,Nuwara Eliya,Balangoda,Central,7365,178,7543,294600,7120,301720
1/10/2025,Malakanthi,Nuwara Eliya,Balangoda,Central,3678,62,3740,147120,2480,149600
1/11/2025,Malakanthi,Nuwara Eliya,Balangoda,Central,848,9419,10267,33920,376760,410680
1/12/2025,Malakanthi,Nuwara Eliya,Balangoda,Central,5539,9487,15026,221560,379480,601040
1/13/2025,Malakanthi,Nuwara Eliya,Balangoda,Central,2778,6365,9143,111120,254600,365720
1/14/2025,Malakanthi,Nuwara Eliya,Balangoda,Central,3736,9778,13514,149440,391120,540560
1/15/2025,Malakanthi,Nuwara Eliya,Balangoda,Central,2912,2392,5304,116480,95680,212160
1/16/2025,Malakanthi,Nuwara Eliya,Balangoda,Central,7230,1468,8698,289200,58720,347920
1/17/2025,Malakanthi,Nuwara Eliya,Balangoda,Central,8041,9854,17895,321640,394160,715800
1/18/2025,Malakanthi,Nuwara Eliya,Balangoda,Central,9650,8497,18147,386000,339880,725880
1/19/2025,Malakanthi,Nuwara Eliya,Balangoda,Central,6377,6319,12696,255080,252760,507840
1/20/2025,Malakanthi,Nuwara Eliya,Balangoda,Central,4921,6729,11650,196840,269160,466000
1/21/2025,Malakanthi,Nuwara Eliya,Balangoda,Central,6983,3467,10450,279320,138680,418000
1/22/2025,Malakanthi,Nuwara Eliya,Balangoda,Central,3905,3932,7837,156200,157280,313480
1/23/2025,Malakanthi,Nuwara Eliya,Balangoda,Central,6972,8320,15292,278880,332800,611680
1/24/2025,Malakanthi,Nuwara Eliya,Balangoda,Central,7830,7391,15221,313200,295640,608840
1/25/2025,Malakanthi,Nuwara Eliya,Balangoda,Central,5038,6634,11672,201520,265360,466880
1/26/2025,Malakanthi,Nuwara Eliya,Balangoda,Central,3337,2974,6311,133480,118960,252440
1/27/2025,Malakanthi,Nuwara Eliya,Balangoda,Central,1415,8123,9538,56600,324920,381520
1/28/2025,Malakanthi,Nuwara Eliya,Balangoda,Central,525,2198,2723,21000,87920,108920
1/29/2025,Malakanthi,Nuwara Eliya,Balangoda,Central,9362,6133,15495,374480,245320,619800
1/30/2025,Malakanthi,Nuwara Eliya,Balangoda,Central,9271,1441,10712,370840,57640,428480
1/31/2025,Malakanthi,Nuwara Eliya,Balangoda,Central,4700,5087,9787,188000,203480,391480
2/1/2025,Malakanthi,Nuwara Eliya,Balangoda,Central,4649,9580,14229,185960,383200,569160
2/2/2025,Malakanthi,Nuwara Eliya,Balangoda,Central,8409,8915,17324,336360,356600,692960
2/3/2025,Malakanthi,Nuwara Eliya,Balangoda,Central,6335,4354,10689,253400,174160,427560
2/4/2025,Malakanthi,Nuwara Eliya,Balangoda,Central,8487,6394,14881,339480,255760,595240
2/5/2025,Malakanthi,Nuwara Eliya,Balangoda,Central,293,4148,4441,11720,165920,177640
2/6/2025,Malakanthi,Nuwara Eliya,Balangoda,Central,5785,7742,13527,231400,309680,541080
2/7/2025,Malakanthi,Nuwara Eliya,Balangoda,Central,9525,1541,11066,381000,61640,442640
2/8/2025,Malakanthi,Nuwara Eliya,Balangoda,Central,3220,4963,8183,128800,198520,327320
2/9/2025,Malakanthi,Nuwara Eliya,Balangoda,Central,1125,2875,4000,45000,115000,160000
2/10/2025,Malakanthi,Nuwara Eliya,Balangoda,Central,9559,3219,12778,382360,128760,511120
2/11/2025,Malakanthi,Nuwara Eliya,Balangoda,Central,6396,2223,8619,255840,88920,344760
2/12/2025,Malakanthi,Nuwara Eliya,Balangoda,Central,4510,9863,14373,180400,394520,574920
2/13/2025,Malakanthi,Nuwara Eliya,Balangoda,Central,227,5626,5853,9080,225040,234120
2/14/2025,Malakanthi,Nuwara Eliya,Balangoda,Central,6497,5564,12061,259880,222560,482440
2/15/2025,Malakanthi,Nuwara Eliya,Balangoda,Central,4917,154,5071,196680,6160,202840
2/16/2025,Malakanthi,Nuwara Eliya,Balangoda,Central,3264,8110,11374,130560,324400,454960
2/17/2025,Malakanthi,Nuwara Eliya,Balangoda,Central,3497,4687,8184,139880,187480,327360
2/18/2025,Malakanthi,Nuwara Eliya,Balangoda,Central,2262,5156,7418,90480,206240,296720
2/19/2025,Malakanthi,Nuwara Eliya,Balangoda,Central,943,8355,9298,37720,334200,371920
2/20/2025,Malakanthi,Nuwara Eliya,Balangoda,Central,6614,5897,12511,264560,235880,500440
2/21/2025,Malakanthi,Nuwara Eliya,Balangoda,Central,4231,5976,10207,169240,239040,408280
2/22/2025,Malakanthi,Nuwara Eliya,Balangoda,Central,3535,1954,5489,141400,78160,219560
2/23/2025,Malakanthi,Nuwara Eliya,Balangoda,Central,4017,7264,11281,160680,290560,451240
2/24/2025,Malakanthi,Nuwara Eliya,Balangoda,Central,809,415,1224,32360,16600,48960
2/25/2025,Malakanthi,Nuwara Eliya,Balangoda,Central,7726,8465,16191,309040,338600,647640
2/26/2025,Malakanthi,Nuwara Eliya,Balangoda,Central,9678,5845,15523,387120,233800,620920
2/27/2025,Malakanthi,Nuwara Eliya,Balangoda,Central,2491,5970,8461,99640,238800,338440
2/28/2025,Malakanthi,Nuwara Eliya,Balangoda,Central,664,7633,8297,26560,305320,331880
3/1/2025,Malakanthi,Nuwara Eliya,Balangoda,Central,9058,7130,16188,362320,285200,647520
3/2/2025,Malakanthi,Nuwara Eliya,Balangoda,Central,289,7829,8118,11560,313160,324720
3/3/2025,Malakanthi,Nuwara Eliya,Balangoda,Central,4094,3008,7102,163760,120320,284080
3/4/2025,Malakanthi,Nuwara Eliya,Balangoda,Central,6981,7815,14796,279240,312600,591840
3/5/2025,Malakanthi,Nuwara Eliya,Balangoda,Central,5614,7402,13016,224560,296080,520640
3/6/2025,Malakanthi,Nuwara Eliya,Balangoda,Central,4752,7736,12488,190080,309440,499520
3/7/2025,Malakanthi,Nuwara Eliya,Balangoda,Central,401,7524,7925,16040,300960,317000
3/8/2025,Malakanthi,Nuwara Eliya,Balangoda,Central,4225,6730,10955,169000,269200,438200
3/9/2025,Malakanthi,Nuwara Eliya,Balangoda,Central,4584,3226,7810,183360,129040,312400
3/10/2025,Malakanthi,Nuwara Eliya,Balangoda,Central,5008,3405,8413,200320,136200,336520
3/11/2025,Malakanthi,Nuwara Eliya,Balangoda,Central,5434,8818,14252,217360,352720,570080
3/12/2025,Malakanthi,Nuwara Eliya,Balangoda,Central,6059,9906,15965,242360,396240,638600
3/13/2025,Malakanthi,Nuwara Eliya,Balangoda,Central,9700,5509,15209,388000,220360,608360
3/14/2025,Malakanthi,Nuwara Eliya,Balangoda,Central,1566,8787,10353,62640,351480,414120
3/15/2025,Malakanthi,Nuwara Eliya,Balangoda,Central,3199,7979,11178,127960,319160,447120
3/16/2025,Malakanthi,Nuwara Eliya,Balangoda,Central,4899,9069,13968,195960,362760,558720
3/17/2025,Malakanthi,Nuwara Eliya,Balangoda,Central,47,3041,3088,1880,121640,123520
3/18/2025,Malakanthi,Nuwara Eliya,Balangoda,Central,4014,8234,12248,160560,329360,489920
3/19/2025,Malakanthi,Nuwara Eliya,Balangoda,Central,9129,6556,15685,365160,262240,627400
3/20/2025,Malakanthi,Nuwara Eliya,Balangoda,Central,7237,4140,11377,289480,165600,455080
3/21/2025,Malakanthi,Nuwara Eliya,Balangoda,Central,7346,7728,15074,293840,309120,602960
3/22/2025,Malakanthi,Nuwara Eliya,Balangoda,Central,8302,1042,9344,332080,41680,373760
3/23/2025,Malakanthi,Nuwara Eliya,Balangoda,Central,886,1507,2393,35440,60280,95720
3/25/2024,Sisira Perera,Jaffna,Chavakachcheri,Northern,2036,4534,6570,81440,181360,262800
3/26/2024,Sisira Perera,Jaffna,Chavakachcheri,Northern,9255,6287,15542,370200,251480,621680
3/27/2024,Sisira Perera,Jaffna,Chavakachcheri,Northern,7168,1251,8419,286720,50040,336760
3/28/2024,Sisira Perera,Jaffna,Chavakachcheri,Northern,1101,1872,2973,44040,74880,118920
3/29/2024,Sisira Perera,Jaffna,Chavakachcheri,Northern,5162,1862,7024,206480,74480,280960
3/30/2024,Sisira Perera,Jaffna,Chavakachcheri,Northern,6869,7370,14239,274760,294800,569560
3/31/2024,Sisira Perera,Jaffna,Chavakachcheri,Northern,8204,3370,11574,328160,134800,462960
4/1/2024,Sisira Perera,Jaffna,Chavakachcheri,Northern,3286,645,3931,131440,25800,157240
4/2/2024,Sisira Perera,Jaffna,Chavakachcheri,Northern,7646,1841,9487,305840,73640,379480
4/3/2024,Sisira Perera,Jaffna,Chavakachcheri,Northern,8883,7290,16173,355320,291600,646920
4/4/2024,Sisira Perera,Jaffna,Chavakachcheri,Northern,263,9678,9941,10520,387120,397640
4/5/2024,Sisira Perera,Jaffna,Chavakachcheri,Northern,8023,5127,13150,320920,205080,526000
4/6/2024,Sisira Perera,Jaffna,Chavakachcheri,Northern,1068,780,1848,42720,31200,73920
4/7/2024,Sisira Perera,Jaffna,Chavakachcheri,Northern,7056,7757,14813,282240,310280,592520
4/8/2024,Sisira Perera,Jaffna,Chavakachcheri,Northern,3292,1766,5058,131680,70640,202320
4/9/2024,Sisira Perera,Jaffna,Chavakachcheri,Northern,576,5853,6429,23040,234120,257160
4/10/2024,Sisira Perera,Jaffna,Chavakachcheri,Northern,590,685,1275,23600,27400,51000
4/11/2024,Sisira Perera,Jaffna,Chavakachcheri,Northern,3325,4662,7987,133000,186480,319480
4/19/2024,Sisira Perera,Jaffna,Chavakachcheri,Northern,8277,856,9133,331080,34240,365320
4/20/2024,Sisira Perera,Jaffna,Chavakachcheri,Northern,962,4489,5451,38480,179560,218040
4/21/2024,Sisira Perera,Jaffna,Chavakachcheri,Northern,7407,4523,11930,296280,180920,477200
4/22/2024,Sisira Perera,Jaffna,Chavakachcheri,Northern,1662,4409,6071,66480,176360,242840
4/23/2024,Sisira Perera,Jaffna,Chavakachcheri,Northern,3910,9295,13205,156400,371800,528200
4/24/2024,Sisira Perera,Jaffna,Chavakachcheri,Northern,8270,6809,15079,330800,272360,603160
4/25/2024,Sisira Perera,Jaffna,Chavakachcheri,Northern,6210,2712,8922,248400,108480,356880
4/26/2024,Sisira Perera,Jaffna,Chavakachcheri,Northern,8426,4762,13188,337040,190480,527520
4/27/2024,Sisira Perera,Jaffna,Chavakachcheri,Northern,3121,687,3808,124840,27480,152320
4/28/2024,Sisira Perera,Jaffna,Chavakachcheri,Northern,1748,4319,6067,69920,172760,242680
4/29/2024,Sisira Perera,Jaffna,Chavakachcheri,Northern,2870,7165,10035,114800,286600,401400
4/30/2024,Sisira Perera,Jaffna,Chavakachcheri,Northern,7644,981,8625,305760,39240,345000
5/1/2024,Sisira Perera,Jaffna,Chavakachcheri,Northern,5645,8809,14454,225800,352360,578160
5/2/2024,Sisira Perera,Jaffna,Chavakachcheri,Northern,5687,8807,14494,227480,352280,579760
5/3/2024,Sisira Perera,Jaffna,Chavakachcheri,Northern,753,8915,9668,30120,356600,386720
5/4/2024,Sisira Perera,Jaffna,Chavakachcheri,Northern,6912,2629,9541,276480,105160,381640
5/5/2024,Sisira Perera,Jaffna,Chavakachcheri,Northern,3459,6675,10134,138360,267000,405360
5/6/2024,Sisira Perera,Jaffna,Chavakachcheri,Northern,6380,1715,8095,255200,68600,323800
5/7/2024,Sisira Perera,Jaffna,Chavakachcheri,Northern,3432,4263,7695,137280,170520,307800
5/8/2024,Sisira Perera,Jaffna,Chavakachcheri,Northern,6315,5364,11679,252600,214560,467160
5/9/2024,Sisira Perera,Jaffna,Chavakachcheri,Northern,938,78,1016,37520,3120,40640
5/10/2024,Sisira Perera,Jaffna,Chavakachcheri,Northern,7497,3049,10546,299880,121960,421840
5/11/2024,Sisira Perera,Jaffna,Chavakachcheri,Northern,2212,3247,5459,88480,129880,218360
5/12/2024,Sisira Perera,Jaffna,Chavakachcheri,Northern,740,7455,8195,29600,298200,327800
5/13/2024,Sisira Perera,Jaffna,Chavakachcheri,Northern,8623,7507,16130,344920,300280,645200
5/14/2024,Sisira Perera,Jaffna,Chavakachcheri,Northern,4348,3968,8316,173920,158720,332640
5/15/2024,Sisira Perera,Jaffna,Chavakachcheri,Northern,6482,3228,9710,259280,129120,388400
5/16/2024,Sisira Perera,Jaffna,Chavakachcheri,Northern,8099,7812,15911,323960,312480,636440
5/17/2024,Sisira Perera,Jaffna,Chavakachcheri,Northern,4496,5430,9926,179840,217200,397040
5/18/2024,Sisira Perera,Jaffna,Chavakachcheri,Northern,4680,7814,12494,187200,312560,499760
5/19/2024,Sisira Perera,Jaffna,Chavakachcheri,Northern,5148,7782,12930,205920,311280,517200
5/20/2024,Sisira Perera,Jaffna,Chavakachcheri,Northern,8380,1261,9641,335200,50440,385640
5/21/2024,Sisira Perera,Jaffna,Chavakachcheri,Northern,3909,8322,12231,156360,332880,489240
5/22/2024,Sisira Perera,Jaffna,Chavakachcheri,Northern,7051,1047,8098,282040,41880,323920
5/24/2024,Sisira Perera,Jaffna,Chavakachcheri,Northern,9514,1383,10897,380560,55320,435880
5/25/2024,Sisira Perera,Jaffna,Chavakachcheri,Northern,5464,4265,9729,218560,170600,389160
5/26/2024,Sisira Perera,Jaffna,Chavakachcheri,Northern,8363,3942,12305,334520,157680,492200
5/27/2024,Sisira Perera,Jaffna,Chavakachcheri,Northern,3240,2767,6007,129600,110680,240280
5/28/2024,Sisira Perera,Jaffna,Chavakachcheri,Northern,8796,6687,15483,351840,267480,619320
5/29/2024,Sisira Perera,Jaffna,Chavakachcheri,Northern,7866,3744,11610,314640,149760,464400
5/30/2024,Sisira Perera,Jaffna,Chavakachcheri,Northern,2541,6236,8777,101640,249440,351080
5/31/2024,Sisira Perera,Jaffna,Chavakachcheri,Northern,169,7030,7199,6760,281200,287960
6/1/2024,Sisira Perera,Jaffna,Chavakachcheri,Northern,3068,5197,8265,122720,207880,330600
6/2/2024,Sisira Perera,Jaffna,Chavakachcheri,Northern,7549,4937,12486,301960,197480,499440
6/3/2024,Sisira Perera,Jaffna,Chavakachcheri,Northern,1153,8227,9380,46120,329080,375200
6/4/2024,Sisira Perera,Jaffna,Chavakachcheri,Northern,987,8259,9246,39480,330360,369840
6/5/2024,Sisira Perera,Jaffna,Chavakachcheri,Northern,5965,2543,8508,238600,101720,340320
6/6/2024,Sisira Perera,Jaffna,Chavakachcheri,Northern,9205,9232,18437,368200,369280,737480
6/7/2024,Sisira Perera,Jaffna,Chavakachcheri,Northern,9459,2116,11575,378360,84640,463000
6/8/2024,Sisira Perera,Jaffna,Chavakachcheri,Northern,6519,3871,10390,260760,154840,415600
6/9/2024,Sisira Perera,Jaffna,Chavakachcheri,Northern,7023,3298,10321,280920,131920,412840
6/10/2024,Sisira Perera,Jaffna,Chavakachcheri,Northern,1438,8578,10016,57520,343120,400640
6/11/2024,Sisira Perera,Jaffna,Chavakachcheri,Northern,7218,1812,9030,288720,72480,361200
6/12/2024,Sisira Perera,Jaffna,Chavakachcheri,Northern,744,1174,1918,29760,46960,76720
6/13/2024,Sisira Perera,Jaffna,Chavakachcheri,Northern,5009,9220,14229,200360,368800,569160
6/14/2024,Sisira Perera,Jaffna,Chavakachcheri,Northern,3844,9431,13275,153760,377240,531000
6/15/2024,Sisira Perera,Jaffna,Chavakachcheri,Northern,60,5316,5376,2400,212640,215040
6/16/2024,Sisira Perera,Jaffna,Chavakachcheri,Northern,7797,1500,9297,311880,60000,371880
6/17/2024,Sisira Perera,Jaffna,Chavakachcheri,Northern,5623,8895,14518,224920,355800,580720
6/18/2024,Sisira Perera,Jaffna,Chavakachcheri,Northern,1639,9336,10975,65560,373440,439000
6/19/2024,Sisira Perera,Jaffna,Chavakachcheri,Northern,7078,967,8045,283120,38680,321800
6/20/2024,Sisira Perera,Jaffna,Chavakachcheri,Northern,4687,3188,7875,187480,127520,315000
6/21/2024,Sisira Perera,Jaffna,Chavakachcheri,Northern,8142,7284,15426,325680,291360,617040
6/22/2024,Sisira Perera,Jaffna,Chavakachcheri,Northern,4833,2460,7293,193320,98400,291720
6/23/2024,Sisira Perera,Jaffna,Chavakachcheri,Northern,4506,2698,7204,180240,107920,288160
6/24/2024,Sisira Perera,Jaffna,Chavakachcheri,Northern,2667,4822,7489,106680,192880,299560
6/25/2024,Sisira Perera,Jaffna,Chavakachcheri,Northern,8031,1243,9274,321240,49720,370960
6/26/2024,Sisira Perera,Jaffna,Chavakachcheri,Northern,912,2916,3828,36480,116640,153120
6/27/2024,Sisira Perera,Jaffna,Chavakachcheri,Northern,2852,3635,6487,114080,145400,259480
6/28/2024,Sisira Perera,Jaffna,Chavakachcheri,Northern,9663,3847,13510,386520,153880,540400
6/29/2024,Sisira Perera,Jaffna,Chavakachcheri,Northern,3109,1776,4885,124360,71040,195400
6/30/2024,Sisira Perera,Jaffna,Chavakachcheri,Northern,5433,4389,9822,217320,175560,392880
7/1/2024,Sisira Perera,Jaffna,Chavakachcheri,Northern,5840,7592,13432,233600,303680,537280
7/2/2024,Sisira Perera,Jaffna,Chavakachcheri,Northern,5356,732,6088,214240,29280,243520
7/3/2024,Sisira Perera,Jaffna,Chavakachcheri,Northern,6156,5258,11414,246240,210320,456560
7/4/2024,Sisira Perera,Jaffna,Chavakachcheri,Northern,3573,6301,9874,142920,252040,394960
7/5/2024,Sisira Perera,Jaffna,Chavakachcheri,Northern,5746,1801,7547,229840,72040,301880
7/6/2024,Sisira Perera,Jaffna,Chavakachcheri,Northern,1895,856,2751,75800,34240,110040
7/7/2024,Sisira Perera,Jaffna,Chavakachcheri,Northern,7223,5222,12445,288920,208880,497800
7/8/2024,Sisira Perera,Jaffna,Chavakachcheri,Northern,9926,3302,13228,397040,132080,529120
7/9/2024,Sisira Perera,Jaffna,Chavakachcheri,Northern,3387,6674,10061,135480,266960,402440
7/10/2024,Sisira Perera,Jaffna,Chavakachcheri,Northern,4447,8512,12959,177880,340480,518360
7/11/2024,Sisira Perera,Jaffna,Chavakachcheri,Northern,1842,8488,10330,73680,339520,413200
7/12/2024,Sisira Perera,Jaffna,Chavakachcheri,Northern,7913,6750,14663,316520,270000,586520
7/13/2024,Sisira Perera,Jaffna,Chavakachcheri,Northern,2048,5319,7367,81920,212760,294680
7/14/2024,Sisira Perera,Jaffna,Chavakachcheri,Northern,3553,7381,10934,142120,295240,437360
7/15/2024,Sisira Perera,Jaffna,Chavakachcheri,Northern,1758,3028,4786,70320,121120,191440
7/16/2024,Sisira Perera,Jaffna,Chavakachcheri,Northern,7295,7582,14877,291800,303280,595080
7/17/2024,Sisira Perera,Jaffna,Chavakachcheri,Northern,7915,9393,17308,316600,375720,692320
7/18/2024,Sisira Perera,Jaffna,Chavakachcheri,Northern,643,9139,9782,25720,365560,391280
7/19/2024,Sisira Perera,Jaffna,Chavakachcheri,Northern,9204,4688,13892,368160,187520,555680
7/20/2024,Sisira Perera,Jaffna,Chavakachcheri,Northern,1032,5130,6162,41280,205200,246480
7/21/2024,Sisira Perera,Jaffna,Chavakachcheri,Northern,3957,5655,9612,158280,226200,384480
7/22/2024,Sisira Perera,Jaffna,Chavakachcheri,Northern,7445,6728,14173,297800,269120,566920
7/23/2024,Sisira Perera,Jaffna,Chavakachcheri,Northern,2246,8246,10492,89840,329840,419680
7/24/2024,Sisira Perera,Jaffna,Chavakachcheri,Northern,3792,8118,11910,151680,324720,476400
7/25/2024,Sisira Perera,Jaffna,Chavakachcheri,Northern,525,8370,8895,21000,334800,355800
7/26/2024,Sisira Perera,Jaffna,Chavakachcheri,Northern,5807,9227,15034,232280,369080,601360
7/27/2024,Sisira Perera,Jaffna,Chavakachcheri,Northern,7644,8104,15748,305760,324160,629920
7/28/2024,Sisira Perera,Jaffna,Chavakachcheri,Northern,7120,5229,12349,284800,209160,493960
7/29/2024,Sisira Perera,Jaffna,Chavakachcheri,Northern,5493,8215,13708,219720,328600,548320
7/30/2024,Sisira Perera,Jaffna,Chavakachcheri,Northern,1748,9892,11640,69920,395680,465600
7/31/2024,Sisira Perera,Jaffna,Chavakachcheri,Northern,6839,4759,11598,273560,190360,463920
8/1/2024,Sisira Perera,Jaffna,Chavakachcheri,Northern,9502,3052,12554,380080,122080,502160
8/2/2024,Sisira Perera,Jaffna,Chavakachcheri,Northern,2318,9671,11989,92720,386840,479560
8/3/2024,Sisira Perera,Jaffna,Chavakachcheri,Northern,804,829,1633,32160,33160,65320
8/4/2024,Sisira Perera,Jaffna,Chavakachcheri,Northern,4109,4776,8885,164360,191040,355400
8/5/2024,Sisira Perera,Jaffna,Chavakachcheri,Northern,4903,3286,8189,196120,131440,327560
8/6/2024,Sisira Perera,Jaffna,Chavakachcheri,Northern,8279,183,8462,331160,7320,338480
8/7/2024,Sisira Perera,Jaffna,Chavakachcheri,Northern,6548,6879,13427,261920,275160,537080
8/8/2024,Sisira Perera,Jaffna,Chavakachcheri,Northern,1241,1618,2859,49640,64720,114360
8/9/2024,Sisira Perera,Jaffna,Chavakachcheri,Northern,1809,7736,9545,72360,309440,381800
8/10/2024,Sisira Perera,Jaffna,Chavakachcheri,Northern,8574,8098,16672,342960,323920,666880
8/11/2024,Sisira Perera,Jaffna,Chavakachcheri,Northern,6860,1499,8359,274400,59960,334360
8/12/2024,Sisira Perera,Jaffna,Chavakachcheri,Northern,4001,5236,9237,160040,209440,369480
8/13/2024,Sisira Perera,Jaffna,Chavakachcheri,Northern,6343,8216,14559,253720,328640,582360
8/14/2024,Sisira Perera,Jaffna,Chavakachcheri,Northern,558,7099,7657,22320,283960,306280
8/15/2024,Sisira Perera,Jaffna,Chavakachcheri,Northern,2874,6460,9334,114960,258400,373360
8/16/2024,Sisira Perera,Jaffna,Chavakachcheri,Northern,9526,2985,12511,381040,119400,500440
8/17/2024,Sisira Perera,Jaffna,Chavakachcheri,Northern,5097,9693,14790,203880,387720,591600
8/18/2024,Sisira Perera,Jaffna,Chavakachcheri,Northern,2691,981,3672,107640,39240,146880
8/19/2024,Sisira Perera,Jaffna,Chavakachcheri,Northern,8479,762,9241,339160,30480,369640
8/20/2024,Sisira Perera,Jaffna,Chavakachcheri,Northern,4353,4588,8941,174120,183520,357640
8/21/2024,Sisira Perera,Jaffna,Chavakachcheri,Northern,1589,3838,5427,63560,153520,217080
8/22/2024,Sisira Perera,Jaffna,Chavakachcheri,Northern,1142,3245,4387,45680,129800,175480
8/23/2024,Sisira Perera,Jaffna,Chavakachcheri,Northern,2952,4556,7508,118080,182240,300320
8/24/2024,Sisira Perera,Jaffna,Chavakachcheri,Northern,2526,5009,7535,101040,200360,301400
8/25/2024,Sisira Perera,Jaffna,Chavakachcheri,Northern,7810,5702,13512,312400,228080,540480
8/26/2024,Sisira Perera,Jaffna,Chavakachcheri,Northern,4342,5197,9539,173680,207880,381560
8/27/2024,Sisira Perera,Jaffna,Chavakachcheri,Northern,7012,1201,8213,280480,48040,328520
8/28/2024,Sisira Perera,Jaffna,Chavakachcheri,Northern,4117,6544,10661,164680,261760,426440
8/29/2024,Sisira Perera,Jaffna,Chavakachcheri,Northern,8612,3329,11941,344480,133160,477640
8/30/2024,Sisira Perera,Jaffna,Chavakachcheri,Northern,3264,5795,9059,130560,231800,362360
8/31/2024,Sisira Perera,Jaffna,Chavakachcheri,Northern,5695,1248,6943,227800,49920,277720
9/1/2024,Sisira Perera,Jaffna,Chavakachcheri,Northern,8998,474,9472,359920,18960,378880
9/2/2024,Sisira Perera,Jaffna,Chavakachcheri,Northern,6367,9361,15728,254680,374440,629120
9/3/2024,Sisira Perera,Jaffna,Chavakachcheri,Northern,7997,8890,16887,319880,355600,675480
9/4/2024,Sisira Perera,Jaffna,Chavakachcheri,Northern,8077,4670,12747,323080,186800,509880
9/5/2024,Sisira Perera,Jaffna,Chavakachcheri,Northern,837,2411,3248,33480,96440,129920
9/6/2024,Sisira Perera,Jaffna,Chavakachcheri,Northern,8165,8317,16482,326600,332680,659280
9/7/2024,Sisira Perera,Jaffna,Chavakachcheri,Northern,5646,3266,8912,225840,130640,356480
9/8/2024,Sisira Perera,Jaffna,Chavakachcheri,Northern,9608,967,10575,384320,38680,423000
9/9/2024,Sisira Perera,Jaffna,Chavakachcheri,Northern,1398,577,1975,55920,23080,79000
9/10/2024,Sisira Perera,Jaffna,Chavakachcheri,Northern,2125,748,2873,85000,29920,114920
9/11/2024,Sisira Perera,Jaffna,Chavakachcheri,Northern,428,6966,7394,17120,278640,295760
9/12/2024,Sisira Perera,Jaffna,Chavakachcheri,Northern,4044,9141,13185,161760,365640,527400
9/13/2024,Sisira Perera,Jaffna,Chavakachcheri,Northern,4307,4856,9163,172280,194240,366520
9/14/2024,Sisira Perera,Jaffna,Chavakachcheri,Northern,8172,5480,13652,326880,219200,546080
9/15/2024,Sisira Perera,Jaffna,Chavakachcheri,Northern,9397,8122,17519,375880,324880,700760
9/16/2024,Sisira Perera,Jaffna,Chavakachcheri,Northern,9593,9274,18867,383720,370960,754680
9/17/2024,Sisira Perera,Jaffna,Chavakachcheri,Northern,6525,1039,7564,261000,41560,302560
9/18/2024,Sisira Perera,Jaffna,Chavakachcheri,Northern,4712,8536,13248,188480,341440,529920
9/19/2024,Sisira Perera,Jaffna,Chavakachcheri,Northern,2077,4261,6338,83080,170440,253520
9/20/2024,Sisira Perera,Jaffna,Chavakachcheri,Northern,482,2197,2679,19280,87880,107160
9/21/2024,Sisira Perera,Jaffna,Chavakachcheri,Northern,8911,4751,13662,356440,190040,546480
9/22/2024,Sisira Perera,Jaffna,Chavakachcheri,Northern,2457,8590,11047,98280,343600,441880
9/23/2024,Sisira Perera,Jaffna,Chavakachcheri,Northern,2945,954,3899,117800,38160,155960
9/24/2024,Sisira Perera,Jaffna,Chavakachcheri,Northern,9233,1964,11197,369320,78560,447880
9/25/2024,Sisira Perera,Jaffna,Chavakachcheri,Northern,6411,9238,15649,256440,369520,625960
9/26/2024,Sisira Perera,Jaffna,Chavakachcheri,Northern,1253,4185,5438,50120,167400,217520
9/27/2024,Sisira Perera,Jaffna,Chavakachcheri,Northern,7293,9603,16896,291720,384120,675840
9/28/2024,Sisira Perera,Jaffna,Chavakachcheri,Northern,4346,814,5160,173840,32560,206400
9/29/2024,Sisira Perera,Jaffna,Chavakachcheri,Northern,6748,4552,11300,269920,182080,452000
9/30/2024,Sisira Perera,Jaffna,Chavakachcheri,Northern,315,6349,6664,12600,253960,266560
10/1/2024,Sisira Perera,Jaffna,Chavakachcheri,Northern,1193,7601,8794,47720,304040,351760
10/2/2024,Sisira Perera,Jaffna,Chavakachcheri,Northern,6867,6104,12971,274680,244160,518840
10/3/2024,Sisira Perera,Jaffna,Chavakachcheri,Northern,4256,4010,8266,170240,160400,330640
10/4/2024,Sisira Perera,Jaffna,Chavakachcheri,Northern,5829,62,5891,233160,2480,235640
10/5/2024,Sisira Perera,Jaffna,Chavakachcheri,Northern,9349,166,9515,373960,6640,380600
10/6/2024,Sisira Perera,Jaffna,Chavakachcheri,Northern,4285,2037,6322,171400,81480,252880
10/7/2024,Sisira Perera,Jaffna,Chavakachcheri,Northern,9513,3366,12879,380520,134640,515160
10/8/2024,Sisira Perera,Jaffna,Chavakachcheri,Northern,7394,2198,9592,295760,87920,383680
10/9/2024,Sisira Perera,Jaffna,Chavakachcheri,Northern,9678,904,10582,387120,36160,423280
10/10/2024,Sisira Perera,Jaffna,Chavakachcheri,Northern,9349,570,9919,373960,22800,396760
10/11/2024,Sisira Perera,Jaffna,Chavakachcheri,Northern,6953,2696,9649,278120,107840,385960
10/12/2024,Sisira Perera,Jaffna,Chavakachcheri,Northern,4378,5555,9933,175120,222200,397320
10/13/2024,Sisira Perera,Jaffna,Chavakachcheri,Northern,7086,1735,8821,283440,69400,352840
10/14/2024,Sisira Perera,Jaffna,Chavakachcheri,Northern,7197,6101,13298,287880,244040,531920
10/15/2024,Sisira Perera,Jaffna,Chavakachcheri,Northern,6685,6448,13133,267400,257920,525320
10/16/2024,Sisira Perera,Jaffna,Chavakachcheri,Northern,4541,2039,6580,181640,81560,263200
10/17/2024,Sisira Perera,Jaffna,Chavakachcheri,Northern,1246,9897,11143,49840,395880,445720
10/18/2024,Sisira Perera,Jaffna,Chavakachcheri,Northern,670,7095,7765,26800,283800,310600
10/19/2024,Sisira Perera,Jaffna,Chavakachcheri,Northern,2503,2787,5290,100120,111480,211600
10/20/2024,Sisira Perera,Jaffna,Chavakachcheri,Northern,5107,2788,7895,204280,111520,315800
10/21/2024,Sisira Perera,Jaffna,Chavakachcheri,Northern,9325,5089,14414,373000,203560,576560
10/22/2024,Sisira Perera,Jaffna,Chavakachcheri,Northern,5180,256,5436,207200,10240,217440
10/23/2024,Sisira Perera,Jaffna,Chavakachcheri,Northern,8493,4177,12670,339720,167080,506800
10/24/2024,Sisira Perera,Jaffna,Chavakachcheri,Northern,9978,7295,17273,399120,291800,690920
10/25/2024,Sisira Perera,Jaffna,Chavakachcheri,Northern,2646,6236,8882,105840,249440,355280
10/26/2024,Sisira Perera,Jaffna,Chavakachcheri,Northern,7553,9741,17294,302120,389640,691760
10/27/2024,Sisira Perera,Jaffna,Chavakachcheri,Northern,7845,2355,10200,313800,94200,408000
10/28/2024,Sisira Perera,Jaffna,Chavakachcheri,Northern,3095,2726,5821,123800,109040,232840
10/29/2024,Sisira Perera,Jaffna,Chavakachcheri,Northern,395,3648,4043,15800,145920,161720
10/30/2024,Sisira Perera,Jaffna,Chavakachcheri,Northern,4104,2937,7041,164160,117480,281640
10/31/2024,Sisira Perera,Jaffna,Chavakachcheri,Northern,6315,1532,7847,252600,61280,313880
11/1/2024,Sisira Perera,Jaffna,Chavakachcheri,Northern,5541,6059,11600,221640,242360,464000
11/2/2024,Sisira Perera,Jaffna,Chavakachcheri,Northern,8446,2908,11354,337840,116320,454160
11/3/2024,Sisira Perera,Jaffna,Chavakachcheri,Northern,7837,4054,11891,313480,162160,475640
11/4/2024,Sisira Perera,Jaffna,Chavakachcheri,Northern,3270,1583,4853,130800,63320,194120
11/5/2024,Sisira Perera,Jaffna,Chavakachcheri,Northern,8461,4656,13117,338440,186240,524680
11/6/2024,Sisira Perera,Jaffna,Chavakachcheri,Northern,474,2926,3400,18960,117040,136000
11/7/2024,Sisira Perera,Jaffna,Chavakachcheri,Northern,2937,5549,8486,117480,221960,339440
11/8/2024,Sisira Perera,Jaffna,Chavakachcheri,Northern,3964,3037,7001,158560,121480,280040
11/9/2024,Sisira Perera,Jaffna,Chavakachcheri,Northern,9597,2418,12015,383880,96720,480600
11/10/2024,Sisira Perera,Jaffna,Chavakachcheri,Northern,7165,5012,12177,286600,200480,487080
11/11/2024,Sisira Perera,Jaffna,Chavakachcheri,Northern,7033,1892,8925,281320,75680,357000
11/12/2024,Sisira Perera,Jaffna,Chavakachcheri,Northern,9525,6328,15853,381000,253120,634120
11/13/2024,Sisira Perera,Jaffna,Chavakachcheri,Northern,6448,2783,9231,257920,111320,369240
11/14/2024,Sisira Perera,Jaffna,Chavakachcheri,Northern,7302,7218,14520,292080,288720,580800
11/15/2024,Sisira Perera,Jaffna,Chavakachcheri,Northern,1809,6063,7872,72360,242520,314880
11/16/2024,Sisira Perera,Jaffna,Chavakachcheri,Northern,7216,7682,14898,288640,307280,595920
11/17/2024,Sisira Perera,Jaffna,Chavakachcheri,Northern,7529,143,7672,301160,5720,306880
11/18/2024,Sisira Perera,Jaffna,Chavakachcheri,Northern,8476,3148,11624,339040,125920,464960
11/19/2024,Sisira Perera,Jaffna,Chavakachcheri,Northern,5375,9512,14887,215000,380480,595480
11/20/2024,Sisira Perera,Jaffna,Chavakachcheri,Northern,5752,8740,14492,230080,349600,579680
11/21/2024,Sisira Perera,Jaffna,Chavakachcheri,Northern,4994,2761,7755,199760,110440,310200
11/22/2024,Sisira Perera,Jaffna,Chavakachcheri,Northern,6398,3769,10167,255920,150760,406680
11/23/2024,Sisira Perera,Jaffna,Chavakachcheri,Northern,560,2147,2707,22400,85880,108280
11/24/2024,Sisira Perera,Jaffna,Chavakachcheri,Northern,9060,7936,16996,362400,317440,679840
11/25/2024,Sisira Perera,Jaffna,Chavakachcheri,Northern,8287,951,9238,331480,38040,369520
11/26/2024,Sisira Perera,Jaffna,Chavakachcheri,Northern,8499,2526,11025,339960,101040,441000
11/27/2024,Sisira Perera,Jaffna,Chavakachcheri,Northern,2041,4078,6119,81640,163120,244760
11/28/2024,Sisira Perera,Jaffna,Chavakachcheri,Northern,4057,2952,7009,162280,118080,280360
11/29/2024,Sisira Perera,Jaffna,Chavakachcheri,Northern,6292,5705,11997,251680,228200,479880
11/30/2024,Sisira Perera,Jaffna,Chavakachcheri,Northern,2998,1833,4831,119920,73320,193240
12/1/2024,Sisira Perera,Jaffna,Chavakachcheri,Northern,7093,6227,13320,283720,249080,532800
12/2/2024,Sisira Perera,Jaffna,Chavakachcheri,Northern,6665,9347,16012,266600,373880,640480
12/3/2024,Sisira Perera,Jaffna,Chavakachcheri,Northern,901,5753,6654,36040,230120,266160
12/4/2024,Sisira Perera,Jaffna,Chavakachcheri,Northern,5864,3326,9190,234560,133040,367600
12/5/2024,Sisira Perera,Jaffna,Chavakachcheri,Northern,4408,3127,7535,176320,125080,301400
12/6/2024,Sisira Perera,Jaffna,Chavakachcheri,Northern,5586,4229,9815,223440,169160,392600
12/7/2024,Sisira Perera,Jaffna,Chavakachcheri,Northern,5455,8987,14442,218200,359480,577680
12/8/2024,Sisira Perera,Jaffna,Chavakachcheri,Northern,2537,5209,7746,101480,208360,309840
12/9/2024,Sisira Perera,Jaffna,Chavakachcheri,Northern,3967,6425,10392,158680,257000,415680
12/10/2024,Sisira Perera,Jaffna,Chavakachcheri,Northern,1482,5823,7305,59280,232920,292200
12/11/2024,Sisira Perera,Jaffna,Chavakachcheri,Northern,5856,8496,14352,234240,339840,574080
12/12/2024,Sisira Perera,Jaffna,Chavakachcheri,Northern,2992,2589,5581,119680,103560,223240
12/13/2024,Sisira Perera,Jaffna,Chavakachcheri,Northern,8048,4410,12458,321920,176400,498320
12/14/2024,Sisira Perera,Jaffna,Chavakachcheri,Northern,3970,2001,5971,158800,80040,238840
12/15/2024,Sisira Perera,Jaffna,Chavakachcheri,Northern,9702,5787,15489,388080,231480,619560
12/16/2024,Sisira Perera,Jaffna,Chavakachcheri,Northern,3242,1184,4426,129680,47360,177040
12/17/2024,Sisira Perera,Jaffna,Chavakachcheri,Northern,9465,4361,13826,378600,174440,553040
12/18/2024,Sisira Perera,Jaffna,Chavakachcheri,Northern,4328,7560,11888,173120,302400,475520
12/19/2024,Sisira Perera,Jaffna,Chavakachcheri,Northern,6658,7075,13733,266320,283000,549320
12/20/2024,Sisira Perera,Jaffna,Chavakachcheri,Northern,6534,2036,8570,261360,81440,342800
12/21/2024,Sisira Perera,Jaffna,Chavakachcheri,Northern,4103,3642,7745,164120,145680,309800
12/22/2024,Sisira Perera,Jaffna,Chavakachcheri,Northern,47,8244,8291,1880,329760,331640
12/23/2024,Sisira Perera,Jaffna,Chavakachcheri,Northern,5150,3390,8540,206000,135600,341600
12/24/2024,Sisira Perera,Jaffna,Chavakachcheri,Northern,4214,8412,12626,168560,336480,505040
12/25/2024,Sisira Perera,Jaffna,Chavakachcheri,Northern,2543,2792,5335,101720,111680,213400
12/26/2024,Sisira Perera,Jaffna,Chavakachcheri,Northern,8570,7141,15711,342800,285640,628440
12/27/2024,Sisira Perera,Jaffna,Chavakachcheri,Northern,1663,1828,3491,66520,73120,139640
12/28/2024,Sisira Perera,Jaffna,Chavakachcheri,Northern,391,4872,5263,15640,194880,210520
12/29/2024,Sisira Perera,Jaffna,Chavakachcheri,Northern,6383,5548,11931,255320,221920,477240
12/30/2024,Sisira Perera,Jaffna,Chavakachcheri,Northern,7970,9844,17814,318800,393760,712560
12/31/2024,Sisira Perera,Jaffna,Chavakachcheri,Northern,1112,3341,4453,44480,133640,178120
1/1/2025,Sisira Perera,Jaffna,Chavakachcheri,Northern,8131,161,8292,325240,6440,331680
1/2/2025,Sisira Perera,Jaffna,Chavakachcheri,Northern,284,5000,5284,11360,200000,211360
1/3/2025,Sisira Perera,Jaffna,Chavakachcheri,Northern,8874,2411,11285,354960,96440,451400
1/4/2025,Sisira Perera,Jaffna,Chavakachcheri,Northern,6865,5453,12318,274600,218120,492720
1/5/2025,Sisira Perera,Jaffna,Chavakachcheri,Northern,2214,3140,5354,88560,125600,214160
1/6/2025,Sisira Perera,Jaffna,Chavakachcheri,Northern,9596,8951,18547,383840,358040,741880
1/7/2025,Sisira Perera,Jaffna,Chavakachcheri,Northern,4448,63,4511,177920,2520,180440
1/8/2025,Sisira Perera,Jaffna,Chavakachcheri,Northern,6376,6962,13338,255040,278480,533520
1/9/2025,Sisira Perera,Jaffna,Chavakachcheri,Northern,4185,1568,5753,167400,62720,230120
1/10/2025,Sisira Perera,Jaffna,Chavakachcheri,Northern,9612,4,9616,384480,160,384640
1/11/2025,Sisira Perera,Jaffna,Chavakachcheri,Northern,2796,1822,4618,111840,72880,184720
1/12/2025,Sisira Perera,Jaffna,Chavakachcheri,Northern,1511,3943,5454,60440,157720,218160
1/13/2025,Sisira Perera,Jaffna,Chavakachcheri,Northern,3796,7483,11279,151840,299320,451160
1/14/2025,Sisira Perera,Jaffna,Chavakachcheri,Northern,1878,353,2231,75120,14120,89240
1/15/2025,Sisira Perera,Jaffna,Chavakachcheri,Northern,7194,9649,16843,287760,385960,673720
1/16/2025,Sisira Perera,Jaffna,Chavakachcheri,Northern,9834,1491,11325,393360,59640,453000
1/17/2025,Sisira Perera,Jaffna,Chavakachcheri,Northern,6010,7652,13662,240400,306080,546480
1/18/2025,Sisira Perera,Jaffna,Chavakachcheri,Northern,1949,8914,10863,77960,356560,434520
1/19/2025,Sisira Perera,Jaffna,Chavakachcheri,Northern,6692,1069,7761,267680,42760,310440
1/20/2025,Sisira Perera,Jaffna,Chavakachcheri,Northern,600,6146,6746,24000,245840,269840
1/21/2025,Sisira Perera,Jaffna,Chavakachcheri,Northern,101,6866,6967,4040,274640,278680
1/22/2025,Sisira Perera,Jaffna,Chavakachcheri,Northern,9219,6883,16102,368760,275320,644080
1/23/2025,Sisira Perera,Jaffna,Chavakachcheri,Northern,1803,450,2253,72120,18000,90120
1/24/2025,Sisira Perera,Jaffna,Chavakachcheri,Northern,267,151,418,10680,6040,16720
1/25/2025,Sisira Perera,Jaffna,Chavakachcheri,Northern,4662,8370,13032,186480,334800,521280
1/26/2025,Sisira Perera,Jaffna,Chavakachcheri,Northern,1293,8585,9878,51720,343400,395120
1/27/2025,Sisira Perera,Jaffna,Chavakachcheri,Northern,7658,3010,10668,306320,120400,426720
1/28/2025,Sisira Perera,Jaffna,Chavakachcheri,Northern,315,3371,3686,12600,134840,147440
1/29/2025,Sisira Perera,Jaffna,Chavakachcheri,Northern,4807,8432,13239,192280,337280,529560
1/30/2025,Sisira Perera,Jaffna,Chavakachcheri,Northern,2651,8749,11400,106040,349960,456000
1/31/2025,Sisira Perera,Jaffna,Chavakachcheri,Northern,9350,6161,15511,374000,246440,620440
2/1/2025,Sisira Perera,Jaffna,Chavakachcheri,Northern,4783,4915,9698,191320,196600,387920
2/2/2025,Sisira Perera,Jaffna,Chavakachcheri,Northern,5763,1200,6963,230520,48000,278520
2/3/2025,Sisira Perera,Jaffna,Chavakachcheri,Northern,6071,69,6140,242840,2760,245600
2/4/2025,Sisira Perera,Jaffna,Chavakachcheri,Northern,8921,1137,10058,356840,45480,402320
2/5/2025,Sisira Perera,Jaffna,Chavakachcheri,Northern,36,1059,1095,1440,42360,43800
2/6/2025,Sisira Perera,Jaffna,Chavakachcheri,Northern,6035,2277,8312,241400,91080,332480
2/7/2025,Sisira Perera,Jaffna,Chavakachcheri,Northern,7711,9535,17246,308440,381400,689840
2/8/2025,Sisira Perera,Jaffna,Chavakachcheri,Northern,1862,9228,11090,74480,369120,443600
2/9/2025,Sisira Perera,Jaffna,Chavakachcheri,Northern,5444,1384,6828,217760,55360,273120
2/10/2025,Sisira Perera,Jaffna,Chavakachcheri,Northern,2671,1065,3736,106840,42600,149440
2/11/2025,Sisira Perera,Jaffna,Chavakachcheri,Northern,4830,7928,12758,193200,317120,510320
2/12/2025,Sisira Perera,Jaffna,Chavakachcheri,Northern,5629,382,6011,225160,15280,240440
2/13/2025,Sisira Perera,Jaffna,Chavakachcheri,Northern,2472,2956,5428,98880,118240,217120
2/14/2025,Sisira Perera,Jaffna,Chavakachcheri,Northern,2593,3053,5646,103720,122120,225840
2/15/2025,Sisira Perera,Jaffna,Chavakachcheri,Northern,1617,7543,9160,64680,301720,366400
2/16/2025,Sisira Perera,Jaffna,Chavakachcheri,Northern,2333,6451,8784,93320,258040,351360
2/17/2025,Sisira Perera,Jaffna,Chavakachcheri,Northern,2903,7018,9921,116120,280720,396840
2/18/2025,Sisira Perera,Jaffna,Chavakachcheri,Northern,6478,3292,9770,259120,131680,390800
2/19/2025,Sisira Perera,Jaffna,Chavakachcheri,Northern,3928,9939,13867,157120,397560,554680
2/20/2025,Sisira Perera,Jaffna,Chavakachcheri,Northern,1388,2965,4353,55520,118600,174120
2/21/2025,Sisira Perera,Jaffna,Chavakachcheri,Northern,9614,7110,16724,384560,284400,668960
2/22/2025,Sisira Perera,Jaffna,Chavakachcheri,Northern,633,9137,9770,25320,365480,390800
2/23/2025,Sisira Perera,Jaffna,Chavakachcheri,Northern,8753,4716,13469,350120,188640,538760
2/24/2025,Sisira Perera,Jaffna,Chavakachcheri,Northern,8478,8344,16822,339120,333760,672880
2/25/2025,Sisira Perera,Jaffna,Chavakachcheri,Northern,4029,5166,9195,161160,206640,367800
2/26/2025,Sisira Perera,Jaffna,Chavakachcheri,Northern,6775,9564,16339,271000,382560,653560
2/27/2025,Sisira Perera,Jaffna,Chavakachcheri,Northern,3422,5131,8553,136880,205240,342120
2/28/2025,Sisira Perera,Jaffna,Chavakachcheri,Northern,4767,5080,9847,190680,203200,393880
3/1/2025,Sisira Perera,Jaffna,Chavakachcheri,Northern,8535,4597,13132,341400,183880,525280
3/2/2025,Sisira Perera,Jaffna,Chavakachcheri,Northern,9720,8822,18542,388800,352880,741680
3/3/2025,Sisira Perera,Jaffna,Chavakachcheri,Northern,8144,4170,12314,325760,166800,492560
3/4/2025,Sisira Perera,Jaffna,Chavakachcheri,Northern,5736,6452,12188,229440,258080,487520
3/5/2025,Sisira Perera,Jaffna,Chavakachcheri,Northern,3879,2126,6005,155160,85040,240200
3/6/2025,Sisira Perera,Jaffna,Chavakachcheri,Northern,3322,9576,12898,132880,383040,515920
3/7/2025,Sisira Perera,Jaffna,Chavakachcheri,Northern,8173,7010,15183,326920,280400,607320
3/8/2025,Sisira Perera,Jaffna,Chavakachcheri,Northern,1288,7847,9135,51520,313880,365400
3/9/2025,Sisira Perera,Jaffna,Chavakachcheri,Northern,1777,1530,3307,71080,61200,132280
3/10/2025,Sisira Perera,Jaffna,Chavakachcheri,Northern,6648,8912,15560,265920,356480,622400
3/11/2025,Sisira Perera,Jaffna,Chavakachcheri,Northern,8391,3254,11645,335640,130160,465800
3/12/2025,Sisira Perera,Jaffna,Chavakachcheri,Northern,8585,4365,12950,343400,174600,518000
3/13/2025,Sisira Perera,Jaffna,Chavakachcheri,Northern,6353,7037,13390,254120,281480,535600
3/14/2025,Sisira Perera,Jaffna,Chavakachcheri,Northern,3549,1669,5218,141960,66760,208720
3/15/2025,Sisira Perera,Jaffna,Chavakachcheri,Northern,1722,79,1801,68880,3160,72040
3/16/2025,Sisira Perera,Jaffna,Chavakachcheri,Northern,4980,5721,10701,199200,228840,428040
3/17/2025,Sisira Perera,Jaffna,Chavakachcheri,Northern,5402,5385,10787,216080,215400,431480
3/18/2025,Sisira Perera,Jaffna,Chavakachcheri,Northern,9973,245,10218,398920,9800,408720
3/19/2025,Sisira Perera,Jaffna,Chavakachcheri,Northern,8723,1650,10373,348920,66000,414920
3/20/2025,Sisira Perera,Jaffna,Chavakachcheri,Northern,111,6465,6576,4440,258600,263040
3/21/2025,Sisira Perera,Jaffna,Chavakachcheri,Northern,6150,8061,14211,246000,322440,568440
3/22/2025,Sisira Perera,Jaffna,Chavakachcheri,Northern,9891,3256,13147,395640,130240,525880
3/23/2025,Sisira Perera,Jaffna,Chavakachcheri,Northern,1705,4358,6063,68200,174320,242520
3/25/2024,Priyantha Gunasekara,Nuwara Eliya,Nanu Oya,Central,1792,5996,7788,71680,239840,311520
3/26/2024,Priyantha Gunasekara,Nuwara Eliya,Nanu Oya,Central,3847,8152,11999,153880,326080,479960
3/27/2024,Priyantha Gunasekara,Nuwara Eliya,Nanu Oya,Central,322,7101,7423,12880,284040,296920
3/28/2024,Priyantha Gunasekara,Nuwara Eliya,Nanu Oya,Central,6019,1055,7074,240760,42200,282960
3/29/2024,Priyantha Gunasekara,Nuwara Eliya,Nanu Oya,Central,8430,3571,12001,337200,142840,480040
3/30/2024,Priyantha Gunasekara,Nuwara Eliya,Nanu Oya,Central,2945,3427,6372,117800,137080,254880
3/31/2024,Priyantha Gunasekara,Nuwara Eliya,Nanu Oya,Central,4400,7200,11600,176000,288000,464000
4/1/2024,Priyantha Gunasekara,Nuwara Eliya,Nanu Oya,Central,8750,2786,11536,350000,111440,461440
4/2/2024,Priyantha Gunasekara,Nuwara Eliya,Nanu Oya,Central,6138,9040,15178,245520,361600,607120
4/3/2024,Priyantha Gunasekara,Nuwara Eliya,Nanu Oya,Central,686,2505,3191,27440,100200,127640
4/4/2024,Priyantha Gunasekara,Nuwara Eliya,Nanu Oya,Central,5084,9928,15012,203360,397120,600480
4/5/2024,Priyantha Gunasekara,Nuwara Eliya,Nanu Oya,Central,1097,5912,7009,43880,236480,280360
4/6/2024,Priyantha Gunasekara,Nuwara Eliya,Nanu Oya,Central,8790,4883,13673,351600,195320,546920
4/7/2024,Priyantha Gunasekara,Nuwara Eliya,Nanu Oya,Central,1870,3352,5222,74800,134080,208880
4/8/2024,Priyantha Gunasekara,Nuwara Eliya,Nanu Oya,Central,9113,6567,15680,364520,262680,627200
4/9/2024,Priyantha Gunasekara,Nuwara Eliya,Nanu Oya,Central,4300,1484,5784,172000,59360,231360
4/10/2024,Priyantha Gunasekara,Nuwara Eliya,Nanu Oya,Central,1723,9483,11206,68920,379320,448240
4/11/2024,Priyantha Gunasekara,Nuwara Eliya,Nanu Oya,Central,1310,7890,9200,52400,315600,368000
4/19/2024,Priyantha Gunasekara,Nuwara Eliya,Nanu Oya,Central,460,5285,5745,18400,211400,229800
4/20/2024,Priyantha Gunasekara,Nuwara Eliya,Nanu Oya,Central,1585,9112,10697,63400,364480,427880
4/21/2024,Priyantha Gunasekara,Nuwara Eliya,Nanu Oya,Central,6432,3226,9658,257280,129040,386320
4/22/2024,Priyantha Gunasekara,Nuwara Eliya,Nanu Oya,Central,3131,3970,7101,125240,158800,284040
4/23/2024,Priyantha Gunasekara,Nuwara Eliya,Nanu Oya,Central,9939,4756,14695,397560,190240,587800
4/24/2024,Priyantha Gunasekara,Nuwara Eliya,Nanu Oya,Central,9500,4209,13709,380000,168360,548360
4/25/2024,Priyantha Gunasekara,Nuwara Eliya,Nanu Oya,Central,5111,2115,7226,204440,84600,289040
4/26/2024,Priyantha Gunasekara,Nuwara Eliya,Nanu Oya,Central,8702,8779,17481,348080,351160,699240
4/27/2024,Priyantha Gunasekara,Nuwara Eliya,Nanu Oya,Central,8953,6837,15790,358120,273480,631600
4/28/2024,Priyantha Gunasekara,Nuwara Eliya,Nanu Oya,Central,5394,1671,7065,215760,66840,282600
4/29/2024,Priyantha Gunasekara,Nuwara Eliya,Nanu Oya,Central,9121,77,9198,364840,3080,367920
4/30/2024,Priyantha Gunasekara,Nuwara Eliya,Nanu Oya,Central,7267,3934,11201,290680,157360,448040
5/1/2024,Priyantha Gunasekara,Nuwara Eliya,Nanu Oya,Central,2048,4711,6759,81920,188440,270360
5/2/2024,Priyantha Gunasekara,Nuwara Eliya,Nanu Oya,Central,6112,9966,16078,244480,398640,643120
5/3/2024,Priyantha Gunasekara,Nuwara Eliya,Nanu Oya,Central,2733,9269,12002,109320,370760,480080
5/4/2024,Priyantha Gunasekara,Nuwara Eliya,Nanu Oya,Central,4079,183,4262,163160,7320,170480
5/5/2024,Priyantha Gunasekara,Nuwara Eliya,Nanu Oya,Central,9578,7287,16865,383120,291480,674600
5/6/2024,Priyantha Gunasekara,Nuwara Eliya,Nanu Oya,Central,6300,4815,11115,252000,192600,444600
5/7/2024,Priyantha Gunasekara,Nuwara Eliya,Nanu Oya,Central,9132,8892,18024,365280,355680,720960
5/8/2024,Priyantha Gunasekara,Nuwara Eliya,Nanu Oya,Central,2612,4082,6694,104480,163280,267760
5/9/2024,Priyantha Gunasekara,Nuwara Eliya,Nanu Oya,Central,5951,2465,8416,238040,98600,336640
5/10/2024,Priyantha Gunasekara,Nuwara Eliya,Nanu Oya,Central,4334,6201,10535,173360,248040,421400
5/11/2024,Priyantha Gunasekara,Nuwara Eliya,Nanu Oya,Central,8499,7505,16004,339960,300200,640160
5/12/2024,Priyantha Gunasekara,Nuwara Eliya,Nanu Oya,Central,8497,8719,17216,339880,348760,688640
5/13/2024,Priyantha Gunasekara,Nuwara Eliya,Nanu Oya,Central,3741,4510,8251,149640,180400,330040
5/14/2024,Priyantha Gunasekara,Nuwara Eliya,Nanu Oya,Central,4028,7678,11706,161120,307120,468240
5/15/2024,Priyantha Gunasekara,Nuwara Eliya,Nanu Oya,Central,1540,2167,3707,61600,86680,148280
5/16/2024,Priyantha Gunasekara,Nuwara Eliya,Nanu Oya,Central,6819,6751,13570,272760,270040,542800
5/17/2024,Priyantha Gunasekara,Nuwara Eliya,Nanu Oya,Central,2819,8474,11293,112760,338960,451720
5/18/2024,Priyantha Gunasekara,Nuwara Eliya,Nanu Oya,Central,1979,5956,7935,79160,238240,317400
5/19/2024,Priyantha Gunasekara,Nuwara Eliya,Nanu Oya,Central,7015,2155,9170,280600,86200,366800
5/20/2024,Priyantha Gunasekara,Nuwara Eliya,Nanu Oya,Central,5147,9313,14460,205880,372520,578400
5/21/2024,Priyantha Gunasekara,Nuwara Eliya,Nanu Oya,Central,2344,1617,3961,93760,64680,158440
5/22/2024,Priyantha Gunasekara,Nuwara Eliya,Nanu Oya,Central,2906,1556,4462,116240,62240,178480
5/24/2024,Priyantha Gunasekara,Nuwara Eliya,Nanu Oya,Central,2040,2766,4806,81600,110640,192240
5/25/2024,Priyantha Gunasekara,Nuwara Eliya,Nanu Oya,Central,7836,9369,17205,313440,374760,688200
5/26/2024,Priyantha Gunasekara,Nuwara Eliya,Nanu Oya,Central,6399,3287,9686,255960,131480,387440
5/27/2024,Priyantha Gunasekara,Nuwara Eliya,Nanu Oya,Central,1606,3588,5194,64240,143520,207760
5/28/2024,Priyantha Gunasekara,Nuwara Eliya,Nanu Oya,Central,2619,7680,10299,104760,307200,411960
5/29/2024,Priyantha Gunasekara,Nuwara Eliya,Nanu Oya,Central,9846,7241,17087,393840,289640,683480
5/30/2024,Priyantha Gunasekara,Nuwara Eliya,Nanu Oya,Central,9444,4253,13697,377760,170120,547880
5/31/2024,Priyantha Gunasekara,Nuwara Eliya,Nanu Oya,Central,6964,5133,12097,278560,205320,483880
6/1/2024,Priyantha Gunasekara,Nuwara Eliya,Nanu Oya,Central,9214,6826,16040,368560,273040,641600
6/2/2024,Priyantha Gunasekara,Nuwara Eliya,Nanu Oya,Central,1137,6324,7461,45480,252960,298440
6/3/2024,Priyantha Gunasekara,Nuwara Eliya,Nanu Oya,Central,1421,5432,6853,56840,217280,274120
6/4/2024,Priyantha Gunasekara,Nuwara Eliya,Nanu Oya,Central,8708,2346,11054,348320,93840,442160
6/5/2024,Priyantha Gunasekara,Nuwara Eliya,Nanu Oya,Central,7209,2147,9356,288360,85880,374240
6/6/2024,Priyantha Gunasekara,Nuwara Eliya,Nanu Oya,Central,123,3913,4036,4920,156520,161440
6/7/2024,Priyantha Gunasekara,Nuwara Eliya,Nanu Oya,Central,8241,3997,12238,329640,159880,489520
6/8/2024,Priyantha Gunasekara,Nuwara Eliya,Nanu Oya,Central,5120,1014,6134,204800,40560,245360
6/9/2024,Priyantha Gunasekara,Nuwara Eliya,Nanu Oya,Central,3543,6367,9910,141720,254680,396400
6/10/2024,Priyantha Gunasekara,Nuwara Eliya,Nanu Oya,Central,5863,2055,7918,234520,82200,316720
6/11/2024,Priyantha Gunasekara,Nuwara Eliya,Nanu Oya,Central,5529,7785,13314,221160,311400,532560
6/12/2024,Priyantha Gunasekara,Nuwara Eliya,Nanu Oya,Central,7003,8484,15487,280120,339360,619480
6/13/2024,Priyantha Gunasekara,Nuwara Eliya,Nanu Oya,Central,3379,8121,11500,135160,324840,460000
6/14/2024,Priyantha Gunasekara,Nuwara Eliya,Nanu Oya,Central,5216,999,6215,208640,39960,248600
6/15/2024,Priyantha Gunasekara,Nuwara Eliya,Nanu Oya,Central,652,9245,9897,26080,369800,395880
6/16/2024,Priyantha Gunasekara,Nuwara Eliya,Nanu Oya,Central,3184,6279,9463,127360,251160,378520
6/17/2024,Priyantha Gunasekara,Nuwara Eliya,Nanu Oya,Central,7197,9859,17056,287880,394360,682240
6/18/2024,Priyantha Gunasekara,Nuwara Eliya,Nanu Oya,Central,3088,2583,5671,123520,103320,226840
6/19/2024,Priyantha Gunasekara,Nuwara Eliya,Nanu Oya,Central,9028,9715,18743,361120,388600,749720
6/20/2024,Priyantha Gunasekara,Nuwara Eliya,Nanu Oya,Central,9559,5297,14856,382360,211880,594240
6/21/2024,Priyantha Gunasekara,Nuwara Eliya,Nanu Oya,Central,4299,3924,8223,171960,156960,328920
6/22/2024,Priyantha Gunasekara,Nuwara Eliya,Nanu Oya,Central,2770,8928,11698,110800,357120,467920
6/23/2024,Priyantha Gunasekara,Nuwara Eliya,Nanu Oya,Central,1519,8101,9620,60760,324040,384800
6/24/2024,Priyantha Gunasekara,Nuwara Eliya,Nanu Oya,Central,3077,6950,10027,123080,278000,401080
6/25/2024,Priyantha Gunasekara,Nuwara Eliya,Nanu Oya,Central,8074,9130,17204,322960,365200,688160
6/26/2024,Priyantha Gunasekara,Nuwara Eliya,Nanu Oya,Central,4580,9729,14309,183200,389160,572360
6/27/2024,Priyantha Gunasekara,Nuwara Eliya,Nanu Oya,Central,2808,6257,9065,112320,250280,362600
6/28/2024,Priyantha Gunasekara,Nuwara Eliya,Nanu Oya,Central,1475,8152,9627,59000,326080,385080
6/29/2024,Priyantha Gunasekara,Nuwara Eliya,Nanu Oya,Central,6582,8225,14807,263280,329000,592280
6/30/2024,Priyantha Gunasekara,Nuwara Eliya,Nanu Oya,Central,2258,4548,6806,90320,181920,272240
7/1/2024,Priyantha Gunasekara,Nuwara Eliya,Nanu Oya,Central,9667,4714,14381,386680,188560,575240
7/2/2024,Priyantha Gunasekara,Nuwara Eliya,Nanu Oya,Central,4253,71,4324,170120,2840,172960
7/3/2024,Priyantha Gunasekara,Nuwara Eliya,Nanu Oya,Central,4580,5919,10499,183200,236760,419960
7/4/2024,Priyantha Gunasekara,Nuwara Eliya,Nanu Oya,Central,9337,9177,18514,373480,367080,740560
7/5/2024,Priyantha Gunasekara,Nuwara Eliya,Nanu Oya,Central,4076,4547,8623,163040,181880,344920
7/6/2024,Priyantha Gunasekara,Nuwara Eliya,Nanu Oya,Central,7542,378,7920,301680,15120,316800
7/7/2024,Priyantha Gunasekara,Nuwara Eliya,Nanu Oya,Central,2570,435,3005,102800,17400,120200
7/8/2024,Priyantha Gunasekara,Nuwara Eliya,Nanu Oya,Central,4414,3710,8124,176560,148400,324960
7/9/2024,Priyantha Gunasekara,Nuwara Eliya,Nanu Oya,Central,6772,8426,15198,270880,337040,607920
7/10/2024,Priyantha Gunasekara,Nuwara Eliya,Nanu Oya,Central,5003,5656,10659,200120,226240,426360
7/11/2024,Priyantha Gunasekara,Nuwara Eliya,Nanu Oya,Central,2684,3146,5830,107360,125840,233200
7/12/2024,Priyantha Gunasekara,Nuwara Eliya,Nanu Oya,Central,441,9728,10169,17640,389120,406760
7/13/2024,Priyantha Gunasekara,Nuwara Eliya,Nanu Oya,Central,1786,1444,3230,71440,57760,129200
7/14/2024,Priyantha Gunasekara,Nuwara Eliya,Nanu Oya,Central,9825,7944,17769,393000,317760,710760
7/15/2024,Priyantha Gunasekara,Nuwara Eliya,Nanu Oya,Central,3623,3113,6736,144920,124520,269440
7/16/2024,Priyantha Gunasekara,Nuwara Eliya,Nanu Oya,Central,9053,249,9302,362120,9960,372080
7/17/2024,Priyantha Gunasekara,Nuwara Eliya,Nanu Oya,Central,9296,9792,19088,371840,391680,763520
7/18/2024,Priyantha Gunasekara,Nuwara Eliya,Nanu Oya,Central,421,5649,6070,16840,225960,242800
7/19/2024,Priyantha Gunasekara,Nuwara Eliya,Nanu Oya,Central,9116,6995,16111,364640,279800,644440
7/20/2024,Priyantha Gunasekara,Nuwara Eliya,Nanu Oya,Central,91,9164,9255,3640,366560,370200
7/21/2024,Priyantha Gunasekara,Nuwara Eliya,Nanu Oya,Central,2991,4170,7161,119640,166800,286440
7/22/2024,Priyantha Gunasekara,Nuwara Eliya,Nanu Oya,Central,7208,8084,15292,288320,323360,611680
7/23/2024,Priyantha Gunasekara,Nuwara Eliya,Nanu Oya,Central,9305,1316,10621,372200,52640,424840
7/24/2024,Priyantha Gunasekara,Nuwara Eliya,Nanu Oya,Central,8895,7001,15896,355800,280040,635840
7/25/2024,Priyantha Gunasekara,Nuwara Eliya,Nanu Oya,Central,5911,6560,12471,236440,262400,498840
7/26/2024,Priyantha Gunasekara,Nuwara Eliya,Nanu Oya,Central,534,8246,8780,21360,329840,351200
7/27/2024,Priyantha Gunasekara,Nuwara Eliya,Nanu Oya,Central,8026,7969,15995,321040,318760,639800
7/28/2024,Priyantha Gunasekara,Nuwara Eliya,Nanu Oya,Central,1974,9542,11516,78960,381680,460640
7/29/2024,Priyantha Gunasekara,Nuwara Eliya,Nanu Oya,Central,6537,7586,14123,261480,303440,564920
7/30/2024,Priyantha Gunasekara,Nuwara Eliya,Nanu Oya,Central,6967,2763,9730,278680,110520,389200
7/31/2024,Priyantha Gunasekara,Nuwara Eliya,Nanu Oya,Central,6170,3067,9237,246800,122680,369480
8/1/2024,Priyantha Gunasekara,Nuwara Eliya,Nanu Oya,Central,2566,2755,5321,102640,110200,212840
8/2/2024,Priyantha Gunasekara,Nuwara Eliya,Nanu Oya,Central,6959,7105,14064,278360,284200,562560
8/3/2024,Priyantha Gunasekara,Nuwara Eliya,Nanu Oya,Central,7600,9953,17553,304000,398120,702120
8/4/2024,Priyantha Gunasekara,Nuwara Eliya,Nanu Oya,Central,6192,2784,8976,247680,111360,359040
8/5/2024,Priyantha Gunasekara,Nuwara Eliya,Nanu Oya,Central,7251,1413,8664,290040,56520,346560
8/6/2024,Priyantha Gunasekara,Nuwara Eliya,Nanu Oya,Central,4685,8946,13631,187400,357840,545240
8/7/2024,Priyantha Gunasekara,Nuwara Eliya,Nanu Oya,Central,825,2475,3300,33000,99000,132000
8/8/2024,Priyantha Gunasekara,Nuwara Eliya,Nanu Oya,Central,3964,1595,5559,158560,63800,222360
8/9/2024,Priyantha Gunasekara,Nuwara Eliya,Nanu Oya,Central,3086,6302,9388,123440,252080,375520
8/10/2024,Priyantha Gunasekara,Nuwara Eliya,Nanu Oya,Central,4034,7880,11914,161360,315200,476560
8/11/2024,Priyantha Gunasekara,Nuwara Eliya,Nanu Oya,Central,1150,6309,7459,46000,252360,298360
8/12/2024,Priyantha Gunasekara,Nuwara Eliya,Nanu Oya,Central,1484,780,2264,59360,31200,90560
8/13/2024,Priyantha Gunasekara,Nuwara Eliya,Nanu Oya,Central,5328,9782,15110,213120,391280,604400
8/14/2024,Priyantha Gunasekara,Nuwara Eliya,Nanu Oya,Central,2556,3058,5614,102240,122320,224560
8/15/2024,Priyantha Gunasekara,Nuwara Eliya,Nanu Oya,Central,4886,60,4946,195440,2400,197840
8/16/2024,Priyantha Gunasekara,Nuwara Eliya,Nanu Oya,Central,7656,9358,17014,306240,374320,680560
8/17/2024,Priyantha Gunasekara,Nuwara Eliya,Nanu Oya,Central,1042,4138,5180,41680,165520,207200
8/18/2024,Priyantha Gunasekara,Nuwara Eliya,Nanu Oya,Central,2356,4201,6557,94240,168040,262280
8/19/2024,Priyantha Gunasekara,Nuwara Eliya,Nanu Oya,Central,7135,9859,16994,285400,394360,679760
8/20/2024,Priyantha Gunasekara,Nuwara Eliya,Nanu Oya,Central,8543,1214,9757,341720,48560,390280
8/21/2024,Priyantha Gunasekara,Nuwara Eliya,Nanu Oya,Central,9140,5499,14639,365600,219960,585560
8/22/2024,Priyantha Gunasekara,Nuwara Eliya,Nanu Oya,Central,8974,5481,14455,358960,219240,578200
8/23/2024,Priyantha Gunasekara,Nuwara Eliya,Nanu Oya,Central,4634,4486,9120,185360,179440,364800
8/24/2024,Priyantha Gunasekara,Nuwara Eliya,Nanu Oya,Central,7016,3764,10780,280640,150560,431200
8/25/2024,Priyantha Gunasekara,Nuwara Eliya,Nanu Oya,Central,6444,4796,11240,257760,191840,449600
8/26/2024,Priyantha Gunasekara,Nuwara Eliya,Nanu Oya,Central,5088,8407,13495,203520,336280,539800
8/27/2024,Priyantha Gunasekara,Nuwara Eliya,Nanu Oya,Central,3486,9810,13296,139440,392400,531840
8/28/2024,Priyantha Gunasekara,Nuwara Eliya,Nanu Oya,Central,9933,3206,13139,397320,128240,525560
8/29/2024,Priyantha Gunasekara,Nuwara Eliya,Nanu Oya,Central,8806,1571,10377,352240,62840,415080
8/30/2024,Priyantha Gunasekara,Nuwara Eliya,Nanu Oya,Central,5241,7704,12945,209640,308160,517800
8/31/2024,Priyantha Gunasekara,Nuwara Eliya,Nanu Oya,Central,9708,2404,12112,388320,96160,484480
9/1/2024,Priyantha Gunasekara,Nuwara Eliya,Nanu Oya,Central,455,8565,9020,18200,342600,360800
9/2/2024,Priyantha Gunasekara,Nuwara Eliya,Nanu Oya,Central,3777,7878,11655,151080,315120,466200
9/3/2024,Priyantha Gunasekara,Nuwara Eliya,Nanu Oya,Central,9835,8590,18425,393400,343600,737000
9/4/2024,Priyantha Gunasekara,Nuwara Eliya,Nanu Oya,Central,8748,8887,17635,349920,355480,705400
9/5/2024,Priyantha Gunasekara,Nuwara Eliya,Nanu Oya,Central,7724,3383,11107,308960,135320,444280
9/6/2024,Priyantha Gunasekara,Nuwara Eliya,Nanu Oya,Central,8382,4039,12421,335280,161560,496840
9/7/2024,Priyantha Gunasekara,Nuwara Eliya,Nanu Oya,Central,6288,1091,7379,251520,43640,295160
9/8/2024,Priyantha Gunasekara,Nuwara Eliya,Nanu Oya,Central,101,6403,6504,4040,256120,260160
9/9/2024,Priyantha Gunasekara,Nuwara Eliya,Nanu Oya,Central,117,5828,5945,4680,233120,237800
9/10/2024,Priyantha Gunasekara,Nuwara Eliya,Nanu Oya,Central,6626,8978,15604,265040,359120,624160
9/11/2024,Priyantha Gunasekara,Nuwara Eliya,Nanu Oya,Central,2258,2845,5103,90320,113800,204120
9/12/2024,Priyantha Gunasekara,Nuwara Eliya,Nanu Oya,Central,9135,2574,11709,365400,102960,468360
9/13/2024,Priyantha Gunasekara,Nuwara Eliya,Nanu Oya,Central,1653,9615,11268,66120,384600,450720
9/14/2024,Priyantha Gunasekara,Nuwara Eliya,Nanu Oya,Central,7793,9693,17486,311720,387720,699440
9/15/2024,Priyantha Gunasekara,Nuwara Eliya,Nanu Oya,Central,6268,7833,14101,250720,313320,564040
9/16/2024,Priyantha Gunasekara,Nuwara Eliya,Nanu Oya,Central,4567,3257,7824,182680,130280,312960
9/17/2024,Priyantha Gunasekara,Nuwara Eliya,Nanu Oya,Central,6977,5078,12055,279080,203120,482200
9/18/2024,Priyantha Gunasekara,Nuwara Eliya,Nanu Oya,Central,2957,583,3540,118280,23320,141600
9/19/2024,Priyantha Gunasekara,Nuwara Eliya,Nanu Oya,Central,7354,4094,11448,294160,163760,457920
9/20/2024,Priyantha Gunasekara,Nuwara Eliya,Nanu Oya,Central,9397,1964,11361,375880,78560,454440
9/21/2024,Priyantha Gunasekara,Nuwara Eliya,Nanu Oya,Central,4755,1515,6270,190200,60600,250800
9/22/2024,Priyantha Gunasekara,Nuwara Eliya,Nanu Oya,Central,233,2104,2337,9320,84160,93480
9/23/2024,Priyantha Gunasekara,Nuwara Eliya,Nanu Oya,Central,2250,2628,4878,90000,105120,195120
9/24/2024,Priyantha Gunasekara,Nuwara Eliya,Nanu Oya,Central,694,2722,3416,27760,108880,136640
9/25/2024,Priyantha Gunasekara,Nuwara Eliya,Nanu Oya,Central,4962,2377,7339,198480,95080,293560
9/26/2024,Priyantha Gunasekara,Nuwara Eliya,Nanu Oya,Central,5654,1782,7436,226160,71280,297440
9/27/2024,Priyantha Gunasekara,Nuwara Eliya,Nanu Oya,Central,5033,8519,13552,201320,340760,542080
9/28/2024,Priyantha Gunasekara,Nuwara Eliya,Nanu Oya,Central,3939,4654,8593,157560,186160,343720
9/29/2024,Priyantha Gunasekara,Nuwara Eliya,Nanu Oya,Central,9028,3505,12533,361120,140200,501320
9/30/2024,Priyantha Gunasekara,Nuwara Eliya,Nanu Oya,Central,3136,3531,6667,125440,141240,266680
10/1/2024,Priyantha Gunasekara,Nuwara Eliya,Nanu Oya,Central,8733,9998,18731,349320,399920,749240
10/2/2024,Priyantha Gunasekara,Nuwara Eliya,Nanu Oya,Central,6411,81,6492,256440,3240,259680
10/3/2024,Priyantha Gunasekara,Nuwara Eliya,Nanu Oya,Central,4242,5192,9434,169680,207680,377360
10/4/2024,Priyantha Gunasekara,Nuwara Eliya,Nanu Oya,Central,5128,268,5396,205120,10720,215840
10/5/2024,Priyantha Gunasekara,Nuwara Eliya,Nanu Oya,Central,9713,1854,11567,388520,74160,462680
10/6/2024,Priyantha Gunasekara,Nuwara Eliya,Nanu Oya,Central,7963,8303,16266,318520,332120,650640
10/7/2024,Priyantha Gunasekara,Nuwara Eliya,Nanu Oya,Central,1589,9315,10904,63560,372600,436160
10/8/2024,Priyantha Gunasekara,Nuwara Eliya,Nanu Oya,Central,9240,9391,18631,369600,375640,745240
10/9/2024,Priyantha Gunasekara,Nuwara Eliya,Nanu Oya,Central,5434,540,5974,217360,21600,238960
10/10/2024,Priyantha Gunasekara,Nuwara Eliya,Nanu Oya,Central,5012,759,5771,200480,30360,230840
10/11/2024,Priyantha Gunasekara,Nuwara Eliya,Nanu Oya,Central,2903,4150,7053,116120,166000,282120
10/12/2024,Priyantha Gunasekara,Nuwara Eliya,Nanu Oya,Central,4738,9699,14437,189520,387960,577480
10/13/2024,Priyantha Gunasekara,Nuwara Eliya,Nanu Oya,Central,2636,2597,5233,105440,103880,209320
10/14/2024,Priyantha Gunasekara,Nuwara Eliya,Nanu Oya,Central,3883,8511,12394,155320,340440,495760
10/15/2024,Priyantha Gunasekara,Nuwara Eliya,Nanu Oya,Central,5535,9182,14717,221400,367280,588680
10/16/2024,Priyantha Gunasekara,Nuwara Eliya,Nanu Oya,Central,2452,2753,5205,98080,110120,208200
10/17/2024,Priyantha Gunasekara,Nuwara Eliya,Nanu Oya,Central,512,3787,4299,20480,151480,171960
10/18/2024,Priyantha Gunasekara,Nuwara Eliya,Nanu Oya,Central,4796,3105,7901,191840,124200,316040
10/19/2024,Priyantha Gunasekara,Nuwara Eliya,Nanu Oya,Central,9463,9807,19270,378520,392280,770800
10/20/2024,Priyantha Gunasekara,Nuwara Eliya,Nanu Oya,Central,677,6761,7438,27080,270440,297520
10/21/2024,Priyantha Gunasekara,Nuwara Eliya,Nanu Oya,Central,3847,6120,9967,153880,244800,398680
10/22/2024,Priyantha Gunasekara,Nuwara Eliya,Nanu Oya,Central,6312,5947,12259,252480,237880,490360
10/23/2024,Priyantha Gunasekara,Nuwara Eliya,Nanu Oya,Central,4223,9506,13729,168920,380240,549160
10/24/2024,Priyantha Gunasekara,Nuwara Eliya,Nanu Oya,Central,2775,6295,9070,111000,251800,362800
10/25/2024,Priyantha Gunasekara,Nuwara Eliya,Nanu Oya,Central,1557,638,2195,62280,25520,87800
10/26/2024,Priyantha Gunasekara,Nuwara Eliya,Nanu Oya,Central,4472,1383,5855,178880,55320,234200
10/27/2024,Priyantha Gunasekara,Nuwara Eliya,Nanu Oya,Central,1552,5261,6813,62080,210440,272520
10/28/2024,Priyantha Gunasekara,Nuwara Eliya,Nanu Oya,Central,3568,6635,10203,142720,265400,408120
10/29/2024,Priyantha Gunasekara,Nuwara Eliya,Nanu Oya,Central,3940,5902,9842,157600,236080,393680
10/30/2024,Priyantha Gunasekara,Nuwara Eliya,Nanu Oya,Central,2256,8372,10628,90240,334880,425120
10/31/2024,Priyantha Gunasekara,Nuwara Eliya,Nanu Oya,Central,5549,9055,14604,221960,362200,584160
11/1/2024,Priyantha Gunasekara,Nuwara Eliya,Nanu Oya,Central,2858,4756,7614,114320,190240,304560
11/2/2024,Priyantha Gunasekara,Nuwara Eliya,Nanu Oya,Central,2485,8091,10576,99400,323640,423040
11/3/2024,Priyantha Gunasekara,Nuwara Eliya,Nanu Oya,Central,7743,9137,16880,309720,365480,675200
11/4/2024,Priyantha Gunasekara,Nuwara Eliya,Nanu Oya,Central,7748,6530,14278,309920,261200,571120
11/5/2024,Priyantha Gunasekara,Nuwara Eliya,Nanu Oya,Central,6285,5003,11288,251400,200120,451520
11/6/2024,Priyantha Gunasekara,Nuwara Eliya,Nanu Oya,Central,3481,8441,11922,139240,337640,476880
11/7/2024,Priyantha Gunasekara,Nuwara Eliya,Nanu Oya,Central,7698,7570,15268,307920,302800,610720
11/8/2024,Priyantha Gunasekara,Nuwara Eliya,Nanu Oya,Central,2067,6878,8945,82680,275120,357800
11/9/2024,Priyantha Gunasekara,Nuwara Eliya,Nanu Oya,Central,7401,996,8397,296040,39840,335880
11/10/2024,Priyantha Gunasekara,Nuwara Eliya,Nanu Oya,Central,8156,4807,12963,326240,192280,518520
11/11/2024,Priyantha Gunasekara,Nuwara Eliya,Nanu Oya,Central,791,4770,5561,31640,190800,222440
11/12/2024,Priyantha Gunasekara,Nuwara Eliya,Nanu Oya,Central,3344,1229,4573,133760,49160,182920
11/13/2024,Priyantha Gunasekara,Nuwara Eliya,Nanu Oya,Central,7288,2693,9981,291520,107720,399240
11/14/2024,Priyantha Gunasekara,Nuwara Eliya,Nanu Oya,Central,4599,3870,8469,183960,154800,338760
11/15/2024,Priyantha Gunasekara,Nuwara Eliya,Nanu Oya,Central,3678,6586,10264,147120,263440,410560
11/16/2024,Priyantha Gunasekara,Nuwara Eliya,Nanu Oya,Central,6097,482,6579,243880,19280,263160
11/17/2024,Priyantha Gunasekara,Nuwara Eliya,Nanu Oya,Central,4042,4108,8150,161680,164320,326000
11/18/2024,Priyantha Gunasekara,Nuwara Eliya,Nanu Oya,Central,2783,8631,11414,111320,345240,456560
11/19/2024,Priyantha Gunasekara,Nuwara Eliya,Nanu Oya,Central,9695,3856,13551,387800,154240,542040
11/20/2024,Priyantha Gunasekara,Nuwara Eliya,Nanu Oya,Central,7747,6367,14114,309880,254680,564560
11/21/2024,Priyantha Gunasekara,Nuwara Eliya,Nanu Oya,Central,1865,2166,4031,74600,86640,161240
11/22/2024,Priyantha Gunasekara,Nuwara Eliya,Nanu Oya,Central,7585,3099,10684,303400,123960,427360
11/23/2024,Priyantha Gunasekara,Nuwara Eliya,Nanu Oya,Central,1004,7897,8901,40160,315880,356040
11/24/2024,Priyantha Gunasekara,Nuwara Eliya,Nanu Oya,Central,9634,470,10104,385360,18800,404160
11/25/2024,Priyantha Gunasekara,Nuwara Eliya,Nanu Oya,Central,1200,9429,10629,48000,377160,425160
11/26/2024,Priyantha Gunasekara,Nuwara Eliya,Nanu Oya,Central,5497,9354,14851,219880,374160,594040
11/27/2024,Priyantha Gunasekara,Nuwara Eliya,Nanu Oya,Central,5093,6177,11270,203720,247080,450800
11/28/2024,Priyantha Gunasekara,Nuwara Eliya,Nanu Oya,Central,5582,9111,14693,223280,364440,587720
11/29/2024,Priyantha Gunasekara,Nuwara Eliya,Nanu Oya,Central,3306,827,4133,132240,33080,165320
11/30/2024,Priyantha Gunasekara,Nuwara Eliya,Nanu Oya,Central,8631,8792,17423,345240,351680,696920
12/1/2024,Priyantha Gunasekara,Nuwara Eliya,Nanu Oya,Central,673,4961,5634,26920,198440,225360
12/2/2024,Priyantha Gunasekara,Nuwara Eliya,Nanu Oya,Central,5272,9835,15107,210880,393400,604280
12/3/2024,Priyantha Gunasekara,Nuwara Eliya,Nanu Oya,Central,6825,3228,10053,273000,129120,402120
12/4/2024,Priyantha Gunasekara,Nuwara Eliya,Nanu Oya,Central,8745,8604,17349,349800,344160,693960
12/5/2024,Priyantha Gunasekara,Nuwara Eliya,Nanu Oya,Central,8930,8691,17621,357200,347640,704840
12/6/2024,Priyantha Gunasekara,Nuwara Eliya,Nanu Oya,Central,49,6916,6965,1960,276640,278600
12/7/2024,Priyantha Gunasekara,Nuwara Eliya,Nanu Oya,Central,8065,9103,17168,322600,364120,686720
12/8/2024,Priyantha Gunasekara,Nuwara Eliya,Nanu Oya,Central,8885,6700,15585,355400,268000,623400
12/9/2024,Priyantha Gunasekara,Nuwara Eliya,Nanu Oya,Central,5013,8467,13480,200520,338680,539200
12/10/2024,Priyantha Gunasekara,Nuwara Eliya,Nanu Oya,Central,4918,1148,6066,196720,45920,242640
12/11/2024,Priyantha Gunasekara,Nuwara Eliya,Nanu Oya,Central,4220,4315,8535,168800,172600,341400
12/12/2024,Priyantha Gunasekara,Nuwara Eliya,Nanu Oya,Central,7812,8783,16595,312480,351320,663800
12/13/2024,Priyantha Gunasekara,Nuwara Eliya,Nanu Oya,Central,5462,5647,11109,218480,225880,444360
12/14/2024,Priyantha Gunasekara,Nuwara Eliya,Nanu Oya,Central,9846,226,10072,393840,9040,402880
12/15/2024,Priyantha Gunasekara,Nuwara Eliya,Nanu Oya,Central,1998,7294,9292,79920,291760,371680
12/16/2024,Priyantha Gunasekara,Nuwara Eliya,Nanu Oya,Central,8739,220,8959,349560,8800,358360
12/17/2024,Priyantha Gunasekara,Nuwara Eliya,Nanu Oya,Central,2699,2255,4954,107960,90200,198160
12/18/2024,Priyantha Gunasekara,Nuwara Eliya,Nanu Oya,Central,7883,2784,10667,315320,111360,426680
12/19/2024,Priyantha Gunasekara,Nuwara Eliya,Nanu Oya,Central,329,114,443,13160,4560,17720
12/20/2024,Priyantha Gunasekara,Nuwara Eliya,Nanu Oya,Central,669,3839,4508,26760,153560,180320
12/21/2024,Priyantha Gunasekara,Nuwara Eliya,Nanu Oya,Central,1362,7123,8485,54480,284920,339400
12/22/2024,Priyantha Gunasekara,Nuwara Eliya,Nanu Oya,Central,6439,5332,11771,257560,213280,470840
12/23/2024,Priyantha Gunasekara,Nuwara Eliya,Nanu Oya,Central,196,4912,5108,7840,196480,204320
12/24/2024,Priyantha Gunasekara,Nuwara Eliya,Nanu Oya,Central,5385,2321,7706,215400,92840,308240
12/25/2024,Priyantha Gunasekara,Nuwara Eliya,Nanu Oya,Central,7806,3836,11642,312240,153440,465680
12/26/2024,Priyantha Gunasekara,Nuwara Eliya,Nanu Oya,Central,4730,2193,6923,189200,87720,276920
12/27/2024,Priyantha Gunasekara,Nuwara Eliya,Nanu Oya,Central,9631,2138,11769,385240,85520,470760
12/28/2024,Priyantha Gunasekara,Nuwara Eliya,Nanu Oya,Central,255,2655,2910,10200,106200,116400
12/29/2024,Priyantha Gunasekara,Nuwara Eliya,Nanu Oya,Central,5133,373,5506,205320,14920,220240
12/30/2024,Priyantha Gunasekara,Nuwara Eliya,Nanu Oya,Central,5019,2650,7669,200760,106000,306760
12/31/2024,Priyantha Gunasekara,Nuwara Eliya,Nanu Oya,Central,7445,9011,16456,297800,360440,658240
1/1/2025,Priyantha Gunasekara,Nuwara Eliya,Nanu Oya,Central,9273,9995,19268,370920,399800,770720
1/2/2025,Priyantha Gunasekara,Nuwara Eliya,Nanu Oya,Central,3266,4000,7266,130640,160000,290640
1/3/2025,Priyantha Gunasekara,Nuwara Eliya,Nanu Oya,Central,4241,6507,10748,169640,260280,429920
1/4/2025,Priyantha Gunasekara,Nuwara Eliya,Nanu Oya,Central,2759,7758,10517,110360,310320,420680
1/5/2025,Priyantha Gunasekara,Nuwara Eliya,Nanu Oya,Central,2579,1178,3757,103160,47120,150280
1/6/2025,Priyantha Gunasekara,Nuwara Eliya,Nanu Oya,Central,2835,4174,7009,113400,166960,280360
1/7/2025,Priyantha Gunasekara,Nuwara Eliya,Nanu Oya,Central,3425,1430,4855,137000,57200,194200
1/8/2025,Priyantha Gunasekara,Nuwara Eliya,Nanu Oya,Central,158,5837,5995,6320,233480,239800
1/9/2025,Priyantha Gunasekara,Nuwara Eliya,Nanu Oya,Central,2153,6699,8852,86120,267960,354080
1/10/2025,Priyantha Gunasekara,Nuwara Eliya,Nanu Oya,Central,6622,3327,9949,264880,133080,397960
1/11/2025,Priyantha Gunasekara,Nuwara Eliya,Nanu Oya,Central,2677,5838,8515,107080,233520,340600
1/12/2025,Priyantha Gunasekara,Nuwara Eliya,Nanu Oya,Central,6244,2504,8748,249760,100160,349920
1/13/2025,Priyantha Gunasekara,Nuwara Eliya,Nanu Oya,Central,7965,6587,14552,318600,263480,582080
1/14/2025,Priyantha Gunasekara,Nuwara Eliya,Nanu Oya,Central,897,5703,6600,35880,228120,264000
1/15/2025,Priyantha Gunasekara,Nuwara Eliya,Nanu Oya,Central,1885,9306,11191,75400,372240,447640
1/16/2025,Priyantha Gunasekara,Nuwara Eliya,Nanu Oya,Central,2266,8071,10337,90640,322840,413480
1/17/2025,Priyantha Gunasekara,Nuwara Eliya,Nanu Oya,Central,1630,8711,10341,65200,348440,413640
1/18/2025,Priyantha Gunasekara,Nuwara Eliya,Nanu Oya,Central,4321,8919,13240,172840,356760,529600
1/19/2025,Priyantha Gunasekara,Nuwara Eliya,Nanu Oya,Central,1290,601,1891,51600,24040,75640
1/20/2025,Priyantha Gunasekara,Nuwara Eliya,Nanu Oya,Central,3691,2813,6504,147640,112520,260160
1/21/2025,Priyantha Gunasekara,Nuwara Eliya,Nanu Oya,Central,4764,6349,11113,190560,253960,444520
1/22/2025,Priyantha Gunasekara,Nuwara Eliya,Nanu Oya,Central,214,7808,8022,8560,312320,320880
1/23/2025,Priyantha Gunasekara,Nuwara Eliya,Nanu Oya,Central,7367,7385,14752,294680,295400,590080
1/24/2025,Priyantha Gunasekara,Nuwara Eliya,Nanu Oya,Central,7355,3905,11260,294200,156200,450400
1/25/2025,Priyantha Gunasekara,Nuwara Eliya,Nanu Oya,Central,3898,4128,8026,155920,165120,321040
1/26/2025,Priyantha Gunasekara,Nuwara Eliya,Nanu Oya,Central,6587,2954,9541,263480,118160,381640
1/27/2025,Priyantha Gunasekara,Nuwara Eliya,Nanu Oya,Central,8895,9620,18515,355800,384800,740600
1/28/2025,Priyantha Gunasekara,Nuwara Eliya,Nanu Oya,Central,9968,3994,13962,398720,159760,558480
1/29/2025,Priyantha Gunasekara,Nuwara Eliya,Nanu Oya,Central,8663,6547,15210,346520,261880,608400
1/30/2025,Priyantha Gunasekara,Nuwara Eliya,Nanu Oya,Central,937,9305,10242,37480,372200,409680
1/31/2025,Priyantha Gunasekara,Nuwara Eliya,Nanu Oya,Central,2124,6896,9020,84960,275840,360800
2/1/2025,Priyantha Gunasekara,Nuwara Eliya,Nanu Oya,Central,6227,9855,16082,249080,394200,643280
2/2/2025,Priyantha Gunasekara,Nuwara Eliya,Nanu Oya,Central,3900,3630,7530,156000,145200,301200
2/3/2025,Priyantha Gunasekara,Nuwara Eliya,Nanu Oya,Central,9176,1737,10913,367040,69480,436520
2/4/2025,Priyantha Gunasekara,Nuwara Eliya,Nanu Oya,Central,714,4793,5507,28560,191720,220280
2/5/2025,Priyantha Gunasekara,Nuwara Eliya,Nanu Oya,Central,5590,5098,10688,223600,203920,427520
2/6/2025,Priyantha Gunasekara,Nuwara Eliya,Nanu Oya,Central,8374,2773,11147,334960,110920,445880
2/7/2025,Priyantha Gunasekara,Nuwara Eliya,Nanu Oya,Central,9262,6213,15475,370480,248520,619000
2/8/2025,Priyantha Gunasekara,Nuwara Eliya,Nanu Oya,Central,3125,170,3295,125000,6800,131800
2/9/2025,Priyantha Gunasekara,Nuwara Eliya,Nanu Oya,Central,9047,24,9071,361880,960,362840
2/10/2025,Priyantha Gunasekara,Nuwara Eliya,Nanu Oya,Central,9674,612,10286,386960,24480,411440
2/11/2025,Priyantha Gunasekara,Nuwara Eliya,Nanu Oya,Central,6582,6434,13016,263280,257360,520640
2/12/2025,Priyantha Gunasekara,Nuwara Eliya,Nanu Oya,Central,5795,5920,11715,231800,236800,468600
2/13/2025,Priyantha Gunasekara,Nuwara Eliya,Nanu Oya,Central,584,7137,7721,23360,285480,308840
2/14/2025,Priyantha Gunasekara,Nuwara Eliya,Nanu Oya,Central,1314,5109,6423,52560,204360,256920
2/15/2025,Priyantha Gunasekara,Nuwara Eliya,Nanu Oya,Central,4978,2920,7898,199120,116800,315920
2/16/2025,Priyantha Gunasekara,Nuwara Eliya,Nanu Oya,Central,7435,7413,14848,297400,296520,593920
2/17/2025,Priyantha Gunasekara,Nuwara Eliya,Nanu Oya,Central,1330,376,1706,53200,15040,68240
2/18/2025,Priyantha Gunasekara,Nuwara Eliya,Nanu Oya,Central,7661,6866,14527,306440,274640,581080
2/19/2025,Priyantha Gunasekara,Nuwara Eliya,Nanu Oya,Central,9565,5908,15473,382600,236320,618920
2/20/2025,Priyantha Gunasekara,Nuwara Eliya,Nanu Oya,Central,7723,664,8387,308920,26560,335480
2/21/2025,Priyantha Gunasekara,Nuwara Eliya,Nanu Oya,Central,2202,8032,10234,88080,321280,409360
2/22/2025,Priyantha Gunasekara,Nuwara Eliya,Nanu Oya,Central,3145,3571,6716,125800,142840,268640
2/23/2025,Priyantha Gunasekara,Nuwara Eliya,Nanu Oya,Central,2024,1137,3161,80960,45480,126440
2/24/2025,Priyantha Gunasekara,Nuwara Eliya,Nanu Oya,Central,4979,6974,11953,199160,278960,478120
2/25/2025,Priyantha Gunasekara,Nuwara Eliya,Nanu Oya,Central,519,1313,1832,20760,52520,73280
2/26/2025,Priyantha Gunasekara,Nuwara Eliya,Nanu Oya,Central,7891,5658,13549,315640,226320,541960
2/27/2025,Priyantha Gunasekara,Nuwara Eliya,Nanu Oya,Central,4382,2308,6690,175280,92320,267600
2/28/2025,Priyantha Gunasekara,Nuwara Eliya,Nanu Oya,Central,8888,1187,10075,355520,47480,403000
3/1/2025,Priyantha Gunasekara,Nuwara Eliya,Nanu Oya,Central,9961,799,10760,398440,31960,430400
3/2/2025,Priyantha Gunasekara,Nuwara Eliya,Nanu Oya,Central,8597,8821,17418,343880,352840,696720
3/3/2025,Priyantha Gunasekara,Nuwara Eliya,Nanu Oya,Central,5374,5641,11015,214960,225640,440600
3/4/2025,Priyantha Gunasekara,Nuwara Eliya,Nanu Oya,Central,8376,6470,14846,335040,258800,593840
3/5/2025,Priyantha Gunasekara,Nuwara Eliya,Nanu Oya,Central,2766,323,3089,110640,12920,123560
3/6/2025,Priyantha Gunasekara,Nuwara Eliya,Nanu Oya,Central,2482,6106,8588,99280,244240,343520
3/7/2025,Priyantha Gunasekara,Nuwara Eliya,Nanu Oya,Central,4667,4870,9537,186680,194800,381480
3/8/2025,Priyantha Gunasekara,Nuwara Eliya,Nanu Oya,Central,4816,1586,6402,192640,63440,256080
3/9/2025,Priyantha Gunasekara,Nuwara Eliya,Nanu Oya,Central,3936,2978,6914,157440,119120,276560
3/10/2025,Priyantha Gunasekara,Nuwara Eliya,Nanu Oya,Central,2689,5207,7896,107560,208280,315840
3/11/2025,Priyantha Gunasekara,Nuwara Eliya,Nanu Oya,Central,8324,573,8897,332960,22920,355880
3/12/2025,Priyantha Gunasekara,Nuwara Eliya,Nanu Oya,Central,5070,5333,10403,202800,213320,416120
3/13/2025,Priyantha Gunasekara,Nuwara Eliya,Nanu Oya,Central,6980,5489,12469,279200,219560,498760
3/14/2025,Priyantha Gunasekara,Nuwara Eliya,Nanu Oya,Central,5191,9559,14750,207640,382360,590000
3/15/2025,Priyantha Gunasekara,Nuwara Eliya,Nanu Oya,Central,8130,8923,17053,325200,356920,682120
3/16/2025,Priyantha Gunasekara,Nuwara Eliya,Nanu Oya,Central,111,9561,9672,4440,382440,386880
3/17/2025,Priyantha Gunasekara,Nuwara Eliya,Nanu Oya,Central,384,4209,4593,15360,168360,183720
3/18/2025,Priyantha Gunasekara,Nuwara Eliya,Nanu Oya,Central,7980,1932,9912,319200,77280,396480
3/19/2025,Priyantha Gunasekara,Nuwara Eliya,Nanu Oya,Central,2891,4517,7408,115640,180680,296320
3/20/2025,Priyantha Gunasekara,Nuwara Eliya,Nanu Oya,Central,1892,364,2256,75680,14560,90240
3/21/2025,Priyantha Gunasekara,Nuwara Eliya,Nanu Oya,Central,2679,1869,4548,107160,74760,181920
3/22/2025,Priyantha Gunasekara,Nuwara Eliya,Nanu Oya,Central,460,113,573,18400,4520,22920
3/23/2025,Priyantha Gunasekara,Nuwara Eliya,Nanu Oya,Central,8312,498,8810,332480,19920,352400
3/25/2024,Indika Rajapaksha,Kandy,Peradeniya,Central,6504,476,6980,260160,19040,279200
3/26/2024,Indika Rajapaksha,Kandy,Peradeniya,Central,5426,3428,8854,217040,137120,354160
3/27/2024,Indika Rajapaksha,Kandy,Peradeniya,Central,1827,900,2727,73080,36000,109080
3/28/2024,Indika Rajapaksha,Kandy,Peradeniya,Central,7890,6945,14835,315600,277800,593400
3/29/2024,Indika Rajapaksha,Kandy,Peradeniya,Central,1823,4709,6532,72920,188360,261280
3/30/2024,Indika Rajapaksha,Kandy,Peradeniya,Central,1862,2963,4825,74480,118520,193000
3/31/2024,Indika Rajapaksha,Kandy,Peradeniya,Central,2066,4874,6940,82640,194960,277600
4/1/2024,Indika Rajapaksha,Kandy,Peradeniya,Central,9377,2618,11995,375080,104720,479800
4/2/2024,Indika Rajapaksha,Kandy,Peradeniya,Central,3063,3948,7011,122520,157920,280440
4/3/2024,Indika Rajapaksha,Kandy,Peradeniya,Central,230,2592,2822,9200,103680,112880
4/4/2024,Indika Rajapaksha,Kandy,Peradeniya,Central,9199,1125,10324,367960,45000,412960
4/5/2024,Indika Rajapaksha,Kandy,Peradeniya,Central,1671,5186,6857,66840,207440,274280
4/6/2024,Indika Rajapaksha,Kandy,Peradeniya,Central,2203,8580,10783,88120,343200,431320
4/7/2024,Indika Rajapaksha,Kandy,Peradeniya,Central,5206,664,5870,208240,26560,234800
4/8/2024,Indika Rajapaksha,Kandy,Peradeniya,Central,2566,2687,5253,102640,107480,210120
4/9/2024,Indika Rajapaksha,Kandy,Peradeniya,Central,2151,6748,8899,86040,269920,355960
4/10/2024,Indika Rajapaksha,Kandy,Peradeniya,Central,799,9796,10595,31960,391840,423800
4/11/2024,Indika Rajapaksha,Kandy,Peradeniya,Central,1480,8413,9893,59200,336520,395720
4/19/2024,Indika Rajapaksha,Kandy,Peradeniya,Central,9884,90,9974,395360,3600,398960
4/20/2024,Indika Rajapaksha,Kandy,Peradeniya,Central,3027,5294,8321,121080,211760,332840
4/21/2024,Indika Rajapaksha,Kandy,Peradeniya,Central,5547,7788,13335,221880,311520,533400
4/22/2024,Indika Rajapaksha,Kandy,Peradeniya,Central,8375,5261,13636,335000,210440,545440
4/23/2024,Indika Rajapaksha,Kandy,Peradeniya,Central,8915,967,9882,356600,38680,395280
4/24/2024,Indika Rajapaksha,Kandy,Peradeniya,Central,7339,810,8149,293560,32400,325960
4/25/2024,Indika Rajapaksha,Kandy,Peradeniya,Central,1381,1395,2776,55240,55800,111040
4/26/2024,Indika Rajapaksha,Kandy,Peradeniya,Central,1750,2793,4543,70000,111720,181720
4/27/2024,Indika Rajapaksha,Kandy,Peradeniya,Central,7635,1666,9301,305400,66640,372040
4/28/2024,Indika Rajapaksha,Kandy,Peradeniya,Central,3676,5315,8991,147040,212600,359640
4/29/2024,Indika Rajapaksha,Kandy,Peradeniya,Central,2351,8333,10684,94040,333320,427360
4/30/2024,Indika Rajapaksha,Kandy,Peradeniya,Central,7426,4112,11538,297040,164480,461520
5/1/2024,Indika Rajapaksha,Kandy,Peradeniya,Central,8028,4272,12300,321120,170880,492000
5/2/2024,Indika Rajapaksha,Kandy,Peradeniya,Central,4381,2427,6808,175240,97080,272320
5/3/2024,Indika Rajapaksha,Kandy,Peradeniya,Central,2379,8963,11342,95160,358520,453680
5/4/2024,Indika Rajapaksha,Kandy,Peradeniya,Central,3474,6504,9978,138960,260160,399120
5/5/2024,Indika Rajapaksha,Kandy,Peradeniya,Central,2158,6857,9015,86320,274280,360600
5/6/2024,Indika Rajapaksha,Kandy,Peradeniya,Central,5483,43,5526,219320,1720,221040
5/7/2024,Indika Rajapaksha,Kandy,Peradeniya,Central,4731,4389,9120,189240,175560,364800
5/8/2024,Indika Rajapaksha,Kandy,Peradeniya,Central,4219,6465,10684,168760,258600,427360
5/9/2024,Indika Rajapaksha,Kandy,Peradeniya,Central,6292,1204,7496,251680,48160,299840
5/10/2024,Indika Rajapaksha,Kandy,Peradeniya,Central,1668,4306,5974,66720,172240,238960
5/11/2024,Indika Rajapaksha,Kandy,Peradeniya,Central,5123,8145,13268,204920,325800,530720
5/12/2024,Indika Rajapaksha,Kandy,Peradeniya,Central,1140,3064,4204,45600,122560,168160
5/13/2024,Indika Rajapaksha,Kandy,Peradeniya,Central,6910,7226,14136,276400,289040,565440
5/14/2024,Indika Rajapaksha,Kandy,Peradeniya,Central,3900,6426,10326,156000,257040,413040
5/15/2024,Indika Rajapaksha,Kandy,Peradeniya,Central,9603,3871,13474,384120,154840,538960
5/16/2024,Indika Rajapaksha,Kandy,Peradeniya,Central,1963,5741,7704,78520,229640,308160
5/17/2024,Indika Rajapaksha,Kandy,Peradeniya,Central,2595,348,2943,103800,13920,117720
5/18/2024,Indika Rajapaksha,Kandy,Peradeniya,Central,8162,5050,13212,326480,202000,528480
5/19/2024,Indika Rajapaksha,Kandy,Peradeniya,Central,1121,5389,6510,44840,215560,260400
5/20/2024,Indika Rajapaksha,Kandy,Peradeniya,Central,9389,6784,16173,375560,271360,646920
5/21/2024,Indika Rajapaksha,Kandy,Peradeniya,Central,5340,4282,9622,213600,171280,384880
5/22/2024,Indika Rajapaksha,Kandy,Peradeniya,Central,6867,8266,15133,274680,330640,605320
5/24/2024,Indika Rajapaksha,Kandy,Peradeniya,Central,4295,5493,9788,171800,219720,391520
5/25/2024,Indika Rajapaksha,Kandy,Peradeniya,Central,7191,887,8078,287640,35480,323120
5/26/2024,Indika Rajapaksha,Kandy,Peradeniya,Central,9551,503,10054,382040,20120,402160
5/27/2024,Indika Rajapaksha,Kandy,Peradeniya,Central,3576,6132,9708,143040,245280,388320
5/28/2024,Indika Rajapaksha,Kandy,Peradeniya,Central,5996,6840,12836,239840,273600,513440
5/29/2024,Indika Rajapaksha,Kandy,Peradeniya,Central,9898,9969,19867,395920,398760,794680
5/30/2024,Indika Rajapaksha,Kandy,Peradeniya,Central,2885,7288,10173,115400,291520,406920
5/31/2024,Indika Rajapaksha,Kandy,Peradeniya,Central,5654,9477,15131,226160,379080,605240
6/1/2024,Indika Rajapaksha,Kandy,Peradeniya,Central,8526,195,8721,341040,7800,348840
6/2/2024,Indika Rajapaksha,Kandy,Peradeniya,Central,3031,6413,9444,121240,256520,377760
6/3/2024,Indika Rajapaksha,Kandy,Peradeniya,Central,3905,5179,9084,156200,207160,363360
6/4/2024,Indika Rajapaksha,Kandy,Peradeniya,Central,7874,5213,13087,314960,208520,523480
6/5/2024,Indika Rajapaksha,Kandy,Peradeniya,Central,3075,9148,12223,123000,365920,488920
6/6/2024,Indika Rajapaksha,Kandy,Peradeniya,Central,8805,2225,11030,352200,89000,441200
6/7/2024,Indika Rajapaksha,Kandy,Peradeniya,Central,7705,1363,9068,308200,54520,362720
6/8/2024,Indika Rajapaksha,Kandy,Peradeniya,Central,7000,8286,15286,280000,331440,611440
6/9/2024,Indika Rajapaksha,Kandy,Peradeniya,Central,6320,2605,8925,252800,104200,357000
6/10/2024,Indika Rajapaksha,Kandy,Peradeniya,Central,4057,8823,12880,162280,352920,515200
6/11/2024,Indika Rajapaksha,Kandy,Peradeniya,Central,6814,3664,10478,272560,146560,419120
6/12/2024,Indika Rajapaksha,Kandy,Peradeniya,Central,9423,9706,19129,376920,388240,765160
6/13/2024,Indika Rajapaksha,Kandy,Peradeniya,Central,3746,3608,7354,149840,144320,294160
6/14/2024,Indika Rajapaksha,Kandy,Peradeniya,Central,7157,581,7738,286280,23240,309520
6/15/2024,Indika Rajapaksha,Kandy,Peradeniya,Central,462,3203,3665,18480,128120,146600
6/16/2024,Indika Rajapaksha,Kandy,Peradeniya,Central,8531,1471,10002,341240,58840,400080
6/17/2024,Indika Rajapaksha,Kandy,Peradeniya,Central,1994,8523,10517,79760,340920,420680
6/18/2024,Indika Rajapaksha,Kandy,Peradeniya,Central,9595,7455,17050,383800,298200,682000
6/19/2024,Indika Rajapaksha,Kandy,Peradeniya,Central,2780,8115,10895,111200,324600,435800
6/20/2024,Indika Rajapaksha,Kandy,Peradeniya,Central,1475,6712,8187,59000,268480,327480
6/21/2024,Indika Rajapaksha,Kandy,Peradeniya,Central,5611,133,5744,224440,5320,229760
6/22/2024,Indika Rajapaksha,Kandy,Peradeniya,Central,3918,7057,10975,156720,282280,439000
6/23/2024,Indika Rajapaksha,Kandy,Peradeniya,Central,4786,9833,14619,191440,393320,584760
6/24/2024,Indika Rajapaksha,Kandy,Peradeniya,Central,3345,2604,5949,133800,104160,237960
6/25/2024,Indika Rajapaksha,Kandy,Peradeniya,Central,6499,4031,10530,259960,161240,421200
6/26/2024,Indika Rajapaksha,Kandy,Peradeniya,Central,7991,5802,13793,319640,232080,551720
6/27/2024,Indika Rajapaksha,Kandy,Peradeniya,Central,9621,2856,12477,384840,114240,499080
6/28/2024,Indika Rajapaksha,Kandy,Peradeniya,Central,9911,7295,17206,396440,291800,688240
6/29/2024,Indika Rajapaksha,Kandy,Peradeniya,Central,6703,843,7546,268120,33720,301840
6/30/2024,Indika Rajapaksha,Kandy,Peradeniya,Central,9982,8902,18884,399280,356080,755360
7/1/2024,Indika Rajapaksha,Kandy,Peradeniya,Central,1929,1464,3393,77160,58560,135720
7/2/2024,Indika Rajapaksha,Kandy,Peradeniya,Central,6379,2984,9363,255160,119360,374520
7/3/2024,Indika Rajapaksha,Kandy,Peradeniya,Central,1119,3223,4342,44760,128920,173680
7/4/2024,Indika Rajapaksha,Kandy,Peradeniya,Central,7249,7695,14944,289960,307800,597760
7/5/2024,Indika Rajapaksha,Kandy,Peradeniya,Central,2191,8927,11118,87640,357080,444720
7/6/2024,Indika Rajapaksha,Kandy,Peradeniya,Central,5878,4800,10678,235120,192000,427120
7/7/2024,Indika Rajapaksha,Kandy,Peradeniya,Central,6234,8758,14992,249360,350320,599680
7/8/2024,Indika Rajapaksha,Kandy,Peradeniya,Central,104,2751,2855,4160,110040,114200
7/9/2024,Indika Rajapaksha,Kandy,Peradeniya,Central,43,237,280,1720,9480,11200
7/10/2024,Indika Rajapaksha,Kandy,Peradeniya,Central,4371,8021,12392,174840,320840,495680
7/11/2024,Indika Rajapaksha,Kandy,Peradeniya,Central,2563,9494,12057,102520,379760,482280
7/12/2024,Indika Rajapaksha,Kandy,Peradeniya,Central,1153,5151,6304,46120,206040,252160
7/13/2024,Indika Rajapaksha,Kandy,Peradeniya,Central,530,2567,3097,21200,102680,123880
7/14/2024,Indika Rajapaksha,Kandy,Peradeniya,Central,8954,4003,12957,358160,160120,518280
7/15/2024,Indika Rajapaksha,Kandy,Peradeniya,Central,4761,1878,6639,190440,75120,265560
7/16/2024,Indika Rajapaksha,Kandy,Peradeniya,Central,826,6926,7752,33040,277040,310080
7/17/2024,Indika Rajapaksha,Kandy,Peradeniya,Central,5792,7908,13700,231680,316320,548000
7/18/2024,Indika Rajapaksha,Kandy,Peradeniya,Central,8342,8379,16721,333680,335160,668840
7/19/2024,Indika Rajapaksha,Kandy,Peradeniya,Central,5929,2887,8816,237160,115480,352640
7/20/2024,Indika Rajapaksha,Kandy,Peradeniya,Central,2072,6280,8352,82880,251200,334080
7/21/2024,Indika Rajapaksha,Kandy,Peradeniya,Central,3654,5217,8871,146160,208680,354840
7/22/2024,Indika Rajapaksha,Kandy,Peradeniya,Central,1423,9120,10543,56920,364800,421720
7/23/2024,Indika Rajapaksha,Kandy,Peradeniya,Central,8970,8081,17051,358800,323240,682040
7/24/2024,Indika Rajapaksha,Kandy,Peradeniya,Central,8215,7707,15922,328600,308280,636880
7/25/2024,Indika Rajapaksha,Kandy,Peradeniya,Central,730,8308,9038,29200,332320,361520
7/26/2024,Indika Rajapaksha,Kandy,Peradeniya,Central,912,2400,3312,36480,96000,132480
7/27/2024,Indika Rajapaksha,Kandy,Peradeniya,Central,9352,5698,15050,374080,227920,602000
7/28/2024,Indika Rajapaksha,Kandy,Peradeniya,Central,693,8587,9280,27720,343480,371200
7/29/2024,Indika Rajapaksha,Kandy,Peradeniya,Central,3378,6794,10172,135120,271760,406880
7/30/2024,Indika Rajapaksha,Kandy,Peradeniya,Central,1174,9510,10684,46960,380400,427360
7/31/2024,Indika Rajapaksha,Kandy,Peradeniya,Central,2612,4442,7054,104480,177680,282160
8/1/2024,Indika Rajapaksha,Kandy,Peradeniya,Central,5915,4704,10619,236600,188160,424760
8/2/2024,Indika Rajapaksha,Kandy,Peradeniya,Central,4342,3501,7843,173680,140040,313720
8/3/2024,Indika Rajapaksha,Kandy,Peradeniya,Central,8955,9759,18714,358200,390360,748560
8/4/2024,Indika Rajapaksha,Kandy,Peradeniya,Central,7761,6919,14680,310440,276760,587200
8/5/2024,Indika Rajapaksha,Kandy,Peradeniya,Central,5202,7970,13172,208080,318800,526880
8/6/2024,Indika Rajapaksha,Kandy,Peradeniya,Central,4276,5481,9757,171040,219240,390280
8/7/2024,Indika Rajapaksha,Kandy,Peradeniya,Central,1400,1823,3223,56000,72920,128920
8/8/2024,Indika Rajapaksha,Kandy,Peradeniya,Central,7150,1614,8764,286000,64560,350560
8/9/2024,Indika Rajapaksha,Kandy,Peradeniya,Central,5006,49,5055,200240,1960,202200
8/10/2024,Indika Rajapaksha,Kandy,Peradeniya,Central,287,3712,3999,11480,148480,159960
8/11/2024,Indika Rajapaksha,Kandy,Peradeniya,Central,5052,3099,8151,202080,123960,326040
8/12/2024,Indika Rajapaksha,Kandy,Peradeniya,Central,9012,3638,12650,360480,145520,506000
8/13/2024,Indika Rajapaksha,Kandy,Peradeniya,Central,362,7070,7432,14480,282800,297280
8/14/2024,Indika Rajapaksha,Kandy,Peradeniya,Central,8002,4378,12380,320080,175120,495200
8/15/2024,Indika Rajapaksha,Kandy,Peradeniya,Central,3289,4483,7772,131560,179320,310880
8/16/2024,Indika Rajapaksha,Kandy,Peradeniya,Central,8158,3354,11512,326320,134160,460480
8/17/2024,Indika Rajapaksha,Kandy,Peradeniya,Central,8215,597,8812,328600,23880,352480
8/18/2024,Indika Rajapaksha,Kandy,Peradeniya,Central,4120,6136,10256,164800,245440,410240
8/19/2024,Indika Rajapaksha,Kandy,Peradeniya,Central,3262,8659,11921,130480,346360,476840
8/20/2024,Indika Rajapaksha,Kandy,Peradeniya,Central,9586,9261,18847,383440,370440,753880
8/21/2024,Indika Rajapaksha,Kandy,Peradeniya,Central,8708,908,9616,348320,36320,384640
8/22/2024,Indika Rajapaksha,Kandy,Peradeniya,Central,4273,4013,8286,170920,160520,331440
8/23/2024,Indika Rajapaksha,Kandy,Peradeniya,Central,1466,7906,9372,58640,316240,374880
8/24/2024,Indika Rajapaksha,Kandy,Peradeniya,Central,9431,7334,16765,377240,293360,670600
8/25/2024,Indika Rajapaksha,Kandy,Peradeniya,Central,7877,8110,15987,315080,324400,639480
8/26/2024,Indika Rajapaksha,Kandy,Peradeniya,Central,7378,4439,11817,295120,177560,472680
8/27/2024,Indika Rajapaksha,Kandy,Peradeniya,Central,8240,7585,15825,329600,303400,633000
8/28/2024,Indika Rajapaksha,Kandy,Peradeniya,Central,9833,7989,17822,393320,319560,712880
8/29/2024,Indika Rajapaksha,Kandy,Peradeniya,Central,141,5764,5905,5640,230560,236200
8/30/2024,Indika Rajapaksha,Kandy,Peradeniya,Central,9602,6510,16112,384080,260400,644480
8/31/2024,Indika Rajapaksha,Kandy,Peradeniya,Central,8467,7963,16430,338680,318520,657200
9/1/2024,Indika Rajapaksha,Kandy,Peradeniya,Central,3928,4747,8675,157120,189880,347000
9/2/2024,Indika Rajapaksha,Kandy,Peradeniya,Central,4326,7331,11657,173040,293240,466280
9/3/2024,Indika Rajapaksha,Kandy,Peradeniya,Central,3178,4012,7190,127120,160480,287600
9/4/2024,Indika Rajapaksha,Kandy,Peradeniya,Central,5009,1523,6532,200360,60920,261280
9/5/2024,Indika Rajapaksha,Kandy,Peradeniya,Central,2292,9131,11423,91680,365240,456920
9/6/2024,Indika Rajapaksha,Kandy,Peradeniya,Central,970,3949,4919,38800,157960,196760
9/7/2024,Indika Rajapaksha,Kandy,Peradeniya,Central,495,3106,3601,19800,124240,144040
9/8/2024,Indika Rajapaksha,Kandy,Peradeniya,Central,2336,6458,8794,93440,258320,351760
9/9/2024,Indika Rajapaksha,Kandy,Peradeniya,Central,529,9373,9902,21160,374920,396080
9/10/2024,Indika Rajapaksha,Kandy,Peradeniya,Central,4560,949,5509,182400,37960,220360
9/11/2024,Indika Rajapaksha,Kandy,Peradeniya,Central,2540,4368,6908,101600,174720,276320
9/12/2024,Indika Rajapaksha,Kandy,Peradeniya,Central,453,4898,5351,18120,195920,214040
9/13/2024,Indika Rajapaksha,Kandy,Peradeniya,Central,7276,5202,12478,291040,208080,499120
9/14/2024,Indika Rajapaksha,Kandy,Peradeniya,Central,2753,6346,9099,110120,253840,363960
9/15/2024,Indika Rajapaksha,Kandy,Peradeniya,Central,6051,5020,11071,242040,200800,442840
9/16/2024,Indika Rajapaksha,Kandy,Peradeniya,Central,8018,8942,16960,320720,357680,678400
9/17/2024,Indika Rajapaksha,Kandy,Peradeniya,Central,6933,8832,15765,277320,353280,630600
9/18/2024,Indika Rajapaksha,Kandy,Peradeniya,Central,3243,996,4239,129720,39840,169560
9/19/2024,Indika Rajapaksha,Kandy,Peradeniya,Central,4936,4898,9834,197440,195920,393360
9/20/2024,Indika Rajapaksha,Kandy,Peradeniya,Central,6731,5915,12646,269240,236600,505840
9/21/2024,Indika Rajapaksha,Kandy,Peradeniya,Central,8689,5934,14623,347560,237360,584920
9/22/2024,Indika Rajapaksha,Kandy,Peradeniya,Central,7638,6559,14197,305520,262360,567880
9/23/2024,Indika Rajapaksha,Kandy,Peradeniya,Central,6943,506,7449,277720,20240,297960
9/24/2024,Indika Rajapaksha,Kandy,Peradeniya,Central,460,1251,1711,18400,50040,68440
9/25/2024,Indika Rajapaksha,Kandy,Peradeniya,Central,1842,1780,3622,73680,71200,144880
9/26/2024,Indika Rajapaksha,Kandy,Peradeniya,Central,5008,6806,11814,200320,272240,472560
9/27/2024,Indika Rajapaksha,Kandy,Peradeniya,Central,7453,1412,8865,298120,56480,354600
9/28/2024,Indika Rajapaksha,Kandy,Peradeniya,Central,4342,885,5227,173680,35400,209080
9/29/2024,Indika Rajapaksha,Kandy,Peradeniya,Central,5382,91,5473,215280,3640,218920
9/30/2024,Indika Rajapaksha,Kandy,Peradeniya,Central,8887,1152,10039,355480,46080,401560
10/1/2024,Indika Rajapaksha,Kandy,Peradeniya,Central,660,5052,5712,26400,202080,228480
10/2/2024,Indika Rajapaksha,Kandy,Peradeniya,Central,5746,2907,8653,229840,116280,346120
10/3/2024,Indika Rajapaksha,Kandy,Peradeniya,Central,1677,9498,11175,67080,379920,447000
10/4/2024,Indika Rajapaksha,Kandy,Peradeniya,Central,2976,1191,4167,119040,47640,166680
10/5/2024,Indika Rajapaksha,Kandy,Peradeniya,Central,4058,9152,13210,162320,366080,528400
10/6/2024,Indika Rajapaksha,Kandy,Peradeniya,Central,2335,767,3102,93400,30680,124080
10/7/2024,Indika Rajapaksha,Kandy,Peradeniya,Central,2777,4557,7334,111080,182280,293360
10/8/2024,Indika Rajapaksha,Kandy,Peradeniya,Central,6639,967,7606,265560,38680,304240
10/9/2024,Indika Rajapaksha,Kandy,Peradeniya,Central,1475,8797,10272,59000,351880,410880
10/10/2024,Indika Rajapaksha,Kandy,Peradeniya,Central,9332,9468,18800,373280,378720,752000
10/11/2024,Indika Rajapaksha,Kandy,Peradeniya,Central,4157,2938,7095,166280,117520,283800
10/12/2024,Indika Rajapaksha,Kandy,Peradeniya,Central,3188,1293,4481,127520,51720,179240
10/13/2024,Indika Rajapaksha,Kandy,Peradeniya,Central,4076,9307,13383,163040,372280,535320
10/14/2024,Indika Rajapaksha,Kandy,Peradeniya,Central,7025,5043,12068,281000,201720,482720
10/15/2024,Indika Rajapaksha,Kandy,Peradeniya,Central,9333,9993,19326,373320,399720,773040
10/16/2024,Indika Rajapaksha,Kandy,Peradeniya,Central,4047,7189,11236,161880,287560,449440
10/17/2024,Indika Rajapaksha,Kandy,Peradeniya,Central,2212,4852,7064,88480,194080,282560
10/18/2024,Indika Rajapaksha,Kandy,Peradeniya,Central,2612,7555,10167,104480,302200,406680
10/19/2024,Indika Rajapaksha,Kandy,Peradeniya,Central,5415,3486,8901,216600,139440,356040
10/20/2024,Indika Rajapaksha,Kandy,Peradeniya,Central,1320,330,1650,52800,13200,66000
10/21/2024,Indika Rajapaksha,Kandy,Peradeniya,Central,8241,1522,9763,329640,60880,390520
10/22/2024,Indika Rajapaksha,Kandy,Peradeniya,Central,7107,1271,8378,284280,50840,335120
10/23/2024,Indika Rajapaksha,Kandy,Peradeniya,Central,3925,2064,5989,157000,82560,239560
10/24/2024,Indika Rajapaksha,Kandy,Peradeniya,Central,3364,1345,4709,134560,53800,188360
10/25/2024,Indika Rajapaksha,Kandy,Peradeniya,Central,7118,7384,14502,284720,295360,580080
10/26/2024,Indika Rajapaksha,Kandy,Peradeniya,Central,7879,6172,14051,315160,246880,562040
10/27/2024,Indika Rajapaksha,Kandy,Peradeniya,Central,2480,1166,3646,99200,46640,145840
10/28/2024,Indika Rajapaksha,Kandy,Peradeniya,Central,5241,2071,7312,209640,82840,292480
10/29/2024,Indika Rajapaksha,Kandy,Peradeniya,Central,7328,3179,10507,293120,127160,420280
10/30/2024,Indika Rajapaksha,Kandy,Peradeniya,Central,8144,8249,16393,325760,329960,655720
10/31/2024,Indika Rajapaksha,Kandy,Peradeniya,Central,6227,6161,12388,249080,246440,495520
11/1/2024,Indika Rajapaksha,Kandy,Peradeniya,Central,5574,7129,12703,222960,285160,508120
11/2/2024,Indika Rajapaksha,Kandy,Peradeniya,Central,3085,1998,5083,123400,79920,203320
11/3/2024,Indika Rajapaksha,Kandy,Peradeniya,Central,2138,1866,4004,85520,74640,160160
11/4/2024,Indika Rajapaksha,Kandy,Peradeniya,Central,9477,3305,12782,379080,132200,511280
11/5/2024,Indika Rajapaksha,Kandy,Peradeniya,Central,4567,3743,8310,182680,149720,332400
11/6/2024,Indika Rajapaksha,Kandy,Peradeniya,Central,4985,9963,14948,199400,398520,597920
11/7/2024,Indika Rajapaksha,Kandy,Peradeniya,Central,3592,7701,11293,143680,308040,451720
11/8/2024,Indika Rajapaksha,Kandy,Peradeniya,Central,19,4633,4652,760,185320,186080
11/9/2024,Indika Rajapaksha,Kandy,Peradeniya,Central,737,6638,7375,29480,265520,295000
11/10/2024,Indika Rajapaksha,Kandy,Peradeniya,Central,4416,7975,12391,176640,319000,495640
11/11/2024,Indika Rajapaksha,Kandy,Peradeniya,Central,4382,8182,12564,175280,327280,502560
11/12/2024,Indika Rajapaksha,Kandy,Peradeniya,Central,1189,9197,10386,47560,367880,415440
11/13/2024,Indika Rajapaksha,Kandy,Peradeniya,Central,7313,362,7675,292520,14480,307000
11/14/2024,Indika Rajapaksha,Kandy,Peradeniya,Central,8805,1753,10558,352200,70120,422320
11/15/2024,Indika Rajapaksha,Kandy,Peradeniya,Central,1530,5590,7120,61200,223600,284800
11/16/2024,Indika Rajapaksha,Kandy,Peradeniya,Central,761,3759,4520,30440,150360,180800
11/17/2024,Indika Rajapaksha,Kandy,Peradeniya,Central,392,9673,10065,15680,386920,402600
11/18/2024,Indika Rajapaksha,Kandy,Peradeniya,Central,7865,4052,11917,314600,162080,476680
11/19/2024,Indika Rajapaksha,Kandy,Peradeniya,Central,2393,5542,7935,95720,221680,317400
11/20/2024,Indika Rajapaksha,Kandy,Peradeniya,Central,3172,1794,4966,126880,71760,198640
11/21/2024,Indika Rajapaksha,Kandy,Peradeniya,Central,8328,9825,18153,333120,393000,726120
11/22/2024,Indika Rajapaksha,Kandy,Peradeniya,Central,3842,5814,9656,153680,232560,386240
11/23/2024,Indika Rajapaksha,Kandy,Peradeniya,Central,909,1781,2690,36360,71240,107600
11/24/2024,Indika Rajapaksha,Kandy,Peradeniya,Central,3626,2803,6429,145040,112120,257160
11/25/2024,Indika Rajapaksha,Kandy,Peradeniya,Central,7828,4632,12460,313120,185280,498400
11/26/2024,Indika Rajapaksha,Kandy,Peradeniya,Central,4593,3848,8441,183720,153920,337640
11/27/2024,Indika Rajapaksha,Kandy,Peradeniya,Central,971,2710,3681,38840,108400,147240
11/28/2024,Indika Rajapaksha,Kandy,Peradeniya,Central,6908,943,7851,276320,37720,314040
11/29/2024,Indika Rajapaksha,Kandy,Peradeniya,Central,9164,486,9650,366560,19440,386000
11/30/2024,Indika Rajapaksha,Kandy,Peradeniya,Central,5460,9035,14495,218400,361400,579800
12/1/2024,Indika Rajapaksha,Kandy,Peradeniya,Central,8163,5455,13618,326520,218200,544720
12/2/2024,Indika Rajapaksha,Kandy,Peradeniya,Central,4888,3753,8641,195520,150120,345640
12/3/2024,Indika Rajapaksha,Kandy,Peradeniya,Central,6896,3965,10861,275840,158600,434440
12/4/2024,Indika Rajapaksha,Kandy,Peradeniya,Central,7595,619,8214,303800,24760,328560
12/5/2024,Indika Rajapaksha,Kandy,Peradeniya,Central,8183,160,8343,327320,6400,333720
12/6/2024,Indika Rajapaksha,Kandy,Peradeniya,Central,4949,1503,6452,197960,60120,258080
12/7/2024,Indika Rajapaksha,Kandy,Peradeniya,Central,563,8054,8617,22520,322160,344680
12/8/2024,Indika Rajapaksha,Kandy,Peradeniya,Central,8013,9996,18009,320520,399840,720360
12/9/2024,Indika Rajapaksha,Kandy,Peradeniya,Central,802,1467,2269,32080,58680,90760
12/10/2024,Indika Rajapaksha,Kandy,Peradeniya,Central,2388,337,2725,95520,13480,109000
12/11/2024,Indika Rajapaksha,Kandy,Peradeniya,Central,8958,5683,14641,358320,227320,585640
12/12/2024,Indika Rajapaksha,Kandy,Peradeniya,Central,3937,1021,4958,157480,40840,198320
12/13/2024,Indika Rajapaksha,Kandy,Peradeniya,Central,2657,4848,7505,106280,193920,300200
12/14/2024,Indika Rajapaksha,Kandy,Peradeniya,Central,9327,8788,18115,373080,351520,724600
12/15/2024,Indika Rajapaksha,Kandy,Peradeniya,Central,4070,1141,5211,162800,45640,208440
12/16/2024,Indika Rajapaksha,Kandy,Peradeniya,Central,4148,2945,7093,165920,117800,283720
12/17/2024,Indika Rajapaksha,Kandy,Peradeniya,Central,349,6083,6432,13960,243320,257280
12/18/2024,Indika Rajapaksha,Kandy,Peradeniya,Central,7293,5122,12415,291720,204880,496600
12/19/2024,Indika Rajapaksha,Kandy,Peradeniya,Central,8423,9621,18044,336920,384840,721760
12/20/2024,Indika Rajapaksha,Kandy,Peradeniya,Central,610,8578,9188,24400,343120,367520
12/21/2024,Indika Rajapaksha,Kandy,Peradeniya,Central,1316,9455,10771,52640,378200,430840
12/22/2024,Indika Rajapaksha,Kandy,Peradeniya,Central,7624,4259,11883,304960,170360,475320
12/23/2024,Indika Rajapaksha,Kandy,Peradeniya,Central,6690,8149,14839,267600,325960,593560
12/24/2024,Indika Rajapaksha,Kandy,Peradeniya,Central,8060,7188,15248,322400,287520,609920
12/25/2024,Indika Rajapaksha,Kandy,Peradeniya,Central,9683,5229,14912,387320,209160,596480
12/26/2024,Indika Rajapaksha,Kandy,Peradeniya,Central,901,7573,8474,36040,302920,338960
12/27/2024,Indika Rajapaksha,Kandy,Peradeniya,Central,7965,4185,12150,318600,167400,486000
12/28/2024,Indika Rajapaksha,Kandy,Peradeniya,Central,3938,5923,9861,157520,236920,394440
12/29/2024,Indika Rajapaksha,Kandy,Peradeniya,Central,1364,7404,8768,54560,296160,350720
12/30/2024,Indika Rajapaksha,Kandy,Peradeniya,Central,9397,9770,19167,375880,390800,766680
12/31/2024,Indika Rajapaksha,Kandy,Peradeniya,Central,3286,4385,7671,131440,175400,306840
1/1/2025,Indika Rajapaksha,Kandy,Peradeniya,Central,5390,7065,12455,215600,282600,498200
1/2/2025,Indika Rajapaksha,Kandy,Peradeniya,Central,192,502,694,7680,20080,27760
1/3/2025,Indika Rajapaksha,Kandy,Peradeniya,Central,3160,4394,7554,126400,175760,302160
1/4/2025,Indika Rajapaksha,Kandy,Peradeniya,Central,444,9710,10154,17760,388400,406160
1/5/2025,Indika Rajapaksha,Kandy,Peradeniya,Central,8512,6744,15256,340480,269760,610240
1/6/2025,Indika Rajapaksha,Kandy,Peradeniya,Central,1462,2133,3595,58480,85320,143800
1/7/2025,Indika Rajapaksha,Kandy,Peradeniya,Central,3679,3909,7588,147160,156360,303520
1/8/2025,Indika Rajapaksha,Kandy,Peradeniya,Central,7155,1210,8365,286200,48400,334600
1/9/2025,Indika Rajapaksha,Kandy,Peradeniya,Central,4662,7056,11718,186480,282240,468720
1/10/2025,Indika Rajapaksha,Kandy,Peradeniya,Central,4717,6243,10960,188680,249720,438400
1/11/2025,Indika Rajapaksha,Kandy,Peradeniya,Central,7965,8564,16529,318600,342560,661160
1/12/2025,Indika Rajapaksha,Kandy,Peradeniya,Central,1472,5266,6738,58880,210640,269520
1/13/2025,Indika Rajapaksha,Kandy,Peradeniya,Central,511,5744,6255,20440,229760,250200
1/14/2025,Indika Rajapaksha,Kandy,Peradeniya,Central,3032,3423,6455,121280,136920,258200
1/15/2025,Indika Rajapaksha,Kandy,Peradeniya,Central,4370,9818,14188,174800,392720,567520
1/16/2025,Indika Rajapaksha,Kandy,Peradeniya,Central,1769,6748,8517,70760,269920,340680
1/17/2025,Indika Rajapaksha,Kandy,Peradeniya,Central,2322,3701,6023,92880,148040,240920
1/18/2025,Indika Rajapaksha,Kandy,Peradeniya,Central,7540,1393,8933,301600,55720,357320
1/19/2025,Indika Rajapaksha,Kandy,Peradeniya,Central,6411,5312,11723,256440,212480,468920
1/20/2025,Indika Rajapaksha,Kandy,Peradeniya,Central,5739,7222,12961,229560,288880,518440
1/21/2025,Indika Rajapaksha,Kandy,Peradeniya,Central,6510,1569,8079,260400,62760,323160
1/22/2025,Indika Rajapaksha,Kandy,Peradeniya,Central,3255,3097,6352,130200,123880,254080
1/23/2025,Indika Rajapaksha,Kandy,Peradeniya,Central,6221,8837,15058,248840,353480,602320
1/24/2025,Indika Rajapaksha,Kandy,Peradeniya,Central,8089,7955,16044,323560,318200,641760
1/25/2025,Indika Rajapaksha,Kandy,Peradeniya,Central,3419,102,3521,136760,4080,140840
1/26/2025,Indika Rajapaksha,Kandy,Peradeniya,Central,2064,5894,7958,82560,235760,318320
1/27/2025,Indika Rajapaksha,Kandy,Peradeniya,Central,9552,9920,19472,382080,396800,778880
1/28/2025,Indika Rajapaksha,Kandy,Peradeniya,Central,6666,601,7267,266640,24040,290680
1/29/2025,Indika Rajapaksha,Kandy,Peradeniya,Central,5874,637,6511,234960,25480,260440
1/30/2025,Indika Rajapaksha,Kandy,Peradeniya,Central,6066,9897,15963,242640,395880,638520
1/31/2025,Indika Rajapaksha,Kandy,Peradeniya,Central,5369,2784,8153,214760,111360,326120
2/1/2025,Indika Rajapaksha,Kandy,Peradeniya,Central,4196,4271,8467,167840,170840,338680
2/2/2025,Indika Rajapaksha,Kandy,Peradeniya,Central,494,3167,3661,19760,126680,146440
2/3/2025,Indika Rajapaksha,Kandy,Peradeniya,Central,3173,6299,9472,126920,251960,378880
2/4/2025,Indika Rajapaksha,Kandy,Peradeniya,Central,6653,4672,11325,266120,186880,453000
2/5/2025,Indika Rajapaksha,Kandy,Peradeniya,Central,4168,8751,12919,166720,350040,516760
2/6/2025,Indika Rajapaksha,Kandy,Peradeniya,Central,2741,3804,6545,109640,152160,261800
2/7/2025,Indika Rajapaksha,Kandy,Peradeniya,Central,8740,1305,10045,349600,52200,401800
2/8/2025,Indika Rajapaksha,Kandy,Peradeniya,Central,2347,4541,6888,93880,181640,275520
2/9/2025,Indika Rajapaksha,Kandy,Peradeniya,Central,5708,6022,11730,228320,240880,469200
2/10/2025,Indika Rajapaksha,Kandy,Peradeniya,Central,7990,1774,9764,319600,70960,390560
2/11/2025,Indika Rajapaksha,Kandy,Peradeniya,Central,3547,2136,5683,141880,85440,227320
2/12/2025,Indika Rajapaksha,Kandy,Peradeniya,Central,5869,1456,7325,234760,58240,293000
2/13/2025,Indika Rajapaksha,Kandy,Peradeniya,Central,846,9117,9963,33840,364680,398520
2/14/2025,Indika Rajapaksha,Kandy,Peradeniya,Central,7693,8309,16002,307720,332360,640080
2/15/2025,Indika Rajapaksha,Kandy,Peradeniya,Central,8521,7622,16143,340840,304880,645720
2/16/2025,Indika Rajapaksha,Kandy,Peradeniya,Central,3041,4095,7136,121640,163800,285440
2/17/2025,Indika Rajapaksha,Kandy,Peradeniya,Central,910,3701,4611,36400,148040,184440
2/18/2025,Indika Rajapaksha,Kandy,Peradeniya,Central,9935,8571,18506,397400,342840,740240
2/19/2025,Indika Rajapaksha,Kandy,Peradeniya,Central,2346,1948,4294,93840,77920,171760
2/20/2025,Indika Rajapaksha,Kandy,Peradeniya,Central,2204,5745,7949,88160,229800,317960
2/21/2025,Indika Rajapaksha,Kandy,Peradeniya,Central,1481,7178,8659,59240,287120,346360
2/22/2025,Indika Rajapaksha,Kandy,Peradeniya,Central,3216,6061,9277,128640,242440,371080
2/23/2025,Indika Rajapaksha,Kandy,Peradeniya,Central,3567,7308,10875,142680,292320,435000
2/24/2025,Indika Rajapaksha,Kandy,Peradeniya,Central,9065,3813,12878,362600,152520,515120
2/25/2025,Indika Rajapaksha,Kandy,Peradeniya,Central,8381,9682,18063,335240,387280,722520
2/26/2025,Indika Rajapaksha,Kandy,Peradeniya,Central,9084,6023,15107,363360,240920,604280
2/27/2025,Indika Rajapaksha,Kandy,Peradeniya,Central,9180,3741,12921,367200,149640,516840
2/28/2025,Indika Rajapaksha,Kandy,Peradeniya,Central,7719,3456,11175,308760,138240,447000
3/1/2025,Indika Rajapaksha,Kandy,Peradeniya,Central,5474,8337,13811,218960,333480,552440
3/2/2025,Indika Rajapaksha,Kandy,Peradeniya,Central,7383,6978,14361,295320,279120,574440
3/3/2025,Indika Rajapaksha,Kandy,Peradeniya,Central,3058,6221,9279,122320,248840,371160
3/4/2025,Indika Rajapaksha,Kandy,Peradeniya,Central,5339,9327,14666,213560,373080,586640
3/5/2025,Indika Rajapaksha,Kandy,Peradeniya,Central,1966,3267,5233,78640,130680,209320
3/6/2025,Indika Rajapaksha,Kandy,Peradeniya,Central,8644,3694,12338,345760,147760,493520
3/7/2025,Indika Rajapaksha,Kandy,Peradeniya,Central,1557,5168,6725,62280,206720,269000
3/8/2025,Indika Rajapaksha,Kandy,Peradeniya,Central,9413,9541,18954,376520,381640,758160
3/9/2025,Indika Rajapaksha,Kandy,Peradeniya,Central,4049,4848,8897,161960,193920,355880
3/10/2025,Indika Rajapaksha,Kandy,Peradeniya,Central,5841,153,5994,233640,6120,239760
3/11/2025,Indika Rajapaksha,Kandy,Peradeniya,Central,9576,3478,13054,383040,139120,522160
3/12/2025,Indika Rajapaksha,Kandy,Peradeniya,Central,4730,4627,9357,189200,185080,374280
3/13/2025,Indika Rajapaksha,Kandy,Peradeniya,Central,5541,9912,15453,221640,396480,618120
3/14/2025,Indika Rajapaksha,Kandy,Peradeniya,Central,4644,5379,10023,185760,215160,400920
3/15/2025,Indika Rajapaksha,Kandy,Peradeniya,Central,5624,4758,10382,224960,190320,415280
3/16/2025,Indika Rajapaksha,Kandy,Peradeniya,Central,1051,1010,2061,42040,40400,82440
3/17/2025,Indika Rajapaksha,Kandy,Peradeniya,Central,4147,9703,13850,165880,388120,554000
3/18/2025,Indika Rajapaksha,Kandy,Peradeniya,Central,4482,3551,8033,179280,142040,321320
3/19/2025,Indika Rajapaksha,Kandy,Peradeniya,Central,9252,7191,16443,370080,287640,657720
3/20/2025,Indika Rajapaksha,Kandy,Peradeniya,Central,7290,5314,12604,291600,212560,504160
3/21/2025,Indika Rajapaksha,Kandy,Peradeniya,Central,1736,1647,3383,69440,65880,135320
3/22/2025,Indika Rajapaksha,Kandy,Peradeniya,Central,3850,3695,7545,154000,147800,301800
3/23/2025,Indika Rajapaksha,Kandy,Peradeniya,Central,1123,6262,7385,44920,250480,295400
3/25/2024,Lalitha Wickramasinghe,Moneragala,Moneragala,Uva,750,5660,6410,30000,226400,256400
3/26/2024,Lalitha Wickramasinghe,Moneragala,Moneragala,Uva,7084,4764,11848,283360,190560,473920
3/27/2024,Lalitha Wickramasinghe,Moneragala,Moneragala,Uva,7419,7134,14553,296760,285360,582120
3/28/2024,Lalitha Wickramasinghe,Moneragala,Moneragala,Uva,5611,4194,9805,224440,167760,392200
3/29/2024,Lalitha Wickramasinghe,Moneragala,Moneragala,Uva,7059,6156,13215,282360,246240,528600
3/30/2024,Lalitha Wickramasinghe,Moneragala,Moneragala,Uva,4234,2386,6620,169360,95440,264800
3/31/2024,Lalitha Wickramasinghe,Moneragala,Moneragala,Uva,1610,6244,7854,64400,249760,314160
4/1/2024,Lalitha Wickramasinghe,Moneragala,Moneragala,Uva,9999,2379,12378,399960,95160,495120
4/2/2024,Lalitha Wickramasinghe,Moneragala,Moneragala,Uva,2745,4184,6929,109800,167360,277160
4/3/2024,Lalitha Wickramasinghe,Moneragala,Moneragala,Uva,5155,8707,13862,206200,348280,554480
4/4/2024,Lalitha Wickramasinghe,Moneragala,Moneragala,Uva,1996,5156,7152,79840,206240,286080
4/5/2024,Lalitha Wickramasinghe,Moneragala,Moneragala,Uva,4047,8746,12793,161880,349840,511720
4/6/2024,Lalitha Wickramasinghe,Moneragala,Moneragala,Uva,7562,3933,11495,302480,157320,459800
4/7/2024,Lalitha Wickramasinghe,Moneragala,Moneragala,Uva,9786,4814,14600,391440,192560,584000
4/8/2024,Lalitha Wickramasinghe,Moneragala,Moneragala,Uva,8103,8626,16729,324120,345040,669160
4/9/2024,Lalitha Wickramasinghe,Moneragala,Moneragala,Uva,3805,4227,8032,152200,169080,321280
4/10/2024,Lalitha Wickramasinghe,Moneragala,Moneragala,Uva,1947,932,2879,77880,37280,115160
4/11/2024,Lalitha Wickramasinghe,Moneragala,Moneragala,Uva,7465,6597,14062,298600,263880,562480
4/19/2024,Lalitha Wickramasinghe,Moneragala,Moneragala,Uva,8842,2485,11327,353680,99400,453080
4/20/2024,Lalitha Wickramasinghe,Moneragala,Moneragala,Uva,6606,9497,16103,264240,379880,644120
4/21/2024,Lalitha Wickramasinghe,Moneragala,Moneragala,Uva,3904,4743,8647,156160,189720,345880
4/22/2024,Lalitha Wickramasinghe,Moneragala,Moneragala,Uva,1765,3312,5077,70600,132480,203080
4/23/2024,Lalitha Wickramasinghe,Moneragala,Moneragala,Uva,88,533,621,3520,21320,24840
4/24/2024,Lalitha Wickramasinghe,Moneragala,Moneragala,Uva,5915,9248,15163,236600,369920,606520
4/25/2024,Lalitha Wickramasinghe,Moneragala,Moneragala,Uva,3491,4753,8244,139640,190120,329760
4/26/2024,Lalitha Wickramasinghe,Moneragala,Moneragala,Uva,5901,967,6868,236040,38680,274720
4/27/2024,Lalitha Wickramasinghe,Moneragala,Moneragala,Uva,939,9752,10691,37560,390080,427640
4/28/2024,Lalitha Wickramasinghe,Moneragala,Moneragala,Uva,7534,9451,16985,301360,378040,679400
4/29/2024,Lalitha Wickramasinghe,Moneragala,Moneragala,Uva,1302,75,1377,52080,3000,55080
4/30/2024,Lalitha Wickramasinghe,Moneragala,Moneragala,Uva,8922,2964,11886,356880,118560,475440
5/1/2024,Lalitha Wickramasinghe,Moneragala,Moneragala,Uva,2612,6753,9365,104480,270120,374600
5/2/2024,Lalitha Wickramasinghe,Moneragala,Moneragala,Uva,6668,1529,8197,266720,61160,327880
5/3/2024,Lalitha Wickramasinghe,Moneragala,Moneragala,Uva,9454,4953,14407,378160,198120,576280
5/4/2024,Lalitha Wickramasinghe,Moneragala,Moneragala,Uva,4871,6240,11111,194840,249600,444440
5/5/2024,Lalitha Wickramasinghe,Moneragala,Moneragala,Uva,2920,8413,11333,116800,336520,453320
5/6/2024,Lalitha Wickramasinghe,Moneragala,Moneragala,Uva,2322,5264,7586,92880,210560,303440
5/7/2024,Lalitha Wickramasinghe,Moneragala,Moneragala,Uva,5817,2019,7836,232680,80760,313440
5/8/2024,Lalitha Wickramasinghe,Moneragala,Moneragala,Uva,1248,5784,7032,49920,231360,281280
5/9/2024,Lalitha Wickramasinghe,Moneragala,Moneragala,Uva,2618,2704,5322,104720,108160,212880
5/10/2024,Lalitha Wickramasinghe,Moneragala,Moneragala,Uva,749,5161,5910,29960,206440,236400
5/11/2024,Lalitha Wickramasinghe,Moneragala,Moneragala,Uva,6641,9585,16226,265640,383400,649040
5/12/2024,Lalitha Wickramasinghe,Moneragala,Moneragala,Uva,8550,9172,17722,342000,366880,708880
5/13/2024,Lalitha Wickramasinghe,Moneragala,Moneragala,Uva,4284,9638,13922,171360,385520,556880
5/14/2024,Lalitha Wickramasinghe,Moneragala,Moneragala,Uva,620,7069,7689,24800,282760,307560
5/15/2024,Lalitha Wickramasinghe,Moneragala,Moneragala,Uva,5270,1066,6336,210800,42640,253440
5/16/2024,Lalitha Wickramasinghe,Moneragala,Moneragala,Uva,464,5546,6010,18560,221840,240400
5/17/2024,Lalitha Wickramasinghe,Moneragala,Moneragala,Uva,6452,670,7122,258080,26800,284880
5/18/2024,Lalitha Wickramasinghe,Moneragala,Moneragala,Uva,8798,4553,13351,351920,182120,534040
5/19/2024,Lalitha Wickramasinghe,Moneragala,Moneragala,Uva,9126,7733,16859,365040,309320,674360
5/20/2024,Lalitha Wickramasinghe,Moneragala,Moneragala,Uva,5287,501,5788,211480,20040,231520
5/21/2024,Lalitha Wickramasinghe,Moneragala,Moneragala,Uva,5600,4245,9845,224000,169800,393800
5/22/2024,Lalitha Wickramasinghe,Moneragala,Moneragala,Uva,700,3590,4290,28000,143600,171600
5/24/2024,Lalitha Wickramasinghe,Moneragala,Moneragala,Uva,1480,7357,8837,59200,294280,353480
5/25/2024,Lalitha Wickramasinghe,Moneragala,Moneragala,Uva,5913,4831,10744,236520,193240,429760
5/26/2024,Lalitha Wickramasinghe,Moneragala,Moneragala,Uva,4755,3153,7908,190200,126120,316320
5/27/2024,Lalitha Wickramasinghe,Moneragala,Moneragala,Uva,7722,8408,16130,308880,336320,645200
5/28/2024,Lalitha Wickramasinghe,Moneragala,Moneragala,Uva,2727,5752,8479,109080,230080,339160
5/29/2024,Lalitha Wickramasinghe,Moneragala,Moneragala,Uva,1462,9935,11397,58480,397400,455880
5/30/2024,Lalitha Wickramasinghe,Moneragala,Moneragala,Uva,7627,2010,9637,305080,80400,385480
5/31/2024,Lalitha Wickramasinghe,Moneragala,Moneragala,Uva,4123,4860,8983,164920,194400,359320
6/1/2024,Lalitha Wickramasinghe,Moneragala,Moneragala,Uva,3032,6936,9968,121280,277440,398720
6/2/2024,Lalitha Wickramasinghe,Moneragala,Moneragala,Uva,7113,5608,12721,284520,224320,508840
6/3/2024,Lalitha Wickramasinghe,Moneragala,Moneragala,Uva,2892,5034,7926,115680,201360,317040
6/4/2024,Lalitha Wickramasinghe,Moneragala,Moneragala,Uva,2567,7421,9988,102680,296840,399520
6/5/2024,Lalitha Wickramasinghe,Moneragala,Moneragala,Uva,6517,9548,16065,260680,381920,642600
6/6/2024,Lalitha Wickramasinghe,Moneragala,Moneragala,Uva,4476,1934,6410,179040,77360,256400
6/7/2024,Lalitha Wickramasinghe,Moneragala,Moneragala,Uva,9376,5559,14935,375040,222360,597400
6/8/2024,Lalitha Wickramasinghe,Moneragala,Moneragala,Uva,616,1502,2118,24640,60080,84720
6/9/2024,Lalitha Wickramasinghe,Moneragala,Moneragala,Uva,6414,1384,7798,256560,55360,311920
6/10/2024,Lalitha Wickramasinghe,Moneragala,Moneragala,Uva,3704,4550,8254,148160,182000,330160
6/11/2024,Lalitha Wickramasinghe,Moneragala,Moneragala,Uva,8368,4667,13035,334720,186680,521400
6/12/2024,Lalitha Wickramasinghe,Moneragala,Moneragala,Uva,4690,6972,11662,187600,278880,466480
6/13/2024,Lalitha Wickramasinghe,Moneragala,Moneragala,Uva,5456,580,6036,218240,23200,241440
6/14/2024,Lalitha Wickramasinghe,Moneragala,Moneragala,Uva,3577,3546,7123,143080,141840,284920
6/15/2024,Lalitha Wickramasinghe,Moneragala,Moneragala,Uva,9832,897,10729,393280,35880,429160
6/16/2024,Lalitha Wickramasinghe,Moneragala,Moneragala,Uva,39,1624,1663,1560,64960,66520
6/17/2024,Lalitha Wickramasinghe,Moneragala,Moneragala,Uva,36,826,862,1440,33040,34480
6/18/2024,Lalitha Wickramasinghe,Moneragala,Moneragala,Uva,8617,7676,16293,344680,307040,651720
6/19/2024,Lalitha Wickramasinghe,Moneragala,Moneragala,Uva,8660,5726,14386,346400,229040,575440
6/20/2024,Lalitha Wickramasinghe,Moneragala,Moneragala,Uva,1334,404,1738,53360,16160,69520
6/21/2024,Lalitha Wickramasinghe,Moneragala,Moneragala,Uva,7635,2063,9698,305400,82520,387920
6/22/2024,Lalitha Wickramasinghe,Moneragala,Moneragala,Uva,9909,8925,18834,396360,357000,753360
6/23/2024,Lalitha Wickramasinghe,Moneragala,Moneragala,Uva,5722,8387,14109,228880,335480,564360
6/24/2024,Lalitha Wickramasinghe,Moneragala,Moneragala,Uva,9925,4234,14159,397000,169360,566360
6/25/2024,Lalitha Wickramasinghe,Moneragala,Moneragala,Uva,7706,3799,11505,308240,151960,460200
6/26/2024,Lalitha Wickramasinghe,Moneragala,Moneragala,Uva,3314,9440,12754,132560,377600,510160
6/27/2024,Lalitha Wickramasinghe,Moneragala,Moneragala,Uva,3938,3312,7250,157520,132480,290000
6/28/2024,Lalitha Wickramasinghe,Moneragala,Moneragala,Uva,7531,8649,16180,301240,345960,647200
6/29/2024,Lalitha Wickramasinghe,Moneragala,Moneragala,Uva,6672,4884,11556,266880,195360,462240
6/30/2024,Lalitha Wickramasinghe,Moneragala,Moneragala,Uva,3689,3447,7136,147560,137880,285440
7/1/2024,Lalitha Wickramasinghe,Moneragala,Moneragala,Uva,5457,3280,8737,218280,131200,349480
7/2/2024,Lalitha Wickramasinghe,Moneragala,Moneragala,Uva,326,2631,2957,13040,105240,118280
7/3/2024,Lalitha Wickramasinghe,Moneragala,Moneragala,Uva,222,9200,9422,8880,368000,376880
7/4/2024,Lalitha Wickramasinghe,Moneragala,Moneragala,Uva,2350,5496,7846,94000,219840,313840
7/5/2024,Lalitha Wickramasinghe,Moneragala,Moneragala,Uva,6492,7514,14006,259680,300560,560240
7/6/2024,Lalitha Wickramasinghe,Moneragala,Moneragala,Uva,5222,1649,6871,208880,65960,274840
7/7/2024,Lalitha Wickramasinghe,Moneragala,Moneragala,Uva,5964,8517,14481,238560,340680,579240
7/8/2024,Lalitha Wickramasinghe,Moneragala,Moneragala,Uva,595,8703,9298,23800,348120,371920
7/9/2024,Lalitha Wickramasinghe,Moneragala,Moneragala,Uva,3112,9830,12942,124480,393200,517680
7/10/2024,Lalitha Wickramasinghe,Moneragala,Moneragala,Uva,304,2647,2951,12160,105880,118040
7/11/2024,Lalitha Wickramasinghe,Moneragala,Moneragala,Uva,1933,2124,4057,77320,84960,162280
7/12/2024,Lalitha Wickramasinghe,Moneragala,Moneragala,Uva,9563,6634,16197,382520,265360,647880
7/13/2024,Lalitha Wickramasinghe,Moneragala,Moneragala,Uva,5977,6497,12474,239080,259880,498960
7/14/2024,Lalitha Wickramasinghe,Moneragala,Moneragala,Uva,8331,2171,10502,333240,86840,420080
7/15/2024,Lalitha Wickramasinghe,Moneragala,Moneragala,Uva,1391,4004,5395,55640,160160,215800
7/16/2024,Lalitha Wickramasinghe,Moneragala,Moneragala,Uva,8900,5430,14330,356000,217200,573200
7/17/2024,Lalitha Wickramasinghe,Moneragala,Moneragala,Uva,6120,7377,13497,244800,295080,539880
7/18/2024,Lalitha Wickramasinghe,Moneragala,Moneragala,Uva,2993,9435,12428,119720,377400,497120
7/19/2024,Lalitha Wickramasinghe,Moneragala,Moneragala,Uva,5942,2406,8348,237680,96240,333920
7/20/2024,Lalitha Wickramasinghe,Moneragala,Moneragala,Uva,8646,5964,14610,345840,238560,584400
7/21/2024,Lalitha Wickramasinghe,Moneragala,Moneragala,Uva,7917,4657,12574,316680,186280,502960
7/22/2024,Lalitha Wickramasinghe,Moneragala,Moneragala,Uva,4991,3300,8291,199640,132000,331640
7/23/2024,Lalitha Wickramasinghe,Moneragala,Moneragala,Uva,9095,522,9617,363800,20880,384680
7/24/2024,Lalitha Wickramasinghe,Moneragala,Moneragala,Uva,2486,368,2854,99440,14720,114160
7/25/2024,Lalitha Wickramasinghe,Moneragala,Moneragala,Uva,5639,6995,12634,225560,279800,505360
7/26/2024,Lalitha Wickramasinghe,Moneragala,Moneragala,Uva,1229,2679,3908,49160,107160,156320
7/27/2024,Lalitha Wickramasinghe,Moneragala,Moneragala,Uva,3768,1788,5556,150720,71520,222240
7/28/2024,Lalitha Wickramasinghe,Moneragala,Moneragala,Uva,8149,1962,10111,325960,78480,404440
7/29/2024,Lalitha Wickramasinghe,Moneragala,Moneragala,Uva,472,4303,4775,18880,172120,191000
7/30/2024,Lalitha Wickramasinghe,Moneragala,Moneragala,Uva,1088,4930,6018,43520,197200,240720
7/31/2024,Lalitha Wickramasinghe,Moneragala,Moneragala,Uva,3103,4234,7337,124120,169360,293480
8/1/2024,Lalitha Wickramasinghe,Moneragala,Moneragala,Uva,2664,5362,8026,106560,214480,321040
8/2/2024,Lalitha Wickramasinghe,Moneragala,Moneragala,Uva,4804,1420,6224,192160,56800,248960
8/3/2024,Lalitha Wickramasinghe,Moneragala,Moneragala,Uva,6565,9733,16298,262600,389320,651920
8/4/2024,Lalitha Wickramasinghe,Moneragala,Moneragala,Uva,520,9481,10001,20800,379240,400040
8/5/2024,Lalitha Wickramasinghe,Moneragala,Moneragala,Uva,8534,6397,14931,341360,255880,597240
8/6/2024,Lalitha Wickramasinghe,Moneragala,Moneragala,Uva,9400,8928,18328,376000,357120,733120
8/7/2024,Lalitha Wickramasinghe,Moneragala,Moneragala,Uva,4835,7914,12749,193400,316560,509960
8/8/2024,Lalitha Wickramasinghe,Moneragala,Moneragala,Uva,8031,122,8153,321240,4880,326120
8/9/2024,Lalitha Wickramasinghe,Moneragala,Moneragala,Uva,3371,4095,7466,134840,163800,298640
8/10/2024,Lalitha Wickramasinghe,Moneragala,Moneragala,Uva,7986,8806,16792,319440,352240,671680
8/11/2024,Lalitha Wickramasinghe,Moneragala,Moneragala,Uva,421,1736,2157,16840,69440,86280
8/12/2024,Lalitha Wickramasinghe,Moneragala,Moneragala,Uva,2551,5606,8157,102040,224240,326280
8/13/2024,Lalitha Wickramasinghe,Moneragala,Moneragala,Uva,7481,8654,16135,299240,346160,645400
8/14/2024,Lalitha Wickramasinghe,Moneragala,Moneragala,Uva,5927,7711,13638,237080,308440,545520
8/15/2024,Lalitha Wickramasinghe,Moneragala,Moneragala,Uva,6403,4505,10908,256120,180200,436320
8/16/2024,Lalitha Wickramasinghe,Moneragala,Moneragala,Uva,540,8186,8726,21600,327440,349040
8/17/2024,Lalitha Wickramasinghe,Moneragala,Moneragala,Uva,6908,8700,15608,276320,348000,624320
8/18/2024,Lalitha Wickramasinghe,Moneragala,Moneragala,Uva,3710,8852,12562,148400,354080,502480
8/19/2024,Lalitha Wickramasinghe,Moneragala,Moneragala,Uva,7626,3553,11179,305040,142120,447160
8/20/2024,Lalitha Wickramasinghe,Moneragala,Moneragala,Uva,10000,1031,11031,400000,41240,441240
8/21/2024,Lalitha Wickramasinghe,Moneragala,Moneragala,Uva,6646,2092,8738,265840,83680,349520
8/22/2024,Lalitha Wickramasinghe,Moneragala,Moneragala,Uva,7172,4387,11559,286880,175480,462360
8/23/2024,Lalitha Wickramasinghe,Moneragala,Moneragala,Uva,4178,7469,11647,167120,298760,465880
8/24/2024,Lalitha Wickramasinghe,Moneragala,Moneragala,Uva,6861,9831,16692,274440,393240,667680
8/25/2024,Lalitha Wickramasinghe,Moneragala,Moneragala,Uva,7300,2050,9350,292000,82000,374000
8/26/2024,Lalitha Wickramasinghe,Moneragala,Moneragala,Uva,9967,6960,16927,398680,278400,677080
8/27/2024,Lalitha Wickramasinghe,Moneragala,Moneragala,Uva,6091,6084,12175,243640,243360,487000
8/28/2024,Lalitha Wickramasinghe,Moneragala,Moneragala,Uva,8841,7880,16721,353640,315200,668840
8/29/2024,Lalitha Wickramasinghe,Moneragala,Moneragala,Uva,7403,4333,11736,296120,173320,469440
8/30/2024,Lalitha Wickramasinghe,Moneragala,Moneragala,Uva,8226,9664,17890,329040,386560,715600
8/31/2024,Lalitha Wickramasinghe,Moneragala,Moneragala,Uva,4436,2108,6544,177440,84320,261760
9/1/2024,Lalitha Wickramasinghe,Moneragala,Moneragala,Uva,2077,7254,9331,83080,290160,373240
9/2/2024,Lalitha Wickramasinghe,Moneragala,Moneragala,Uva,7472,7247,14719,298880,289880,588760
9/3/2024,Lalitha Wickramasinghe,Moneragala,Moneragala,Uva,8669,4755,13424,346760,190200,536960
9/4/2024,Lalitha Wickramasinghe,Moneragala,Moneragala,Uva,8427,2719,11146,337080,108760,445840
9/5/2024,Lalitha Wickramasinghe,Moneragala,Moneragala,Uva,7688,2784,10472,307520,111360,418880
9/6/2024,Lalitha Wickramasinghe,Moneragala,Moneragala,Uva,8010,9715,17725,320400,388600,709000
9/7/2024,Lalitha Wickramasinghe,Moneragala,Moneragala,Uva,7085,2438,9523,283400,97520,380920
9/8/2024,Lalitha Wickramasinghe,Moneragala,Moneragala,Uva,6304,4617,10921,252160,184680,436840
9/9/2024,Lalitha Wickramasinghe,Moneragala,Moneragala,Uva,6215,7925,14140,248600,317000,565600
9/10/2024,Lalitha Wickramasinghe,Moneragala,Moneragala,Uva,9020,2984,12004,360800,119360,480160
9/11/2024,Lalitha Wickramasinghe,Moneragala,Moneragala,Uva,6773,1623,8396,270920,64920,335840
9/12/2024,Lalitha Wickramasinghe,Moneragala,Moneragala,Uva,8536,8762,17298,341440,350480,691920
9/13/2024,Lalitha Wickramasinghe,Moneragala,Moneragala,Uva,7428,3705,11133,297120,148200,445320
9/14/2024,Lalitha Wickramasinghe,Moneragala,Moneragala,Uva,9835,5097,14932,393400,203880,597280
9/15/2024,Lalitha Wickramasinghe,Moneragala,Moneragala,Uva,1477,6732,8209,59080,269280,328360
9/16/2024,Lalitha Wickramasinghe,Moneragala,Moneragala,Uva,4789,572,5361,191560,22880,214440
9/17/2024,Lalitha Wickramasinghe,Moneragala,Moneragala,Uva,5703,7068,12771,228120,282720,510840
9/18/2024,Lalitha Wickramasinghe,Moneragala,Moneragala,Uva,1211,5710,6921,48440,228400,276840
9/19/2024,Lalitha Wickramasinghe,Moneragala,Moneragala,Uva,5751,5419,11170,230040,216760,446800
9/20/2024,Lalitha Wickramasinghe,Moneragala,Moneragala,Uva,4717,8059,12776,188680,322360,511040
9/21/2024,Lalitha Wickramasinghe,Moneragala,Moneragala,Uva,5585,8296,13881,223400,331840,555240
9/22/2024,Lalitha Wickramasinghe,Moneragala,Moneragala,Uva,1396,4384,5780,55840,175360,231200
9/23/2024,Lalitha Wickramasinghe,Moneragala,Moneragala,Uva,1295,1378,2673,51800,55120,106920
9/24/2024,Lalitha Wickramasinghe,Moneragala,Moneragala,Uva,4039,8023,12062,161560,320920,482480
9/25/2024,Lalitha Wickramasinghe,Moneragala,Moneragala,Uva,6178,5120,11298,247120,204800,451920
9/26/2024,Lalitha Wickramasinghe,Moneragala,Moneragala,Uva,460,583,1043,18400,23320,41720
9/27/2024,Lalitha Wickramasinghe,Moneragala,Moneragala,Uva,1014,7229,8243,40560,289160,329720
9/28/2024,Lalitha Wickramasinghe,Moneragala,Moneragala,Uva,8878,6458,15336,355120,258320,613440
9/29/2024,Lalitha Wickramasinghe,Moneragala,Moneragala,Uva,4791,6010,10801,191640,240400,432040
9/30/2024,Lalitha Wickramasinghe,Moneragala,Moneragala,Uva,7874,7620,15494,314960,304800,619760
10/1/2024,Lalitha Wickramasinghe,Moneragala,Moneragala,Uva,4811,2412,7223,192440,96480,288920
10/2/2024,Lalitha Wickramasinghe,Moneragala,Moneragala,Uva,7665,4106,11771,306600,164240,470840
10/3/2024,Lalitha Wickramasinghe,Moneragala,Moneragala,Uva,8952,9489,18441,358080,379560,737640
10/4/2024,Lalitha Wickramasinghe,Moneragala,Moneragala,Uva,9892,1775,11667,395680,71000,466680
10/5/2024,Lalitha Wickramasinghe,Moneragala,Moneragala,Uva,1310,2116,3426,52400,84640,137040
10/6/2024,Lalitha Wickramasinghe,Moneragala,Moneragala,Uva,3206,8436,11642,128240,337440,465680
10/7/2024,Lalitha Wickramasinghe,Moneragala,Moneragala,Uva,2350,972,3322,94000,38880,132880
10/8/2024,Lalitha Wickramasinghe,Moneragala,Moneragala,Uva,8186,3055,11241,327440,122200,449640
10/9/2024,Lalitha Wickramasinghe,Moneragala,Moneragala,Uva,4193,8567,12760,167720,342680,510400
10/10/2024,Lalitha Wickramasinghe,Moneragala,Moneragala,Uva,4509,4926,9435,180360,197040,377400
10/11/2024,Lalitha Wickramasinghe,Moneragala,Moneragala,Uva,6648,5638,12286,265920,225520,491440
10/12/2024,Lalitha Wickramasinghe,Moneragala,Moneragala,Uva,1509,1405,2914,60360,56200,116560
10/13/2024,Lalitha Wickramasinghe,Moneragala,Moneragala,Uva,9982,8823,18805,399280,352920,752200
10/14/2024,Lalitha Wickramasinghe,Moneragala,Moneragala,Uva,9499,1369,10868,379960,54760,434720
10/15/2024,Lalitha Wickramasinghe,Moneragala,Moneragala,Uva,1712,1168,2880,68480,46720,115200
10/16/2024,Lalitha Wickramasinghe,Moneragala,Moneragala,Uva,129,5911,6040,5160,236440,241600
10/17/2024,Lalitha Wickramasinghe,Moneragala,Moneragala,Uva,5271,243,5514,210840,9720,220560
10/18/2024,Lalitha Wickramasinghe,Moneragala,Moneragala,Uva,8011,7674,15685,320440,306960,627400
10/19/2024,Lalitha Wickramasinghe,Moneragala,Moneragala,Uva,2532,6628,9160,101280,265120,366400
10/20/2024,Lalitha Wickramasinghe,Moneragala,Moneragala,Uva,8459,3839,12298,338360,153560,491920
10/21/2024,Lalitha Wickramasinghe,Moneragala,Moneragala,Uva,6239,4668,10907,249560,186720,436280
10/22/2024,Lalitha Wickramasinghe,Moneragala,Moneragala,Uva,7930,9724,17654,317200,388960,706160
10/23/2024,Lalitha Wickramasinghe,Moneragala,Moneragala,Uva,8255,2639,10894,330200,105560,435760
10/24/2024,Lalitha Wickramasinghe,Moneragala,Moneragala,Uva,558,1915,2473,22320,76600,98920
10/25/2024,Lalitha Wickramasinghe,Moneragala,Moneragala,Uva,2925,2198,5123,117000,87920,204920
10/26/2024,Lalitha Wickramasinghe,Moneragala,Moneragala,Uva,9608,4185,13793,384320,167400,551720
10/27/2024,Lalitha Wickramasinghe,Moneragala,Moneragala,Uva,9933,5551,15484,397320,222040,619360
10/28/2024,Lalitha Wickramasinghe,Moneragala,Moneragala,Uva,7689,300,7989,307560,12000,319560
10/29/2024,Lalitha Wickramasinghe,Moneragala,Moneragala,Uva,2581,350,2931,103240,14000,117240
10/30/2024,Lalitha Wickramasinghe,Moneragala,Moneragala,Uva,1022,9091,10113,40880,363640,404520
10/31/2024,Lalitha Wickramasinghe,Moneragala,Moneragala,Uva,9470,1065,10535,378800,42600,421400
11/1/2024,Lalitha Wickramasinghe,Moneragala,Moneragala,Uva,6457,3795,10252,258280,151800,410080
11/2/2024,Lalitha Wickramasinghe,Moneragala,Moneragala,Uva,1662,4274,5936,66480,170960,237440
11/3/2024,Lalitha Wickramasinghe,Moneragala,Moneragala,Uva,9876,43,9919,395040,1720,396760
11/4/2024,Lalitha Wickramasinghe,Moneragala,Moneragala,Uva,4707,5170,9877,188280,206800,395080
11/5/2024,Lalitha Wickramasinghe,Moneragala,Moneragala,Uva,2558,4046,6604,102320,161840,264160
11/6/2024,Lalitha Wickramasinghe,Moneragala,Moneragala,Uva,6478,8914,15392,259120,356560,615680
11/7/2024,Lalitha Wickramasinghe,Moneragala,Moneragala,Uva,8326,5302,13628,333040,212080,545120
11/8/2024,Lalitha Wickramasinghe,Moneragala,Moneragala,Uva,9375,9350,18725,375000,374000,749000
11/9/2024,Lalitha Wickramasinghe,Moneragala,Moneragala,Uva,3573,2375,5948,142920,95000,237920
11/10/2024,Lalitha Wickramasinghe,Moneragala,Moneragala,Uva,9376,9773,19149,375040,390920,765960
11/11/2024,Lalitha Wickramasinghe,Moneragala,Moneragala,Uva,3234,69,3303,129360,2760,132120
11/12/2024,Lalitha Wickramasinghe,Moneragala,Moneragala,Uva,846,9326,10172,33840,373040,406880
11/13/2024,Lalitha Wickramasinghe,Moneragala,Moneragala,Uva,8395,6786,15181,335800,271440,607240
11/14/2024,Lalitha Wickramasinghe,Moneragala,Moneragala,Uva,4000,207,4207,160000,8280,168280
11/15/2024,Lalitha Wickramasinghe,Moneragala,Moneragala,Uva,8203,8954,17157,328120,358160,686280
11/16/2024,Lalitha Wickramasinghe,Moneragala,Moneragala,Uva,5894,8549,14443,235760,341960,577720
11/17/2024,Lalitha Wickramasinghe,Moneragala,Moneragala,Uva,3851,7415,11266,154040,296600,450640
11/18/2024,Lalitha Wickramasinghe,Moneragala,Moneragala,Uva,2640,8821,11461,105600,352840,458440
11/19/2024,Lalitha Wickramasinghe,Moneragala,Moneragala,Uva,3226,1536,4762,129040,61440,190480
11/20/2024,Lalitha Wickramasinghe,Moneragala,Moneragala,Uva,3176,7673,10849,127040,306920,433960
11/21/2024,Lalitha Wickramasinghe,Moneragala,Moneragala,Uva,3977,9719,13696,159080,388760,547840
11/22/2024,Lalitha Wickramasinghe,Moneragala,Moneragala,Uva,753,5773,6526,30120,230920,261040
11/23/2024,Lalitha Wickramasinghe,Moneragala,Moneragala,Uva,2050,9217,11267,82000,368680,450680
11/24/2024,Lalitha Wickramasinghe,Moneragala,Moneragala,Uva,1610,4475,6085,64400,179000,243400
11/25/2024,Lalitha Wickramasinghe,Moneragala,Moneragala,Uva,8890,3979,12869,355600,159160,514760
11/26/2024,Lalitha Wickramasinghe,Moneragala,Moneragala,Uva,2072,5370,7442,82880,214800,297680
11/27/2024,Lalitha Wickramasinghe,Moneragala,Moneragala,Uva,3668,2268,5936,146720,90720,237440
11/28/2024,Lalitha Wickramasinghe,Moneragala,Moneragala,Uva,6097,6772,12869,243880,270880,514760
11/29/2024,Lalitha Wickramasinghe,Moneragala,Moneragala,Uva,476,1581,2057,19040,63240,82280
11/30/2024,Lalitha Wickramasinghe,Moneragala,Moneragala,Uva,780,553,1333,31200,22120,53320
12/1/2024,Lalitha Wickramasinghe,Moneragala,Moneragala,Uva,362,7738,8100,14480,309520,324000
12/2/2024,Lalitha Wickramasinghe,Moneragala,Moneragala,Uva,7515,686,8201,300600,27440,328040
12/3/2024,Lalitha Wickramasinghe,Moneragala,Moneragala,Uva,9123,1368,10491,364920,54720,419640
12/4/2024,Lalitha Wickramasinghe,Moneragala,Moneragala,Uva,4174,3054,7228,166960,122160,289120
12/5/2024,Lalitha Wickramasinghe,Moneragala,Moneragala,Uva,620,5779,6399,24800,231160,255960
12/6/2024,Lalitha Wickramasinghe,Moneragala,Moneragala,Uva,4027,5453,9480,161080,218120,379200
12/7/2024,Lalitha Wickramasinghe,Moneragala,Moneragala,Uva,4231,3679,7910,169240,147160,316400
12/8/2024,Lalitha Wickramasinghe,Moneragala,Moneragala,Uva,4874,1,4875,194960,40,195000
12/9/2024,Lalitha Wickramasinghe,Moneragala,Moneragala,Uva,4190,3894,8084,167600,155760,323360
12/10/2024,Lalitha Wickramasinghe,Moneragala,Moneragala,Uva,3399,1314,4713,135960,52560,188520
12/11/2024,Lalitha Wickramasinghe,Moneragala,Moneragala,Uva,3625,2687,6312,145000,107480,252480
12/12/2024,Lalitha Wickramasinghe,Moneragala,Moneragala,Uva,1153,3418,4571,46120,136720,182840
12/13/2024,Lalitha Wickramasinghe,Moneragala,Moneragala,Uva,7434,4755,12189,297360,190200,487560
12/14/2024,Lalitha Wickramasinghe,Moneragala,Moneragala,Uva,8174,214,8388,326960,8560,335520
12/15/2024,Lalitha Wickramasinghe,Moneragala,Moneragala,Uva,3091,7473,10564,123640,298920,422560
12/16/2024,Lalitha Wickramasinghe,Moneragala,Moneragala,Uva,2312,995,3307,92480,39800,132280
12/17/2024,Lalitha Wickramasinghe,Moneragala,Moneragala,Uva,9810,5801,15611,392400,232040,624440
12/18/2024,Lalitha Wickramasinghe,Moneragala,Moneragala,Uva,5915,8055,13970,236600,322200,558800
12/19/2024,Lalitha Wickramasinghe,Moneragala,Moneragala,Uva,8654,218,8872,346160,8720,354880
12/20/2024,Lalitha Wickramasinghe,Moneragala,Moneragala,Uva,2139,4651,6790,85560,186040,271600
12/21/2024,Lalitha Wickramasinghe,Moneragala,Moneragala,Uva,3503,6426,9929,140120,257040,397160
12/22/2024,Lalitha Wickramasinghe,Moneragala,Moneragala,Uva,1377,3373,4750,55080,134920,190000
12/23/2024,Lalitha Wickramasinghe,Moneragala,Moneragala,Uva,6272,835,7107,250880,33400,284280
12/24/2024,Lalitha Wickramasinghe,Moneragala,Moneragala,Uva,5251,1940,7191,210040,77600,287640
12/25/2024,Lalitha Wickramasinghe,Moneragala,Moneragala,Uva,139,2208,2347,5560,88320,93880
12/26/2024,Lalitha Wickramasinghe,Moneragala,Moneragala,Uva,896,3488,4384,35840,139520,175360
12/27/2024,Lalitha Wickramasinghe,Moneragala,Moneragala,Uva,6992,2879,9871,279680,115160,394840
12/28/2024,Lalitha Wickramasinghe,Moneragala,Moneragala,Uva,4678,8581,13259,187120,343240,530360
12/29/2024,Lalitha Wickramasinghe,Moneragala,Moneragala,Uva,8834,9856,18690,353360,394240,747600
12/30/2024,Lalitha Wickramasinghe,Moneragala,Moneragala,Uva,2641,3012,5653,105640,120480,226120
12/31/2024,Lalitha Wickramasinghe,Moneragala,Moneragala,Uva,1191,9682,10873,47640,387280,434920
1/1/2025,Lalitha Wickramasinghe,Moneragala,Moneragala,Uva,9262,6110,15372,370480,244400,614880
1/2/2025,Lalitha Wickramasinghe,Moneragala,Moneragala,Uva,5752,4983,10735,230080,199320,429400
1/3/2025,Lalitha Wickramasinghe,Moneragala,Moneragala,Uva,9837,8983,18820,393480,359320,752800
1/4/2025,Lalitha Wickramasinghe,Moneragala,Moneragala,Uva,8994,8426,17420,359760,337040,696800
1/5/2025,Lalitha Wickramasinghe,Moneragala,Moneragala,Uva,3715,8894,12609,148600,355760,504360
1/6/2025,Lalitha Wickramasinghe,Moneragala,Moneragala,Uva,6878,5256,12134,275120,210240,485360
1/7/2025,Lalitha Wickramasinghe,Moneragala,Moneragala,Uva,7777,7838,15615,311080,313520,624600
1/8/2025,Lalitha Wickramasinghe,Moneragala,Moneragala,Uva,1599,8199,9798,63960,327960,391920
1/9/2025,Lalitha Wickramasinghe,Moneragala,Moneragala,Uva,1690,468,2158,67600,18720,86320
1/10/2025,Lalitha Wickramasinghe,Moneragala,Moneragala,Uva,4820,1903,6723,192800,76120,268920
1/11/2025,Lalitha Wickramasinghe,Moneragala,Moneragala,Uva,1141,3147,4288,45640,125880,171520
1/12/2025,Lalitha Wickramasinghe,Moneragala,Moneragala,Uva,418,6634,7052,16720,265360,282080
1/13/2025,Lalitha Wickramasinghe,Moneragala,Moneragala,Uva,5995,2878,8873,239800,115120,354920
1/14/2025,Lalitha Wickramasinghe,Moneragala,Moneragala,Uva,3662,1593,5255,146480,63720,210200
1/15/2025,Lalitha Wickramasinghe,Moneragala,Moneragala,Uva,958,139,1097,38320,5560,43880
1/16/2025,Lalitha Wickramasinghe,Moneragala,Moneragala,Uva,243,550,793,9720,22000,31720
1/17/2025,Lalitha Wickramasinghe,Moneragala,Moneragala,Uva,4522,7089,11611,180880,283560,464440
1/18/2025,Lalitha Wickramasinghe,Moneragala,Moneragala,Uva,426,7772,8198,17040,310880,327920
1/19/2025,Lalitha Wickramasinghe,Moneragala,Moneragala,Uva,7054,2391,9445,282160,95640,377800
1/20/2025,Lalitha Wickramasinghe,Moneragala,Moneragala,Uva,2888,9342,12230,115520,373680,489200
1/21/2025,Lalitha Wickramasinghe,Moneragala,Moneragala,Uva,7742,8155,15897,309680,326200,635880
1/22/2025,Lalitha Wickramasinghe,Moneragala,Moneragala,Uva,2526,9190,11716,101040,367600,468640
1/23/2025,Lalitha Wickramasinghe,Moneragala,Moneragala,Uva,576,6763,7339,23040,270520,293560
1/24/2025,Lalitha Wickramasinghe,Moneragala,Moneragala,Uva,7557,9662,17219,302280,386480,688760
1/25/2025,Lalitha Wickramasinghe,Moneragala,Moneragala,Uva,511,9771,10282,20440,390840,411280
1/26/2025,Lalitha Wickramasinghe,Moneragala,Moneragala,Uva,3702,5794,9496,148080,231760,379840
1/27/2025,Lalitha Wickramasinghe,Moneragala,Moneragala,Uva,9471,9992,19463,378840,399680,778520
1/28/2025,Lalitha Wickramasinghe,Moneragala,Moneragala,Uva,9059,267,9326,362360,10680,373040
1/29/2025,Lalitha Wickramasinghe,Moneragala,Moneragala,Uva,1218,2141,3359,48720,85640,134360
1/30/2025,Lalitha Wickramasinghe,Moneragala,Moneragala,Uva,8617,815,9432,344680,32600,377280
1/31/2025,Lalitha Wickramasinghe,Moneragala,Moneragala,Uva,2718,9771,12489,108720,390840,499560
2/1/2025,Lalitha Wickramasinghe,Moneragala,Moneragala,Uva,6621,8918,15539,264840,356720,621560
2/2/2025,Lalitha Wickramasinghe,Moneragala,Moneragala,Uva,537,1441,1978,21480,57640,79120
2/3/2025,Lalitha Wickramasinghe,Moneragala,Moneragala,Uva,4715,749,5464,188600,29960,218560
2/4/2025,Lalitha Wickramasinghe,Moneragala,Moneragala,Uva,965,1698,2663,38600,67920,106520
2/5/2025,Lalitha Wickramasinghe,Moneragala,Moneragala,Uva,6776,8341,15117,271040,333640,604680
2/6/2025,Lalitha Wickramasinghe,Moneragala,Moneragala,Uva,7590,7870,15460,303600,314800,618400
2/7/2025,Lalitha Wickramasinghe,Moneragala,Moneragala,Uva,6670,2849,9519,266800,113960,380760
2/8/2025,Lalitha Wickramasinghe,Moneragala,Moneragala,Uva,1485,9875,11360,59400,395000,454400
2/9/2025,Lalitha Wickramasinghe,Moneragala,Moneragala,Uva,319,5124,5443,12760,204960,217720
2/10/2025,Lalitha Wickramasinghe,Moneragala,Moneragala,Uva,465,6447,6912,18600,257880,276480
2/11/2025,Lalitha Wickramasinghe,Moneragala,Moneragala,Uva,9453,4929,14382,378120,197160,575280
2/12/2025,Lalitha Wickramasinghe,Moneragala,Moneragala,Uva,5566,9311,14877,222640,372440,595080
2/13/2025,Lalitha Wickramasinghe,Moneragala,Moneragala,Uva,9833,5732,15565,393320,229280,622600
2/14/2025,Lalitha Wickramasinghe,Moneragala,Moneragala,Uva,9217,8816,18033,368680,352640,721320
2/15/2025,Lalitha Wickramasinghe,Moneragala,Moneragala,Uva,4648,8374,13022,185920,334960,520880
2/16/2025,Lalitha Wickramasinghe,Moneragala,Moneragala,Uva,3835,2283,6118,153400,91320,244720
2/17/2025,Lalitha Wickramasinghe,Moneragala,Moneragala,Uva,1013,4184,5197,40520,167360,207880
2/18/2025,Lalitha Wickramasinghe,Moneragala,Moneragala,Uva,7093,9285,16378,283720,371400,655120
2/19/2025,Lalitha Wickramasinghe,Moneragala,Moneragala,Uva,5693,8611,14304,227720,344440,572160
2/20/2025,Lalitha Wickramasinghe,Moneragala,Moneragala,Uva,2160,4895,7055,86400,195800,282200
2/21/2025,Lalitha Wickramasinghe,Moneragala,Moneragala,Uva,97,8706,8803,3880,348240,352120
2/22/2025,Lalitha Wickramasinghe,Moneragala,Moneragala,Uva,6723,7049,13772,268920,281960,550880
2/23/2025,Lalitha Wickramasinghe,Moneragala,Moneragala,Uva,5543,2929,8472,221720,117160,338880
2/24/2025,Lalitha Wickramasinghe,Moneragala,Moneragala,Uva,1946,1862,3808,77840,74480,152320
2/25/2025,Lalitha Wickramasinghe,Moneragala,Moneragala,Uva,1303,3940,5243,52120,157600,209720
2/26/2025,Lalitha Wickramasinghe,Moneragala,Moneragala,Uva,9861,5828,15689,394440,233120,627560
2/27/2025,Lalitha Wickramasinghe,Moneragala,Moneragala,Uva,3054,4888,7942,122160,195520,317680
2/28/2025,Lalitha Wickramasinghe,Moneragala,Moneragala,Uva,160,1865,2025,6400,74600,81000
3/1/2025,Lalitha Wickramasinghe,Moneragala,Moneragala,Uva,5098,978,6076,203920,39120,243040
3/2/2025,Lalitha Wickramasinghe,Moneragala,Moneragala,Uva,3909,1923,5832,156360,76920,233280
3/3/2025,Lalitha Wickramasinghe,Moneragala,Moneragala,Uva,3820,8553,12373,152800,342120,494920
3/4/2025,Lalitha Wickramasinghe,Moneragala,Moneragala,Uva,9873,4211,14084,394920,168440,563360
3/5/2025,Lalitha Wickramasinghe,Moneragala,Moneragala,Uva,3935,8029,11964,157400,321160,478560
3/6/2025,Lalitha Wickramasinghe,Moneragala,Moneragala,Uva,7552,2050,9602,302080,82000,384080
3/7/2025,Lalitha Wickramasinghe,Moneragala,Moneragala,Uva,7816,25,7841,312640,1000,313640
3/8/2025,Lalitha Wickramasinghe,Moneragala,Moneragala,Uva,4280,5743,10023,171200,229720,400920
3/9/2025,Lalitha Wickramasinghe,Moneragala,Moneragala,Uva,8019,7097,15116,320760,283880,604640
3/10/2025,Lalitha Wickramasinghe,Moneragala,Moneragala,Uva,8067,5420,13487,322680,216800,539480
3/11/2025,Lalitha Wickramasinghe,Moneragala,Moneragala,Uva,2555,2024,4579,102200,80960,183160
3/12/2025,Lalitha Wickramasinghe,Moneragala,Moneragala,Uva,4359,6672,11031,174360,266880,441240
3/13/2025,Lalitha Wickramasinghe,Moneragala,Moneragala,Uva,2228,5722,7950,89120,228880,318000
3/14/2025,Lalitha Wickramasinghe,Moneragala,Moneragala,Uva,7921,1619,9540,316840,64760,381600
3/15/2025,Lalitha Wickramasinghe,Moneragala,Moneragala,Uva,5919,7179,13098,236760,287160,523920
3/16/2025,Lalitha Wickramasinghe,Moneragala,Moneragala,Uva,6733,7510,14243,269320,300400,569720
3/17/2025,Lalitha Wickramasinghe,Moneragala,Moneragala,Uva,5095,716,5811,203800,28640,232440
3/18/2025,Lalitha Wickramasinghe,Moneragala,Moneragala,Uva,9525,6451,15976,381000,258040,639040
3/19/2025,Lalitha Wickramasinghe,Moneragala,Moneragala,Uva,6830,3307,10137,273200,132280,405480
3/20/2025,Lalitha Wickramasinghe,Moneragala,Moneragala,Uva,5148,2228,7376,205920,89120,295040
3/21/2025,Lalitha Wickramasinghe,Moneragala,Moneragala,Uva,5558,694,6252,222320,27760,250080
3/22/2025,Lalitha Wickramasinghe,Moneragala,Moneragala,Uva,629,3790,4419,25160,151600,176760
3/23/2025,Lalitha Wickramasinghe,Moneragala,Moneragala,Uva,3164,2913,6077,126560,116520,243080
3/25/2024,Saman Kumara,Nuwara Eliya,Nanu Oya,Central,3003,4511,7514,120120,180440,300560
3/26/2024,Saman Kumara,Nuwara Eliya,Nanu Oya,Central,2676,247,2923,107040,9880,116920
3/27/2024,Saman Kumara,Nuwara Eliya,Nanu Oya,Central,6778,1458,8236,271120,58320,329440
3/28/2024,Saman Kumara,Nuwara Eliya,Nanu Oya,Central,7053,2194,9247,282120,87760,369880
3/29/2024,Saman Kumara,Nuwara Eliya,Nanu Oya,Central,2217,1298,3515,88680,51920,140600
3/30/2024,Saman Kumara,Nuwara Eliya,Nanu Oya,Central,3861,7993,11854,154440,319720,474160
3/31/2024,Saman Kumara,Nuwara Eliya,Nanu Oya,Central,5855,8369,14224,234200,334760,568960
4/1/2024,Saman Kumara,Nuwara Eliya,Nanu Oya,Central,2685,6202,8887,107400,248080,355480
4/2/2024,Saman Kumara,Nuwara Eliya,Nanu Oya,Central,2574,7091,9665,102960,283640,386600
4/3/2024,Saman Kumara,Nuwara Eliya,Nanu Oya,Central,6218,4889,11107,248720,195560,444280
4/4/2024,Saman Kumara,Nuwara Eliya,Nanu Oya,Central,8290,9678,17968,331600,387120,718720
4/5/2024,Saman Kumara,Nuwara Eliya,Nanu Oya,Central,3303,4122,7425,132120,164880,297000
4/6/2024,Saman Kumara,Nuwara Eliya,Nanu Oya,Central,5242,9652,14894,209680,386080,595760
4/7/2024,Saman Kumara,Nuwara Eliya,Nanu Oya,Central,9586,5620,15206,383440,224800,608240
4/8/2024,Saman Kumara,Nuwara Eliya,Nanu Oya,Central,7278,231,7509,291120,9240,300360
4/9/2024,Saman Kumara,Nuwara Eliya,Nanu Oya,Central,2475,9733,12208,99000,389320,488320
4/10/2024,Saman Kumara,Nuwara Eliya,Nanu Oya,Central,9759,4377,14136,390360,175080,565440
4/11/2024,Saman Kumara,Nuwara Eliya,Nanu Oya,Central,8287,9109,17396,331480,364360,695840
4/19/2024,Saman Kumara,Nuwara Eliya,Nanu Oya,Central,7103,6203,13306,284120,248120,532240
4/20/2024,Saman Kumara,Nuwara Eliya,Nanu Oya,Central,6133,9633,15766,245320,385320,630640
4/21/2024,Saman Kumara,Nuwara Eliya,Nanu Oya,Central,7457,1110,8567,298280,44400,342680
4/22/2024,Saman Kumara,Nuwara Eliya,Nanu Oya,Central,6164,7761,13925,246560,310440,557000
4/23/2024,Saman Kumara,Nuwara Eliya,Nanu Oya,Central,1777,4258,6035,71080,170320,241400
4/24/2024,Saman Kumara,Nuwara Eliya,Nanu Oya,Central,4598,2835,7433,183920,113400,297320
4/25/2024,Saman Kumara,Nuwara Eliya,Nanu Oya,Central,1595,5030,6625,63800,201200,265000
4/26/2024,Saman Kumara,Nuwara Eliya,Nanu Oya,Central,44,2076,2120,1760,83040,84800
4/27/2024,Saman Kumara,Nuwara Eliya,Nanu Oya,Central,2625,4913,7538,105000,196520,301520
4/28/2024,Saman Kumara,Nuwara Eliya,Nanu Oya,Central,4367,8957,13324,174680,358280,532960
4/29/2024,Saman Kumara,Nuwara Eliya,Nanu Oya,Central,6790,9039,15829,271600,361560,633160
4/30/2024,Saman Kumara,Nuwara Eliya,Nanu Oya,Central,9828,8227,18055,393120,329080,722200
5/1/2024,Saman Kumara,Nuwara Eliya,Nanu Oya,Central,8229,6833,15062,329160,273320,602480
5/2/2024,Saman Kumara,Nuwara Eliya,Nanu Oya,Central,1588,4064,5652,63520,162560,226080
5/3/2024,Saman Kumara,Nuwara Eliya,Nanu Oya,Central,2406,3947,6353,96240,157880,254120
5/4/2024,Saman Kumara,Nuwara Eliya,Nanu Oya,Central,2319,6890,9209,92760,275600,368360
5/5/2024,Saman Kumara,Nuwara Eliya,Nanu Oya,Central,4459,9652,14111,178360,386080,564440
5/6/2024,Saman Kumara,Nuwara Eliya,Nanu Oya,Central,1084,7472,8556,43360,298880,342240
5/7/2024,Saman Kumara,Nuwara Eliya,Nanu Oya,Central,3391,1977,5368,135640,79080,214720
5/8/2024,Saman Kumara,Nuwara Eliya,Nanu Oya,Central,1745,7466,9211,69800,298640,368440
5/9/2024,Saman Kumara,Nuwara Eliya,Nanu Oya,Central,9852,3386,13238,394080,135440,529520
5/10/2024,Saman Kumara,Nuwara Eliya,Nanu Oya,Central,9580,4368,13948,383200,174720,557920
5/11/2024,Saman Kumara,Nuwara Eliya,Nanu Oya,Central,1692,8242,9934,67680,329680,397360
5/12/2024,Saman Kumara,Nuwara Eliya,Nanu Oya,Central,8018,4047,12065,320720,161880,482600
5/13/2024,Saman Kumara,Nuwara Eliya,Nanu Oya,Central,7347,8806,16153,293880,352240,646120
5/14/2024,Saman Kumara,Nuwara Eliya,Nanu Oya,Central,307,9260,9567,12280,370400,382680
5/15/2024,Saman Kumara,Nuwara Eliya,Nanu Oya,Central,5082,4726,9808,203280,189040,392320
5/16/2024,Saman Kumara,Nuwara Eliya,Nanu Oya,Central,7247,6247,13494,289880,249880,539760
5/17/2024,Saman Kumara,Nuwara Eliya,Nanu Oya,Central,5430,7998,13428,217200,319920,537120
5/18/2024,Saman Kumara,Nuwara Eliya,Nanu Oya,Central,7241,4363,11604,289640,174520,464160
5/19/2024,Saman Kumara,Nuwara Eliya,Nanu Oya,Central,2616,2400,5016,104640,96000,200640
5/20/2024,Saman Kumara,Nuwara Eliya,Nanu Oya,Central,4299,1443,5742,171960,57720,229680
5/21/2024,Saman Kumara,Nuwara Eliya,Nanu Oya,Central,1519,2939,4458,60760,117560,178320
5/22/2024,Saman Kumara,Nuwara Eliya,Nanu Oya,Central,8521,9494,18015,340840,379760,720600
5/24/2024,Saman Kumara,Nuwara Eliya,Nanu Oya,Central,211,7593,7804,8440,303720,312160
5/25/2024,Saman Kumara,Nuwara Eliya,Nanu Oya,Central,3465,8562,12027,138600,342480,481080
5/26/2024,Saman Kumara,Nuwara Eliya,Nanu Oya,Central,886,6607,7493,35440,264280,299720
5/27/2024,Saman Kumara,Nuwara Eliya,Nanu Oya,Central,5438,8946,14384,217520,357840,575360
5/28/2024,Saman Kumara,Nuwara Eliya,Nanu Oya,Central,4584,5895,10479,183360,235800,419160
5/29/2024,Saman Kumara,Nuwara Eliya,Nanu Oya,Central,5105,1893,6998,204200,75720,279920
5/30/2024,Saman Kumara,Nuwara Eliya,Nanu Oya,Central,4252,3754,8006,170080,150160,320240
5/31/2024,Saman Kumara,Nuwara Eliya,Nanu Oya,Central,2457,2828,5285,98280,113120,211400
6/1/2024,Saman Kumara,Nuwara Eliya,Nanu Oya,Central,6392,4285,10677,255680,171400,427080
6/2/2024,Saman Kumara,Nuwara Eliya,Nanu Oya,Central,8208,999,9207,328320,39960,368280
6/3/2024,Saman Kumara,Nuwara Eliya,Nanu Oya,Central,7356,4278,11634,294240,171120,465360
6/4/2024,Saman Kumara,Nuwara Eliya,Nanu Oya,Central,2092,4259,6351,83680,170360,254040
6/5/2024,Saman Kumara,Nuwara Eliya,Nanu Oya,Central,8849,5001,13850,353960,200040,554000
6/6/2024,Saman Kumara,Nuwara Eliya,Nanu Oya,Central,5547,5300,10847,221880,212000,433880
6/7/2024,Saman Kumara,Nuwara Eliya,Nanu Oya,Central,9179,1912,11091,367160,76480,443640
6/8/2024,Saman Kumara,Nuwara Eliya,Nanu Oya,Central,2455,2121,4576,98200,84840,183040
6/9/2024,Saman Kumara,Nuwara Eliya,Nanu Oya,Central,5453,8071,13524,218120,322840,540960
6/10/2024,Saman Kumara,Nuwara Eliya,Nanu Oya,Central,2801,7723,10524,112040,308920,420960
6/11/2024,Saman Kumara,Nuwara Eliya,Nanu Oya,Central,936,5254,6190,37440,210160,247600
6/12/2024,Saman Kumara,Nuwara Eliya,Nanu Oya,Central,1798,491,2289,71920,19640,91560
6/13/2024,Saman Kumara,Nuwara Eliya,Nanu Oya,Central,5465,9047,14512,218600,361880,580480
6/14/2024,Saman Kumara,Nuwara Eliya,Nanu Oya,Central,2567,1042,3609,102680,41680,144360
6/15/2024,Saman Kumara,Nuwara Eliya,Nanu Oya,Central,7404,5142,12546,296160,205680,501840
6/16/2024,Saman Kumara,Nuwara Eliya,Nanu Oya,Central,3714,2934,6648,148560,117360,265920
6/17/2024,Saman Kumara,Nuwara Eliya,Nanu Oya,Central,9678,9610,19288,387120,384400,771520
6/18/2024,Saman Kumara,Nuwara Eliya,Nanu Oya,Central,3338,5990,9328,133520,239600,373120
6/19/2024,Saman Kumara,Nuwara Eliya,Nanu Oya,Central,2653,8839,11492,106120,353560,459680
6/20/2024,Saman Kumara,Nuwara Eliya,Nanu Oya,Central,4761,6333,11094,190440,253320,443760
6/21/2024,Saman Kumara,Nuwara Eliya,Nanu Oya,Central,6567,6379,12946,262680,255160,517840
6/22/2024,Saman Kumara,Nuwara Eliya,Nanu Oya,Central,1038,3204,4242,41520,128160,169680
6/23/2024,Saman Kumara,Nuwara Eliya,Nanu Oya,Central,683,7947,8630,27320,317880,345200
6/24/2024,Saman Kumara,Nuwara Eliya,Nanu Oya,Central,6733,2811,9544,269320,112440,381760
6/25/2024,Saman Kumara,Nuwara Eliya,Nanu Oya,Central,9444,4299,13743,377760,171960,549720
6/26/2024,Saman Kumara,Nuwara Eliya,Nanu Oya,Central,2344,484,2828,93760,19360,113120
6/27/2024,Saman Kumara,Nuwara Eliya,Nanu Oya,Central,4944,5102,10046,197760,204080,401840
6/28/2024,Saman Kumara,Nuwara Eliya,Nanu Oya,Central,1872,449,2321,74880,17960,92840
6/29/2024,Saman Kumara,Nuwara Eliya,Nanu Oya,Central,9551,4200,13751,382040,168000,550040
6/30/2024,Saman Kumara,Nuwara Eliya,Nanu Oya,Central,1556,4266,5822,62240,170640,232880
7/1/2024,Saman Kumara,Nuwara Eliya,Nanu Oya,Central,6724,9131,15855,268960,365240,634200
7/2/2024,Saman Kumara,Nuwara Eliya,Nanu Oya,Central,4137,1136,5273,165480,45440,210920
7/3/2024,Saman Kumara,Nuwara Eliya,Nanu Oya,Central,4515,1731,6246,180600,69240,249840
7/4/2024,Saman Kumara,Nuwara Eliya,Nanu Oya,Central,3149,1622,4771,125960,64880,190840
7/5/2024,Saman Kumara,Nuwara Eliya,Nanu Oya,Central,3348,4472,7820,133920,178880,312800
7/6/2024,Saman Kumara,Nuwara Eliya,Nanu Oya,Central,8498,4152,12650,339920,166080,506000
7/7/2024,Saman Kumara,Nuwara Eliya,Nanu Oya,Central,7867,7065,14932,314680,282600,597280
7/8/2024,Saman Kumara,Nuwara Eliya,Nanu Oya,Central,4096,9265,13361,163840,370600,534440
7/9/2024,Saman Kumara,Nuwara Eliya,Nanu Oya,Central,7427,8763,16190,297080,350520,647600
7/10/2024,Saman Kumara,Nuwara Eliya,Nanu Oya,Central,2279,1867,4146,91160,74680,165840
7/11/2024,Saman Kumara,Nuwara Eliya,Nanu Oya,Central,7517,1772,9289,300680,70880,371560
7/12/2024,Saman Kumara,Nuwara Eliya,Nanu Oya,Central,6136,3993,10129,245440,159720,405160
7/13/2024,Saman Kumara,Nuwara Eliya,Nanu Oya,Central,1449,4133,5582,57960,165320,223280
7/14/2024,Saman Kumara,Nuwara Eliya,Nanu Oya,Central,3985,3566,7551,159400,142640,302040
7/15/2024,Saman Kumara,Nuwara Eliya,Nanu Oya,Central,5890,7196,13086,235600,287840,523440
7/16/2024,Saman Kumara,Nuwara Eliya,Nanu Oya,Central,6503,588,7091,260120,23520,283640
7/17/2024,Saman Kumara,Nuwara Eliya,Nanu Oya,Central,1821,6511,8332,72840,260440,333280
7/18/2024,Saman Kumara,Nuwara Eliya,Nanu Oya,Central,3875,9244,13119,155000,369760,524760
7/19/2024,Saman Kumara,Nuwara Eliya,Nanu Oya,Central,2557,5905,8462,102280,236200,338480
7/20/2024,Saman Kumara,Nuwara Eliya,Nanu Oya,Central,836,6902,7738,33440,276080,309520
7/21/2024,Saman Kumara,Nuwara Eliya,Nanu Oya,Central,9622,1837,11459,384880,73480,458360
7/22/2024,Saman Kumara,Nuwara Eliya,Nanu Oya,Central,5235,9489,14724,209400,379560,588960
7/23/2024,Saman Kumara,Nuwara Eliya,Nanu Oya,Central,2702,4559,7261,108080,182360,290440
7/24/2024,Saman Kumara,Nuwara Eliya,Nanu Oya,Central,5205,3687,8892,208200,147480,355680
7/25/2024,Saman Kumara,Nuwara Eliya,Nanu Oya,Central,5661,2264,7925,226440,90560,317000
7/26/2024,Saman Kumara,Nuwara Eliya,Nanu Oya,Central,8120,4267,12387,324800,170680,495480
7/27/2024,Saman Kumara,Nuwara Eliya,Nanu Oya,Central,5662,8435,14097,226480,337400,563880
7/28/2024,Saman Kumara,Nuwara Eliya,Nanu Oya,Central,4820,1635,6455,192800,65400,258200
7/29/2024,Saman Kumara,Nuwara Eliya,Nanu Oya,Central,1690,3148,4838,67600,125920,193520
7/30/2024,Saman Kumara,Nuwara Eliya,Nanu Oya,Central,3132,4121,7253,125280,164840,290120
7/31/2024,Saman Kumara,Nuwara Eliya,Nanu Oya,Central,3941,1075,5016,157640,43000,200640
8/1/2024,Saman Kumara,Nuwara Eliya,Nanu Oya,Central,9687,5111,14798,387480,204440,591920
8/2/2024,Saman Kumara,Nuwara Eliya,Nanu Oya,Central,7366,6090,13456,294640,243600,538240
8/3/2024,Saman Kumara,Nuwara Eliya,Nanu Oya,Central,3186,3839,7025,127440,153560,281000
8/4/2024,Saman Kumara,Nuwara Eliya,Nanu Oya,Central,3298,9795,13093,131920,391800,523720
8/5/2024,Saman Kumara,Nuwara Eliya,Nanu Oya,Central,5953,7475,13428,238120,299000,537120
8/6/2024,Saman Kumara,Nuwara Eliya,Nanu Oya,Central,1288,8369,9657,51520,334760,386280
8/7/2024,Saman Kumara,Nuwara Eliya,Nanu Oya,Central,9677,2963,12640,387080,118520,505600
8/8/2024,Saman Kumara,Nuwara Eliya,Nanu Oya,Central,3594,363,3957,143760,14520,158280
8/9/2024,Saman Kumara,Nuwara Eliya,Nanu Oya,Central,3338,9094,12432,133520,363760,497280
8/10/2024,Saman Kumara,Nuwara Eliya,Nanu Oya,Central,755,7215,7970,30200,288600,318800
8/11/2024,Saman Kumara,Nuwara Eliya,Nanu Oya,Central,1581,2775,4356,63240,111000,174240
8/12/2024,Saman Kumara,Nuwara Eliya,Nanu Oya,Central,8448,358,8806,337920,14320,352240
8/13/2024,Saman Kumara,Nuwara Eliya,Nanu Oya,Central,2877,7418,10295,115080,296720,411800
8/14/2024,Saman Kumara,Nuwara Eliya,Nanu Oya,Central,3064,3411,6475,122560,136440,259000
8/15/2024,Saman Kumara,Nuwara Eliya,Nanu Oya,Central,5621,6709,12330,224840,268360,493200
8/16/2024,Saman Kumara,Nuwara Eliya,Nanu Oya,Central,2320,4169,6489,92800,166760,259560
8/17/2024,Saman Kumara,Nuwara Eliya,Nanu Oya,Central,8289,121,8410,331560,4840,336400
8/18/2024,Saman Kumara,Nuwara Eliya,Nanu Oya,Central,3512,9319,12831,140480,372760,513240
8/19/2024,Saman Kumara,Nuwara Eliya,Nanu Oya,Central,1280,1480,2760,51200,59200,110400
8/20/2024,Saman Kumara,Nuwara Eliya,Nanu Oya,Central,7138,9922,17060,285520,396880,682400
8/21/2024,Saman Kumara,Nuwara Eliya,Nanu Oya,Central,8058,5255,13313,322320,210200,532520
8/22/2024,Saman Kumara,Nuwara Eliya,Nanu Oya,Central,3070,4977,8047,122800,199080,321880
8/23/2024,Saman Kumara,Nuwara Eliya,Nanu Oya,Central,5337,2251,7588,213480,90040,303520
8/24/2024,Saman Kumara,Nuwara Eliya,Nanu Oya,Central,2628,2289,4917,105120,91560,196680
8/25/2024,Saman Kumara,Nuwara Eliya,Nanu Oya,Central,6498,168,6666,259920,6720,266640
8/26/2024,Saman Kumara,Nuwara Eliya,Nanu Oya,Central,5884,4910,10794,235360,196400,431760
8/27/2024,Saman Kumara,Nuwara Eliya,Nanu Oya,Central,7656,4985,12641,306240,199400,505640
8/28/2024,Saman Kumara,Nuwara Eliya,Nanu Oya,Central,3293,4844,8137,131720,193760,325480
8/29/2024,Saman Kumara,Nuwara Eliya,Nanu Oya,Central,8559,2742,11301,342360,109680,452040
8/30/2024,Saman Kumara,Nuwara Eliya,Nanu Oya,Central,255,9383,9638,10200,375320,385520
8/31/2024,Saman Kumara,Nuwara Eliya,Nanu Oya,Central,3195,6960,10155,127800,278400,406200
9/1/2024,Saman Kumara,Nuwara Eliya,Nanu Oya,Central,4670,590,5260,186800,23600,210400
9/2/2024,Saman Kumara,Nuwara Eliya,Nanu Oya,Central,1764,2699,4463,70560,107960,178520
9/3/2024,Saman Kumara,Nuwara Eliya,Nanu Oya,Central,1062,9796,10858,42480,391840,434320
9/4/2024,Saman Kumara,Nuwara Eliya,Nanu Oya,Central,9551,7345,16896,382040,293800,675840
9/5/2024,Saman Kumara,Nuwara Eliya,Nanu Oya,Central,5209,5267,10476,208360,210680,419040
9/6/2024,Saman Kumara,Nuwara Eliya,Nanu Oya,Central,965,9075,10040,38600,363000,401600
9/7/2024,Saman Kumara,Nuwara Eliya,Nanu Oya,Central,256,9629,9885,10240,385160,395400
9/8/2024,Saman Kumara,Nuwara Eliya,Nanu Oya,Central,3000,8218,11218,120000,328720,448720
9/9/2024,Saman Kumara,Nuwara Eliya,Nanu Oya,Central,5923,7137,13060,236920,285480,522400
9/10/2024,Saman Kumara,Nuwara Eliya,Nanu Oya,Central,4105,486,4591,164200,19440,183640
9/11/2024,Saman Kumara,Nuwara Eliya,Nanu Oya,Central,8053,2429,10482,322120,97160,419280
9/12/2024,Saman Kumara,Nuwara Eliya,Nanu Oya,Central,8166,6972,15138,326640,278880,605520
9/13/2024,Saman Kumara,Nuwara Eliya,Nanu Oya,Central,4934,7125,12059,197360,285000,482360
9/14/2024,Saman Kumara,Nuwara Eliya,Nanu Oya,Central,766,7892,8658,30640,315680,346320
9/15/2024,Saman Kumara,Nuwara Eliya,Nanu Oya,Central,111,1127,1238,4440,45080,49520
9/16/2024,Saman Kumara,Nuwara Eliya,Nanu Oya,Central,5376,2290,7666,215040,91600,306640
9/17/2024,Saman Kumara,Nuwara Eliya,Nanu Oya,Central,9509,2099,11608,380360,83960,464320
9/18/2024,Saman Kumara,Nuwara Eliya,Nanu Oya,Central,9817,9640,19457,392680,385600,778280
9/19/2024,Saman Kumara,Nuwara Eliya,Nanu Oya,Central,7195,3363,10558,287800,134520,422320
9/20/2024,Saman Kumara,Nuwara Eliya,Nanu Oya,Central,5872,9022,14894,234880,360880,595760
9/21/2024,Saman Kumara,Nuwara Eliya,Nanu Oya,Central,2854,96,2950,114160,3840,118000
9/22/2024,Saman Kumara,Nuwara Eliya,Nanu Oya,Central,1696,8235,9931,67840,329400,397240
9/23/2024,Saman Kumara,Nuwara Eliya,Nanu Oya,Central,6054,2308,8362,242160,92320,334480
9/24/2024,Saman Kumara,Nuwara Eliya,Nanu Oya,Central,891,8214,9105,35640,328560,364200
9/25/2024,Saman Kumara,Nuwara Eliya,Nanu Oya,Central,8899,2563,11462,355960,102520,458480
9/26/2024,Saman Kumara,Nuwara Eliya,Nanu Oya,Central,9877,1066,10943,395080,42640,437720
9/27/2024,Saman Kumara,Nuwara Eliya,Nanu Oya,Central,6160,3553,9713,246400,142120,388520
9/28/2024,Saman Kumara,Nuwara Eliya,Nanu Oya,Central,7250,1160,8410,290000,46400,336400
9/29/2024,Saman Kumara,Nuwara Eliya,Nanu Oya,Central,8339,3382,11721,333560,135280,468840
9/30/2024,Saman Kumara,Nuwara Eliya,Nanu Oya,Central,4650,9996,14646,186000,399840,585840
10/1/2024,Saman Kumara,Nuwara Eliya,Nanu Oya,Central,6126,4055,10181,245040,162200,407240
10/2/2024,Saman Kumara,Nuwara Eliya,Nanu Oya,Central,649,1057,1706,25960,42280,68240
10/3/2024,Saman Kumara,Nuwara Eliya,Nanu Oya,Central,5114,1315,6429,204560,52600,257160
10/4/2024,Saman Kumara,Nuwara Eliya,Nanu Oya,Central,3423,6115,9538,136920,244600,381520
10/5/2024,Saman Kumara,Nuwara Eliya,Nanu Oya,Central,9929,5039,14968,397160,201560,598720
10/6/2024,Saman Kumara,Nuwara Eliya,Nanu Oya,Central,9658,1639,11297,386320,65560,451880
10/7/2024,Saman Kumara,Nuwara Eliya,Nanu Oya,Central,3562,7188,10750,142480,287520,430000
10/8/2024,Saman Kumara,Nuwara Eliya,Nanu Oya,Central,1515,8872,10387,60600,354880,415480
10/9/2024,Saman Kumara,Nuwara Eliya,Nanu Oya,Central,982,9875,10857,39280,395000,434280
10/10/2024,Saman Kumara,Nuwara Eliya,Nanu Oya,Central,3731,9494,13225,149240,379760,529000
10/11/2024,Saman Kumara,Nuwara Eliya,Nanu Oya,Central,6102,5428,11530,244080,217120,461200
10/12/2024,Saman Kumara,Nuwara Eliya,Nanu Oya,Central,7275,2135,9410,291000,85400,376400
10/13/2024,Saman Kumara,Nuwara Eliya,Nanu Oya,Central,9623,6057,15680,384920,242280,627200
10/14/2024,Saman Kumara,Nuwara Eliya,Nanu Oya,Central,9377,1613,10990,375080,64520,439600
10/15/2024,Saman Kumara,Nuwara Eliya,Nanu Oya,Central,7768,7679,15447,310720,307160,617880
10/16/2024,Saman Kumara,Nuwara Eliya,Nanu Oya,Central,3862,7475,11337,154480,299000,453480
10/17/2024,Saman Kumara,Nuwara Eliya,Nanu Oya,Central,4100,8120,12220,164000,324800,488800
10/18/2024,Saman Kumara,Nuwara Eliya,Nanu Oya,Central,2695,845,3540,107800,33800,141600
10/19/2024,Saman Kumara,Nuwara Eliya,Nanu Oya,Central,2122,3984,6106,84880,159360,244240
10/20/2024,Saman Kumara,Nuwara Eliya,Nanu Oya,Central,7276,6110,13386,291040,244400,535440
10/21/2024,Saman Kumara,Nuwara Eliya,Nanu Oya,Central,7917,944,8861,316680,37760,354440
10/22/2024,Saman Kumara,Nuwara Eliya,Nanu Oya,Central,7016,5686,12702,280640,227440,508080
10/23/2024,Saman Kumara,Nuwara Eliya,Nanu Oya,Central,165,7859,8024,6600,314360,320960
10/24/2024,Saman Kumara,Nuwara Eliya,Nanu Oya,Central,3812,5154,8966,152480,206160,358640
10/25/2024,Saman Kumara,Nuwara Eliya,Nanu Oya,Central,6051,6343,12394,242040,253720,495760
10/26/2024,Saman Kumara,Nuwara Eliya,Nanu Oya,Central,4742,6053,10795,189680,242120,431800
10/27/2024,Saman Kumara,Nuwara Eliya,Nanu Oya,Central,6825,6106,12931,273000,244240,517240
10/28/2024,Saman Kumara,Nuwara Eliya,Nanu Oya,Central,9944,5550,15494,397760,222000,619760
10/29/2024,Saman Kumara,Nuwara Eliya,Nanu Oya,Central,5136,5782,10918,205440,231280,436720
10/30/2024,Saman Kumara,Nuwara Eliya,Nanu Oya,Central,6013,2083,8096,240520,83320,323840
10/31/2024,Saman Kumara,Nuwara Eliya,Nanu Oya,Central,4886,8044,12930,195440,321760,517200
11/1/2024,Saman Kumara,Nuwara Eliya,Nanu Oya,Central,9281,8333,17614,371240,333320,704560
11/2/2024,Saman Kumara,Nuwara Eliya,Nanu Oya,Central,1571,6867,8438,62840,274680,337520
11/3/2024,Saman Kumara,Nuwara Eliya,Nanu Oya,Central,2814,5574,8388,112560,222960,335520
11/4/2024,Saman Kumara,Nuwara Eliya,Nanu Oya,Central,5170,4728,9898,206800,189120,395920
11/5/2024,Saman Kumara,Nuwara Eliya,Nanu Oya,Central,4162,8049,12211,166480,321960,488440
11/6/2024,Saman Kumara,Nuwara Eliya,Nanu Oya,Central,1331,1648,2979,53240,65920,119160
11/7/2024,Saman Kumara,Nuwara Eliya,Nanu Oya,Central,3760,3042,6802,150400,121680,272080
11/8/2024,Saman Kumara,Nuwara Eliya,Nanu Oya,Central,2557,2309,4866,102280,92360,194640
11/9/2024,Saman Kumara,Nuwara Eliya,Nanu Oya,Central,7475,7366,14841,299000,294640,593640
11/10/2024,Saman Kumara,Nuwara Eliya,Nanu Oya,Central,3418,4278,7696,136720,171120,307840
11/11/2024,Saman Kumara,Nuwara Eliya,Nanu Oya,Central,151,467,618,6040,18680,24720
11/12/2024,Saman Kumara,Nuwara Eliya,Nanu Oya,Central,2905,3008,5913,116200,120320,236520
11/13/2024,Saman Kumara,Nuwara Eliya,Nanu Oya,Central,5507,7651,13158,220280,306040,526320
11/14/2024,Saman Kumara,Nuwara Eliya,Nanu Oya,Central,5211,8652,13863,208440,346080,554520
11/15/2024,Saman Kumara,Nuwara Eliya,Nanu Oya,Central,7090,7099,14189,283600,283960,567560
11/16/2024,Saman Kumara,Nuwara Eliya,Nanu Oya,Central,5562,7825,13387,222480,313000,535480
11/17/2024,Saman Kumara,Nuwara Eliya,Nanu Oya,Central,2310,1992,4302,92400,79680,172080
11/18/2024,Saman Kumara,Nuwara Eliya,Nanu Oya,Central,2878,3929,6807,115120,157160,272280
11/19/2024,Saman Kumara,Nuwara Eliya,Nanu Oya,Central,6971,8989,15960,278840,359560,638400
11/20/2024,Saman Kumara,Nuwara Eliya,Nanu Oya,Central,8929,4303,13232,357160,172120,529280
11/21/2024,Saman Kumara,Nuwara Eliya,Nanu Oya,Central,7996,1037,9033,319840,41480,361320
11/22/2024,Saman Kumara,Nuwara Eliya,Nanu Oya,Central,1232,6543,7775,49280,261720,311000
11/23/2024,Saman Kumara,Nuwara Eliya,Nanu Oya,Central,9543,7760,17303,381720,310400,692120
11/24/2024,Saman Kumara,Nuwara Eliya,Nanu Oya,Central,9212,3573,12785,368480,142920,511400
11/25/2024,Saman Kumara,Nuwara Eliya,Nanu Oya,Central,5186,114,5300,207440,4560,212000
11/26/2024,Saman Kumara,Nuwara Eliya,Nanu Oya,Central,7413,5824,13237,296520,232960,529480
11/27/2024,Saman Kumara,Nuwara Eliya,Nanu Oya,Central,830,8246,9076,33200,329840,363040
11/28/2024,Saman Kumara,Nuwara Eliya,Nanu Oya,Central,6479,8569,15048,259160,342760,601920
11/29/2024,Saman Kumara,Nuwara Eliya,Nanu Oya,Central,2473,3061,5534,98920,122440,221360
11/30/2024,Saman Kumara,Nuwara Eliya,Nanu Oya,Central,832,1070,1902,33280,42800,76080
12/1/2024,Saman Kumara,Nuwara Eliya,Nanu Oya,Central,4354,2885,7239,174160,115400,289560
12/2/2024,Saman Kumara,Nuwara Eliya,Nanu Oya,Central,4010,9857,13867,160400,394280,554680
12/3/2024,Saman Kumara,Nuwara Eliya,Nanu Oya,Central,6529,6005,12534,261160,240200,501360
12/4/2024,Saman Kumara,Nuwara Eliya,Nanu Oya,Central,4771,4498,9269,190840,179920,370760
12/5/2024,Saman Kumara,Nuwara Eliya,Nanu Oya,Central,42,1561,1603,1680,62440,64120
12/6/2024,Saman Kumara,Nuwara Eliya,Nanu Oya,Central,9485,8131,17616,379400,325240,704640
12/7/2024,Saman Kumara,Nuwara Eliya,Nanu Oya,Central,4126,37,4163,165040,1480,166520
12/8/2024,Saman Kumara,Nuwara Eliya,Nanu Oya,Central,2622,7224,9846,104880,288960,393840
12/9/2024,Saman Kumara,Nuwara Eliya,Nanu Oya,Central,2556,7439,9995,102240,297560,399800
12/10/2024,Saman Kumara,Nuwara Eliya,Nanu Oya,Central,1470,5082,6552,58800,203280,262080
12/11/2024,Saman Kumara,Nuwara Eliya,Nanu Oya,Central,3137,1463,4600,125480,58520,184000
12/12/2024,Saman Kumara,Nuwara Eliya,Nanu Oya,Central,3321,4514,7835,132840,180560,313400
12/13/2024,Saman Kumara,Nuwara Eliya,Nanu Oya,Central,9136,9887,19023,365440,395480,760920
12/14/2024,Saman Kumara,Nuwara Eliya,Nanu Oya,Central,2540,4284,6824,101600,171360,272960
12/15/2024,Saman Kumara,Nuwara Eliya,Nanu Oya,Central,6182,4166,10348,247280,166640,413920
12/16/2024,Saman Kumara,Nuwara Eliya,Nanu Oya,Central,4839,9232,14071,193560,369280,562840
12/17/2024,Saman Kumara,Nuwara Eliya,Nanu Oya,Central,7857,9330,17187,314280,373200,687480
12/18/2024,Saman Kumara,Nuwara Eliya,Nanu Oya,Central,333,1797,2130,13320,71880,85200
12/19/2024,Saman Kumara,Nuwara Eliya,Nanu Oya,Central,5990,5687,11677,239600,227480,467080
12/20/2024,Saman Kumara,Nuwara Eliya,Nanu Oya,Central,5757,3511,9268,230280,140440,370720
12/21/2024,Saman Kumara,Nuwara Eliya,Nanu Oya,Central,8455,5308,13763,338200,212320,550520
12/22/2024,Saman Kumara,Nuwara Eliya,Nanu Oya,Central,8979,9443,18422,359160,377720,736880
12/23/2024,Saman Kumara,Nuwara Eliya,Nanu Oya,Central,3155,6131,9286,126200,245240,371440
12/24/2024,Saman Kumara,Nuwara Eliya,Nanu Oya,Central,3739,6410,10149,149560,256400,405960
12/25/2024,Saman Kumara,Nuwara Eliya,Nanu Oya,Central,2434,7687,10121,97360,307480,404840
12/26/2024,Saman Kumara,Nuwara Eliya,Nanu Oya,Central,4325,7652,11977,173000,306080,479080
12/27/2024,Saman Kumara,Nuwara Eliya,Nanu Oya,Central,17,4352,4369,680,174080,174760
12/28/2024,Saman Kumara,Nuwara Eliya,Nanu Oya,Central,3030,7466,10496,121200,298640,419840
12/29/2024,Saman Kumara,Nuwara Eliya,Nanu Oya,Central,6700,1502,8202,268000,60080,328080
12/30/2024,Saman Kumara,Nuwara Eliya,Nanu Oya,Central,5567,3107,8674,222680,124280,346960
12/31/2024,Saman Kumara,Nuwara Eliya,Nanu Oya,Central,6186,5931,12117,247440,237240,484680
1/1/2025,Saman Kumara,Nuwara Eliya,Nanu Oya,Central,2409,7745,10154,96360,309800,406160
1/2/2025,Saman Kumara,Nuwara Eliya,Nanu Oya,Central,5133,4121,9254,205320,164840,370160
1/3/2025,Saman Kumara,Nuwara Eliya,Nanu Oya,Central,4986,5976,10962,199440,239040,438480
1/4/2025,Saman Kumara,Nuwara Eliya,Nanu Oya,Central,6836,3788,10624,273440,151520,424960
1/5/2025,Saman Kumara,Nuwara Eliya,Nanu Oya,Central,5451,598,6049,218040,23920,241960
1/6/2025,Saman Kumara,Nuwara Eliya,Nanu Oya,Central,6468,6082,12550,258720,243280,502000
1/7/2025,Saman Kumara,Nuwara Eliya,Nanu Oya,Central,5296,3196,8492,211840,127840,339680
1/8/2025,Saman Kumara,Nuwara Eliya,Nanu Oya,Central,8894,3254,12148,355760,130160,485920
1/9/2025,Saman Kumara,Nuwara Eliya,Nanu Oya,Central,1928,8633,10561,77120,345320,422440
1/10/2025,Saman Kumara,Nuwara Eliya,Nanu Oya,Central,1953,1462,3415,78120,58480,136600
1/11/2025,Saman Kumara,Nuwara Eliya,Nanu Oya,Central,2721,6702,9423,108840,268080,376920
1/12/2025,Saman Kumara,Nuwara Eliya,Nanu Oya,Central,9093,4736,13829,363720,189440,553160
1/13/2025,Saman Kumara,Nuwara Eliya,Nanu Oya,Central,2911,225,3136,116440,9000,125440
1/14/2025,Saman Kumara,Nuwara Eliya,Nanu Oya,Central,1003,2257,3260,40120,90280,130400
1/15/2025,Saman Kumara,Nuwara Eliya,Nanu Oya,Central,8747,939,9686,349880,37560,387440
1/16/2025,Saman Kumara,Nuwara Eliya,Nanu Oya,Central,8519,6206,14725,340760,248240,589000
1/17/2025,Saman Kumara,Nuwara Eliya,Nanu Oya,Central,8262,8468,16730,330480,338720,669200
1/18/2025,Saman Kumara,Nuwara Eliya,Nanu Oya,Central,4214,1864,6078,168560,74560,243120
1/19/2025,Saman Kumara,Nuwara Eliya,Nanu Oya,Central,2852,8914,11766,114080,356560,470640
1/20/2025,Saman Kumara,Nuwara Eliya,Nanu Oya,Central,1554,1420,2974,62160,56800,118960
1/21/2025,Saman Kumara,Nuwara Eliya,Nanu Oya,Central,2112,8949,11061,84480,357960,442440
1/22/2025,Saman Kumara,Nuwara Eliya,Nanu Oya,Central,9183,7449,16632,367320,297960,665280
1/23/2025,Saman Kumara,Nuwara Eliya,Nanu Oya,Central,2655,5414,8069,106200,216560,322760
1/24/2025,Saman Kumara,Nuwara Eliya,Nanu Oya,Central,8409,8430,16839,336360,337200,673560
1/25/2025,Saman Kumara,Nuwara Eliya,Nanu Oya,Central,6207,5635,11842,248280,225400,473680
1/26/2025,Saman Kumara,Nuwara Eliya,Nanu Oya,Central,6937,6960,13897,277480,278400,555880
1/27/2025,Saman Kumara,Nuwara Eliya,Nanu Oya,Central,453,3798,4251,18120,151920,170040
1/28/2025,Saman Kumara,Nuwara Eliya,Nanu Oya,Central,2318,8095,10413,92720,323800,416520
1/29/2025,Saman Kumara,Nuwara Eliya,Nanu Oya,Central,5310,1530,6840,212400,61200,273600
1/30/2025,Saman Kumara,Nuwara Eliya,Nanu Oya,Central,3033,2868,5901,121320,114720,236040
1/31/2025,Saman Kumara,Nuwara Eliya,Nanu Oya,Central,6036,1916,7952,241440,76640,318080
2/1/2025,Saman Kumara,Nuwara Eliya,Nanu Oya,Central,6510,5115,11625,260400,204600,465000
2/2/2025,Saman Kumara,Nuwara Eliya,Nanu Oya,Central,1461,9895,11356,58440,395800,454240
2/3/2025,Saman Kumara,Nuwara Eliya,Nanu Oya,Central,8717,8140,16857,348680,325600,674280
2/4/2025,Saman Kumara,Nuwara Eliya,Nanu Oya,Central,5776,9949,15725,231040,397960,629000
2/5/2025,Saman Kumara,Nuwara Eliya,Nanu Oya,Central,1952,9307,11259,78080,372280,450360
2/6/2025,Saman Kumara,Nuwara Eliya,Nanu Oya,Central,9559,1725,11284,382360,69000,451360
2/7/2025,Saman Kumara,Nuwara Eliya,Nanu Oya,Central,8055,1439,9494,322200,57560,379760
2/8/2025,Saman Kumara,Nuwara Eliya,Nanu Oya,Central,4859,7183,12042,194360,287320,481680
2/9/2025,Saman Kumara,Nuwara Eliya,Nanu Oya,Central,430,3736,4166,17200,149440,166640
2/10/2025,Saman Kumara,Nuwara Eliya,Nanu Oya,Central,1213,794,2007,48520,31760,80280
2/11/2025,Saman Kumara,Nuwara Eliya,Nanu Oya,Central,3886,1899,5785,155440,75960,231400
2/12/2025,Saman Kumara,Nuwara Eliya,Nanu Oya,Central,4732,1530,6262,189280,61200,250480
2/13/2025,Saman Kumara,Nuwara Eliya,Nanu Oya,Central,297,1781,2078,11880,71240,83120
2/14/2025,Saman Kumara,Nuwara Eliya,Nanu Oya,Central,9737,5713,15450,389480,228520,618000
2/15/2025,Saman Kumara,Nuwara Eliya,Nanu Oya,Central,3991,2196,6187,159640,87840,247480
2/16/2025,Saman Kumara,Nuwara Eliya,Nanu Oya,Central,5323,5932,11255,212920,237280,450200
2/17/2025,Saman Kumara,Nuwara Eliya,Nanu Oya,Central,2754,2484,5238,110160,99360,209520
2/18/2025,Saman Kumara,Nuwara Eliya,Nanu Oya,Central,3169,9356,12525,126760,374240,501000
2/19/2025,Saman Kumara,Nuwara Eliya,Nanu Oya,Central,2496,6309,8805,99840,252360,352200
2/20/2025,Saman Kumara,Nuwara Eliya,Nanu Oya,Central,2465,9088,11553,98600,363520,462120
2/21/2025,Saman Kumara,Nuwara Eliya,Nanu Oya,Central,9276,7554,16830,371040,302160,673200
2/22/2025,Saman Kumara,Nuwara Eliya,Nanu Oya,Central,1816,8968,10784,72640,358720,431360
2/23/2025,Saman Kumara,Nuwara Eliya,Nanu Oya,Central,6325,5660,11985,253000,226400,479400
2/24/2025,Saman Kumara,Nuwara Eliya,Nanu Oya,Central,3000,2819,5819,120000,112760,232760
2/25/2025,Saman Kumara,Nuwara Eliya,Nanu Oya,Central,5364,1074,6438,214560,42960,257520
2/26/2025,Saman Kumara,Nuwara Eliya,Nanu Oya,Central,5411,4574,9985,216440,182960,399400
2/27/2025,Saman Kumara,Nuwara Eliya,Nanu Oya,Central,727,803,1530,29080,32120,61200
2/28/2025,Saman Kumara,Nuwara Eliya,Nanu Oya,Central,9056,9423,18479,362240,376920,739160
3/1/2025,Saman Kumara,Nuwara Eliya,Nanu Oya,Central,7858,9281,17139,314320,371240,685560
3/2/2025,Saman Kumara,Nuwara Eliya,Nanu Oya,Central,709,1708,2417,28360,68320,96680
3/3/2025,Saman Kumara,Nuwara Eliya,Nanu Oya,Central,4659,2438,7097,186360,97520,283880
3/4/2025,Saman Kumara,Nuwara Eliya,Nanu Oya,Central,1187,9062,10249,47480,362480,409960
3/5/2025,Saman Kumara,Nuwara Eliya,Nanu Oya,Central,5399,186,5585,215960,7440,223400
3/6/2025,Saman Kumara,Nuwara Eliya,Nanu Oya,Central,7251,8010,15261,290040,320400,610440
3/7/2025,Saman Kumara,Nuwara Eliya,Nanu Oya,Central,3767,3917,7684,150680,156680,307360
3/8/2025,Saman Kumara,Nuwara Eliya,Nanu Oya,Central,1409,2282,3691,56360,91280,147640
3/9/2025,Saman Kumara,Nuwara Eliya,Nanu Oya,Central,3070,7603,10673,122800,304120,426920
3/10/2025,Saman Kumara,Nuwara Eliya,Nanu Oya,Central,6688,4533,11221,267520,181320,448840
3/11/2025,Saman Kumara,Nuwara Eliya,Nanu Oya,Central,6493,1607,8100,259720,64280,324000
3/12/2025,Saman Kumara,Nuwara Eliya,Nanu Oya,Central,7393,1462,8855,295720,58480,354200
3/13/2025,Saman Kumara,Nuwara Eliya,Nanu Oya,Central,5545,721,6266,221800,28840,250640
3/14/2025,Saman Kumara,Nuwara Eliya,Nanu Oya,Central,8544,3928,12472,341760,157120,498880
3/15/2025,Saman Kumara,Nuwara Eliya,Nanu Oya,Central,9058,9773,18831,362320,390920,753240
3/16/2025,Saman Kumara,Nuwara Eliya,Nanu Oya,Central,2688,4545,7233,107520,181800,289320
3/17/2025,Saman Kumara,Nuwara Eliya,Nanu Oya,Central,8385,5545,13930,335400,221800,557200
3/18/2025,Saman Kumara,Nuwara Eliya,Nanu Oya,Central,8970,1230,10200,358800,49200,408000
3/19/2025,Saman Kumara,Nuwara Eliya,Nanu Oya,Central,6452,8551,15003,258080,342040,600120
3/20/2025,Saman Kumara,Nuwara Eliya,Nanu Oya,Central,5986,8048,14034,239440,321920,561360
3/21/2025,Saman Kumara,Nuwara Eliya,Nanu Oya,Central,6068,552,6620,242720,22080,264800
3/22/2025,Saman Kumara,Nuwara Eliya,Nanu Oya,Central,5361,9486,14847,214440,379440,593880
3/23/2025,Saman Kumara,Nuwara Eliya,Nanu Oya,Central,7218,8734,15952,288720,349360,638080
3/25/2024,Dilani Fernando,Moneragala,Wellawaya,Uva,585,5236,5821,23400,209440,232840
3/26/2024,Dilani Fernando,Moneragala,Wellawaya,Uva,7928,8077,16005,317120,323080,640200
3/27/2024,Dilani Fernando,Moneragala,Wellawaya,Uva,1356,1855,3211,54240,74200,128440
3/28/2024,Dilani Fernando,Moneragala,Wellawaya,Uva,1219,5490,6709,48760,219600,268360
3/29/2024,Dilani Fernando,Moneragala,Wellawaya,Uva,8568,8654,17222,342720,346160,688880
3/30/2024,Dilani Fernando,Moneragala,Wellawaya,Uva,2800,4565,7365,112000,182600,294600
3/31/2024,Dilani Fernando,Moneragala,Wellawaya,Uva,4851,5830,10681,194040,233200,427240
4/1/2024,Dilani Fernando,Moneragala,Wellawaya,Uva,9039,125,9164,361560,5000,366560
4/2/2024,Dilani Fernando,Moneragala,Wellawaya,Uva,5664,3380,9044,226560,135200,361760
4/3/2024,Dilani Fernando,Moneragala,Wellawaya,Uva,6330,3,6333,253200,120,253320
4/4/2024,Dilani Fernando,Moneragala,Wellawaya,Uva,8965,2584,11549,358600,103360,461960
4/5/2024,Dilani Fernando,Moneragala,Wellawaya,Uva,2024,5573,7597,80960,222920,303880
4/6/2024,Dilani Fernando,Moneragala,Wellawaya,Uva,6774,4777,11551,270960,191080,462040
4/7/2024,Dilani Fernando,Moneragala,Wellawaya,Uva,6109,5570,11679,244360,222800,467160
4/8/2024,Dilani Fernando,Moneragala,Wellawaya,Uva,690,9495,10185,27600,379800,407400
4/9/2024,Dilani Fernando,Moneragala,Wellawaya,Uva,4213,7685,11898,168520,307400,475920
4/10/2024,Dilani Fernando,Moneragala,Wellawaya,Uva,8490,3034,11524,339600,121360,460960
4/11/2024,Dilani Fernando,Moneragala,Wellawaya,Uva,5967,7382,13349,238680,295280,533960
4/19/2024,Dilani Fernando,Moneragala,Wellawaya,Uva,2826,199,3025,113040,7960,121000
4/20/2024,Dilani Fernando,Moneragala,Wellawaya,Uva,9300,5285,14585,372000,211400,583400
4/21/2024,Dilani Fernando,Moneragala,Wellawaya,Uva,4625,5713,10338,185000,228520,413520
4/22/2024,Dilani Fernando,Moneragala,Wellawaya,Uva,5598,1731,7329,223920,69240,293160
4/23/2024,Dilani Fernando,Moneragala,Wellawaya,Uva,7189,1042,8231,287560,41680,329240
4/24/2024,Dilani Fernando,Moneragala,Wellawaya,Uva,7472,7430,14902,298880,297200,596080
4/25/2024,Dilani Fernando,Moneragala,Wellawaya,Uva,3002,6570,9572,120080,262800,382880
4/26/2024,Dilani Fernando,Moneragala,Wellawaya,Uva,584,4177,4761,23360,167080,190440
4/27/2024,Dilani Fernando,Moneragala,Wellawaya,Uva,7718,1719,9437,308720,68760,377480
4/28/2024,Dilani Fernando,Moneragala,Wellawaya,Uva,2701,5979,8680,108040,239160,347200
4/29/2024,Dilani Fernando,Moneragala,Wellawaya,Uva,2457,1529,3986,98280,61160,159440
4/30/2024,Dilani Fernando,Moneragala,Wellawaya,Uva,8973,7655,16628,358920,306200,665120
5/1/2024,Dilani Fernando,Moneragala,Wellawaya,Uva,1238,5115,6353,49520,204600,254120
5/2/2024,Dilani Fernando,Moneragala,Wellawaya,Uva,8061,3132,11193,322440,125280,447720
5/3/2024,Dilani Fernando,Moneragala,Wellawaya,Uva,9186,928,10114,367440,37120,404560
5/4/2024,Dilani Fernando,Moneragala,Wellawaya,Uva,4620,5214,9834,184800,208560,393360
5/5/2024,Dilani Fernando,Moneragala,Wellawaya,Uva,7568,3171,10739,302720,126840,429560
5/6/2024,Dilani Fernando,Moneragala,Wellawaya,Uva,9875,585,10460,395000,23400,418400
5/7/2024,Dilani Fernando,Moneragala,Wellawaya,Uva,8661,4333,12994,346440,173320,519760
5/8/2024,Dilani Fernando,Moneragala,Wellawaya,Uva,5552,278,5830,222080,11120,233200
5/9/2024,Dilani Fernando,Moneragala,Wellawaya,Uva,485,9322,9807,19400,372880,392280
5/10/2024,Dilani Fernando,Moneragala,Wellawaya,Uva,125,8327,8452,5000,333080,338080
5/11/2024,Dilani Fernando,Moneragala,Wellawaya,Uva,6306,9590,15896,252240,383600,635840
5/12/2024,Dilani Fernando,Moneragala,Wellawaya,Uva,9772,393,10165,390880,15720,406600
5/13/2024,Dilani Fernando,Moneragala,Wellawaya,Uva,9663,2827,12490,386520,113080,499600
5/14/2024,Dilani Fernando,Moneragala,Wellawaya,Uva,1335,2381,3716,53400,95240,148640
5/15/2024,Dilani Fernando,Moneragala,Wellawaya,Uva,5815,9278,15093,232600,371120,603720
5/16/2024,Dilani Fernando,Moneragala,Wellawaya,Uva,1666,9061,10727,66640,362440,429080
5/17/2024,Dilani Fernando,Moneragala,Wellawaya,Uva,963,29,992,38520,1160,39680
5/18/2024,Dilani Fernando,Moneragala,Wellawaya,Uva,9888,9925,19813,395520,397000,792520
5/19/2024,Dilani Fernando,Moneragala,Wellawaya,Uva,3842,5999,9841,153680,239960,393640
5/20/2024,Dilani Fernando,Moneragala,Wellawaya,Uva,4107,3581,7688,164280,143240,307520
5/21/2024,Dilani Fernando,Moneragala,Wellawaya,Uva,1813,7645,9458,72520,305800,378320
5/22/2024,Dilani Fernando,Moneragala,Wellawaya,Uva,4572,9077,13649,182880,363080,545960
5/24/2024,Dilani Fernando,Moneragala,Wellawaya,Uva,6636,4133,10769,265440,165320,430760
5/25/2024,Dilani Fernando,Moneragala,Wellawaya,Uva,7022,9013,16035,280880,360520,641400
5/26/2024,Dilani Fernando,Moneragala,Wellawaya,Uva,1,4166,4167,40,166640,166680
5/27/2024,Dilani Fernando,Moneragala,Wellawaya,Uva,7400,7836,15236,296000,313440,609440
5/28/2024,Dilani Fernando,Moneragala,Wellawaya,Uva,9507,2966,12473,380280,118640,498920
5/29/2024,Dilani Fernando,Moneragala,Wellawaya,Uva,9095,2610,11705,363800,104400,468200
5/30/2024,Dilani Fernando,Moneragala,Wellawaya,Uva,8734,7052,15786,349360,282080,631440
5/31/2024,Dilani Fernando,Moneragala,Wellawaya,Uva,6514,8131,14645,260560,325240,585800
6/1/2024,Dilani Fernando,Moneragala,Wellawaya,Uva,9477,9521,18998,379080,380840,759920
6/2/2024,Dilani Fernando,Moneragala,Wellawaya,Uva,688,6460,7148,27520,258400,285920
6/3/2024,Dilani Fernando,Moneragala,Wellawaya,Uva,4623,8858,13481,184920,354320,539240
6/4/2024,Dilani Fernando,Moneragala,Wellawaya,Uva,4719,9502,14221,188760,380080,568840
6/5/2024,Dilani Fernando,Moneragala,Wellawaya,Uva,3703,843,4546,148120,33720,181840
6/6/2024,Dilani Fernando,Moneragala,Wellawaya,Uva,8535,367,8902,341400,14680,356080
6/7/2024,Dilani Fernando,Moneragala,Wellawaya,Uva,5895,6587,12482,235800,263480,499280
6/8/2024,Dilani Fernando,Moneragala,Wellawaya,Uva,2537,8196,10733,101480,327840,429320
6/9/2024,Dilani Fernando,Moneragala,Wellawaya,Uva,5075,2504,7579,203000,100160,303160
6/10/2024,Dilani Fernando,Moneragala,Wellawaya,Uva,9999,6048,16047,399960,241920,641880
6/11/2024,Dilani Fernando,Moneragala,Wellawaya,Uva,9130,3529,12659,365200,141160,506360
6/12/2024,Dilani Fernando,Moneragala,Wellawaya,Uva,5204,3279,8483,208160,131160,339320
6/13/2024,Dilani Fernando,Moneragala,Wellawaya,Uva,5523,2005,7528,220920,80200,301120
6/14/2024,Dilani Fernando,Moneragala,Wellawaya,Uva,6514,1368,7882,260560,54720,315280
6/15/2024,Dilani Fernando,Moneragala,Wellawaya,Uva,7177,1466,8643,287080,58640,345720
6/16/2024,Dilani Fernando,Moneragala,Wellawaya,Uva,7030,5738,12768,281200,229520,510720
6/17/2024,Dilani Fernando,Moneragala,Wellawaya,Uva,3861,8626,12487,154440,345040,499480
6/18/2024,Dilani Fernando,Moneragala,Wellawaya,Uva,1846,6941,8787,73840,277640,351480
6/19/2024,Dilani Fernando,Moneragala,Wellawaya,Uva,1754,6925,8679,70160,277000,347160
6/20/2024,Dilani Fernando,Moneragala,Wellawaya,Uva,4240,8869,13109,169600,354760,524360
6/21/2024,Dilani Fernando,Moneragala,Wellawaya,Uva,9294,6617,15911,371760,264680,636440
6/22/2024,Dilani Fernando,Moneragala,Wellawaya,Uva,3503,3747,7250,140120,149880,290000
6/23/2024,Dilani Fernando,Moneragala,Wellawaya,Uva,3442,742,4184,137680,29680,167360
6/24/2024,Dilani Fernando,Moneragala,Wellawaya,Uva,6774,6428,13202,270960,257120,528080
6/25/2024,Dilani Fernando,Moneragala,Wellawaya,Uva,5406,2749,8155,216240,109960,326200
6/26/2024,Dilani Fernando,Moneragala,Wellawaya,Uva,4779,6537,11316,191160,261480,452640
6/27/2024,Dilani Fernando,Moneragala,Wellawaya,Uva,2165,7038,9203,86600,281520,368120
6/28/2024,Dilani Fernando,Moneragala,Wellawaya,Uva,448,2489,2937,17920,99560,117480
6/29/2024,Dilani Fernando,Moneragala,Wellawaya,Uva,3188,4638,7826,127520,185520,313040
6/30/2024,Dilani Fernando,Moneragala,Wellawaya,Uva,1446,5608,7054,57840,224320,282160
7/1/2024,Dilani Fernando,Moneragala,Wellawaya,Uva,8258,2600,10858,330320,104000,434320
7/2/2024,Dilani Fernando,Moneragala,Wellawaya,Uva,1599,1961,3560,63960,78440,142400
7/3/2024,Dilani Fernando,Moneragala,Wellawaya,Uva,8695,7013,15708,347800,280520,628320
7/4/2024,Dilani Fernando,Moneragala,Wellawaya,Uva,2716,3223,5939,108640,128920,237560
7/5/2024,Dilani Fernando,Moneragala,Wellawaya,Uva,123,7642,7765,4920,305680,310600
7/6/2024,Dilani Fernando,Moneragala,Wellawaya,Uva,7265,5248,12513,290600,209920,500520
7/7/2024,Dilani Fernando,Moneragala,Wellawaya,Uva,2605,1003,3608,104200,40120,144320
7/8/2024,Dilani Fernando,Moneragala,Wellawaya,Uva,5334,7743,13077,213360,309720,523080
7/9/2024,Dilani Fernando,Moneragala,Wellawaya,Uva,6631,6109,12740,265240,244360,509600
7/10/2024,Dilani Fernando,Moneragala,Wellawaya,Uva,1954,3033,4987,78160,121320,199480
7/11/2024,Dilani Fernando,Moneragala,Wellawaya,Uva,6395,6430,12825,255800,257200,513000
7/12/2024,Dilani Fernando,Moneragala,Wellawaya,Uva,9139,2890,12029,365560,115600,481160
7/13/2024,Dilani Fernando,Moneragala,Wellawaya,Uva,208,7095,7303,8320,283800,292120
7/14/2024,Dilani Fernando,Moneragala,Wellawaya,Uva,1145,3836,4981,45800,153440,199240
7/15/2024,Dilani Fernando,Moneragala,Wellawaya,Uva,6262,892,7154,250480,35680,286160
7/16/2024,Dilani Fernando,Moneragala,Wellawaya,Uva,6518,7047,13565,260720,281880,542600
7/17/2024,Dilani Fernando,Moneragala,Wellawaya,Uva,8460,7651,16111,338400,306040,644440
7/18/2024,Dilani Fernando,Moneragala,Wellawaya,Uva,865,4477,5342,34600,179080,213680
7/19/2024,Dilani Fernando,Moneragala,Wellawaya,Uva,5445,9555,15000,217800,382200,600000
7/20/2024,Dilani Fernando,Moneragala,Wellawaya,Uva,1773,195,1968,70920,7800,78720
7/21/2024,Dilani Fernando,Moneragala,Wellawaya,Uva,591,2439,3030,23640,97560,121200
7/22/2024,Dilani Fernando,Moneragala,Wellawaya,Uva,9192,5453,14645,367680,218120,585800
7/23/2024,Dilani Fernando,Moneragala,Wellawaya,Uva,9227,7310,16537,369080,292400,661480
7/24/2024,Dilani Fernando,Moneragala,Wellawaya,Uva,4463,4038,8501,178520,161520,340040
7/25/2024,Dilani Fernando,Moneragala,Wellawaya,Uva,5073,9060,14133,202920,362400,565320
7/26/2024,Dilani Fernando,Moneragala,Wellawaya,Uva,7656,9009,16665,306240,360360,666600
7/27/2024,Dilani Fernando,Moneragala,Wellawaya,Uva,7077,8957,16034,283080,358280,641360
7/28/2024,Dilani Fernando,Moneragala,Wellawaya,Uva,9827,7803,17630,393080,312120,705200
7/29/2024,Dilani Fernando,Moneragala,Wellawaya,Uva,6753,9664,16417,270120,386560,656680
7/30/2024,Dilani Fernando,Moneragala,Wellawaya,Uva,1536,6622,8158,61440,264880,326320
7/31/2024,Dilani Fernando,Moneragala,Wellawaya,Uva,111,7367,7478,4440,294680,299120
8/1/2024,Dilani Fernando,Moneragala,Wellawaya,Uva,962,207,1169,38480,8280,46760
8/2/2024,Dilani Fernando,Moneragala,Wellawaya,Uva,9594,4036,13630,383760,161440,545200
8/3/2024,Dilani Fernando,Moneragala,Wellawaya,Uva,6616,1284,7900,264640,51360,316000
8/4/2024,Dilani Fernando,Moneragala,Wellawaya,Uva,4285,497,4782,171400,19880,191280
8/5/2024,Dilani Fernando,Moneragala,Wellawaya,Uva,5065,5793,10858,202600,231720,434320
8/6/2024,Dilani Fernando,Moneragala,Wellawaya,Uva,9504,9050,18554,380160,362000,742160
8/7/2024,Dilani Fernando,Moneragala,Wellawaya,Uva,7284,8274,15558,291360,330960,622320
8/8/2024,Dilani Fernando,Moneragala,Wellawaya,Uva,5257,1591,6848,210280,63640,273920
8/9/2024,Dilani Fernando,Moneragala,Wellawaya,Uva,2709,3970,6679,108360,158800,267160
8/10/2024,Dilani Fernando,Moneragala,Wellawaya,Uva,9143,7392,16535,365720,295680,661400
8/11/2024,Dilani Fernando,Moneragala,Wellawaya,Uva,5779,5550,11329,231160,222000,453160
8/12/2024,Dilani Fernando,Moneragala,Wellawaya,Uva,1611,2254,3865,64440,90160,154600
8/13/2024,Dilani Fernando,Moneragala,Wellawaya,Uva,5733,6679,12412,229320,267160,496480
8/14/2024,Dilani Fernando,Moneragala,Wellawaya,Uva,7125,1654,8779,285000,66160,351160
8/15/2024,Dilani Fernando,Moneragala,Wellawaya,Uva,3945,5498,9443,157800,219920,377720
8/16/2024,Dilani Fernando,Moneragala,Wellawaya,Uva,2045,770,2815,81800,30800,112600
8/17/2024,Dilani Fernando,Moneragala,Wellawaya,Uva,5605,7709,13314,224200,308360,532560
8/18/2024,Dilani Fernando,Moneragala,Wellawaya,Uva,9863,1959,11822,394520,78360,472880
8/19/2024,Dilani Fernando,Moneragala,Wellawaya,Uva,9725,8858,18583,389000,354320,743320
8/20/2024,Dilani Fernando,Moneragala,Wellawaya,Uva,5367,1741,7108,214680,69640,284320
8/21/2024,Dilani Fernando,Moneragala,Wellawaya,Uva,5653,4133,9786,226120,165320,391440
8/22/2024,Dilani Fernando,Moneragala,Wellawaya,Uva,1858,8557,10415,74320,342280,416600
8/23/2024,Dilani Fernando,Moneragala,Wellawaya,Uva,2084,427,2511,83360,17080,100440
8/24/2024,Dilani Fernando,Moneragala,Wellawaya,Uva,3128,5528,8656,125120,221120,346240
8/25/2024,Dilani Fernando,Moneragala,Wellawaya,Uva,7698,9695,17393,307920,387800,695720
8/26/2024,Dilani Fernando,Moneragala,Wellawaya,Uva,8560,5765,14325,342400,230600,573000
8/27/2024,Dilani Fernando,Moneragala,Wellawaya,Uva,6028,6839,12867,241120,273560,514680
8/28/2024,Dilani Fernando,Moneragala,Wellawaya,Uva,7017,3084,10101,280680,123360,404040
8/29/2024,Dilani Fernando,Moneragala,Wellawaya,Uva,5759,7232,12991,230360,289280,519640
8/30/2024,Dilani Fernando,Moneragala,Wellawaya,Uva,132,7622,7754,5280,304880,310160
8/31/2024,Dilani Fernando,Moneragala,Wellawaya,Uva,6301,9033,15334,252040,361320,613360
9/1/2024,Dilani Fernando,Moneragala,Wellawaya,Uva,7789,7753,15542,311560,310120,621680
9/2/2024,Dilani Fernando,Moneragala,Wellawaya,Uva,8372,4507,12879,334880,180280,515160
9/3/2024,Dilani Fernando,Moneragala,Wellawaya,Uva,1352,5056,6408,54080,202240,256320
9/4/2024,Dilani Fernando,Moneragala,Wellawaya,Uva,9089,1048,10137,363560,41920,405480
9/5/2024,Dilani Fernando,Moneragala,Wellawaya,Uva,9061,7079,16140,362440,283160,645600
9/6/2024,Dilani Fernando,Moneragala,Wellawaya,Uva,1791,9908,11699,71640,396320,467960
9/7/2024,Dilani Fernando,Moneragala,Wellawaya,Uva,8392,4824,13216,335680,192960,528640
9/8/2024,Dilani Fernando,Moneragala,Wellawaya,Uva,689,4355,5044,27560,174200,201760
9/9/2024,Dilani Fernando,Moneragala,Wellawaya,Uva,125,7952,8077,5000,318080,323080
9/10/2024,Dilani Fernando,Moneragala,Wellawaya,Uva,3254,1499,4753,130160,59960,190120
9/11/2024,Dilani Fernando,Moneragala,Wellawaya,Uva,3738,5133,8871,149520,205320,354840
9/12/2024,Dilani Fernando,Moneragala,Wellawaya,Uva,905,1848,2753,36200,73920,110120
9/13/2024,Dilani Fernando,Moneragala,Wellawaya,Uva,2269,5246,7515,90760,209840,300600
9/14/2024,Dilani Fernando,Moneragala,Wellawaya,Uva,7732,6021,13753,309280,240840,550120
9/15/2024,Dilani Fernando,Moneragala,Wellawaya,Uva,4289,7482,11771,171560,299280,470840
9/16/2024,Dilani Fernando,Moneragala,Wellawaya,Uva,6606,6394,13000,264240,255760,520000
9/17/2024,Dilani Fernando,Moneragala,Wellawaya,Uva,4318,3036,7354,172720,121440,294160
9/18/2024,Dilani Fernando,Moneragala,Wellawaya,Uva,2837,5625,8462,113480,225000,338480
9/19/2024,Dilani Fernando,Moneragala,Wellawaya,Uva,4080,2919,6999,163200,116760,279960
9/20/2024,Dilani Fernando,Moneragala,Wellawaya,Uva,6187,6670,12857,247480,266800,514280
9/21/2024,Dilani Fernando,Moneragala,Wellawaya,Uva,9191,622,9813,367640,24880,392520
9/22/2024,Dilani Fernando,Moneragala,Wellawaya,Uva,8463,9807,18270,338520,392280,730800
9/23/2024,Dilani Fernando,Moneragala,Wellawaya,Uva,9289,5803,15092,371560,232120,603680
9/24/2024,Dilani Fernando,Moneragala,Wellawaya,Uva,1228,9899,11127,49120,395960,445080
9/25/2024,Dilani Fernando,Moneragala,Wellawaya,Uva,4551,9679,14230,182040,387160,569200
9/26/2024,Dilani Fernando,Moneragala,Wellawaya,Uva,7891,4689,12580,315640,187560,503200
9/27/2024,Dilani Fernando,Moneragala,Wellawaya,Uva,3344,3652,6996,133760,146080,279840
9/28/2024,Dilani Fernando,Moneragala,Wellawaya,Uva,1180,4827,6007,47200,193080,240280
9/29/2024,Dilani Fernando,Moneragala,Wellawaya,Uva,7402,7751,15153,296080,310040,606120
9/30/2024,Dilani Fernando,Moneragala,Wellawaya,Uva,9382,7153,16535,375280,286120,661400
10/1/2024,Dilani Fernando,Moneragala,Wellawaya,Uva,2821,3682,6503,112840,147280,260120
10/2/2024,Dilani Fernando,Moneragala,Wellawaya,Uva,7827,8568,16395,313080,342720,655800
10/3/2024,Dilani Fernando,Moneragala,Wellawaya,Uva,7987,8334,16321,319480,333360,652840
10/4/2024,Dilani Fernando,Moneragala,Wellawaya,Uva,4337,5770,10107,173480,230800,404280
10/5/2024,Dilani Fernando,Moneragala,Wellawaya,Uva,2616,6299,8915,104640,251960,356600
10/6/2024,Dilani Fernando,Moneragala,Wellawaya,Uva,6919,4243,11162,276760,169720,446480
10/7/2024,Dilani Fernando,Moneragala,Wellawaya,Uva,7119,5490,12609,284760,219600,504360
10/8/2024,Dilani Fernando,Moneragala,Wellawaya,Uva,3869,2940,6809,154760,117600,272360
10/9/2024,Dilani Fernando,Moneragala,Wellawaya,Uva,6403,5480,11883,256120,219200,475320
10/10/2024,Dilani Fernando,Moneragala,Wellawaya,Uva,9293,790,10083,371720,31600,403320
10/11/2024,Dilani Fernando,Moneragala,Wellawaya,Uva,6834,8363,15197,273360,334520,607880
10/12/2024,Dilani Fernando,Moneragala,Wellawaya,Uva,1093,6835,7928,43720,273400,317120
10/13/2024,Dilani Fernando,Moneragala,Wellawaya,Uva,7103,230,7333,284120,9200,293320
10/14/2024,Dilani Fernando,Moneragala,Wellawaya,Uva,5828,1420,7248,233120,56800,289920
10/15/2024,Dilani Fernando,Moneragala,Wellawaya,Uva,9388,3912,13300,375520,156480,532000
10/16/2024,Dilani Fernando,Moneragala,Wellawaya,Uva,5147,3619,8766,205880,144760,350640
10/17/2024,Dilani Fernando,Moneragala,Wellawaya,Uva,7684,1102,8786,307360,44080,351440
10/18/2024,Dilani Fernando,Moneragala,Wellawaya,Uva,1926,1685,3611,77040,67400,144440
10/19/2024,Dilani Fernando,Moneragala,Wellawaya,Uva,6019,5486,11505,240760,219440,460200
10/20/2024,Dilani Fernando,Moneragala,Wellawaya,Uva,5785,399,6184,231400,15960,247360
10/21/2024,Dilani Fernando,Moneragala,Wellawaya,Uva,580,219,799,23200,8760,31960
10/22/2024,Dilani Fernando,Moneragala,Wellawaya,Uva,6901,9498,16399,276040,379920,655960
10/23/2024,Dilani Fernando,Moneragala,Wellawaya,Uva,83,4880,4963,3320,195200,198520
10/24/2024,Dilani Fernando,Moneragala,Wellawaya,Uva,1544,9884,11428,61760,395360,457120
10/25/2024,Dilani Fernando,Moneragala,Wellawaya,Uva,6631,755,7386,265240,30200,295440
10/26/2024,Dilani Fernando,Moneragala,Wellawaya,Uva,556,8902,9458,22240,356080,378320
10/27/2024,Dilani Fernando,Moneragala,Wellawaya,Uva,7269,511,7780,290760,20440,311200
10/28/2024,Dilani Fernando,Moneragala,Wellawaya,Uva,572,1157,1729,22880,46280,69160
10/29/2024,Dilani Fernando,Moneragala,Wellawaya,Uva,9501,581,10082,380040,23240,403280
10/30/2024,Dilani Fernando,Moneragala,Wellawaya,Uva,6669,1951,8620,266760,78040,344800
10/31/2024,Dilani Fernando,Moneragala,Wellawaya,Uva,8343,4457,12800,333720,178280,512000
11/1/2024,Dilani Fernando,Moneragala,Wellawaya,Uva,3977,1299,5276,159080,51960,211040
11/2/2024,Dilani Fernando,Moneragala,Wellawaya,Uva,5030,4488,9518,201200,179520,380720
11/3/2024,Dilani Fernando,Moneragala,Wellawaya,Uva,2952,7887,10839,118080,315480,433560
11/4/2024,Dilani Fernando,Moneragala,Wellawaya,Uva,4662,3931,8593,186480,157240,343720
11/5/2024,Dilani Fernando,Moneragala,Wellawaya,Uva,4159,7393,11552,166360,295720,462080
11/6/2024,Dilani Fernando,Moneragala,Wellawaya,Uva,3955,5212,9167,158200,208480,366680
11/7/2024,Dilani Fernando,Moneragala,Wellawaya,Uva,2559,3490,6049,102360,139600,241960
11/8/2024,Dilani Fernando,Moneragala,Wellawaya,Uva,6941,9901,16842,277640,396040,673680
11/9/2024,Dilani Fernando,Moneragala,Wellawaya,Uva,565,1664,2229,22600,66560,89160
11/10/2024,Dilani Fernando,Moneragala,Wellawaya,Uva,575,2993,3568,23000,119720,142720
11/11/2024,Dilani Fernando,Moneragala,Wellawaya,Uva,3861,8970,12831,154440,358800,513240
11/12/2024,Dilani Fernando,Moneragala,Wellawaya,Uva,198,6890,7088,7920,275600,283520
11/13/2024,Dilani Fernando,Moneragala,Wellawaya,Uva,8789,3789,12578,351560,151560,503120
11/14/2024,Dilani Fernando,Moneragala,Wellawaya,Uva,2737,1716,4453,109480,68640,178120
11/15/2024,Dilani Fernando,Moneragala,Wellawaya,Uva,4621,1439,6060,184840,57560,242400
11/16/2024,Dilani Fernando,Moneragala,Wellawaya,Uva,2490,6896,9386,99600,275840,375440
11/17/2024,Dilani Fernando,Moneragala,Wellawaya,Uva,1593,574,2167,63720,22960,86680
11/18/2024,Dilani Fernando,Moneragala,Wellawaya,Uva,2347,3345,5692,93880,133800,227680
11/19/2024,Dilani Fernando,Moneragala,Wellawaya,Uva,3772,6685,10457,150880,267400,418280
11/20/2024,Dilani Fernando,Moneragala,Wellawaya,Uva,4649,7282,11931,185960,291280,477240
11/21/2024,Dilani Fernando,Moneragala,Wellawaya,Uva,4499,4171,8670,179960,166840,346800
11/22/2024,Dilani Fernando,Moneragala,Wellawaya,Uva,6120,1745,7865,244800,69800,314600
11/23/2024,Dilani Fernando,Moneragala,Wellawaya,Uva,4275,3769,8044,171000,150760,321760
11/24/2024,Dilani Fernando,Moneragala,Wellawaya,Uva,2699,1823,4522,107960,72920,180880
11/25/2024,Dilani Fernando,Moneragala,Wellawaya,Uva,4328,8701,13029,173120,348040,521160
11/26/2024,Dilani Fernando,Moneragala,Wellawaya,Uva,1747,9775,11522,69880,391000,460880
11/27/2024,Dilani Fernando,Moneragala,Wellawaya,Uva,6342,9735,16077,253680,389400,643080
11/28/2024,Dilani Fernando,Moneragala,Wellawaya,Uva,1579,7907,9486,63160,316280,379440
11/29/2024,Dilani Fernando,Moneragala,Wellawaya,Uva,2092,9546,11638,83680,381840,465520
11/30/2024,Dilani Fernando,Moneragala,Wellawaya,Uva,3548,2776,6324,141920,111040,252960
12/1/2024,Dilani Fernando,Moneragala,Wellawaya,Uva,1815,5480,7295,72600,219200,291800
12/2/2024,Dilani Fernando,Moneragala,Wellawaya,Uva,3761,3037,6798,150440,121480,271920
12/3/2024,Dilani Fernando,Moneragala,Wellawaya,Uva,618,4878,5496,24720,195120,219840
12/4/2024,Dilani Fernando,Moneragala,Wellawaya,Uva,6387,3619,10006,255480,144760,400240
12/5/2024,Dilani Fernando,Moneragala,Wellawaya,Uva,2853,6976,9829,114120,279040,393160
12/6/2024,Dilani Fernando,Moneragala,Wellawaya,Uva,1127,5664,6791,45080,226560,271640
12/7/2024,Dilani Fernando,Moneragala,Wellawaya,Uva,448,6692,7140,17920,267680,285600
12/8/2024,Dilani Fernando,Moneragala,Wellawaya,Uva,9032,2225,11257,361280,89000,450280
12/9/2024,Dilani Fernando,Moneragala,Wellawaya,Uva,5364,4974,10338,214560,198960,413520
12/10/2024,Dilani Fernando,Moneragala,Wellawaya,Uva,8988,7431,16419,359520,297240,656760
12/11/2024,Dilani Fernando,Moneragala,Wellawaya,Uva,7550,9884,17434,302000,395360,697360
12/12/2024,Dilani Fernando,Moneragala,Wellawaya,Uva,3667,2399,6066,146680,95960,242640
12/13/2024,Dilani Fernando,Moneragala,Wellawaya,Uva,8234,377,8611,329360,15080,344440
12/14/2024,Dilani Fernando,Moneragala,Wellawaya,Uva,5231,260,5491,209240,10400,219640
12/15/2024,Dilani Fernando,Moneragala,Wellawaya,Uva,26,6651,6677,1040,266040,267080
12/16/2024,Dilani Fernando,Moneragala,Wellawaya,Uva,945,9064,10009,37800,362560,400360
12/17/2024,Dilani Fernando,Moneragala,Wellawaya,Uva,9778,8872,18650,391120,354880,746000
12/18/2024,Dilani Fernando,Moneragala,Wellawaya,Uva,9060,8653,17713,362400,346120,708520
12/19/2024,Dilani Fernando,Moneragala,Wellawaya,Uva,1752,7258,9010,70080,290320,360400
12/20/2024,Dilani Fernando,Moneragala,Wellawaya,Uva,8915,5134,14049,356600,205360,561960
12/21/2024,Dilani Fernando,Moneragala,Wellawaya,Uva,3762,4841,8603,150480,193640,344120
12/22/2024,Dilani Fernando,Moneragala,Wellawaya,Uva,2825,2863,5688,113000,114520,227520
12/23/2024,Dilani Fernando,Moneragala,Wellawaya,Uva,9569,1298,10867,382760,51920,434680
12/24/2024,Dilani Fernando,Moneragala,Wellawaya,Uva,1890,7319,9209,75600,292760,368360
12/25/2024,Dilani Fernando,Moneragala,Wellawaya,Uva,5810,1779,7589,232400,71160,303560
12/26/2024,Dilani Fernando,Moneragala,Wellawaya,Uva,6579,7227,13806,263160,289080,552240
12/27/2024,Dilani Fernando,Moneragala,Wellawaya,Uva,7689,2548,10237,307560,101920,409480
12/28/2024,Dilani Fernando,Moneragala,Wellawaya,Uva,1651,3617,5268,66040,144680,210720
12/29/2024,Dilani Fernando,Moneragala,Wellawaya,Uva,1904,773,2677,76160,30920,107080
12/30/2024,Dilani Fernando,Moneragala,Wellawaya,Uva,8550,3286,11836,342000,131440,473440
12/31/2024,Dilani Fernando,Moneragala,Wellawaya,Uva,996,9248,10244,39840,369920,409760
1/1/2025,Dilani Fernando,Moneragala,Wellawaya,Uva,6388,8272,14660,255520,330880,586400
1/2/2025,Dilani Fernando,Moneragala,Wellawaya,Uva,2239,8465,10704,89560,338600,428160
1/3/2025,Dilani Fernando,Moneragala,Wellawaya,Uva,6607,8000,14607,264280,320000,584280
1/4/2025,Dilani Fernando,Moneragala,Wellawaya,Uva,6408,2114,8522,256320,84560,340880
1/5/2025,Dilani Fernando,Moneragala,Wellawaya,Uva,4667,8906,13573,186680,356240,542920
1/6/2025,Dilani Fernando,Moneragala,Wellawaya,Uva,5395,9135,14530,215800,365400,581200
1/7/2025,Dilani Fernando,Moneragala,Wellawaya,Uva,2018,94,2112,80720,3760,84480
1/8/2025,Dilani Fernando,Moneragala,Wellawaya,Uva,1104,5319,6423,44160,212760,256920
1/9/2025,Dilani Fernando,Moneragala,Wellawaya,Uva,8648,163,8811,345920,6520,352440
1/10/2025,Dilani Fernando,Moneragala,Wellawaya,Uva,2458,7326,9784,98320,293040,391360
1/11/2025,Dilani Fernando,Moneragala,Wellawaya,Uva,4682,7969,12651,187280,318760,506040
1/12/2025,Dilani Fernando,Moneragala,Wellawaya,Uva,3870,3729,7599,154800,149160,303960
1/13/2025,Dilani Fernando,Moneragala,Wellawaya,Uva,1429,70,1499,57160,2800,59960
1/14/2025,Dilani Fernando,Moneragala,Wellawaya,Uva,7151,240,7391,286040,9600,295640
1/15/2025,Dilani Fernando,Moneragala,Wellawaya,Uva,3338,6074,9412,133520,242960,376480
1/16/2025,Dilani Fernando,Moneragala,Wellawaya,Uva,7925,9077,17002,317000,363080,680080
1/17/2025,Dilani Fernando,Moneragala,Wellawaya,Uva,1563,5162,6725,62520,206480,269000
1/18/2025,Dilani Fernando,Moneragala,Wellawaya,Uva,7047,9523,16570,281880,380920,662800
1/19/2025,Dilani Fernando,Moneragala,Wellawaya,Uva,7697,6869,14566,307880,274760,582640
1/20/2025,Dilani Fernando,Moneragala,Wellawaya,Uva,6116,7949,14065,244640,317960,562600
1/21/2025,Dilani Fernando,Moneragala,Wellawaya,Uva,7192,956,8148,287680,38240,325920
1/22/2025,Dilani Fernando,Moneragala,Wellawaya,Uva,3071,2138,5209,122840,85520,208360
1/23/2025,Dilani Fernando,Moneragala,Wellawaya,Uva,2458,8647,11105,98320,345880,444200
1/24/2025,Dilani Fernando,Moneragala,Wellawaya,Uva,7311,2589,9900,292440,103560,396000
1/25/2025,Dilani Fernando,Moneragala,Wellawaya,Uva,1011,1180,2191,40440,47200,87640
1/26/2025,Dilani Fernando,Moneragala,Wellawaya,Uva,6059,5448,11507,242360,217920,460280
1/27/2025,Dilani Fernando,Moneragala,Wellawaya,Uva,4338,5202,9540,173520,208080,381600
1/28/2025,Dilani Fernando,Moneragala,Wellawaya,Uva,4833,9922,14755,193320,396880,590200
1/29/2025,Dilani Fernando,Moneragala,Wellawaya,Uva,4302,368,4670,172080,14720,186800
1/30/2025,Dilani Fernando,Moneragala,Wellawaya,Uva,6321,1785,8106,252840,71400,324240
1/31/2025,Dilani Fernando,Moneragala,Wellawaya,Uva,5740,3311,9051,229600,132440,362040
2/1/2025,Dilani Fernando,Moneragala,Wellawaya,Uva,2954,2409,5363,118160,96360,214520
2/2/2025,Dilani Fernando,Moneragala,Wellawaya,Uva,1862,3244,5106,74480,129760,204240
2/3/2025,Dilani Fernando,Moneragala,Wellawaya,Uva,1246,7807,9053,49840,312280,362120
2/4/2025,Dilani Fernando,Moneragala,Wellawaya,Uva,8725,1730,10455,349000,69200,418200
2/5/2025,Dilani Fernando,Moneragala,Wellawaya,Uva,6320,5300,11620,252800,212000,464800
2/6/2025,Dilani Fernando,Moneragala,Wellawaya,Uva,1498,2439,3937,59920,97560,157480
2/7/2025,Dilani Fernando,Moneragala,Wellawaya,Uva,1004,2413,3417,40160,96520,136680
2/8/2025,Dilani Fernando,Moneragala,Wellawaya,Uva,6865,8445,15310,274600,337800,612400
2/9/2025,Dilani Fernando,Moneragala,Wellawaya,Uva,752,6890,7642,30080,275600,305680
2/10/2025,Dilani Fernando,Moneragala,Wellawaya,Uva,645,9694,10339,25800,387760,413560
2/11/2025,Dilani Fernando,Moneragala,Wellawaya,Uva,3660,6421,10081,146400,256840,403240
2/12/2025,Dilani Fernando,Moneragala,Wellawaya,Uva,7560,1250,8810,302400,50000,352400
2/13/2025,Dilani Fernando,Moneragala,Wellawaya,Uva,3396,3858,7254,135840,154320,290160
2/14/2025,Dilani Fernando,Moneragala,Wellawaya,Uva,1750,738,2488,70000,29520,99520
2/15/2025,Dilani Fernando,Moneragala,Wellawaya,Uva,7136,5854,12990,285440,234160,519600
2/16/2025,Dilani Fernando,Moneragala,Wellawaya,Uva,6396,5266,11662,255840,210640,466480
2/17/2025,Dilani Fernando,Moneragala,Wellawaya,Uva,2758,7448,10206,110320,297920,408240
2/18/2025,Dilani Fernando,Moneragala,Wellawaya,Uva,1691,5854,7545,67640,234160,301800
2/19/2025,Dilani Fernando,Moneragala,Wellawaya,Uva,8972,7797,16769,358880,311880,670760
2/20/2025,Dilani Fernando,Moneragala,Wellawaya,Uva,5132,5215,10347,205280,208600,413880
2/21/2025,Dilani Fernando,Moneragala,Wellawaya,Uva,9788,741,10529,391520,29640,421160
2/22/2025,Dilani Fernando,Moneragala,Wellawaya,Uva,2864,9186,12050,114560,367440,482000
2/23/2025,Dilani Fernando,Moneragala,Wellawaya,Uva,7332,2225,9557,293280,89000,382280
2/24/2025,Dilani Fernando,Moneragala,Wellawaya,Uva,5162,8470,13632,206480,338800,545280
2/25/2025,Dilani Fernando,Moneragala,Wellawaya,Uva,4621,7463,12084,184840,298520,483360
2/26/2025,Dilani Fernando,Moneragala,Wellawaya,Uva,6410,9306,15716,256400,372240,628640
2/27/2025,Dilani Fernando,Moneragala,Wellawaya,Uva,7120,8345,15465,284800,333800,618600
2/28/2025,Dilani Fernando,Moneragala,Wellawaya,Uva,4980,3008,7988,199200,120320,319520
3/1/2025,Dilani Fernando,Moneragala,Wellawaya,Uva,7709,4048,11757,308360,161920,470280
3/2/2025,Dilani Fernando,Moneragala,Wellawaya,Uva,3123,5334,8457,124920,213360,338280
3/3/2025,Dilani Fernando,Moneragala,Wellawaya,Uva,4955,8678,13633,198200,347120,545320
3/4/2025,Dilani Fernando,Moneragala,Wellawaya,Uva,502,5670,6172,20080,226800,246880
3/5/2025,Dilani Fernando,Moneragala,Wellawaya,Uva,8443,3530,11973,337720,141200,478920
3/6/2025,Dilani Fernando,Moneragala,Wellawaya,Uva,1272,6731,8003,50880,269240,320120
3/7/2025,Dilani Fernando,Moneragala,Wellawaya,Uva,8814,9367,18181,352560,374680,727240
3/8/2025,Dilani Fernando,Moneragala,Wellawaya,Uva,8477,7508,15985,339080,300320,639400
3/9/2025,Dilani Fernando,Moneragala,Wellawaya,Uva,2030,3572,5602,81200,142880,224080
3/10/2025,Dilani Fernando,Moneragala,Wellawaya,Uva,3476,1193,4669,139040,47720,186760
3/11/2025,Dilani Fernando,Moneragala,Wellawaya,Uva,644,4513,5157,25760,180520,206280
3/12/2025,Dilani Fernando,Moneragala,Wellawaya,Uva,2275,4908,7183,91000,196320,287320
3/13/2025,Dilani Fernando,Moneragala,Wellawaya,Uva,7963,4867,12830,318520,194680,513200
3/14/2025,Dilani Fernando,Moneragala,Wellawaya,Uva,6237,5875,12112,249480,235000,484480
3/15/2025,Dilani Fernando,Moneragala,Wellawaya,Uva,5232,6543,11775,209280,261720,471000
3/16/2025,Dilani Fernando,Moneragala,Wellawaya,Uva,5869,4305,10174,234760,172200,406960
3/17/2025,Dilani Fernando,Moneragala,Wellawaya,Uva,8218,8729,16947,328720,349160,677880
3/18/2025,Dilani Fernando,Moneragala,Wellawaya,Uva,8692,7754,16446,347680,310160,657840
3/19/2025,Dilani Fernando,Moneragala,Wellawaya,Uva,9128,2312,11440,365120,92480,457600
3/20/2025,Dilani Fernando,Moneragala,Wellawaya,Uva,713,2061,2774,28520,82440,110960
3/21/2025,Dilani Fernando,Moneragala,Wellawaya,Uva,8317,827,9144,332680,33080,365760
3/22/2025,Dilani Fernando,Moneragala,Wellawaya,Uva,4176,2569,6745,167040,102760,269800
3/23/2025,Dilani Fernando,Moneragala,Wellawaya,Uva,9101,7303,16404,364040,292120,656160
3/25/2024,Mahesh Rukshan,Jaffna,Vavuniya,Northern,6553,732,7285,262120,29280,291400
3/26/2024,Mahesh Rukshan,Jaffna,Vavuniya,Northern,5145,3104,8249,205800,124160,329960
3/27/2024,Mahesh Rukshan,Jaffna,Vavuniya,Northern,4162,3138,7300,166480,125520,292000
3/28/2024,Mahesh Rukshan,Jaffna,Vavuniya,Northern,7882,4220,12102,315280,168800,484080
3/29/2024,Mahesh Rukshan,Jaffna,Vavuniya,Northern,9475,3784,13259,379000,151360,530360
3/30/2024,Mahesh Rukshan,Jaffna,Vavuniya,Northern,1483,4549,6032,59320,181960,241280
3/31/2024,Mahesh Rukshan,Jaffna,Vavuniya,Northern,5226,3434,8660,209040,137360,346400
4/1/2024,Mahesh Rukshan,Jaffna,Vavuniya,Northern,1042,1691,2733,41680,67640,109320
4/2/2024,Mahesh Rukshan,Jaffna,Vavuniya,Northern,5111,975,6086,204440,39000,243440
4/3/2024,Mahesh Rukshan,Jaffna,Vavuniya,Northern,7022,7671,14693,280880,306840,587720
4/4/2024,Mahesh Rukshan,Jaffna,Vavuniya,Northern,8352,659,9011,334080,26360,360440
4/5/2024,Mahesh Rukshan,Jaffna,Vavuniya,Northern,8448,8565,17013,337920,342600,680520
4/6/2024,Mahesh Rukshan,Jaffna,Vavuniya,Northern,3368,8430,11798,134720,337200,471920
4/7/2024,Mahesh Rukshan,Jaffna,Vavuniya,Northern,3843,5383,9226,153720,215320,369040
4/8/2024,Mahesh Rukshan,Jaffna,Vavuniya,Northern,2761,6374,9135,110440,254960,365400
4/9/2024,Mahesh Rukshan,Jaffna,Vavuniya,Northern,1726,8744,10470,69040,349760,418800
4/10/2024,Mahesh Rukshan,Jaffna,Vavuniya,Northern,4151,6163,10314,166040,246520,412560
4/11/2024,Mahesh Rukshan,Jaffna,Vavuniya,Northern,3530,5697,9227,141200,227880,369080
4/19/2024,Mahesh Rukshan,Jaffna,Vavuniya,Northern,393,6391,6784,15720,255640,271360
4/20/2024,Mahesh Rukshan,Jaffna,Vavuniya,Northern,1032,7468,8500,41280,298720,340000
4/21/2024,Mahesh Rukshan,Jaffna,Vavuniya,Northern,1508,5801,7309,60320,232040,292360
4/22/2024,Mahesh Rukshan,Jaffna,Vavuniya,Northern,8769,9404,18173,350760,376160,726920
4/23/2024,Mahesh Rukshan,Jaffna,Vavuniya,Northern,3816,3092,6908,152640,123680,276320
4/24/2024,Mahesh Rukshan,Jaffna,Vavuniya,Northern,2346,3630,5976,93840,145200,239040
4/25/2024,Mahesh Rukshan,Jaffna,Vavuniya,Northern,6299,280,6579,251960,11200,263160
4/26/2024,Mahesh Rukshan,Jaffna,Vavuniya,Northern,1994,4507,6501,79760,180280,260040
4/27/2024,Mahesh Rukshan,Jaffna,Vavuniya,Northern,8343,3937,12280,333720,157480,491200
4/28/2024,Mahesh Rukshan,Jaffna,Vavuniya,Northern,3728,4729,8457,149120,189160,338280
4/29/2024,Mahesh Rukshan,Jaffna,Vavuniya,Northern,2105,8064,10169,84200,322560,406760
4/30/2024,Mahesh Rukshan,Jaffna,Vavuniya,Northern,1732,9901,11633,69280,396040,465320
5/1/2024,Mahesh Rukshan,Jaffna,Vavuniya,Northern,9669,7065,16734,386760,282600,669360
5/2/2024,Mahesh Rukshan,Jaffna,Vavuniya,Northern,1519,8139,9658,60760,325560,386320
5/3/2024,Mahesh Rukshan,Jaffna,Vavuniya,Northern,2422,8478,10900,96880,339120,436000
5/4/2024,Mahesh Rukshan,Jaffna,Vavuniya,Northern,7671,880,8551,306840,35200,342040
5/5/2024,Mahesh Rukshan,Jaffna,Vavuniya,Northern,8789,1524,10313,351560,60960,412520
5/6/2024,Mahesh Rukshan,Jaffna,Vavuniya,Northern,7120,3356,10476,284800,134240,419040
5/7/2024,Mahesh Rukshan,Jaffna,Vavuniya,Northern,6551,8661,15212,262040,346440,608480
5/8/2024,Mahesh Rukshan,Jaffna,Vavuniya,Northern,3291,1276,4567,131640,51040,182680
5/9/2024,Mahesh Rukshan,Jaffna,Vavuniya,Northern,5571,9601,15172,222840,384040,606880
5/10/2024,Mahesh Rukshan,Jaffna,Vavuniya,Northern,4608,5735,10343,184320,229400,413720
5/11/2024,Mahesh Rukshan,Jaffna,Vavuniya,Northern,8668,934,9602,346720,37360,384080
5/12/2024,Mahesh Rukshan,Jaffna,Vavuniya,Northern,3290,73,3363,131600,2920,134520
5/13/2024,Mahesh Rukshan,Jaffna,Vavuniya,Northern,1857,1718,3575,74280,68720,143000
5/14/2024,Mahesh Rukshan,Jaffna,Vavuniya,Northern,1613,1156,2769,64520,46240,110760
5/15/2024,Mahesh Rukshan,Jaffna,Vavuniya,Northern,1846,8745,10591,73840,349800,423640
5/16/2024,Mahesh Rukshan,Jaffna,Vavuniya,Northern,3292,2453,5745,131680,98120,229800
5/17/2024,Mahesh Rukshan,Jaffna,Vavuniya,Northern,2733,7006,9739,109320,280240,389560
5/18/2024,Mahesh Rukshan,Jaffna,Vavuniya,Northern,6109,8714,14823,244360,348560,592920
5/19/2024,Mahesh Rukshan,Jaffna,Vavuniya,Northern,1897,5823,7720,75880,232920,308800
5/20/2024,Mahesh Rukshan,Jaffna,Vavuniya,Northern,1612,2544,4156,64480,101760,166240
5/21/2024,Mahesh Rukshan,Jaffna,Vavuniya,Northern,1041,6079,7120,41640,243160,284800
5/22/2024,Mahesh Rukshan,Jaffna,Vavuniya,Northern,5087,1430,6517,203480,57200,260680
5/24/2024,Mahesh Rukshan,Jaffna,Vavuniya,Northern,7951,7004,14955,318040,280160,598200
5/25/2024,Mahesh Rukshan,Jaffna,Vavuniya,Northern,9031,9410,18441,361240,376400,737640
5/26/2024,Mahesh Rukshan,Jaffna,Vavuniya,Northern,2092,9099,11191,83680,363960,447640
5/27/2024,Mahesh Rukshan,Jaffna,Vavuniya,Northern,4182,8724,12906,167280,348960,516240
5/28/2024,Mahesh Rukshan,Jaffna,Vavuniya,Northern,3816,4083,7899,152640,163320,315960
5/29/2024,Mahesh Rukshan,Jaffna,Vavuniya,Northern,966,5078,6044,38640,203120,241760
5/30/2024,Mahesh Rukshan,Jaffna,Vavuniya,Northern,1844,9818,11662,73760,392720,466480
5/31/2024,Mahesh Rukshan,Jaffna,Vavuniya,Northern,4603,5126,9729,184120,205040,389160
6/1/2024,Mahesh Rukshan,Jaffna,Vavuniya,Northern,8082,4629,12711,323280,185160,508440
6/2/2024,Mahesh Rukshan,Jaffna,Vavuniya,Northern,5750,1484,7234,230000,59360,289360
6/3/2024,Mahesh Rukshan,Jaffna,Vavuniya,Northern,4641,5889,10530,185640,235560,421200
6/4/2024,Mahesh Rukshan,Jaffna,Vavuniya,Northern,8422,5322,13744,336880,212880,549760
6/5/2024,Mahesh Rukshan,Jaffna,Vavuniya,Northern,9295,5103,14398,371800,204120,575920
6/6/2024,Mahesh Rukshan,Jaffna,Vavuniya,Northern,5399,9907,15306,215960,396280,612240
6/7/2024,Mahesh Rukshan,Jaffna,Vavuniya,Northern,2586,7289,9875,103440,291560,395000
6/8/2024,Mahesh Rukshan,Jaffna,Vavuniya,Northern,5335,5727,11062,213400,229080,442480
6/9/2024,Mahesh Rukshan,Jaffna,Vavuniya,Northern,7890,4757,12647,315600,190280,505880
6/10/2024,Mahesh Rukshan,Jaffna,Vavuniya,Northern,314,104,418,12560,4160,16720
6/11/2024,Mahesh Rukshan,Jaffna,Vavuniya,Northern,4802,1652,6454,192080,66080,258160
6/12/2024,Mahesh Rukshan,Jaffna,Vavuniya,Northern,4826,4172,8998,193040,166880,359920
6/13/2024,Mahesh Rukshan,Jaffna,Vavuniya,Northern,2936,5355,8291,117440,214200,331640
6/14/2024,Mahesh Rukshan,Jaffna,Vavuniya,Northern,3380,2716,6096,135200,108640,243840
6/15/2024,Mahesh Rukshan,Jaffna,Vavuniya,Northern,7080,5864,12944,283200,234560,517760
6/16/2024,Mahesh Rukshan,Jaffna,Vavuniya,Northern,5662,8259,13921,226480,330360,556840
6/17/2024,Mahesh Rukshan,Jaffna,Vavuniya,Northern,8173,1362,9535,326920,54480,381400
6/18/2024,Mahesh Rukshan,Jaffna,Vavuniya,Northern,9800,5952,15752,392000,238080,630080
6/19/2024,Mahesh Rukshan,Jaffna,Vavuniya,Northern,1057,6207,7264,42280,248280,290560
6/20/2024,Mahesh Rukshan,Jaffna,Vavuniya,Northern,4740,9097,13837,189600,363880,553480
6/21/2024,Mahesh Rukshan,Jaffna,Vavuniya,Northern,7025,3691,10716,281000,147640,428640
6/22/2024,Mahesh Rukshan,Jaffna,Vavuniya,Northern,1517,3230,4747,60680,129200,189880
6/23/2024,Mahesh Rukshan,Jaffna,Vavuniya,Northern,3370,9712,13082,134800,388480,523280
6/24/2024,Mahesh Rukshan,Jaffna,Vavuniya,Northern,8766,1586,10352,350640,63440,414080
6/25/2024,Mahesh Rukshan,Jaffna,Vavuniya,Northern,3182,2082,5264,127280,83280,210560
6/26/2024,Mahesh Rukshan,Jaffna,Vavuniya,Northern,5546,1285,6831,221840,51400,273240
6/27/2024,Mahesh Rukshan,Jaffna,Vavuniya,Northern,2074,4023,6097,82960,160920,243880
6/28/2024,Mahesh Rukshan,Jaffna,Vavuniya,Northern,170,9351,9521,6800,374040,380840
6/29/2024,Mahesh Rukshan,Jaffna,Vavuniya,Northern,5027,6483,11510,201080,259320,460400
6/30/2024,Mahesh Rukshan,Jaffna,Vavuniya,Northern,9270,1142,10412,370800,45680,416480
7/1/2024,Mahesh Rukshan,Jaffna,Vavuniya,Northern,8253,3606,11859,330120,144240,474360
7/2/2024,Mahesh Rukshan,Jaffna,Vavuniya,Northern,7929,3763,11692,317160,150520,467680
7/3/2024,Mahesh Rukshan,Jaffna,Vavuniya,Northern,2718,8454,11172,108720,338160,446880
7/4/2024,Mahesh Rukshan,Jaffna,Vavuniya,Northern,6529,9449,15978,261160,377960,639120
7/5/2024,Mahesh Rukshan,Jaffna,Vavuniya,Northern,8820,8841,17661,352800,353640,706440
7/6/2024,Mahesh Rukshan,Jaffna,Vavuniya,Northern,9344,3522,12866,373760,140880,514640
7/7/2024,Mahesh Rukshan,Jaffna,Vavuniya,Northern,9767,9335,19102,390680,373400,764080
7/8/2024,Mahesh Rukshan,Jaffna,Vavuniya,Northern,7549,7125,14674,301960,285000,586960
7/9/2024,Mahesh Rukshan,Jaffna,Vavuniya,Northern,9304,688,9992,372160,27520,399680
7/10/2024,Mahesh Rukshan,Jaffna,Vavuniya,Northern,6141,4916,11057,245640,196640,442280
7/11/2024,Mahesh Rukshan,Jaffna,Vavuniya,Northern,8815,3217,12032,352600,128680,481280
7/12/2024,Mahesh Rukshan,Jaffna,Vavuniya,Northern,1484,6505,7989,59360,260200,319560
7/13/2024,Mahesh Rukshan,Jaffna,Vavuniya,Northern,4350,6446,10796,174000,257840,431840
7/14/2024,Mahesh Rukshan,Jaffna,Vavuniya,Northern,5308,4373,9681,212320,174920,387240
7/15/2024,Mahesh Rukshan,Jaffna,Vavuniya,Northern,8616,1693,10309,344640,67720,412360
7/16/2024,Mahesh Rukshan,Jaffna,Vavuniya,Northern,7933,4337,12270,317320,173480,490800
7/17/2024,Mahesh Rukshan,Jaffna,Vavuniya,Northern,6748,3364,10112,269920,134560,404480
7/18/2024,Mahesh Rukshan,Jaffna,Vavuniya,Northern,1080,1792,2872,43200,71680,114880
7/19/2024,Mahesh Rukshan,Jaffna,Vavuniya,Northern,7970,1068,9038,318800,42720,361520
7/20/2024,Mahesh Rukshan,Jaffna,Vavuniya,Northern,6254,5226,11480,250160,209040,459200
7/21/2024,Mahesh Rukshan,Jaffna,Vavuniya,Northern,7525,2439,9964,301000,97560,398560
7/22/2024,Mahesh Rukshan,Jaffna,Vavuniya,Northern,3139,8809,11948,125560,352360,477920
7/23/2024,Mahesh Rukshan,Jaffna,Vavuniya,Northern,3744,565,4309,149760,22600,172360
7/24/2024,Mahesh Rukshan,Jaffna,Vavuniya,Northern,1003,7194,8197,40120,287760,327880
7/25/2024,Mahesh Rukshan,Jaffna,Vavuniya,Northern,374,3959,4333,14960,158360,173320
7/26/2024,Mahesh Rukshan,Jaffna,Vavuniya,Northern,8735,8182,16917,349400,327280,676680
7/27/2024,Mahesh Rukshan,Jaffna,Vavuniya,Northern,7707,6616,14323,308280,264640,572920
7/28/2024,Mahesh Rukshan,Jaffna,Vavuniya,Northern,6207,9365,15572,248280,374600,622880
7/29/2024,Mahesh Rukshan,Jaffna,Vavuniya,Northern,415,1897,2312,16600,75880,92480
7/30/2024,Mahesh Rukshan,Jaffna,Vavuniya,Northern,2583,6826,9409,103320,273040,376360
7/31/2024,Mahesh Rukshan,Jaffna,Vavuniya,Northern,6851,6896,13747,274040,275840,549880
8/1/2024,Mahesh Rukshan,Jaffna,Vavuniya,Northern,1115,2373,3488,44600,94920,139520
8/2/2024,Mahesh Rukshan,Jaffna,Vavuniya,Northern,1021,7789,8810,40840,311560,352400
8/3/2024,Mahesh Rukshan,Jaffna,Vavuniya,Northern,2854,5001,7855,114160,200040,314200
8/4/2024,Mahesh Rukshan,Jaffna,Vavuniya,Northern,7534,1905,9439,301360,76200,377560
8/5/2024,Mahesh Rukshan,Jaffna,Vavuniya,Northern,6442,3812,10254,257680,152480,410160
8/6/2024,Mahesh Rukshan,Jaffna,Vavuniya,Northern,8106,6739,14845,324240,269560,593800
8/7/2024,Mahesh Rukshan,Jaffna,Vavuniya,Northern,5865,1503,7368,234600,60120,294720
8/8/2024,Mahesh Rukshan,Jaffna,Vavuniya,Northern,8091,2533,10624,323640,101320,424960
8/9/2024,Mahesh Rukshan,Jaffna,Vavuniya,Northern,8835,424,9259,353400,16960,370360
8/10/2024,Mahesh Rukshan,Jaffna,Vavuniya,Northern,7020,4481,11501,280800,179240,460040
8/11/2024,Mahesh Rukshan,Jaffna,Vavuniya,Northern,6723,8927,15650,268920,357080,626000
8/12/2024,Mahesh Rukshan,Jaffna,Vavuniya,Northern,8743,5747,14490,349720,229880,579600
8/13/2024,Mahesh Rukshan,Jaffna,Vavuniya,Northern,6821,9709,16530,272840,388360,661200
8/14/2024,Mahesh Rukshan,Jaffna,Vavuniya,Northern,4995,7758,12753,199800,310320,510120
8/15/2024,Mahesh Rukshan,Jaffna,Vavuniya,Northern,6706,3628,10334,268240,145120,413360
8/16/2024,Mahesh Rukshan,Jaffna,Vavuniya,Northern,8280,3648,11928,331200,145920,477120
8/17/2024,Mahesh Rukshan,Jaffna,Vavuniya,Northern,8407,9356,17763,336280,374240,710520
8/18/2024,Mahesh Rukshan,Jaffna,Vavuniya,Northern,8507,7631,16138,340280,305240,645520
8/19/2024,Mahesh Rukshan,Jaffna,Vavuniya,Northern,4044,3288,7332,161760,131520,293280
8/20/2024,Mahesh Rukshan,Jaffna,Vavuniya,Northern,9447,6404,15851,377880,256160,634040
8/21/2024,Mahesh Rukshan,Jaffna,Vavuniya,Northern,336,5012,5348,13440,200480,213920
8/22/2024,Mahesh Rukshan,Jaffna,Vavuniya,Northern,7028,4366,11394,281120,174640,455760
8/23/2024,Mahesh Rukshan,Jaffna,Vavuniya,Northern,9464,991,10455,378560,39640,418200
8/24/2024,Mahesh Rukshan,Jaffna,Vavuniya,Northern,3515,7406,10921,140600,296240,436840
8/25/2024,Mahesh Rukshan,Jaffna,Vavuniya,Northern,6382,8223,14605,255280,328920,584200
8/26/2024,Mahesh Rukshan,Jaffna,Vavuniya,Northern,1631,3126,4757,65240,125040,190280
8/27/2024,Mahesh Rukshan,Jaffna,Vavuniya,Northern,5601,6234,11835,224040,249360,473400
8/28/2024,Mahesh Rukshan,Jaffna,Vavuniya,Northern,7315,6201,13516,292600,248040,540640
8/29/2024,Mahesh Rukshan,Jaffna,Vavuniya,Northern,4054,9762,13816,162160,390480,552640
8/30/2024,Mahesh Rukshan,Jaffna,Vavuniya,Northern,3447,5022,8469,137880,200880,338760
8/31/2024,Mahesh Rukshan,Jaffna,Vavuniya,Northern,1137,6019,7156,45480,240760,286240
9/1/2024,Mahesh Rukshan,Jaffna,Vavuniya,Northern,1901,6721,8622,76040,268840,344880
9/2/2024,Mahesh Rukshan,Jaffna,Vavuniya,Northern,6403,7189,13592,256120,287560,543680
9/3/2024,Mahesh Rukshan,Jaffna,Vavuniya,Northern,1317,5926,7243,52680,237040,289720
9/4/2024,Mahesh Rukshan,Jaffna,Vavuniya,Northern,2300,1839,4139,92000,73560,165560
9/5/2024,Mahesh Rukshan,Jaffna,Vavuniya,Northern,188,2970,3158,7520,118800,126320
9/6/2024,Mahesh Rukshan,Jaffna,Vavuniya,Northern,2926,1151,4077,117040,46040,163080
9/7/2024,Mahesh Rukshan,Jaffna,Vavuniya,Northern,9616,8728,18344,384640,349120,733760
9/8/2024,Mahesh Rukshan,Jaffna,Vavuniya,Northern,113,7077,7190,4520,283080,287600
9/9/2024,Mahesh Rukshan,Jaffna,Vavuniya,Northern,8676,6326,15002,347040,253040,600080
9/10/2024,Mahesh Rukshan,Jaffna,Vavuniya,Northern,3263,7732,10995,130520,309280,439800
9/11/2024,Mahesh Rukshan,Jaffna,Vavuniya,Northern,7574,1097,8671,302960,43880,346840
9/12/2024,Mahesh Rukshan,Jaffna,Vavuniya,Northern,7015,6564,13579,280600,262560,543160
9/13/2024,Mahesh Rukshan,Jaffna,Vavuniya,Northern,1691,2214,3905,67640,88560,156200
9/14/2024,Mahesh Rukshan,Jaffna,Vavuniya,Northern,3578,9705,13283,143120,388200,531320
9/15/2024,Mahesh Rukshan,Jaffna,Vavuniya,Northern,6002,1385,7387,240080,55400,295480
9/16/2024,Mahesh Rukshan,Jaffna,Vavuniya,Northern,2710,4857,7567,108400,194280,302680
9/17/2024,Mahesh Rukshan,Jaffna,Vavuniya,Northern,2681,9477,12158,107240,379080,486320
9/18/2024,Mahesh Rukshan,Jaffna,Vavuniya,Northern,8501,903,9404,340040,36120,376160
9/19/2024,Mahesh Rukshan,Jaffna,Vavuniya,Northern,1740,4537,6277,69600,181480,251080
9/20/2024,Mahesh Rukshan,Jaffna,Vavuniya,Northern,3037,265,3302,121480,10600,132080
9/21/2024,Mahesh Rukshan,Jaffna,Vavuniya,Northern,4525,1339,5864,181000,53560,234560
9/22/2024,Mahesh Rukshan,Jaffna,Vavuniya,Northern,4457,6110,10567,178280,244400,422680
9/23/2024,Mahesh Rukshan,Jaffna,Vavuniya,Northern,1238,40,1278,49520,1600,51120
9/24/2024,Mahesh Rukshan,Jaffna,Vavuniya,Northern,9386,1445,10831,375440,57800,433240
9/25/2024,Mahesh Rukshan,Jaffna,Vavuniya,Northern,8346,7329,15675,333840,293160,627000
9/26/2024,Mahesh Rukshan,Jaffna,Vavuniya,Northern,9865,31,9896,394600,1240,395840
9/27/2024,Mahesh Rukshan,Jaffna,Vavuniya,Northern,4588,2380,6968,183520,95200,278720
9/28/2024,Mahesh Rukshan,Jaffna,Vavuniya,Northern,2639,4747,7386,105560,189880,295440
9/29/2024,Mahesh Rukshan,Jaffna,Vavuniya,Northern,3593,9574,13167,143720,382960,526680
9/30/2024,Mahesh Rukshan,Jaffna,Vavuniya,Northern,8487,3030,11517,339480,121200,460680
10/1/2024,Mahesh Rukshan,Jaffna,Vavuniya,Northern,8092,9684,17776,323680,387360,711040
10/2/2024,Mahesh Rukshan,Jaffna,Vavuniya,Northern,4408,7606,12014,176320,304240,480560
10/3/2024,Mahesh Rukshan,Jaffna,Vavuniya,Northern,3060,8058,11118,122400,322320,444720
10/4/2024,Mahesh Rukshan,Jaffna,Vavuniya,Northern,194,1922,2116,7760,76880,84640
10/5/2024,Mahesh Rukshan,Jaffna,Vavuniya,Northern,3707,1615,5322,148280,64600,212880
10/6/2024,Mahesh Rukshan,Jaffna,Vavuniya,Northern,3648,693,4341,145920,27720,173640
10/7/2024,Mahesh Rukshan,Jaffna,Vavuniya,Northern,6163,7205,13368,246520,288200,534720
10/8/2024,Mahesh Rukshan,Jaffna,Vavuniya,Northern,9294,7965,17259,371760,318600,690360
10/9/2024,Mahesh Rukshan,Jaffna,Vavuniya,Northern,8694,4721,13415,347760,188840,536600
10/10/2024,Mahesh Rukshan,Jaffna,Vavuniya,Northern,4534,8925,13459,181360,357000,538360
10/11/2024,Mahesh Rukshan,Jaffna,Vavuniya,Northern,5467,5538,11005,218680,221520,440200
10/12/2024,Mahesh Rukshan,Jaffna,Vavuniya,Northern,709,5312,6021,28360,212480,240840
10/13/2024,Mahesh Rukshan,Jaffna,Vavuniya,Northern,2200,9234,11434,88000,369360,457360
10/14/2024,Mahesh Rukshan,Jaffna,Vavuniya,Northern,619,6035,6654,24760,241400,266160
10/15/2024,Mahesh Rukshan,Jaffna,Vavuniya,Northern,2922,8077,10999,116880,323080,439960
10/16/2024,Mahesh Rukshan,Jaffna,Vavuniya,Northern,62,6843,6905,2480,273720,276200
10/17/2024,Mahesh Rukshan,Jaffna,Vavuniya,Northern,3925,9428,13353,157000,377120,534120
10/18/2024,Mahesh Rukshan,Jaffna,Vavuniya,Northern,2653,56,2709,106120,2240,108360
10/19/2024,Mahesh Rukshan,Jaffna,Vavuniya,Northern,5506,4909,10415,220240,196360,416600
10/20/2024,Mahesh Rukshan,Jaffna,Vavuniya,Northern,1607,4870,6477,64280,194800,259080
10/21/2024,Mahesh Rukshan,Jaffna,Vavuniya,Northern,9383,2596,11979,375320,103840,479160
10/22/2024,Mahesh Rukshan,Jaffna,Vavuniya,Northern,5323,7039,12362,212920,281560,494480
10/23/2024,Mahesh Rukshan,Jaffna,Vavuniya,Northern,8223,6697,14920,328920,267880,596800
10/24/2024,Mahesh Rukshan,Jaffna,Vavuniya,Northern,6758,9670,16428,270320,386800,657120
10/25/2024,Mahesh Rukshan,Jaffna,Vavuniya,Northern,3580,7687,11267,143200,307480,450680
10/26/2024,Mahesh Rukshan,Jaffna,Vavuniya,Northern,4240,9216,13456,169600,368640,538240
10/27/2024,Mahesh Rukshan,Jaffna,Vavuniya,Northern,7342,8922,16264,293680,356880,650560
10/28/2024,Mahesh Rukshan,Jaffna,Vavuniya,Northern,9001,9533,18534,360040,381320,741360
10/29/2024,Mahesh Rukshan,Jaffna,Vavuniya,Northern,7903,26,7929,316120,1040,317160
10/30/2024,Mahesh Rukshan,Jaffna,Vavuniya,Northern,2710,1139,3849,108400,45560,153960
10/31/2024,Mahesh Rukshan,Jaffna,Vavuniya,Northern,5866,6512,12378,234640,260480,495120
11/1/2024,Mahesh Rukshan,Jaffna,Vavuniya,Northern,9938,5155,15093,397520,206200,603720
11/2/2024,Mahesh Rukshan,Jaffna,Vavuniya,Northern,6803,9267,16070,272120,370680,642800
11/3/2024,Mahesh Rukshan,Jaffna,Vavuniya,Northern,1141,3306,4447,45640,132240,177880
11/4/2024,Mahesh Rukshan,Jaffna,Vavuniya,Northern,6239,4296,10535,249560,171840,421400
11/5/2024,Mahesh Rukshan,Jaffna,Vavuniya,Northern,1312,7262,8574,52480,290480,342960
11/6/2024,Mahesh Rukshan,Jaffna,Vavuniya,Northern,6825,1597,8422,273000,63880,336880
11/7/2024,Mahesh Rukshan,Jaffna,Vavuniya,Northern,1355,7419,8774,54200,296760,350960
11/8/2024,Mahesh Rukshan,Jaffna,Vavuniya,Northern,7397,7923,15320,295880,316920,612800
11/9/2024,Mahesh Rukshan,Jaffna,Vavuniya,Northern,2323,1320,3643,92920,52800,145720
11/10/2024,Mahesh Rukshan,Jaffna,Vavuniya,Northern,825,7094,7919,33000,283760,316760
11/11/2024,Mahesh Rukshan,Jaffna,Vavuniya,Northern,1716,7833,9549,68640,313320,381960
11/12/2024,Mahesh Rukshan,Jaffna,Vavuniya,Northern,8165,8450,16615,326600,338000,664600
11/13/2024,Mahesh Rukshan,Jaffna,Vavuniya,Northern,4496,4867,9363,179840,194680,374520
11/14/2024,Mahesh Rukshan,Jaffna,Vavuniya,Northern,3037,9075,12112,121480,363000,484480
11/15/2024,Mahesh Rukshan,Jaffna,Vavuniya,Northern,3669,5966,9635,146760,238640,385400
11/16/2024,Mahesh Rukshan,Jaffna,Vavuniya,Northern,7247,4954,12201,289880,198160,488040
11/17/2024,Mahesh Rukshan,Jaffna,Vavuniya,Northern,3292,1493,4785,131680,59720,191400
11/18/2024,Mahesh Rukshan,Jaffna,Vavuniya,Northern,6853,5431,12284,274120,217240,491360
11/19/2024,Mahesh Rukshan,Jaffna,Vavuniya,Northern,5066,3969,9035,202640,158760,361400
11/20/2024,Mahesh Rukshan,Jaffna,Vavuniya,Northern,7841,5451,13292,313640,218040,531680
11/21/2024,Mahesh Rukshan,Jaffna,Vavuniya,Northern,9476,5103,14579,379040,204120,583160
11/22/2024,Mahesh Rukshan,Jaffna,Vavuniya,Northern,4116,9201,13317,164640,368040,532680
11/23/2024,Mahesh Rukshan,Jaffna,Vavuniya,Northern,7915,748,8663,316600,29920,346520
11/24/2024,Mahesh Rukshan,Jaffna,Vavuniya,Northern,3439,8087,11526,137560,323480,461040
11/25/2024,Mahesh Rukshan,Jaffna,Vavuniya,Northern,1624,9316,10940,64960,372640,437600
11/26/2024,Mahesh Rukshan,Jaffna,Vavuniya,Northern,1679,9284,10963,67160,371360,438520
11/27/2024,Mahesh Rukshan,Jaffna,Vavuniya,Northern,1627,5223,6850,65080,208920,274000
11/28/2024,Mahesh Rukshan,Jaffna,Vavuniya,Northern,7174,2331,9505,286960,93240,380200
11/29/2024,Mahesh Rukshan,Jaffna,Vavuniya,Northern,2308,8539,10847,92320,341560,433880
11/30/2024,Mahesh Rukshan,Jaffna,Vavuniya,Northern,8558,4940,13498,342320,197600,539920
12/1/2024,Mahesh Rukshan,Jaffna,Vavuniya,Northern,7082,5175,12257,283280,207000,490280
12/2/2024,Mahesh Rukshan,Jaffna,Vavuniya,Northern,3012,3884,6896,120480,155360,275840
12/3/2024,Mahesh Rukshan,Jaffna,Vavuniya,Northern,2929,1477,4406,117160,59080,176240
12/4/2024,Mahesh Rukshan,Jaffna,Vavuniya,Northern,7973,4121,12094,318920,164840,483760
12/5/2024,Mahesh Rukshan,Jaffna,Vavuniya,Northern,4973,1957,6930,198920,78280,277200
12/6/2024,Mahesh Rukshan,Jaffna,Vavuniya,Northern,1340,3641,4981,53600,145640,199240
12/7/2024,Mahesh Rukshan,Jaffna,Vavuniya,Northern,9021,8423,17444,360840,336920,697760
12/8/2024,Mahesh Rukshan,Jaffna,Vavuniya,Northern,7482,8146,15628,299280,325840,625120
12/9/2024,Mahesh Rukshan,Jaffna,Vavuniya,Northern,9054,6470,15524,362160,258800,620960
12/10/2024,Mahesh Rukshan,Jaffna,Vavuniya,Northern,7426,3434,10860,297040,137360,434400
12/11/2024,Mahesh Rukshan,Jaffna,Vavuniya,Northern,2528,3274,5802,101120,130960,232080
12/12/2024,Mahesh Rukshan,Jaffna,Vavuniya,Northern,6707,5148,11855,268280,205920,474200
12/13/2024,Mahesh Rukshan,Jaffna,Vavuniya,Northern,6107,1513,7620,244280,60520,304800
12/14/2024,Mahesh Rukshan,Jaffna,Vavuniya,Northern,1876,4902,6778,75040,196080,271120
12/15/2024,Mahesh Rukshan,Jaffna,Vavuniya,Northern,5243,2484,7727,209720,99360,309080
12/16/2024,Mahesh Rukshan,Jaffna,Vavuniya,Northern,7359,4593,11952,294360,183720,478080
12/17/2024,Mahesh Rukshan,Jaffna,Vavuniya,Northern,4638,9469,14107,185520,378760,564280
12/18/2024,Mahesh Rukshan,Jaffna,Vavuniya,Northern,3981,2814,6795,159240,112560,271800
12/19/2024,Mahesh Rukshan,Jaffna,Vavuniya,Northern,4210,8431,12641,168400,337240,505640
12/20/2024,Mahesh Rukshan,Jaffna,Vavuniya,Northern,7671,8930,16601,306840,357200,664040
12/21/2024,Mahesh Rukshan,Jaffna,Vavuniya,Northern,9610,3501,13111,384400,140040,524440
12/22/2024,Mahesh Rukshan,Jaffna,Vavuniya,Northern,3710,1396,5106,148400,55840,204240
12/23/2024,Mahesh Rukshan,Jaffna,Vavuniya,Northern,6915,2013,8928,276600,80520,357120
12/24/2024,Mahesh Rukshan,Jaffna,Vavuniya,Northern,1081,6384,7465,43240,255360,298600
12/25/2024,Mahesh Rukshan,Jaffna,Vavuniya,Northern,7013,9998,17011,280520,399920,680440
12/26/2024,Mahesh Rukshan,Jaffna,Vavuniya,Northern,9511,2709,12220,380440,108360,488800
12/27/2024,Mahesh Rukshan,Jaffna,Vavuniya,Northern,821,4233,5054,32840,169320,202160
12/28/2024,Mahesh Rukshan,Jaffna,Vavuniya,Northern,7466,1128,8594,298640,45120,343760
12/29/2024,Mahesh Rukshan,Jaffna,Vavuniya,Northern,1247,3918,5165,49880,156720,206600
12/30/2024,Mahesh Rukshan,Jaffna,Vavuniya,Northern,3700,5407,9107,148000,216280,364280
12/31/2024,Mahesh Rukshan,Jaffna,Vavuniya,Northern,4049,4290,8339,161960,171600,333560
1/1/2025,Mahesh Rukshan,Jaffna,Vavuniya,Northern,8427,2872,11299,337080,114880,451960
1/2/2025,Mahesh Rukshan,Jaffna,Vavuniya,Northern,9131,7328,16459,365240,293120,658360
1/3/2025,Mahesh Rukshan,Jaffna,Vavuniya,Northern,9952,7127,17079,398080,285080,683160
1/4/2025,Mahesh Rukshan,Jaffna,Vavuniya,Northern,2195,1943,4138,87800,77720,165520
1/5/2025,Mahesh Rukshan,Jaffna,Vavuniya,Northern,8665,6836,15501,346600,273440,620040
1/6/2025,Mahesh Rukshan,Jaffna,Vavuniya,Northern,9206,3797,13003,368240,151880,520120
1/7/2025,Mahesh Rukshan,Jaffna,Vavuniya,Northern,4609,8037,12646,184360,321480,505840
1/8/2025,Mahesh Rukshan,Jaffna,Vavuniya,Northern,6402,9598,16000,256080,383920,640000
1/9/2025,Mahesh Rukshan,Jaffna,Vavuniya,Northern,9865,2246,12111,394600,89840,484440
1/10/2025,Mahesh Rukshan,Jaffna,Vavuniya,Northern,2114,9479,11593,84560,379160,463720
1/11/2025,Mahesh Rukshan,Jaffna,Vavuniya,Northern,2590,5079,7669,103600,203160,306760
1/12/2025,Mahesh Rukshan,Jaffna,Vavuniya,Northern,1100,3872,4972,44000,154880,198880
1/13/2025,Mahesh Rukshan,Jaffna,Vavuniya,Northern,5549,6354,11903,221960,254160,476120
1/14/2025,Mahesh Rukshan,Jaffna,Vavuniya,Northern,8972,1056,10028,358880,42240,401120
1/15/2025,Mahesh Rukshan,Jaffna,Vavuniya,Northern,7609,8847,16456,304360,353880,658240
1/16/2025,Mahesh Rukshan,Jaffna,Vavuniya,Northern,5795,7948,13743,231800,317920,549720
1/17/2025,Mahesh Rukshan,Jaffna,Vavuniya,Northern,1148,2139,3287,45920,85560,131480
1/18/2025,Mahesh Rukshan,Jaffna,Vavuniya,Northern,8240,3770,12010,329600,150800,480400
1/19/2025,Mahesh Rukshan,Jaffna,Vavuniya,Northern,8996,4087,13083,359840,163480,523320
1/20/2025,Mahesh Rukshan,Jaffna,Vavuniya,Northern,4179,747,4926,167160,29880,197040
1/21/2025,Mahesh Rukshan,Jaffna,Vavuniya,Northern,4169,7007,11176,166760,280280,447040
1/22/2025,Mahesh Rukshan,Jaffna,Vavuniya,Northern,235,6361,6596,9400,254440,263840
1/23/2025,Mahesh Rukshan,Jaffna,Vavuniya,Northern,6884,3597,10481,275360,143880,419240
1/24/2025,Mahesh Rukshan,Jaffna,Vavuniya,Northern,5233,9889,15122,209320,395560,604880
1/25/2025,Mahesh Rukshan,Jaffna,Vavuniya,Northern,5554,675,6229,222160,27000,249160
1/26/2025,Mahesh Rukshan,Jaffna,Vavuniya,Northern,6355,2269,8624,254200,90760,344960
1/27/2025,Mahesh Rukshan,Jaffna,Vavuniya,Northern,7,7269,7276,280,290760,291040
1/28/2025,Mahesh Rukshan,Jaffna,Vavuniya,Northern,1997,7130,9127,79880,285200,365080
1/29/2025,Mahesh Rukshan,Jaffna,Vavuniya,Northern,8528,2358,10886,341120,94320,435440
1/30/2025,Mahesh Rukshan,Jaffna,Vavuniya,Northern,4813,9429,14242,192520,377160,569680
1/31/2025,Mahesh Rukshan,Jaffna,Vavuniya,Northern,4414,7218,11632,176560,288720,465280
2/1/2025,Mahesh Rukshan,Jaffna,Vavuniya,Northern,646,7066,7712,25840,282640,308480
2/2/2025,Mahesh Rukshan,Jaffna,Vavuniya,Northern,7853,7625,15478,314120,305000,619120
2/3/2025,Mahesh Rukshan,Jaffna,Vavuniya,Northern,6369,8477,14846,254760,339080,593840
2/4/2025,Mahesh Rukshan,Jaffna,Vavuniya,Northern,8776,6451,15227,351040,258040,609080
2/5/2025,Mahesh Rukshan,Jaffna,Vavuniya,Northern,6460,253,6713,258400,10120,268520
2/6/2025,Mahesh Rukshan,Jaffna,Vavuniya,Northern,9031,1919,10950,361240,76760,438000
2/7/2025,Mahesh Rukshan,Jaffna,Vavuniya,Northern,9872,8571,18443,394880,342840,737720
2/8/2025,Mahesh Rukshan,Jaffna,Vavuniya,Northern,8930,5763,14693,357200,230520,587720
2/9/2025,Mahesh Rukshan,Jaffna,Vavuniya,Northern,9801,7251,17052,392040,290040,682080
2/10/2025,Mahesh Rukshan,Jaffna,Vavuniya,Northern,6211,3648,9859,248440,145920,394360
2/11/2025,Mahesh Rukshan,Jaffna,Vavuniya,Northern,3526,5635,9161,141040,225400,366440
2/12/2025,Mahesh Rukshan,Jaffna,Vavuniya,Northern,5081,142,5223,203240,5680,208920
2/13/2025,Mahesh Rukshan,Jaffna,Vavuniya,Northern,729,4716,5445,29160,188640,217800
2/14/2025,Mahesh Rukshan,Jaffna,Vavuniya,Northern,1752,5316,7068,70080,212640,282720
2/15/2025,Mahesh Rukshan,Jaffna,Vavuniya,Northern,9202,2516,11718,368080,100640,468720
2/16/2025,Mahesh Rukshan,Jaffna,Vavuniya,Northern,7250,527,7777,290000,21080,311080
2/17/2025,Mahesh Rukshan,Jaffna,Vavuniya,Northern,7250,8277,15527,290000,331080,621080
2/18/2025,Mahesh Rukshan,Jaffna,Vavuniya,Northern,2611,98,2709,104440,3920,108360
2/19/2025,Mahesh Rukshan,Jaffna,Vavuniya,Northern,5276,5043,10319,211040,201720,412760
2/20/2025,Mahesh Rukshan,Jaffna,Vavuniya,Northern,5321,3408,8729,212840,136320,349160
2/21/2025,Mahesh Rukshan,Jaffna,Vavuniya,Northern,4814,7958,12772,192560,318320,510880
2/22/2025,Mahesh Rukshan,Jaffna,Vavuniya,Northern,9202,6371,15573,368080,254840,622920
2/23/2025,Mahesh Rukshan,Jaffna,Vavuniya,Northern,4903,1327,6230,196120,53080,249200
2/24/2025,Mahesh Rukshan,Jaffna,Vavuniya,Northern,2134,2460,4594,85360,98400,183760
2/25/2025,Mahesh Rukshan,Jaffna,Vavuniya,Northern,5370,5730,11100,214800,229200,444000
2/26/2025,Mahesh Rukshan,Jaffna,Vavuniya,Northern,1231,2230,3461,49240,89200,138440
2/27/2025,Mahesh Rukshan,Jaffna,Vavuniya,Northern,7320,7851,15171,292800,314040,606840
2/28/2025,Mahesh Rukshan,Jaffna,Vavuniya,Northern,7936,9416,17352,317440,376640,694080
3/1/2025,Mahesh Rukshan,Jaffna,Vavuniya,Northern,7534,7510,15044,301360,300400,601760
3/2/2025,Mahesh Rukshan,Jaffna,Vavuniya,Northern,1662,3584,5246,66480,143360,209840
3/3/2025,Mahesh Rukshan,Jaffna,Vavuniya,Northern,2990,1888,4878,119600,75520,195120
3/4/2025,Mahesh Rukshan,Jaffna,Vavuniya,Northern,10,30,40,400,1200,1600
3/5/2025,Mahesh Rukshan,Jaffna,Vavuniya,Northern,3503,4940,8443,140120,197600,337720
3/6/2025,Mahesh Rukshan,Jaffna,Vavuniya,Northern,3454,554,4008,138160,22160,160320
3/7/2025,Mahesh Rukshan,Jaffna,Vavuniya,Northern,7690,7628,15318,307600,305120,612720
3/8/2025,Mahesh Rukshan,Jaffna,Vavuniya,Northern,3848,6323,10171,153920,252920,406840
3/9/2025,Mahesh Rukshan,Jaffna,Vavuniya,Northern,9387,8759,18146,375480,350360,725840
3/10/2025,Mahesh Rukshan,Jaffna,Vavuniya,Northern,7735,5597,13332,309400,223880,533280
3/11/2025,Mahesh Rukshan,Jaffna,Vavuniya,Northern,8988,8963,17951,359520,358520,718040
3/12/2025,Mahesh Rukshan,Jaffna,Vavuniya,Northern,675,6539,7214,27000,261560,288560
3/13/2025,Mahesh Rukshan,Jaffna,Vavuniya,Northern,2723,1162,3885,108920,46480,155400
3/14/2025,Mahesh Rukshan,Jaffna,Vavuniya,Northern,4743,9257,14000,189720,370280,560000
3/15/2025,Mahesh Rukshan,Jaffna,Vavuniya,Northern,3653,1183,4836,146120,47320,193440
3/16/2025,Mahesh Rukshan,Jaffna,Vavuniya,Northern,7076,1273,8349,283040,50920,333960
3/17/2025,Mahesh Rukshan,Jaffna,Vavuniya,Northern,8810,2740,11550,352400,109600,462000
3/18/2025,Mahesh Rukshan,Jaffna,Vavuniya,Northern,6450,1894,8344,258000,75760,333760
3/19/2025,Mahesh Rukshan,Jaffna,Vavuniya,Northern,8510,6391,14901,340400,255640,596040
3/20/2025,Mahesh Rukshan,Jaffna,Vavuniya,Northern,3369,785,4154,134760,31400,166160
3/21/2025,Mahesh Rukshan,Jaffna,Vavuniya,Northern,6330,9279,15609,253200,371160,624360
3/22/2025,Mahesh Rukshan,Jaffna,Vavuniya,Northern,220,4582,4802,8800,183280,192080
3/23/2025,Mahesh Rukshan,Jaffna,Vavuniya,Northern,6843,5333,12176,273720,213320,487040
3/25/2024,Nadeesha Wijesuriya,Ratnapura,Kuruwita,Sabaragamuwa,112,961,1073,4480,38440,42920
3/26/2024,Nadeesha Wijesuriya,Ratnapura,Kuruwita,Sabaragamuwa,6731,5270,12001,269240,210800,480040
3/27/2024,Nadeesha Wijesuriya,Ratnapura,Kuruwita,Sabaragamuwa,4575,663,5238,183000,26520,209520
3/28/2024,Nadeesha Wijesuriya,Ratnapura,Kuruwita,Sabaragamuwa,4248,2360,6608,169920,94400,264320
3/29/2024,Nadeesha Wijesuriya,Ratnapura,Kuruwita,Sabaragamuwa,6925,7088,14013,277000,283520,560520
3/30/2024,Nadeesha Wijesuriya,Ratnapura,Kuruwita,Sabaragamuwa,481,6350,6831,19240,254000,273240
3/31/2024,Nadeesha Wijesuriya,Ratnapura,Kuruwita,Sabaragamuwa,9537,2986,12523,381480,119440,500920
4/1/2024,Nadeesha Wijesuriya,Ratnapura,Kuruwita,Sabaragamuwa,5532,5768,11300,221280,230720,452000
4/2/2024,Nadeesha Wijesuriya,Ratnapura,Kuruwita,Sabaragamuwa,1469,302,1771,58760,12080,70840
4/3/2024,Nadeesha Wijesuriya,Ratnapura,Kuruwita,Sabaragamuwa,3055,7923,10978,122200,316920,439120
4/4/2024,Nadeesha Wijesuriya,Ratnapura,Kuruwita,Sabaragamuwa,8786,5790,14576,351440,231600,583040
4/5/2024,Nadeesha Wijesuriya,Ratnapura,Kuruwita,Sabaragamuwa,3244,309,3553,129760,12360,142120
4/6/2024,Nadeesha Wijesuriya,Ratnapura,Kuruwita,Sabaragamuwa,2346,7272,9618,93840,290880,384720
4/7/2024,Nadeesha Wijesuriya,Ratnapura,Kuruwita,Sabaragamuwa,741,688,1429,29640,27520,57160
4/8/2024,Nadeesha Wijesuriya,Ratnapura,Kuruwita,Sabaragamuwa,3412,5127,8539,136480,205080,341560
4/9/2024,Nadeesha Wijesuriya,Ratnapura,Kuruwita,Sabaragamuwa,3113,4893,8006,124520,195720,320240
4/10/2024,Nadeesha Wijesuriya,Ratnapura,Kuruwita,Sabaragamuwa,1407,5841,7248,56280,233640,289920
4/11/2024,Nadeesha Wijesuriya,Ratnapura,Kuruwita,Sabaragamuwa,9059,811,9870,362360,32440,394800
4/19/2024,Nadeesha Wijesuriya,Ratnapura,Kuruwita,Sabaragamuwa,5290,1688,6978,211600,67520,279120
4/20/2024,Nadeesha Wijesuriya,Ratnapura,Kuruwita,Sabaragamuwa,5158,2532,7690,206320,101280,307600
4/21/2024,Nadeesha Wijesuriya,Ratnapura,Kuruwita,Sabaragamuwa,3519,9600,13119,140760,384000,524760
4/22/2024,Nadeesha Wijesuriya,Ratnapura,Kuruwita,Sabaragamuwa,8036,6671,14707,321440,266840,588280
4/23/2024,Nadeesha Wijesuriya,Ratnapura,Kuruwita,Sabaragamuwa,168,8505,8673,6720,340200,346920
4/24/2024,Nadeesha Wijesuriya,Ratnapura,Kuruwita,Sabaragamuwa,8028,5463,13491,321120,218520,539640
4/25/2024,Nadeesha Wijesuriya,Ratnapura,Kuruwita,Sabaragamuwa,4879,4694,9573,195160,187760,382920
4/26/2024,Nadeesha Wijesuriya,Ratnapura,Kuruwita,Sabaragamuwa,9985,3305,13290,399400,132200,531600
4/27/2024,Nadeesha Wijesuriya,Ratnapura,Kuruwita,Sabaragamuwa,8884,1839,10723,355360,73560,428920
4/28/2024,Nadeesha Wijesuriya,Ratnapura,Kuruwita,Sabaragamuwa,5309,9107,14416,212360,364280,576640
4/29/2024,Nadeesha Wijesuriya,Ratnapura,Kuruwita,Sabaragamuwa,7406,9750,17156,296240,390000,686240
4/30/2024,Nadeesha Wijesuriya,Ratnapura,Kuruwita,Sabaragamuwa,2116,7156,9272,84640,286240,370880
5/1/2024,Nadeesha Wijesuriya,Ratnapura,Kuruwita,Sabaragamuwa,8921,7148,16069,356840,285920,642760
5/2/2024,Nadeesha Wijesuriya,Ratnapura,Kuruwita,Sabaragamuwa,8463,7433,15896,338520,297320,635840
5/3/2024,Nadeesha Wijesuriya,Ratnapura,Kuruwita,Sabaragamuwa,206,8409,8615,8240,336360,344600
5/4/2024,Nadeesha Wijesuriya,Ratnapura,Kuruwita,Sabaragamuwa,7778,708,8486,311120,28320,339440
5/5/2024,Nadeesha Wijesuriya,Ratnapura,Kuruwita,Sabaragamuwa,1714,5323,7037,68560,212920,281480
5/6/2024,Nadeesha Wijesuriya,Ratnapura,Kuruwita,Sabaragamuwa,7857,3415,11272,314280,136600,450880
5/7/2024,Nadeesha Wijesuriya,Ratnapura,Kuruwita,Sabaragamuwa,5910,3109,9019,236400,124360,360760
5/8/2024,Nadeesha Wijesuriya,Ratnapura,Kuruwita,Sabaragamuwa,1852,4776,6628,74080,191040,265120
5/9/2024,Nadeesha Wijesuriya,Ratnapura,Kuruwita,Sabaragamuwa,3053,5080,8133,122120,203200,325320
5/10/2024,Nadeesha Wijesuriya,Ratnapura,Kuruwita,Sabaragamuwa,9870,4501,14371,394800,180040,574840
5/11/2024,Nadeesha Wijesuriya,Ratnapura,Kuruwita,Sabaragamuwa,389,1653,2042,15560,66120,81680
5/12/2024,Nadeesha Wijesuriya,Ratnapura,Kuruwita,Sabaragamuwa,6482,6492,12974,259280,259680,518960
5/13/2024,Nadeesha Wijesuriya,Ratnapura,Kuruwita,Sabaragamuwa,2429,6925,9354,97160,277000,374160
5/14/2024,Nadeesha Wijesuriya,Ratnapura,Kuruwita,Sabaragamuwa,3753,9066,12819,150120,362640,512760
5/15/2024,Nadeesha Wijesuriya,Ratnapura,Kuruwita,Sabaragamuwa,6384,3109,9493,255360,124360,379720
5/16/2024,Nadeesha Wijesuriya,Ratnapura,Kuruwita,Sabaragamuwa,3438,3499,6937,137520,139960,277480
5/17/2024,Nadeesha Wijesuriya,Ratnapura,Kuruwita,Sabaragamuwa,217,9525,9742,8680,381000,389680
5/18/2024,Nadeesha Wijesuriya,Ratnapura,Kuruwita,Sabaragamuwa,6543,2126,8669,261720,85040,346760
5/19/2024,Nadeesha Wijesuriya,Ratnapura,Kuruwita,Sabaragamuwa,4783,1112,5895,191320,44480,235800
5/20/2024,Nadeesha Wijesuriya,Ratnapura,Kuruwita,Sabaragamuwa,5645,2171,7816,225800,86840,312640
5/21/2024,Nadeesha Wijesuriya,Ratnapura,Kuruwita,Sabaragamuwa,1524,8486,10010,60960,339440,400400
5/22/2024,Nadeesha Wijesuriya,Ratnapura,Kuruwita,Sabaragamuwa,7616,7687,15303,304640,307480,612120
5/24/2024,Nadeesha Wijesuriya,Ratnapura,Kuruwita,Sabaragamuwa,6435,22,6457,257400,880,258280
5/25/2024,Nadeesha Wijesuriya,Ratnapura,Kuruwita,Sabaragamuwa,1124,6351,7475,44960,254040,299000
5/26/2024,Nadeesha Wijesuriya,Ratnapura,Kuruwita,Sabaragamuwa,6703,381,7084,268120,15240,283360
5/27/2024,Nadeesha Wijesuriya,Ratnapura,Kuruwita,Sabaragamuwa,9649,7639,17288,385960,305560,691520
5/28/2024,Nadeesha Wijesuriya,Ratnapura,Kuruwita,Sabaragamuwa,2693,8617,11310,107720,344680,452400
5/29/2024,Nadeesha Wijesuriya,Ratnapura,Kuruwita,Sabaragamuwa,2534,5880,8414,101360,235200,336560
5/30/2024,Nadeesha Wijesuriya,Ratnapura,Kuruwita,Sabaragamuwa,2335,2291,4626,93400,91640,185040
5/31/2024,Nadeesha Wijesuriya,Ratnapura,Kuruwita,Sabaragamuwa,7736,386,8122,309440,15440,324880
6/1/2024,Nadeesha Wijesuriya,Ratnapura,Kuruwita,Sabaragamuwa,864,881,1745,34560,35240,69800
6/2/2024,Nadeesha Wijesuriya,Ratnapura,Kuruwita,Sabaragamuwa,3828,968,4796,153120,38720,191840
6/3/2024,Nadeesha Wijesuriya,Ratnapura,Kuruwita,Sabaragamuwa,6054,7767,13821,242160,310680,552840
6/4/2024,Nadeesha Wijesuriya,Ratnapura,Kuruwita,Sabaragamuwa,7078,870,7948,283120,34800,317920
6/5/2024,Nadeesha Wijesuriya,Ratnapura,Kuruwita,Sabaragamuwa,5650,1036,6686,226000,41440,267440
6/6/2024,Nadeesha Wijesuriya,Ratnapura,Kuruwita,Sabaragamuwa,7020,297,7317,280800,11880,292680
6/7/2024,Nadeesha Wijesuriya,Ratnapura,Kuruwita,Sabaragamuwa,3801,5488,9289,152040,219520,371560
6/8/2024,Nadeesha Wijesuriya,Ratnapura,Kuruwita,Sabaragamuwa,6358,1470,7828,254320,58800,313120
6/9/2024,Nadeesha Wijesuriya,Ratnapura,Kuruwita,Sabaragamuwa,8006,9317,17323,320240,372680,692920
6/10/2024,Nadeesha Wijesuriya,Ratnapura,Kuruwita,Sabaragamuwa,8865,2264,11129,354600,90560,445160
6/11/2024,Nadeesha Wijesuriya,Ratnapura,Kuruwita,Sabaragamuwa,8826,9441,18267,353040,377640,730680
6/12/2024,Nadeesha Wijesuriya,Ratnapura,Kuruwita,Sabaragamuwa,9825,1368,11193,393000,54720,447720
6/13/2024,Nadeesha Wijesuriya,Ratnapura,Kuruwita,Sabaragamuwa,5898,7130,13028,235920,285200,521120
6/14/2024,Nadeesha Wijesuriya,Ratnapura,Kuruwita,Sabaragamuwa,4906,7820,12726,196240,312800,509040
6/15/2024,Nadeesha Wijesuriya,Ratnapura,Kuruwita,Sabaragamuwa,9403,8173,17576,376120,326920,703040
6/16/2024,Nadeesha Wijesuriya,Ratnapura,Kuruwita,Sabaragamuwa,4199,2187,6386,167960,87480,255440
6/17/2024,Nadeesha Wijesuriya,Ratnapura,Kuruwita,Sabaragamuwa,4868,5026,9894,194720,201040,395760
6/18/2024,Nadeesha Wijesuriya,Ratnapura,Kuruwita,Sabaragamuwa,1808,9341,11149,72320,373640,445960
6/19/2024,Nadeesha Wijesuriya,Ratnapura,Kuruwita,Sabaragamuwa,4553,4856,9409,182120,194240,376360
6/20/2024,Nadeesha Wijesuriya,Ratnapura,Kuruwita,Sabaragamuwa,5743,9948,15691,229720,397920,627640
6/21/2024,Nadeesha Wijesuriya,Ratnapura,Kuruwita,Sabaragamuwa,1633,7703,9336,65320,308120,373440
6/22/2024,Nadeesha Wijesuriya,Ratnapura,Kuruwita,Sabaragamuwa,8751,600,9351,350040,24000,374040
6/23/2024,Nadeesha Wijesuriya,Ratnapura,Kuruwita,Sabaragamuwa,3048,606,3654,121920,24240,146160
6/24/2024,Nadeesha Wijesuriya,Ratnapura,Kuruwita,Sabaragamuwa,3950,9653,13603,158000,386120,544120
6/25/2024,Nadeesha Wijesuriya,Ratnapura,Kuruwita,Sabaragamuwa,213,7391,7604,8520,295640,304160
6/26/2024,Nadeesha Wijesuriya,Ratnapura,Kuruwita,Sabaragamuwa,2326,6525,8851,93040,261000,354040
6/27/2024,Nadeesha Wijesuriya,Ratnapura,Kuruwita,Sabaragamuwa,4542,9523,14065,181680,380920,562600
6/28/2024,Nadeesha Wijesuriya,Ratnapura,Kuruwita,Sabaragamuwa,2526,7357,9883,101040,294280,395320
6/29/2024,Nadeesha Wijesuriya,Ratnapura,Kuruwita,Sabaragamuwa,6268,9850,16118,250720,394000,644720
6/30/2024,Nadeesha Wijesuriya,Ratnapura,Kuruwita,Sabaragamuwa,2996,5808,8804,119840,232320,352160
7/1/2024,Nadeesha Wijesuriya,Ratnapura,Kuruwita,Sabaragamuwa,138,9059,9197,5520,362360,367880
7/2/2024,Nadeesha Wijesuriya,Ratnapura,Kuruwita,Sabaragamuwa,8589,696,9285,343560,27840,371400
7/3/2024,Nadeesha Wijesuriya,Ratnapura,Kuruwita,Sabaragamuwa,1288,9874,11162,51520,394960,446480
7/4/2024,Nadeesha Wijesuriya,Ratnapura,Kuruwita,Sabaragamuwa,3703,8039,11742,148120,321560,469680
7/5/2024,Nadeesha Wijesuriya,Ratnapura,Kuruwita,Sabaragamuwa,4551,2478,7029,182040,99120,281160
7/6/2024,Nadeesha Wijesuriya,Ratnapura,Kuruwita,Sabaragamuwa,9814,8500,18314,392560,340000,732560
7/7/2024,Nadeesha Wijesuriya,Ratnapura,Kuruwita,Sabaragamuwa,4175,9342,13517,167000,373680,540680
7/8/2024,Nadeesha Wijesuriya,Ratnapura,Kuruwita,Sabaragamuwa,3621,9913,13534,144840,396520,541360
7/9/2024,Nadeesha Wijesuriya,Ratnapura,Kuruwita,Sabaragamuwa,9105,1510,10615,364200,60400,424600
7/10/2024,Nadeesha Wijesuriya,Ratnapura,Kuruwita,Sabaragamuwa,3047,7778,10825,121880,311120,433000
7/11/2024,Nadeesha Wijesuriya,Ratnapura,Kuruwita,Sabaragamuwa,6188,3068,9256,247520,122720,370240
7/12/2024,Nadeesha Wijesuriya,Ratnapura,Kuruwita,Sabaragamuwa,7200,1618,8818,288000,64720,352720
7/13/2024,Nadeesha Wijesuriya,Ratnapura,Kuruwita,Sabaragamuwa,3835,71,3906,153400,2840,156240
7/14/2024,Nadeesha Wijesuriya,Ratnapura,Kuruwita,Sabaragamuwa,5945,9031,14976,237800,361240,599040
7/15/2024,Nadeesha Wijesuriya,Ratnapura,Kuruwita,Sabaragamuwa,4991,7682,12673,199640,307280,506920
7/16/2024,Nadeesha Wijesuriya,Ratnapura,Kuruwita,Sabaragamuwa,4615,5515,10130,184600,220600,405200
7/17/2024,Nadeesha Wijesuriya,Ratnapura,Kuruwita,Sabaragamuwa,6826,6442,13268,273040,257680,530720
7/18/2024,Nadeesha Wijesuriya,Ratnapura,Kuruwita,Sabaragamuwa,2063,5733,7796,82520,229320,311840
7/19/2024,Nadeesha Wijesuriya,Ratnapura,Kuruwita,Sabaragamuwa,2387,8936,11323,95480,357440,452920
7/20/2024,Nadeesha Wijesuriya,Ratnapura,Kuruwita,Sabaragamuwa,3675,1652,5327,147000,66080,213080
7/21/2024,Nadeesha Wijesuriya,Ratnapura,Kuruwita,Sabaragamuwa,8837,573,9410,353480,22920,376400
7/22/2024,Nadeesha Wijesuriya,Ratnapura,Kuruwita,Sabaragamuwa,5652,7849,13501,226080,313960,540040
7/23/2024,Nadeesha Wijesuriya,Ratnapura,Kuruwita,Sabaragamuwa,8288,4829,13117,331520,193160,524680
7/24/2024,Nadeesha Wijesuriya,Ratnapura,Kuruwita,Sabaragamuwa,6207,437,6644,248280,17480,265760
7/25/2024,Nadeesha Wijesuriya,Ratnapura,Kuruwita,Sabaragamuwa,2858,2792,5650,114320,111680,226000
7/26/2024,Nadeesha Wijesuriya,Ratnapura,Kuruwita,Sabaragamuwa,5460,3244,8704,218400,129760,348160
7/27/2024,Nadeesha Wijesuriya,Ratnapura,Kuruwita,Sabaragamuwa,5180,5274,10454,207200,210960,418160
7/28/2024,Nadeesha Wijesuriya,Ratnapura,Kuruwita,Sabaragamuwa,5344,8561,13905,213760,342440,556200
7/29/2024,Nadeesha Wijesuriya,Ratnapura,Kuruwita,Sabaragamuwa,2467,4798,7265,98680,191920,290600
7/30/2024,Nadeesha Wijesuriya,Ratnapura,Kuruwita,Sabaragamuwa,7727,4006,11733,309080,160240,469320
7/31/2024,Nadeesha Wijesuriya,Ratnapura,Kuruwita,Sabaragamuwa,6570,9659,16229,262800,386360,649160
8/1/2024,Nadeesha Wijesuriya,Ratnapura,Kuruwita,Sabaragamuwa,4389,3239,7628,175560,129560,305120
8/2/2024,Nadeesha Wijesuriya,Ratnapura,Kuruwita,Sabaragamuwa,8866,4389,13255,354640,175560,530200
8/3/2024,Nadeesha Wijesuriya,Ratnapura,Kuruwita,Sabaragamuwa,105,7659,7764,4200,306360,310560
8/4/2024,Nadeesha Wijesuriya,Ratnapura,Kuruwita,Sabaragamuwa,2948,144,3092,117920,5760,123680
8/5/2024,Nadeesha Wijesuriya,Ratnapura,Kuruwita,Sabaragamuwa,4698,7399,12097,187920,295960,483880
8/6/2024,Nadeesha Wijesuriya,Ratnapura,Kuruwita,Sabaragamuwa,2935,5168,8103,117400,206720,324120
8/7/2024,Nadeesha Wijesuriya,Ratnapura,Kuruwita,Sabaragamuwa,3473,711,4184,138920,28440,167360
8/8/2024,Nadeesha Wijesuriya,Ratnapura,Kuruwita,Sabaragamuwa,3880,3131,7011,155200,125240,280440
8/9/2024,Nadeesha Wijesuriya,Ratnapura,Kuruwita,Sabaragamuwa,7462,2877,10339,298480,115080,413560
8/10/2024,Nadeesha Wijesuriya,Ratnapura,Kuruwita,Sabaragamuwa,7549,5561,13110,301960,222440,524400
8/11/2024,Nadeesha Wijesuriya,Ratnapura,Kuruwita,Sabaragamuwa,9896,3412,13308,395840,136480,532320
8/12/2024,Nadeesha Wijesuriya,Ratnapura,Kuruwita,Sabaragamuwa,3983,8583,12566,159320,343320,502640
8/13/2024,Nadeesha Wijesuriya,Ratnapura,Kuruwita,Sabaragamuwa,442,6723,7165,17680,268920,286600
8/14/2024,Nadeesha Wijesuriya,Ratnapura,Kuruwita,Sabaragamuwa,9346,8167,17513,373840,326680,700520
8/15/2024,Nadeesha Wijesuriya,Ratnapura,Kuruwita,Sabaragamuwa,1194,6171,7365,47760,246840,294600
8/16/2024,Nadeesha Wijesuriya,Ratnapura,Kuruwita,Sabaragamuwa,9883,7542,17425,395320,301680,697000
8/17/2024,Nadeesha Wijesuriya,Ratnapura,Kuruwita,Sabaragamuwa,9935,3951,13886,397400,158040,555440
8/18/2024,Nadeesha Wijesuriya,Ratnapura,Kuruwita,Sabaragamuwa,2842,6968,9810,113680,278720,392400
8/19/2024,Nadeesha Wijesuriya,Ratnapura,Kuruwita,Sabaragamuwa,4153,8386,12539,166120,335440,501560
8/20/2024,Nadeesha Wijesuriya,Ratnapura,Kuruwita,Sabaragamuwa,7625,8452,16077,305000,338080,643080
8/21/2024,Nadeesha Wijesuriya,Ratnapura,Kuruwita,Sabaragamuwa,7728,4275,12003,309120,171000,480120
8/22/2024,Nadeesha Wijesuriya,Ratnapura,Kuruwita,Sabaragamuwa,602,9880,10482,24080,395200,419280
8/23/2024,Nadeesha Wijesuriya,Ratnapura,Kuruwita,Sabaragamuwa,4698,4334,9032,187920,173360,361280
8/24/2024,Nadeesha Wijesuriya,Ratnapura,Kuruwita,Sabaragamuwa,7426,7954,15380,297040,318160,615200
8/25/2024,Nadeesha Wijesuriya,Ratnapura,Kuruwita,Sabaragamuwa,7180,9001,16181,287200,360040,647240
8/26/2024,Nadeesha Wijesuriya,Ratnapura,Kuruwita,Sabaragamuwa,8880,2484,11364,355200,99360,454560
8/27/2024,Nadeesha Wijesuriya,Ratnapura,Kuruwita,Sabaragamuwa,1276,3927,5203,51040,157080,208120
8/28/2024,Nadeesha Wijesuriya,Ratnapura,Kuruwita,Sabaragamuwa,9721,8553,18274,388840,342120,730960
8/29/2024,Nadeesha Wijesuriya,Ratnapura,Kuruwita,Sabaragamuwa,8840,3552,12392,353600,142080,495680
8/30/2024,Nadeesha Wijesuriya,Ratnapura,Kuruwita,Sabaragamuwa,3701,9320,13021,148040,372800,520840
8/31/2024,Nadeesha Wijesuriya,Ratnapura,Kuruwita,Sabaragamuwa,3052,7582,10634,122080,303280,425360
9/1/2024,Nadeesha Wijesuriya,Ratnapura,Kuruwita,Sabaragamuwa,3098,9707,12805,123920,388280,512200
9/2/2024,Nadeesha Wijesuriya,Ratnapura,Kuruwita,Sabaragamuwa,7596,3411,11007,303840,136440,440280
9/3/2024,Nadeesha Wijesuriya,Ratnapura,Kuruwita,Sabaragamuwa,8904,6439,15343,356160,257560,613720
9/4/2024,Nadeesha Wijesuriya,Ratnapura,Kuruwita,Sabaragamuwa,3230,4499,7729,129200,179960,309160
9/5/2024,Nadeesha Wijesuriya,Ratnapura,Kuruwita,Sabaragamuwa,3846,3728,7574,153840,149120,302960
9/6/2024,Nadeesha Wijesuriya,Ratnapura,Kuruwita,Sabaragamuwa,5062,1424,6486,202480,56960,259440
9/7/2024,Nadeesha Wijesuriya,Ratnapura,Kuruwita,Sabaragamuwa,2873,7487,10360,114920,299480,414400
9/8/2024,Nadeesha Wijesuriya,Ratnapura,Kuruwita,Sabaragamuwa,5543,3048,8591,221720,121920,343640
9/9/2024,Nadeesha Wijesuriya,Ratnapura,Kuruwita,Sabaragamuwa,7519,1628,9147,300760,65120,365880
9/10/2024,Nadeesha Wijesuriya,Ratnapura,Kuruwita,Sabaragamuwa,1139,5968,7107,45560,238720,284280
9/11/2024,Nadeesha Wijesuriya,Ratnapura,Kuruwita,Sabaragamuwa,255,7810,8065,10200,312400,322600
9/12/2024,Nadeesha Wijesuriya,Ratnapura,Kuruwita,Sabaragamuwa,9026,7068,16094,361040,282720,643760
9/13/2024,Nadeesha Wijesuriya,Ratnapura,Kuruwita,Sabaragamuwa,2964,1518,4482,118560,60720,179280
9/14/2024,Nadeesha Wijesuriya,Ratnapura,Kuruwita,Sabaragamuwa,8209,350,8559,328360,14000,342360
9/15/2024,Nadeesha Wijesuriya,Ratnapura,Kuruwita,Sabaragamuwa,2924,212,3136,116960,8480,125440
9/16/2024,Nadeesha Wijesuriya,Ratnapura,Kuruwita,Sabaragamuwa,7841,6673,14514,313640,266920,580560
9/17/2024,Nadeesha Wijesuriya,Ratnapura,Kuruwita,Sabaragamuwa,7319,345,7664,292760,13800,306560
9/18/2024,Nadeesha Wijesuriya,Ratnapura,Kuruwita,Sabaragamuwa,2657,8836,11493,106280,353440,459720
9/19/2024,Nadeesha Wijesuriya,Ratnapura,Kuruwita,Sabaragamuwa,4882,1207,6089,195280,48280,243560
9/20/2024,Nadeesha Wijesuriya,Ratnapura,Kuruwita,Sabaragamuwa,1641,6608,8249,65640,264320,329960
9/21/2024,Nadeesha Wijesuriya,Ratnapura,Kuruwita,Sabaragamuwa,2105,2888,4993,84200,115520,199720
9/22/2024,Nadeesha Wijesuriya,Ratnapura,Kuruwita,Sabaragamuwa,4038,3539,7577,161520,141560,303080
9/23/2024,Nadeesha Wijesuriya,Ratnapura,Kuruwita,Sabaragamuwa,7411,5846,13257,296440,233840,530280
9/24/2024,Nadeesha Wijesuriya,Ratnapura,Kuruwita,Sabaragamuwa,1312,9535,10847,52480,381400,433880
9/25/2024,Nadeesha Wijesuriya,Ratnapura,Kuruwita,Sabaragamuwa,9388,7933,17321,375520,317320,692840
9/26/2024,Nadeesha Wijesuriya,Ratnapura,Kuruwita,Sabaragamuwa,5802,2582,8384,232080,103280,335360
9/27/2024,Nadeesha Wijesuriya,Ratnapura,Kuruwita,Sabaragamuwa,4322,4897,9219,172880,195880,368760
9/28/2024,Nadeesha Wijesuriya,Ratnapura,Kuruwita,Sabaragamuwa,2299,1666,3965,91960,66640,158600
9/29/2024,Nadeesha Wijesuriya,Ratnapura,Kuruwita,Sabaragamuwa,3333,9552,12885,133320,382080,515400
9/30/2024,Nadeesha Wijesuriya,Ratnapura,Kuruwita,Sabaragamuwa,9714,7676,17390,388560,307040,695600
10/1/2024,Nadeesha Wijesuriya,Ratnapura,Kuruwita,Sabaragamuwa,9134,2611,11745,365360,104440,469800
10/2/2024,Nadeesha Wijesuriya,Ratnapura,Kuruwita,Sabaragamuwa,5743,9554,15297,229720,382160,611880
10/3/2024,Nadeesha Wijesuriya,Ratnapura,Kuruwita,Sabaragamuwa,6245,4145,10390,249800,165800,415600
10/4/2024,Nadeesha Wijesuriya,Ratnapura,Kuruwita,Sabaragamuwa,4357,369,4726,174280,14760,189040
10/5/2024,Nadeesha Wijesuriya,Ratnapura,Kuruwita,Sabaragamuwa,1553,6934,8487,62120,277360,339480
10/6/2024,Nadeesha Wijesuriya,Ratnapura,Kuruwita,Sabaragamuwa,1694,8566,10260,67760,342640,410400
10/7/2024,Nadeesha Wijesuriya,Ratnapura,Kuruwita,Sabaragamuwa,4036,3571,7607,161440,142840,304280
10/8/2024,Nadeesha Wijesuriya,Ratnapura,Kuruwita,Sabaragamuwa,4113,7231,11344,164520,289240,453760
10/9/2024,Nadeesha Wijesuriya,Ratnapura,Kuruwita,Sabaragamuwa,8626,8813,17439,345040,352520,697560
10/10/2024,Nadeesha Wijesuriya,Ratnapura,Kuruwita,Sabaragamuwa,1303,5590,6893,52120,223600,275720
10/11/2024,Nadeesha Wijesuriya,Ratnapura,Kuruwita,Sabaragamuwa,7774,1444,9218,310960,57760,368720
10/12/2024,Nadeesha Wijesuriya,Ratnapura,Kuruwita,Sabaragamuwa,612,8556,9168,24480,342240,366720
10/13/2024,Nadeesha Wijesuriya,Ratnapura,Kuruwita,Sabaragamuwa,2293,3278,5571,91720,131120,222840
10/14/2024,Nadeesha Wijesuriya,Ratnapura,Kuruwita,Sabaragamuwa,6907,7330,14237,276280,293200,569480
10/15/2024,Nadeesha Wijesuriya,Ratnapura,Kuruwita,Sabaragamuwa,6021,7519,13540,240840,300760,541600
10/16/2024,Nadeesha Wijesuriya,Ratnapura,Kuruwita,Sabaragamuwa,8214,4764,12978,328560,190560,519120
10/17/2024,Nadeesha Wijesuriya,Ratnapura,Kuruwita,Sabaragamuwa,921,6043,6964,36840,241720,278560
10/18/2024,Nadeesha Wijesuriya,Ratnapura,Kuruwita,Sabaragamuwa,7823,2360,10183,312920,94400,407320
10/19/2024,Nadeesha Wijesuriya,Ratnapura,Kuruwita,Sabaragamuwa,7317,6205,13522,292680,248200,540880
10/20/2024,Nadeesha Wijesuriya,Ratnapura,Kuruwita,Sabaragamuwa,3054,144,3198,122160,5760,127920
10/21/2024,Nadeesha Wijesuriya,Ratnapura,Kuruwita,Sabaragamuwa,9276,3969,13245,371040,158760,529800
10/22/2024,Nadeesha Wijesuriya,Ratnapura,Kuruwita,Sabaragamuwa,7423,2565,9988,296920,102600,399520
10/23/2024,Nadeesha Wijesuriya,Ratnapura,Kuruwita,Sabaragamuwa,4881,8848,13729,195240,353920,549160
10/24/2024,Nadeesha Wijesuriya,Ratnapura,Kuruwita,Sabaragamuwa,1985,3289,5274,79400,131560,210960
10/25/2024,Nadeesha Wijesuriya,Ratnapura,Kuruwita,Sabaragamuwa,2644,9210,11854,105760,368400,474160
10/26/2024,Nadeesha Wijesuriya,Ratnapura,Kuruwita,Sabaragamuwa,3779,178,3957,151160,7120,158280
10/27/2024,Nadeesha Wijesuriya,Ratnapura,Kuruwita,Sabaragamuwa,175,7102,7277,7000,284080,291080
10/28/2024,Nadeesha Wijesuriya,Ratnapura,Kuruwita,Sabaragamuwa,241,4646,4887,9640,185840,195480
10/29/2024,Nadeesha Wijesuriya,Ratnapura,Kuruwita,Sabaragamuwa,3206,1239,4445,128240,49560,177800
10/30/2024,Nadeesha Wijesuriya,Ratnapura,Kuruwita,Sabaragamuwa,6011,5859,11870,240440,234360,474800
10/31/2024,Nadeesha Wijesuriya,Ratnapura,Kuruwita,Sabaragamuwa,8211,2272,10483,328440,90880,419320
11/1/2024,Nadeesha Wijesuriya,Ratnapura,Kuruwita,Sabaragamuwa,3483,2629,6112,139320,105160,244480
11/2/2024,Nadeesha Wijesuriya,Ratnapura,Kuruwita,Sabaragamuwa,3624,2909,6533,144960,116360,261320
11/3/2024,Nadeesha Wijesuriya,Ratnapura,Kuruwita,Sabaragamuwa,6022,8877,14899,240880,355080,595960
11/4/2024,Nadeesha Wijesuriya,Ratnapura,Kuruwita,Sabaragamuwa,168,3067,3235,6720,122680,129400
11/5/2024,Nadeesha Wijesuriya,Ratnapura,Kuruwita,Sabaragamuwa,6011,7707,13718,240440,308280,548720
11/6/2024,Nadeesha Wijesuriya,Ratnapura,Kuruwita,Sabaragamuwa,8460,6997,15457,338400,279880,618280
11/7/2024,Nadeesha Wijesuriya,Ratnapura,Kuruwita,Sabaragamuwa,3340,8010,11350,133600,320400,454000
11/8/2024,Nadeesha Wijesuriya,Ratnapura,Kuruwita,Sabaragamuwa,9579,5664,15243,383160,226560,609720
11/9/2024,Nadeesha Wijesuriya,Ratnapura,Kuruwita,Sabaragamuwa,4252,9931,14183,170080,397240,567320
11/10/2024,Nadeesha Wijesuriya,Ratnapura,Kuruwita,Sabaragamuwa,9129,2382,11511,365160,95280,460440
11/11/2024,Nadeesha Wijesuriya,Ratnapura,Kuruwita,Sabaragamuwa,6484,4081,10565,259360,163240,422600
11/12/2024,Nadeesha Wijesuriya,Ratnapura,Kuruwita,Sabaragamuwa,6666,9485,16151,266640,379400,646040
11/13/2024,Nadeesha Wijesuriya,Ratnapura,Kuruwita,Sabaragamuwa,3839,3908,7747,153560,156320,309880
11/14/2024,Nadeesha Wijesuriya,Ratnapura,Kuruwita,Sabaragamuwa,1049,2748,3797,41960,109920,151880
11/15/2024,Nadeesha Wijesuriya,Ratnapura,Kuruwita,Sabaragamuwa,1197,9186,10383,47880,367440,415320
11/16/2024,Nadeesha Wijesuriya,Ratnapura,Kuruwita,Sabaragamuwa,1721,1804,3525,68840,72160,141000
11/17/2024,Nadeesha Wijesuriya,Ratnapura,Kuruwita,Sabaragamuwa,7203,1519,8722,288120,60760,348880
11/18/2024,Nadeesha Wijesuriya,Ratnapura,Kuruwita,Sabaragamuwa,148,4960,5108,5920,198400,204320
11/19/2024,Nadeesha Wijesuriya,Ratnapura,Kuruwita,Sabaragamuwa,2931,4730,7661,117240,189200,306440
11/20/2024,Nadeesha Wijesuriya,Ratnapura,Kuruwita,Sabaragamuwa,8924,7653,16577,356960,306120,663080
11/21/2024,Nadeesha Wijesuriya,Ratnapura,Kuruwita,Sabaragamuwa,1497,2415,3912,59880,96600,156480
11/22/2024,Nadeesha Wijesuriya,Ratnapura,Kuruwita,Sabaragamuwa,8932,7667,16599,357280,306680,663960
11/23/2024,Nadeesha Wijesuriya,Ratnapura,Kuruwita,Sabaragamuwa,5773,333,6106,230920,13320,244240
11/24/2024,Nadeesha Wijesuriya,Ratnapura,Kuruwita,Sabaragamuwa,6401,9525,15926,256040,381000,637040
11/25/2024,Nadeesha Wijesuriya,Ratnapura,Kuruwita,Sabaragamuwa,8238,656,8894,329520,26240,355760
11/26/2024,Nadeesha Wijesuriya,Ratnapura,Kuruwita,Sabaragamuwa,1032,4944,5976,41280,197760,239040
11/27/2024,Nadeesha Wijesuriya,Ratnapura,Kuruwita,Sabaragamuwa,9399,1578,10977,375960,63120,439080
11/28/2024,Nadeesha Wijesuriya,Ratnapura,Kuruwita,Sabaragamuwa,5390,643,6033,215600,25720,241320
11/29/2024,Nadeesha Wijesuriya,Ratnapura,Kuruwita,Sabaragamuwa,2913,3273,6186,116520,130920,247440
11/30/2024,Nadeesha Wijesuriya,Ratnapura,Kuruwita,Sabaragamuwa,2584,2949,5533,103360,117960,221320
12/1/2024,Nadeesha Wijesuriya,Ratnapura,Kuruwita,Sabaragamuwa,4837,1224,6061,193480,48960,242440
12/2/2024,Nadeesha Wijesuriya,Ratnapura,Kuruwita,Sabaragamuwa,8384,5552,13936,335360,222080,557440
12/3/2024,Nadeesha Wijesuriya,Ratnapura,Kuruwita,Sabaragamuwa,182,5525,5707,7280,221000,228280
12/4/2024,Nadeesha Wijesuriya,Ratnapura,Kuruwita,Sabaragamuwa,4385,4669,9054,175400,186760,362160
12/5/2024,Nadeesha Wijesuriya,Ratnapura,Kuruwita,Sabaragamuwa,4416,4889,9305,176640,195560,372200
12/6/2024,Nadeesha Wijesuriya,Ratnapura,Kuruwita,Sabaragamuwa,465,4742,5207,18600,189680,208280
12/7/2024,Nadeesha Wijesuriya,Ratnapura,Kuruwita,Sabaragamuwa,3859,2774,6633,154360,110960,265320
12/8/2024,Nadeesha Wijesuriya,Ratnapura,Kuruwita,Sabaragamuwa,898,7913,8811,35920,316520,352440
12/9/2024,Nadeesha Wijesuriya,Ratnapura,Kuruwita,Sabaragamuwa,8518,3871,12389,340720,154840,495560
12/10/2024,Nadeesha Wijesuriya,Ratnapura,Kuruwita,Sabaragamuwa,9325,1275,10600,373000,51000,424000
12/11/2024,Nadeesha Wijesuriya,Ratnapura,Kuruwita,Sabaragamuwa,4955,7874,12829,198200,314960,513160
12/12/2024,Nadeesha Wijesuriya,Ratnapura,Kuruwita,Sabaragamuwa,3759,9574,13333,150360,382960,533320
12/13/2024,Nadeesha Wijesuriya,Ratnapura,Kuruwita,Sabaragamuwa,1150,9126,10276,46000,365040,411040
12/14/2024,Nadeesha Wijesuriya,Ratnapura,Kuruwita,Sabaragamuwa,9311,3046,12357,372440,121840,494280
12/15/2024,Nadeesha Wijesuriya,Ratnapura,Kuruwita,Sabaragamuwa,5761,2871,8632,230440,114840,345280
12/16/2024,Nadeesha Wijesuriya,Ratnapura,Kuruwita,Sabaragamuwa,7170,3965,11135,286800,158600,445400
12/17/2024,Nadeesha Wijesuriya,Ratnapura,Kuruwita,Sabaragamuwa,2677,9950,12627,107080,398000,505080
12/18/2024,Nadeesha Wijesuriya,Ratnapura,Kuruwita,Sabaragamuwa,3312,8577,11889,132480,343080,475560
12/19/2024,Nadeesha Wijesuriya,Ratnapura,Kuruwita,Sabaragamuwa,7418,841,8259,296720,33640,330360
12/20/2024,Nadeesha Wijesuriya,Ratnapura,Kuruwita,Sabaragamuwa,2039,8379,10418,81560,335160,416720
12/21/2024,Nadeesha Wijesuriya,Ratnapura,Kuruwita,Sabaragamuwa,5194,1746,6940,207760,69840,277600
12/22/2024,Nadeesha Wijesuriya,Ratnapura,Kuruwita,Sabaragamuwa,5793,6886,12679,231720,275440,507160
12/23/2024,Nadeesha Wijesuriya,Ratnapura,Kuruwita,Sabaragamuwa,5279,7950,13229,211160,318000,529160
12/24/2024,Nadeesha Wijesuriya,Ratnapura,Kuruwita,Sabaragamuwa,6973,7115,14088,278920,284600,563520
12/25/2024,Nadeesha Wijesuriya,Ratnapura,Kuruwita,Sabaragamuwa,2040,5484,7524,81600,219360,300960
12/26/2024,Nadeesha Wijesuriya,Ratnapura,Kuruwita,Sabaragamuwa,4100,445,4545,164000,17800,181800
12/27/2024,Nadeesha Wijesuriya,Ratnapura,Kuruwita,Sabaragamuwa,8248,9709,17957,329920,388360,718280
12/28/2024,Nadeesha Wijesuriya,Ratnapura,Kuruwita,Sabaragamuwa,5482,659,6141,219280,26360,245640
12/29/2024,Nadeesha Wijesuriya,Ratnapura,Kuruwita,Sabaragamuwa,6270,9940,16210,250800,397600,648400
12/30/2024,Nadeesha Wijesuriya,Ratnapura,Kuruwita,Sabaragamuwa,4582,7546,12128,183280,301840,485120
12/31/2024,Nadeesha Wijesuriya,Ratnapura,Kuruwita,Sabaragamuwa,785,2471,3256,31400,98840,130240
1/1/2025,Nadeesha Wijesuriya,Ratnapura,Kuruwita,Sabaragamuwa,7817,8053,15870,312680,322120,634800
1/2/2025,Nadeesha Wijesuriya,Ratnapura,Kuruwita,Sabaragamuwa,2311,8280,10591,92440,331200,423640
1/3/2025,Nadeesha Wijesuriya,Ratnapura,Kuruwita,Sabaragamuwa,4837,1889,6726,193480,75560,269040
1/4/2025,Nadeesha Wijesuriya,Ratnapura,Kuruwita,Sabaragamuwa,7892,3045,10937,315680,121800,437480
1/5/2025,Nadeesha Wijesuriya,Ratnapura,Kuruwita,Sabaragamuwa,6405,3361,9766,256200,134440,390640
1/6/2025,Nadeesha Wijesuriya,Ratnapura,Kuruwita,Sabaragamuwa,9085,1760,10845,363400,70400,433800
1/7/2025,Nadeesha Wijesuriya,Ratnapura,Kuruwita,Sabaragamuwa,8828,1137,9965,353120,45480,398600
1/8/2025,Nadeesha Wijesuriya,Ratnapura,Kuruwita,Sabaragamuwa,882,3013,3895,35280,120520,155800
1/9/2025,Nadeesha Wijesuriya,Ratnapura,Kuruwita,Sabaragamuwa,8860,1425,10285,354400,57000,411400
1/10/2025,Nadeesha Wijesuriya,Ratnapura,Kuruwita,Sabaragamuwa,5099,2115,7214,203960,84600,288560
1/11/2025,Nadeesha Wijesuriya,Ratnapura,Kuruwita,Sabaragamuwa,4481,2389,6870,179240,95560,274800
1/12/2025,Nadeesha Wijesuriya,Ratnapura,Kuruwita,Sabaragamuwa,5826,3635,9461,233040,145400,378440
1/13/2025,Nadeesha Wijesuriya,Ratnapura,Kuruwita,Sabaragamuwa,5708,3669,9377,228320,146760,375080
1/14/2025,Nadeesha Wijesuriya,Ratnapura,Kuruwita,Sabaragamuwa,7530,8802,16332,301200,352080,653280
1/15/2025,Nadeesha Wijesuriya,Ratnapura,Kuruwita,Sabaragamuwa,6712,9635,16347,268480,385400,653880
1/16/2025,Nadeesha Wijesuriya,Ratnapura,Kuruwita,Sabaragamuwa,7258,7225,14483,290320,289000,579320
1/17/2025,Nadeesha Wijesuriya,Ratnapura,Kuruwita,Sabaragamuwa,3613,7579,11192,144520,303160,447680
1/18/2025,Nadeesha Wijesuriya,Ratnapura,Kuruwita,Sabaragamuwa,6447,1595,8042,257880,63800,321680
1/19/2025,Nadeesha Wijesuriya,Ratnapura,Kuruwita,Sabaragamuwa,9219,3358,12577,368760,134320,503080
1/20/2025,Nadeesha Wijesuriya,Ratnapura,Kuruwita,Sabaragamuwa,5429,3277,8706,217160,131080,348240
1/21/2025,Nadeesha Wijesuriya,Ratnapura,Kuruwita,Sabaragamuwa,3960,6282,10242,158400,251280,409680
1/22/2025,Nadeesha Wijesuriya,Ratnapura,Kuruwita,Sabaragamuwa,4180,7478,11658,167200,299120,466320
1/23/2025,Nadeesha Wijesuriya,Ratnapura,Kuruwita,Sabaragamuwa,725,7640,8365,29000,305600,334600
1/24/2025,Nadeesha Wijesuriya,Ratnapura,Kuruwita,Sabaragamuwa,3478,4472,7950,139120,178880,318000
1/25/2025,Nadeesha Wijesuriya,Ratnapura,Kuruwita,Sabaragamuwa,7576,3474,11050,303040,138960,442000
1/26/2025,Nadeesha Wijesuriya,Ratnapura,Kuruwita,Sabaragamuwa,1899,7951,9850,75960,318040,394000
1/27/2025,Nadeesha Wijesuriya,Ratnapura,Kuruwita,Sabaragamuwa,7396,5812,13208,295840,232480,528320
1/28/2025,Nadeesha Wijesuriya,Ratnapura,Kuruwita,Sabaragamuwa,1785,9139,10924,71400,365560,436960
1/29/2025,Nadeesha Wijesuriya,Ratnapura,Kuruwita,Sabaragamuwa,9421,1242,10663,376840,49680,426520
1/30/2025,Nadeesha Wijesuriya,Ratnapura,Kuruwita,Sabaragamuwa,4986,7342,12328,199440,293680,493120
1/31/2025,Nadeesha Wijesuriya,Ratnapura,Kuruwita,Sabaragamuwa,2176,3482,5658,87040,139280,226320
2/1/2025,Nadeesha Wijesuriya,Ratnapura,Kuruwita,Sabaragamuwa,7255,129,7384,290200,5160,295360
2/2/2025,Nadeesha Wijesuriya,Ratnapura,Kuruwita,Sabaragamuwa,9163,6060,15223,366520,242400,608920
2/3/2025,Nadeesha Wijesuriya,Ratnapura,Kuruwita,Sabaragamuwa,9153,8491,17644,366120,339640,705760
2/4/2025,Nadeesha Wijesuriya,Ratnapura,Kuruwita,Sabaragamuwa,8904,5414,14318,356160,216560,572720
2/5/2025,Nadeesha Wijesuriya,Ratnapura,Kuruwita,Sabaragamuwa,5110,8848,13958,204400,353920,558320
2/6/2025,Nadeesha Wijesuriya,Ratnapura,Kuruwita,Sabaragamuwa,8006,8569,16575,320240,342760,663000
2/7/2025,Nadeesha Wijesuriya,Ratnapura,Kuruwita,Sabaragamuwa,7339,1844,9183,293560,73760,367320
2/8/2025,Nadeesha Wijesuriya,Ratnapura,Kuruwita,Sabaragamuwa,4285,5677,9962,171400,227080,398480
2/9/2025,Nadeesha Wijesuriya,Ratnapura,Kuruwita,Sabaragamuwa,5401,3485,8886,216040,139400,355440
2/10/2025,Nadeesha Wijesuriya,Ratnapura,Kuruwita,Sabaragamuwa,485,8354,8839,19400,334160,353560
2/11/2025,Nadeesha Wijesuriya,Ratnapura,Kuruwita,Sabaragamuwa,4051,5127,9178,162040,205080,367120
2/12/2025,Nadeesha Wijesuriya,Ratnapura,Kuruwita,Sabaragamuwa,9215,8744,17959,368600,349760,718360
2/13/2025,Nadeesha Wijesuriya,Ratnapura,Kuruwita,Sabaragamuwa,8835,3763,12598,353400,150520,503920
2/14/2025,Nadeesha Wijesuriya,Ratnapura,Kuruwita,Sabaragamuwa,6694,5020,11714,267760,200800,468560
2/15/2025,Nadeesha Wijesuriya,Ratnapura,Kuruwita,Sabaragamuwa,82,6639,6721,3280,265560,268840
2/16/2025,Nadeesha Wijesuriya,Ratnapura,Kuruwita,Sabaragamuwa,7261,3441,10702,290440,137640,428080
2/17/2025,Nadeesha Wijesuriya,Ratnapura,Kuruwita,Sabaragamuwa,7749,7590,15339,309960,303600,613560
2/18/2025,Nadeesha Wijesuriya,Ratnapura,Kuruwita,Sabaragamuwa,8942,403,9345,357680,16120,373800
2/19/2025,Nadeesha Wijesuriya,Ratnapura,Kuruwita,Sabaragamuwa,6618,8547,15165,264720,341880,606600
2/20/2025,Nadeesha Wijesuriya,Ratnapura,Kuruwita,Sabaragamuwa,8643,6308,14951,345720,252320,598040
2/21/2025,Nadeesha Wijesuriya,Ratnapura,Kuruwita,Sabaragamuwa,7203,1724,8927,288120,68960,357080
2/22/2025,Nadeesha Wijesuriya,Ratnapura,Kuruwita,Sabaragamuwa,5575,8167,13742,223000,326680,549680
2/23/2025,Nadeesha Wijesuriya,Ratnapura,Kuruwita,Sabaragamuwa,2041,219,2260,81640,8760,90400
2/24/2025,Nadeesha Wijesuriya,Ratnapura,Kuruwita,Sabaragamuwa,2520,609,3129,100800,24360,125160
2/25/2025,Nadeesha Wijesuriya,Ratnapura,Kuruwita,Sabaragamuwa,5760,3977,9737,230400,159080,389480
2/26/2025,Nadeesha Wijesuriya,Ratnapura,Kuruwita,Sabaragamuwa,8165,7275,15440,326600,291000,617600
2/27/2025,Nadeesha Wijesuriya,Ratnapura,Kuruwita,Sabaragamuwa,1836,3682,5518,73440,147280,220720
2/28/2025,Nadeesha Wijesuriya,Ratnapura,Kuruwita,Sabaragamuwa,8975,8377,17352,359000,335080,694080
3/1/2025,Nadeesha Wijesuriya,Ratnapura,Kuruwita,Sabaragamuwa,168,9830,9998,6720,393200,399920
3/2/2025,Nadeesha Wijesuriya,Ratnapura,Kuruwita,Sabaragamuwa,6839,3124,9963,273560,124960,398520
3/3/2025,Nadeesha Wijesuriya,Ratnapura,Kuruwita,Sabaragamuwa,7424,3461,10885,296960,138440,435400
3/4/2025,Nadeesha Wijesuriya,Ratnapura,Kuruwita,Sabaragamuwa,3407,8634,12041,136280,345360,481640
3/5/2025,Nadeesha Wijesuriya,Ratnapura,Kuruwita,Sabaragamuwa,3880,7296,11176,155200,291840,447040
3/6/2025,Nadeesha Wijesuriya,Ratnapura,Kuruwita,Sabaragamuwa,397,4884,5281,15880,195360,211240
3/7/2025,Nadeesha Wijesuriya,Ratnapura,Kuruwita,Sabaragamuwa,7499,2527,10026,299960,101080,401040
3/8/2025,Nadeesha Wijesuriya,Ratnapura,Kuruwita,Sabaragamuwa,4323,2060,6383,172920,82400,255320
3/9/2025,Nadeesha Wijesuriya,Ratnapura,Kuruwita,Sabaragamuwa,4289,8847,13136,171560,353880,525440
3/10/2025,Nadeesha Wijesuriya,Ratnapura,Kuruwita,Sabaragamuwa,4566,918,5484,182640,36720,219360
3/11/2025,Nadeesha Wijesuriya,Ratnapura,Kuruwita,Sabaragamuwa,6030,5312,11342,241200,212480,453680
3/12/2025,Nadeesha Wijesuriya,Ratnapura,Kuruwita,Sabaragamuwa,240,8972,9212,9600,358880,368480
3/13/2025,Nadeesha Wijesuriya,Ratnapura,Kuruwita,Sabaragamuwa,7876,9826,17702,315040,393040,708080
3/14/2025,Nadeesha Wijesuriya,Ratnapura,Kuruwita,Sabaragamuwa,8837,3580,12417,353480,143200,496680
3/15/2025,Nadeesha Wijesuriya,Ratnapura,Kuruwita,Sabaragamuwa,6357,9565,15922,254280,382600,636880
3/16/2025,Nadeesha Wijesuriya,Ratnapura,Kuruwita,Sabaragamuwa,1675,2837,4512,67000,113480,180480
3/17/2025,Nadeesha Wijesuriya,Ratnapura,Kuruwita,Sabaragamuwa,32,5110,5142,1280,204400,205680
3/18/2025,Nadeesha Wijesuriya,Ratnapura,Kuruwita,Sabaragamuwa,4946,9239,14185,197840,369560,567400
3/19/2025,Nadeesha Wijesuriya,Ratnapura,Kuruwita,Sabaragamuwa,6299,4432,10731,251960,177280,429240
3/20/2025,Nadeesha Wijesuriya,Ratnapura,Kuruwita,Sabaragamuwa,4557,8116,12673,182280,324640,506920
3/21/2025,Nadeesha Wijesuriya,Ratnapura,Kuruwita,Sabaragamuwa,6032,1462,7494,241280,58480,299760
3/22/2025,Nadeesha Wijesuriya,Ratnapura,Kuruwita,Sabaragamuwa,2262,1411,3673,90480,56440,146920
3/23/2025,Nadeesha Wijesuriya,Ratnapura,Kuruwita,Sabaragamuwa,8738,291,9029,349520,11640,361160
3/25/2024,Tharindu Silva,Kegalle,Kegalle,Sabaragamuwa,498,8920,9418,19920,356800,376720
3/26/2024,Tharindu Silva,Kegalle,Kegalle,Sabaragamuwa,654,2845,3499,26160,113800,139960
3/27/2024,Tharindu Silva,Kegalle,Kegalle,Sabaragamuwa,8150,6737,14887,326000,269480,595480
3/28/2024,Tharindu Silva,Kegalle,Kegalle,Sabaragamuwa,3344,8736,12080,133760,349440,483200
3/29/2024,Tharindu Silva,Kegalle,Kegalle,Sabaragamuwa,9561,3212,12773,382440,128480,510920
3/30/2024,Tharindu Silva,Kegalle,Kegalle,Sabaragamuwa,9506,6915,16421,380240,276600,656840
3/31/2024,Tharindu Silva,Kegalle,Kegalle,Sabaragamuwa,8573,8600,17173,342920,344000,686920
4/1/2024,Tharindu Silva,Kegalle,Kegalle,Sabaragamuwa,8837,1052,9889,353480,42080,395560
4/2/2024,Tharindu Silva,Kegalle,Kegalle,Sabaragamuwa,6016,5930,11946,240640,237200,477840
4/3/2024,Tharindu Silva,Kegalle,Kegalle,Sabaragamuwa,770,3814,4584,30800,152560,183360
4/4/2024,Tharindu Silva,Kegalle,Kegalle,Sabaragamuwa,1987,3442,5429,79480,137680,217160
4/5/2024,Tharindu Silva,Kegalle,Kegalle,Sabaragamuwa,6822,1057,7879,272880,42280,315160
4/6/2024,Tharindu Silva,Kegalle,Kegalle,Sabaragamuwa,6399,2967,9366,255960,118680,374640
4/7/2024,Tharindu Silva,Kegalle,Kegalle,Sabaragamuwa,7992,4944,12936,319680,197760,517440
4/8/2024,Tharindu Silva,Kegalle,Kegalle,Sabaragamuwa,5141,3887,9028,205640,155480,361120
4/9/2024,Tharindu Silva,Kegalle,Kegalle,Sabaragamuwa,4838,6860,11698,193520,274400,467920
4/10/2024,Tharindu Silva,Kegalle,Kegalle,Sabaragamuwa,6787,2357,9144,271480,94280,365760
4/11/2024,Tharindu Silva,Kegalle,Kegalle,Sabaragamuwa,9572,9499,19071,382880,379960,762840
4/19/2024,Tharindu Silva,Kegalle,Kegalle,Sabaragamuwa,9032,6607,15639,361280,264280,625560
4/20/2024,Tharindu Silva,Kegalle,Kegalle,Sabaragamuwa,877,2775,3652,35080,111000,146080
4/21/2024,Tharindu Silva,Kegalle,Kegalle,Sabaragamuwa,3552,9558,13110,142080,382320,524400
4/22/2024,Tharindu Silva,Kegalle,Kegalle,Sabaragamuwa,2085,6991,9076,83400,279640,363040
4/23/2024,Tharindu Silva,Kegalle,Kegalle,Sabaragamuwa,1195,4960,6155,47800,198400,246200
4/24/2024,Tharindu Silva,Kegalle,Kegalle,Sabaragamuwa,981,6820,7801,39240,272800,312040
4/25/2024,Tharindu Silva,Kegalle,Kegalle,Sabaragamuwa,2745,9714,12459,109800,388560,498360
4/26/2024,Tharindu Silva,Kegalle,Kegalle,Sabaragamuwa,5006,4798,9804,200240,191920,392160
4/27/2024,Tharindu Silva,Kegalle,Kegalle,Sabaragamuwa,4751,562,5313,190040,22480,212520
4/28/2024,Tharindu Silva,Kegalle,Kegalle,Sabaragamuwa,8019,2213,10232,320760,88520,409280
4/29/2024,Tharindu Silva,Kegalle,Kegalle,Sabaragamuwa,4882,7566,12448,195280,302640,497920
4/30/2024,Tharindu Silva,Kegalle,Kegalle,Sabaragamuwa,3681,2772,6453,147240,110880,258120
5/1/2024,Tharindu Silva,Kegalle,Kegalle,Sabaragamuwa,3711,5828,9539,148440,233120,381560
5/2/2024,Tharindu Silva,Kegalle,Kegalle,Sabaragamuwa,584,5998,6582,23360,239920,263280
5/3/2024,Tharindu Silva,Kegalle,Kegalle,Sabaragamuwa,6295,2850,9145,251800,114000,365800
5/4/2024,Tharindu Silva,Kegalle,Kegalle,Sabaragamuwa,9542,1112,10654,381680,44480,426160
5/5/2024,Tharindu Silva,Kegalle,Kegalle,Sabaragamuwa,8069,4016,12085,322760,160640,483400
5/6/2024,Tharindu Silva,Kegalle,Kegalle,Sabaragamuwa,271,8042,8313,10840,321680,332520
5/7/2024,Tharindu Silva,Kegalle,Kegalle,Sabaragamuwa,2764,5689,8453,110560,227560,338120
5/8/2024,Tharindu Silva,Kegalle,Kegalle,Sabaragamuwa,8750,3322,12072,350000,132880,482880
5/9/2024,Tharindu Silva,Kegalle,Kegalle,Sabaragamuwa,6657,5126,11783,266280,205040,471320
5/10/2024,Tharindu Silva,Kegalle,Kegalle,Sabaragamuwa,552,1315,1867,22080,52600,74680
5/11/2024,Tharindu Silva,Kegalle,Kegalle,Sabaragamuwa,5980,7626,13606,239200,305040,544240
5/12/2024,Tharindu Silva,Kegalle,Kegalle,Sabaragamuwa,8934,1721,10655,357360,68840,426200
5/13/2024,Tharindu Silva,Kegalle,Kegalle,Sabaragamuwa,8903,2696,11599,356120,107840,463960
5/14/2024,Tharindu Silva,Kegalle,Kegalle,Sabaragamuwa,4375,2966,7341,175000,118640,293640
5/15/2024,Tharindu Silva,Kegalle,Kegalle,Sabaragamuwa,5507,2095,7602,220280,83800,304080
5/16/2024,Tharindu Silva,Kegalle,Kegalle,Sabaragamuwa,4508,4787,9295,180320,191480,371800
5/17/2024,Tharindu Silva,Kegalle,Kegalle,Sabaragamuwa,1278,1515,2793,51120,60600,111720
5/18/2024,Tharindu Silva,Kegalle,Kegalle,Sabaragamuwa,5668,2695,8363,226720,107800,334520
5/19/2024,Tharindu Silva,Kegalle,Kegalle,Sabaragamuwa,3646,4580,8226,145840,183200,329040
5/20/2024,Tharindu Silva,Kegalle,Kegalle,Sabaragamuwa,3032,8982,12014,121280,359280,480560
5/21/2024,Tharindu Silva,Kegalle,Kegalle,Sabaragamuwa,1538,655,2193,61520,26200,87720
5/22/2024,Tharindu Silva,Kegalle,Kegalle,Sabaragamuwa,5285,2514,7799,211400,100560,311960
5/24/2024,Tharindu Silva,Kegalle,Kegalle,Sabaragamuwa,936,6536,7472,37440,261440,298880
5/25/2024,Tharindu Silva,Kegalle,Kegalle,Sabaragamuwa,8198,125,8323,327920,5000,332920
5/26/2024,Tharindu Silva,Kegalle,Kegalle,Sabaragamuwa,1971,9814,11785,78840,392560,471400
5/27/2024,Tharindu Silva,Kegalle,Kegalle,Sabaragamuwa,882,7569,8451,35280,302760,338040
5/28/2024,Tharindu Silva,Kegalle,Kegalle,Sabaragamuwa,460,2320,2780,18400,92800,111200
5/29/2024,Tharindu Silva,Kegalle,Kegalle,Sabaragamuwa,5884,9821,15705,235360,392840,628200
5/30/2024,Tharindu Silva,Kegalle,Kegalle,Sabaragamuwa,2022,8833,10855,80880,353320,434200
5/31/2024,Tharindu Silva,Kegalle,Kegalle,Sabaragamuwa,4675,5473,10148,187000,218920,405920
6/1/2024,Tharindu Silva,Kegalle,Kegalle,Sabaragamuwa,1191,3622,4813,47640,144880,192520
6/2/2024,Tharindu Silva,Kegalle,Kegalle,Sabaragamuwa,4159,4083,8242,166360,163320,329680
6/3/2024,Tharindu Silva,Kegalle,Kegalle,Sabaragamuwa,5828,450,6278,233120,18000,251120
6/4/2024,Tharindu Silva,Kegalle,Kegalle,Sabaragamuwa,951,4331,5282,38040,173240,211280
6/5/2024,Tharindu Silva,Kegalle,Kegalle,Sabaragamuwa,5859,3145,9004,234360,125800,360160
6/6/2024,Tharindu Silva,Kegalle,Kegalle,Sabaragamuwa,649,6541,7190,25960,261640,287600
6/7/2024,Tharindu Silva,Kegalle,Kegalle,Sabaragamuwa,6580,9761,16341,263200,390440,653640
6/8/2024,Tharindu Silva,Kegalle,Kegalle,Sabaragamuwa,9382,6382,15764,375280,255280,630560
6/9/2024,Tharindu Silva,Kegalle,Kegalle,Sabaragamuwa,3333,5868,9201,133320,234720,368040
6/10/2024,Tharindu Silva,Kegalle,Kegalle,Sabaragamuwa,8161,6063,14224,326440,242520,568960
6/11/2024,Tharindu Silva,Kegalle,Kegalle,Sabaragamuwa,7869,2104,9973,314760,84160,398920
6/12/2024,Tharindu Silva,Kegalle,Kegalle,Sabaragamuwa,7907,8206,16113,316280,328240,644520
6/13/2024,Tharindu Silva,Kegalle,Kegalle,Sabaragamuwa,734,8869,9603,29360,354760,384120
6/14/2024,Tharindu Silva,Kegalle,Kegalle,Sabaragamuwa,8873,8968,17841,354920,358720,713640
6/15/2024,Tharindu Silva,Kegalle,Kegalle,Sabaragamuwa,1824,6881,8705,72960,275240,348200
6/16/2024,Tharindu Silva,Kegalle,Kegalle,Sabaragamuwa,4957,2702,7659,198280,108080,306360
6/17/2024,Tharindu Silva,Kegalle,Kegalle,Sabaragamuwa,4667,5030,9697,186680,201200,387880
6/18/2024,Tharindu Silva,Kegalle,Kegalle,Sabaragamuwa,4487,9174,13661,179480,366960,546440
6/19/2024,Tharindu Silva,Kegalle,Kegalle,Sabaragamuwa,4849,75,4924,193960,3000,196960
6/20/2024,Tharindu Silva,Kegalle,Kegalle,Sabaragamuwa,5157,8240,13397,206280,329600,535880
6/21/2024,Tharindu Silva,Kegalle,Kegalle,Sabaragamuwa,2839,8374,11213,113560,334960,448520
6/22/2024,Tharindu Silva,Kegalle,Kegalle,Sabaragamuwa,5705,7141,12846,228200,285640,513840
6/23/2024,Tharindu Silva,Kegalle,Kegalle,Sabaragamuwa,1593,6783,8376,63720,271320,335040
6/24/2024,Tharindu Silva,Kegalle,Kegalle,Sabaragamuwa,7565,9006,16571,302600,360240,662840
6/25/2024,Tharindu Silva,Kegalle,Kegalle,Sabaragamuwa,3720,7515,11235,148800,300600,449400
6/26/2024,Tharindu Silva,Kegalle,Kegalle,Sabaragamuwa,5779,2489,8268,231160,99560,330720
6/27/2024,Tharindu Silva,Kegalle,Kegalle,Sabaragamuwa,298,8352,8650,11920,334080,346000
6/28/2024,Tharindu Silva,Kegalle,Kegalle,Sabaragamuwa,5236,6788,12024,209440,271520,480960
6/29/2024,Tharindu Silva,Kegalle,Kegalle,Sabaragamuwa,7238,2521,9759,289520,100840,390360
6/30/2024,Tharindu Silva,Kegalle,Kegalle,Sabaragamuwa,4787,4532,9319,191480,181280,372760
7/1/2024,Tharindu Silva,Kegalle,Kegalle,Sabaragamuwa,9059,5822,14881,362360,232880,595240
7/2/2024,Tharindu Silva,Kegalle,Kegalle,Sabaragamuwa,2260,6835,9095,90400,273400,363800
7/3/2024,Tharindu Silva,Kegalle,Kegalle,Sabaragamuwa,2475,7711,10186,99000,308440,407440
7/4/2024,Tharindu Silva,Kegalle,Kegalle,Sabaragamuwa,2030,1349,3379,81200,53960,135160
7/5/2024,Tharindu Silva,Kegalle,Kegalle,Sabaragamuwa,2235,5068,7303,89400,202720,292120
7/6/2024,Tharindu Silva,Kegalle,Kegalle,Sabaragamuwa,7811,4928,12739,312440,197120,509560
7/7/2024,Tharindu Silva,Kegalle,Kegalle,Sabaragamuwa,1690,8475,10165,67600,339000,406600
7/8/2024,Tharindu Silva,Kegalle,Kegalle,Sabaragamuwa,3293,504,3797,131720,20160,151880
7/9/2024,Tharindu Silva,Kegalle,Kegalle,Sabaragamuwa,7350,9028,16378,294000,361120,655120
7/10/2024,Tharindu Silva,Kegalle,Kegalle,Sabaragamuwa,6459,8118,14577,258360,324720,583080
7/11/2024,Tharindu Silva,Kegalle,Kegalle,Sabaragamuwa,4559,9003,13562,182360,360120,542480
7/12/2024,Tharindu Silva,Kegalle,Kegalle,Sabaragamuwa,2485,6809,9294,99400,272360,371760
7/13/2024,Tharindu Silva,Kegalle,Kegalle,Sabaragamuwa,9921,8652,18573,396840,346080,742920
7/14/2024,Tharindu Silva,Kegalle,Kegalle,Sabaragamuwa,356,1767,2123,14240,70680,84920
7/15/2024,Tharindu Silva,Kegalle,Kegalle,Sabaragamuwa,5030,5574,10604,201200,222960,424160
7/16/2024,Tharindu Silva,Kegalle,Kegalle,Sabaragamuwa,9131,4459,13590,365240,178360,543600
7/17/2024,Tharindu Silva,Kegalle,Kegalle,Sabaragamuwa,2065,689,2754,82600,27560,110160
7/18/2024,Tharindu Silva,Kegalle,Kegalle,Sabaragamuwa,888,6891,7779,35520,275640,311160
7/19/2024,Tharindu Silva,Kegalle,Kegalle,Sabaragamuwa,7387,1398,8785,295480,55920,351400
7/20/2024,Tharindu Silva,Kegalle,Kegalle,Sabaragamuwa,718,2817,3535,28720,112680,141400
7/21/2024,Tharindu Silva,Kegalle,Kegalle,Sabaragamuwa,6894,7760,14654,275760,310400,586160
7/22/2024,Tharindu Silva,Kegalle,Kegalle,Sabaragamuwa,5507,4631,10138,220280,185240,405520
7/23/2024,Tharindu Silva,Kegalle,Kegalle,Sabaragamuwa,321,9835,10156,12840,393400,406240
7/24/2024,Tharindu Silva,Kegalle,Kegalle,Sabaragamuwa,222,7266,7488,8880,290640,299520
7/25/2024,Tharindu Silva,Kegalle,Kegalle,Sabaragamuwa,92,9637,9729,3680,385480,389160
7/26/2024,Tharindu Silva,Kegalle,Kegalle,Sabaragamuwa,5878,1967,7845,235120,78680,313800
7/27/2024,Tharindu Silva,Kegalle,Kegalle,Sabaragamuwa,6862,1861,8723,274480,74440,348920
7/28/2024,Tharindu Silva,Kegalle,Kegalle,Sabaragamuwa,8808,7471,16279,352320,298840,651160
7/29/2024,Tharindu Silva,Kegalle,Kegalle,Sabaragamuwa,3856,8715,12571,154240,348600,502840
7/30/2024,Tharindu Silva,Kegalle,Kegalle,Sabaragamuwa,7267,9754,17021,290680,390160,680840
7/31/2024,Tharindu Silva,Kegalle,Kegalle,Sabaragamuwa,3974,8092,12066,158960,323680,482640
8/1/2024,Tharindu Silva,Kegalle,Kegalle,Sabaragamuwa,3440,7098,10538,137600,283920,421520
8/2/2024,Tharindu Silva,Kegalle,Kegalle,Sabaragamuwa,5521,9552,15073,220840,382080,602920
8/3/2024,Tharindu Silva,Kegalle,Kegalle,Sabaragamuwa,5128,755,5883,205120,30200,235320
8/4/2024,Tharindu Silva,Kegalle,Kegalle,Sabaragamuwa,4786,386,5172,191440,15440,206880
8/5/2024,Tharindu Silva,Kegalle,Kegalle,Sabaragamuwa,4466,8580,13046,178640,343200,521840
8/6/2024,Tharindu Silva,Kegalle,Kegalle,Sabaragamuwa,207,3328,3535,8280,133120,141400
8/7/2024,Tharindu Silva,Kegalle,Kegalle,Sabaragamuwa,9449,2353,11802,377960,94120,472080
8/8/2024,Tharindu Silva,Kegalle,Kegalle,Sabaragamuwa,9624,9300,18924,384960,372000,756960
8/9/2024,Tharindu Silva,Kegalle,Kegalle,Sabaragamuwa,5018,5766,10784,200720,230640,431360
8/10/2024,Tharindu Silva,Kegalle,Kegalle,Sabaragamuwa,9284,7650,16934,371360,306000,677360
8/11/2024,Tharindu Silva,Kegalle,Kegalle,Sabaragamuwa,9631,1548,11179,385240,61920,447160
8/12/2024,Tharindu Silva,Kegalle,Kegalle,Sabaragamuwa,9394,193,9587,375760,7720,383480
8/13/2024,Tharindu Silva,Kegalle,Kegalle,Sabaragamuwa,6242,8556,14798,249680,342240,591920
8/14/2024,Tharindu Silva,Kegalle,Kegalle,Sabaragamuwa,7867,8938,16805,314680,357520,672200
8/15/2024,Tharindu Silva,Kegalle,Kegalle,Sabaragamuwa,8255,1474,9729,330200,58960,389160
8/16/2024,Tharindu Silva,Kegalle,Kegalle,Sabaragamuwa,9108,3762,12870,364320,150480,514800
8/17/2024,Tharindu Silva,Kegalle,Kegalle,Sabaragamuwa,3182,9171,12353,127280,366840,494120
8/18/2024,Tharindu Silva,Kegalle,Kegalle,Sabaragamuwa,1893,394,2287,75720,15760,91480
8/19/2024,Tharindu Silva,Kegalle,Kegalle,Sabaragamuwa,9577,1215,10792,383080,48600,431680
8/20/2024,Tharindu Silva,Kegalle,Kegalle,Sabaragamuwa,1914,4995,6909,76560,199800,276360
8/21/2024,Tharindu Silva,Kegalle,Kegalle,Sabaragamuwa,9056,5109,14165,362240,204360,566600
8/22/2024,Tharindu Silva,Kegalle,Kegalle,Sabaragamuwa,4091,4044,8135,163640,161760,325400
8/23/2024,Tharindu Silva,Kegalle,Kegalle,Sabaragamuwa,3911,712,4623,156440,28480,184920
8/24/2024,Tharindu Silva,Kegalle,Kegalle,Sabaragamuwa,1297,7802,9099,51880,312080,363960
8/25/2024,Tharindu Silva,Kegalle,Kegalle,Sabaragamuwa,5414,1335,6749,216560,53400,269960
8/26/2024,Tharindu Silva,Kegalle,Kegalle,Sabaragamuwa,9942,6370,16312,397680,254800,652480
8/27/2024,Tharindu Silva,Kegalle,Kegalle,Sabaragamuwa,86,4331,4417,3440,173240,176680
8/28/2024,Tharindu Silva,Kegalle,Kegalle,Sabaragamuwa,9118,7632,16750,364720,305280,670000
8/29/2024,Tharindu Silva,Kegalle,Kegalle,Sabaragamuwa,1407,7520,8927,56280,300800,357080
8/30/2024,Tharindu Silva,Kegalle,Kegalle,Sabaragamuwa,7271,6813,14084,290840,272520,563360
8/31/2024,Tharindu Silva,Kegalle,Kegalle,Sabaragamuwa,6775,8268,15043,271000,330720,601720
9/1/2024,Tharindu Silva,Kegalle,Kegalle,Sabaragamuwa,6222,8706,14928,248880,348240,597120
9/2/2024,Tharindu Silva,Kegalle,Kegalle,Sabaragamuwa,1265,8773,10038,50600,350920,401520
9/3/2024,Tharindu Silva,Kegalle,Kegalle,Sabaragamuwa,7771,3983,11754,310840,159320,470160
9/4/2024,Tharindu Silva,Kegalle,Kegalle,Sabaragamuwa,605,8022,8627,24200,320880,345080
9/5/2024,Tharindu Silva,Kegalle,Kegalle,Sabaragamuwa,6185,1385,7570,247400,55400,302800
9/6/2024,Tharindu Silva,Kegalle,Kegalle,Sabaragamuwa,6316,4688,11004,252640,187520,440160
9/7/2024,Tharindu Silva,Kegalle,Kegalle,Sabaragamuwa,9219,4543,13762,368760,181720,550480
9/8/2024,Tharindu Silva,Kegalle,Kegalle,Sabaragamuwa,6168,3788,9956,246720,151520,398240
9/9/2024,Tharindu Silva,Kegalle,Kegalle,Sabaragamuwa,8936,3378,12314,357440,135120,492560
9/10/2024,Tharindu Silva,Kegalle,Kegalle,Sabaragamuwa,7387,3158,10545,295480,126320,421800
9/11/2024,Tharindu Silva,Kegalle,Kegalle,Sabaragamuwa,5237,665,5902,209480,26600,236080
9/12/2024,Tharindu Silva,Kegalle,Kegalle,Sabaragamuwa,1610,6814,8424,64400,272560,336960
9/13/2024,Tharindu Silva,Kegalle,Kegalle,Sabaragamuwa,4344,1477,5821,173760,59080,232840
9/14/2024,Tharindu Silva,Kegalle,Kegalle,Sabaragamuwa,5852,1560,7412,234080,62400,296480
9/15/2024,Tharindu Silva,Kegalle,Kegalle,Sabaragamuwa,416,1281,1697,16640,51240,67880
9/16/2024,Tharindu Silva,Kegalle,Kegalle,Sabaragamuwa,9183,8890,18073,367320,355600,722920
9/17/2024,Tharindu Silva,Kegalle,Kegalle,Sabaragamuwa,6281,4625,10906,251240,185000,436240
9/18/2024,Tharindu Silva,Kegalle,Kegalle,Sabaragamuwa,9443,6408,15851,377720,256320,634040
9/19/2024,Tharindu Silva,Kegalle,Kegalle,Sabaragamuwa,6793,7333,14126,271720,293320,565040
9/20/2024,Tharindu Silva,Kegalle,Kegalle,Sabaragamuwa,7192,4859,12051,287680,194360,482040
9/21/2024,Tharindu Silva,Kegalle,Kegalle,Sabaragamuwa,3749,1704,5453,149960,68160,218120
9/22/2024,Tharindu Silva,Kegalle,Kegalle,Sabaragamuwa,5223,3899,9122,208920,155960,364880
9/23/2024,Tharindu Silva,Kegalle,Kegalle,Sabaragamuwa,3089,3613,6702,123560,144520,268080
9/24/2024,Tharindu Silva,Kegalle,Kegalle,Sabaragamuwa,6913,2222,9135,276520,88880,365400
9/25/2024,Tharindu Silva,Kegalle,Kegalle,Sabaragamuwa,551,1283,1834,22040,51320,73360
9/26/2024,Tharindu Silva,Kegalle,Kegalle,Sabaragamuwa,9761,5046,14807,390440,201840,592280
9/27/2024,Tharindu Silva,Kegalle,Kegalle,Sabaragamuwa,671,6733,7404,26840,269320,296160
9/28/2024,Tharindu Silva,Kegalle,Kegalle,Sabaragamuwa,9249,9590,18839,369960,383600,753560
9/29/2024,Tharindu Silva,Kegalle,Kegalle,Sabaragamuwa,2644,9946,12590,105760,397840,503600
9/30/2024,Tharindu Silva,Kegalle,Kegalle,Sabaragamuwa,7043,2094,9137,281720,83760,365480
10/1/2024,Tharindu Silva,Kegalle,Kegalle,Sabaragamuwa,9242,8775,18017,369680,351000,720680
10/2/2024,Tharindu Silva,Kegalle,Kegalle,Sabaragamuwa,9461,4394,13855,378440,175760,554200
10/3/2024,Tharindu Silva,Kegalle,Kegalle,Sabaragamuwa,4657,7298,11955,186280,291920,478200
10/4/2024,Tharindu Silva,Kegalle,Kegalle,Sabaragamuwa,4276,4646,8922,171040,185840,356880
10/5/2024,Tharindu Silva,Kegalle,Kegalle,Sabaragamuwa,2028,6408,8436,81120,256320,337440
10/6/2024,Tharindu Silva,Kegalle,Kegalle,Sabaragamuwa,2396,7621,10017,95840,304840,400680
10/7/2024,Tharindu Silva,Kegalle,Kegalle,Sabaragamuwa,6193,9733,15926,247720,389320,637040
10/8/2024,Tharindu Silva,Kegalle,Kegalle,Sabaragamuwa,5207,4501,9708,208280,180040,388320
10/9/2024,Tharindu Silva,Kegalle,Kegalle,Sabaragamuwa,2068,2606,4674,82720,104240,186960
10/10/2024,Tharindu Silva,Kegalle,Kegalle,Sabaragamuwa,8408,3457,11865,336320,138280,474600
10/11/2024,Tharindu Silva,Kegalle,Kegalle,Sabaragamuwa,6820,5548,12368,272800,221920,494720
10/12/2024,Tharindu Silva,Kegalle,Kegalle,Sabaragamuwa,2170,216,2386,86800,8640,95440
10/13/2024,Tharindu Silva,Kegalle,Kegalle,Sabaragamuwa,1710,25,1735,68400,1000,69400
10/14/2024,Tharindu Silva,Kegalle,Kegalle,Sabaragamuwa,7470,1663,9133,298800,66520,365320
10/15/2024,Tharindu Silva,Kegalle,Kegalle,Sabaragamuwa,7558,3310,10868,302320,132400,434720
10/16/2024,Tharindu Silva,Kegalle,Kegalle,Sabaragamuwa,8514,4776,13290,340560,191040,531600
10/17/2024,Tharindu Silva,Kegalle,Kegalle,Sabaragamuwa,5599,7880,13479,223960,315200,539160
10/18/2024,Tharindu Silva,Kegalle,Kegalle,Sabaragamuwa,5486,7321,12807,219440,292840,512280
10/19/2024,Tharindu Silva,Kegalle,Kegalle,Sabaragamuwa,4243,887,5130,169720,35480,205200
10/20/2024,Tharindu Silva,Kegalle,Kegalle,Sabaragamuwa,9938,3313,13251,397520,132520,530040
10/21/2024,Tharindu Silva,Kegalle,Kegalle,Sabaragamuwa,6756,3750,10506,270240,150000,420240
10/22/2024,Tharindu Silva,Kegalle,Kegalle,Sabaragamuwa,6489,3297,9786,259560,131880,391440
10/23/2024,Tharindu Silva,Kegalle,Kegalle,Sabaragamuwa,5170,3073,8243,206800,122920,329720
10/24/2024,Tharindu Silva,Kegalle,Kegalle,Sabaragamuwa,282,2734,3016,11280,109360,120640
10/25/2024,Tharindu Silva,Kegalle,Kegalle,Sabaragamuwa,423,8272,8695,16920,330880,347800
10/26/2024,Tharindu Silva,Kegalle,Kegalle,Sabaragamuwa,6303,2115,8418,252120,84600,336720
10/27/2024,Tharindu Silva,Kegalle,Kegalle,Sabaragamuwa,335,4108,4443,13400,164320,177720
10/28/2024,Tharindu Silva,Kegalle,Kegalle,Sabaragamuwa,8495,5752,14247,339800,230080,569880
10/29/2024,Tharindu Silva,Kegalle,Kegalle,Sabaragamuwa,3155,3103,6258,126200,124120,250320
10/30/2024,Tharindu Silva,Kegalle,Kegalle,Sabaragamuwa,1266,6204,7470,50640,248160,298800
10/31/2024,Tharindu Silva,Kegalle,Kegalle,Sabaragamuwa,5720,1124,6844,228800,44960,273760
11/1/2024,Tharindu Silva,Kegalle,Kegalle,Sabaragamuwa,7948,5211,13159,317920,208440,526360
11/2/2024,Tharindu Silva,Kegalle,Kegalle,Sabaragamuwa,9997,5884,15881,399880,235360,635240
11/3/2024,Tharindu Silva,Kegalle,Kegalle,Sabaragamuwa,9455,9494,18949,378200,379760,757960
11/4/2024,Tharindu Silva,Kegalle,Kegalle,Sabaragamuwa,6074,3468,9542,242960,138720,381680
11/5/2024,Tharindu Silva,Kegalle,Kegalle,Sabaragamuwa,7661,56,7717,306440,2240,308680
11/6/2024,Tharindu Silva,Kegalle,Kegalle,Sabaragamuwa,7206,8645,15851,288240,345800,634040
11/7/2024,Tharindu Silva,Kegalle,Kegalle,Sabaragamuwa,8677,4654,13331,347080,186160,533240
11/8/2024,Tharindu Silva,Kegalle,Kegalle,Sabaragamuwa,5407,5782,11189,216280,231280,447560
11/9/2024,Tharindu Silva,Kegalle,Kegalle,Sabaragamuwa,3023,2247,5270,120920,89880,210800
11/10/2024,Tharindu Silva,Kegalle,Kegalle,Sabaragamuwa,3868,485,4353,154720,19400,174120
11/11/2024,Tharindu Silva,Kegalle,Kegalle,Sabaragamuwa,4172,4075,8247,166880,163000,329880
11/12/2024,Tharindu Silva,Kegalle,Kegalle,Sabaragamuwa,6914,1509,8423,276560,60360,336920
11/13/2024,Tharindu Silva,Kegalle,Kegalle,Sabaragamuwa,8354,4074,12428,334160,162960,497120
11/14/2024,Tharindu Silva,Kegalle,Kegalle,Sabaragamuwa,4191,1267,5458,167640,50680,218320
11/15/2024,Tharindu Silva,Kegalle,Kegalle,Sabaragamuwa,8800,5388,14188,352000,215520,567520
11/16/2024,Tharindu Silva,Kegalle,Kegalle,Sabaragamuwa,298,1071,1369,11920,42840,54760
11/17/2024,Tharindu Silva,Kegalle,Kegalle,Sabaragamuwa,7095,1069,8164,283800,42760,326560
11/18/2024,Tharindu Silva,Kegalle,Kegalle,Sabaragamuwa,9838,4699,14537,393520,187960,581480
11/19/2024,Tharindu Silva,Kegalle,Kegalle,Sabaragamuwa,6463,4962,11425,258520,198480,457000
11/20/2024,Tharindu Silva,Kegalle,Kegalle,Sabaragamuwa,3155,9657,12812,126200,386280,512480
11/21/2024,Tharindu Silva,Kegalle,Kegalle,Sabaragamuwa,3694,601,4295,147760,24040,171800
11/22/2024,Tharindu Silva,Kegalle,Kegalle,Sabaragamuwa,9761,5136,14897,390440,205440,595880
11/23/2024,Tharindu Silva,Kegalle,Kegalle,Sabaragamuwa,2586,4912,7498,103440,196480,299920
11/24/2024,Tharindu Silva,Kegalle,Kegalle,Sabaragamuwa,7927,9136,17063,317080,365440,682520
11/25/2024,Tharindu Silva,Kegalle,Kegalle,Sabaragamuwa,4795,6934,11729,191800,277360,469160
11/26/2024,Tharindu Silva,Kegalle,Kegalle,Sabaragamuwa,9628,3823,13451,385120,152920,538040
11/27/2024,Tharindu Silva,Kegalle,Kegalle,Sabaragamuwa,2264,2540,4804,90560,101600,192160
11/28/2024,Tharindu Silva,Kegalle,Kegalle,Sabaragamuwa,2429,1708,4137,97160,68320,165480
11/29/2024,Tharindu Silva,Kegalle,Kegalle,Sabaragamuwa,2520,8640,11160,100800,345600,446400
11/30/2024,Tharindu Silva,Kegalle,Kegalle,Sabaragamuwa,3017,5278,8295,120680,211120,331800
12/1/2024,Tharindu Silva,Kegalle,Kegalle,Sabaragamuwa,2859,3802,6661,114360,152080,266440
12/2/2024,Tharindu Silva,Kegalle,Kegalle,Sabaragamuwa,8219,2630,10849,328760,105200,433960
12/3/2024,Tharindu Silva,Kegalle,Kegalle,Sabaragamuwa,8534,9992,18526,341360,399680,741040
12/4/2024,Tharindu Silva,Kegalle,Kegalle,Sabaragamuwa,7247,7818,15065,289880,312720,602600
12/5/2024,Tharindu Silva,Kegalle,Kegalle,Sabaragamuwa,2812,3199,6011,112480,127960,240440
12/6/2024,Tharindu Silva,Kegalle,Kegalle,Sabaragamuwa,6907,4694,11601,276280,187760,464040
12/7/2024,Tharindu Silva,Kegalle,Kegalle,Sabaragamuwa,6990,2478,9468,279600,99120,378720
12/8/2024,Tharindu Silva,Kegalle,Kegalle,Sabaragamuwa,5933,8316,14249,237320,332640,569960
12/9/2024,Tharindu Silva,Kegalle,Kegalle,Sabaragamuwa,7001,2015,9016,280040,80600,360640
12/10/2024,Tharindu Silva,Kegalle,Kegalle,Sabaragamuwa,7751,791,8542,310040,31640,341680
12/11/2024,Tharindu Silva,Kegalle,Kegalle,Sabaragamuwa,7362,9500,16862,294480,380000,674480
12/12/2024,Tharindu Silva,Kegalle,Kegalle,Sabaragamuwa,2138,5234,7372,85520,209360,294880
12/13/2024,Tharindu Silva,Kegalle,Kegalle,Sabaragamuwa,8902,4001,12903,356080,160040,516120
12/14/2024,Tharindu Silva,Kegalle,Kegalle,Sabaragamuwa,4522,9546,14068,180880,381840,562720
12/15/2024,Tharindu Silva,Kegalle,Kegalle,Sabaragamuwa,8870,8350,17220,354800,334000,688800
12/16/2024,Tharindu Silva,Kegalle,Kegalle,Sabaragamuwa,1419,9015,10434,56760,360600,417360
12/17/2024,Tharindu Silva,Kegalle,Kegalle,Sabaragamuwa,7966,8015,15981,318640,320600,639240
12/18/2024,Tharindu Silva,Kegalle,Kegalle,Sabaragamuwa,1343,8674,10017,53720,346960,400680
12/19/2024,Tharindu Silva,Kegalle,Kegalle,Sabaragamuwa,4912,8046,12958,196480,321840,518320
12/20/2024,Tharindu Silva,Kegalle,Kegalle,Sabaragamuwa,225,2778,3003,9000,111120,120120
12/21/2024,Tharindu Silva,Kegalle,Kegalle,Sabaragamuwa,8009,108,8117,320360,4320,324680
12/22/2024,Tharindu Silva,Kegalle,Kegalle,Sabaragamuwa,242,4815,5057,9680,192600,202280
12/23/2024,Tharindu Silva,Kegalle,Kegalle,Sabaragamuwa,9485,1477,10962,379400,59080,438480
12/24/2024,Tharindu Silva,Kegalle,Kegalle,Sabaragamuwa,166,2569,2735,6640,102760,109400
12/25/2024,Tharindu Silva,Kegalle,Kegalle,Sabaragamuwa,4583,2020,6603,183320,80800,264120
12/26/2024,Tharindu Silva,Kegalle,Kegalle,Sabaragamuwa,7550,1908,9458,302000,76320,378320
12/27/2024,Tharindu Silva,Kegalle,Kegalle,Sabaragamuwa,8253,1769,10022,330120,70760,400880
12/28/2024,Tharindu Silva,Kegalle,Kegalle,Sabaragamuwa,4780,3490,8270,191200,139600,330800
12/29/2024,Tharindu Silva,Kegalle,Kegalle,Sabaragamuwa,5854,6516,12370,234160,260640,494800
12/30/2024,Tharindu Silva,Kegalle,Kegalle,Sabaragamuwa,9051,4040,13091,362040,161600,523640
12/31/2024,Tharindu Silva,Kegalle,Kegalle,Sabaragamuwa,1240,7433,8673,49600,297320,346920
1/1/2025,Tharindu Silva,Kegalle,Kegalle,Sabaragamuwa,1902,7956,9858,76080,318240,394320
1/2/2025,Tharindu Silva,Kegalle,Kegalle,Sabaragamuwa,760,1504,2264,30400,60160,90560
1/3/2025,Tharindu Silva,Kegalle,Kegalle,Sabaragamuwa,3365,325,3690,134600,13000,147600
1/4/2025,Tharindu Silva,Kegalle,Kegalle,Sabaragamuwa,5021,8657,13678,200840,346280,547120
1/5/2025,Tharindu Silva,Kegalle,Kegalle,Sabaragamuwa,7629,7229,14858,305160,289160,594320
1/6/2025,Tharindu Silva,Kegalle,Kegalle,Sabaragamuwa,2542,67,2609,101680,2680,104360
1/7/2025,Tharindu Silva,Kegalle,Kegalle,Sabaragamuwa,1477,9421,10898,59080,376840,435920
1/8/2025,Tharindu Silva,Kegalle,Kegalle,Sabaragamuwa,6876,9032,15908,275040,361280,636320
1/9/2025,Tharindu Silva,Kegalle,Kegalle,Sabaragamuwa,8646,1991,10637,345840,79640,425480
1/10/2025,Tharindu Silva,Kegalle,Kegalle,Sabaragamuwa,2742,9496,12238,109680,379840,489520
1/11/2025,Tharindu Silva,Kegalle,Kegalle,Sabaragamuwa,8612,9379,17991,344480,375160,719640
1/12/2025,Tharindu Silva,Kegalle,Kegalle,Sabaragamuwa,8032,7944,15976,321280,317760,639040
1/13/2025,Tharindu Silva,Kegalle,Kegalle,Sabaragamuwa,6070,6391,12461,242800,255640,498440
1/14/2025,Tharindu Silva,Kegalle,Kegalle,Sabaragamuwa,7111,7251,14362,284440,290040,574480
1/15/2025,Tharindu Silva,Kegalle,Kegalle,Sabaragamuwa,868,262,1130,34720,10480,45200
1/16/2025,Tharindu Silva,Kegalle,Kegalle,Sabaragamuwa,9586,4639,14225,383440,185560,569000
1/17/2025,Tharindu Silva,Kegalle,Kegalle,Sabaragamuwa,9563,7657,17220,382520,306280,688800
1/18/2025,Tharindu Silva,Kegalle,Kegalle,Sabaragamuwa,8163,131,8294,326520,5240,331760
1/19/2025,Tharindu Silva,Kegalle,Kegalle,Sabaragamuwa,8543,7509,16052,341720,300360,642080
1/20/2025,Tharindu Silva,Kegalle,Kegalle,Sabaragamuwa,9553,8627,18180,382120,345080,727200
1/21/2025,Tharindu Silva,Kegalle,Kegalle,Sabaragamuwa,9633,7976,17609,385320,319040,704360
1/22/2025,Tharindu Silva,Kegalle,Kegalle,Sabaragamuwa,7699,9141,16840,307960,365640,673600
1/23/2025,Tharindu Silva,Kegalle,Kegalle,Sabaragamuwa,461,9709,10170,18440,388360,406800
1/24/2025,Tharindu Silva,Kegalle,Kegalle,Sabaragamuwa,3341,3037,6378,133640,121480,255120
1/25/2025,Tharindu Silva,Kegalle,Kegalle,Sabaragamuwa,5435,8646,14081,217400,345840,563240
1/26/2025,Tharindu Silva,Kegalle,Kegalle,Sabaragamuwa,1404,2688,4092,56160,107520,163680
1/27/2025,Tharindu Silva,Kegalle,Kegalle,Sabaragamuwa,5549,6621,12170,221960,264840,486800
1/28/2025,Tharindu Silva,Kegalle,Kegalle,Sabaragamuwa,237,1062,1299,9480,42480,51960
1/29/2025,Tharindu Silva,Kegalle,Kegalle,Sabaragamuwa,7347,5972,13319,293880,238880,532760
1/30/2025,Tharindu Silva,Kegalle,Kegalle,Sabaragamuwa,3622,1391,5013,144880,55640,200520
1/31/2025,Tharindu Silva,Kegalle,Kegalle,Sabaragamuwa,88,9680,9768,3520,387200,390720
2/1/2025,Tharindu Silva,Kegalle,Kegalle,Sabaragamuwa,4455,213,4668,178200,8520,186720
2/2/2025,Tharindu Silva,Kegalle,Kegalle,Sabaragamuwa,7067,9109,16176,282680,364360,647040
2/3/2025,Tharindu Silva,Kegalle,Kegalle,Sabaragamuwa,5883,8919,14802,235320,356760,592080
2/4/2025,Tharindu Silva,Kegalle,Kegalle,Sabaragamuwa,5870,5184,11054,234800,207360,442160
2/5/2025,Tharindu Silva,Kegalle,Kegalle,Sabaragamuwa,1725,8656,10381,69000,346240,415240
2/6/2025,Tharindu Silva,Kegalle,Kegalle,Sabaragamuwa,4204,6011,10215,168160,240440,408600
2/7/2025,Tharindu Silva,Kegalle,Kegalle,Sabaragamuwa,7645,5271,12916,305800,210840,516640
2/8/2025,Tharindu Silva,Kegalle,Kegalle,Sabaragamuwa,1877,4699,6576,75080,187960,263040
2/9/2025,Tharindu Silva,Kegalle,Kegalle,Sabaragamuwa,1198,5805,7003,47920,232200,280120
2/10/2025,Tharindu Silva,Kegalle,Kegalle,Sabaragamuwa,3242,5587,8829,129680,223480,353160
2/11/2025,Tharindu Silva,Kegalle,Kegalle,Sabaragamuwa,1518,547,2065,60720,21880,82600
2/12/2025,Tharindu Silva,Kegalle,Kegalle,Sabaragamuwa,6123,3965,10088,244920,158600,403520
2/13/2025,Tharindu Silva,Kegalle,Kegalle,Sabaragamuwa,3035,1090,4125,121400,43600,165000
2/14/2025,Tharindu Silva,Kegalle,Kegalle,Sabaragamuwa,3165,6510,9675,126600,260400,387000
2/15/2025,Tharindu Silva,Kegalle,Kegalle,Sabaragamuwa,2648,284,2932,105920,11360,117280
2/16/2025,Tharindu Silva,Kegalle,Kegalle,Sabaragamuwa,457,3799,4256,18280,151960,170240
2/17/2025,Tharindu Silva,Kegalle,Kegalle,Sabaragamuwa,9271,1927,11198,370840,77080,447920
2/18/2025,Tharindu Silva,Kegalle,Kegalle,Sabaragamuwa,8349,2120,10469,333960,84800,418760
2/19/2025,Tharindu Silva,Kegalle,Kegalle,Sabaragamuwa,4317,2079,6396,172680,83160,255840
2/20/2025,Tharindu Silva,Kegalle,Kegalle,Sabaragamuwa,6955,943,7898,278200,37720,315920
2/21/2025,Tharindu Silva,Kegalle,Kegalle,Sabaragamuwa,2069,9191,11260,82760,367640,450400
2/22/2025,Tharindu Silva,Kegalle,Kegalle,Sabaragamuwa,4720,3039,7759,188800,121560,310360
2/23/2025,Tharindu Silva,Kegalle,Kegalle,Sabaragamuwa,6749,7246,13995,269960,289840,559800
2/24/2025,Tharindu Silva,Kegalle,Kegalle,Sabaragamuwa,7503,1961,9464,300120,78440,378560
2/25/2025,Tharindu Silva,Kegalle,Kegalle,Sabaragamuwa,9302,4515,13817,372080,180600,552680
2/26/2025,Tharindu Silva,Kegalle,Kegalle,Sabaragamuwa,9484,7897,17381,379360,315880,695240
2/27/2025,Tharindu Silva,Kegalle,Kegalle,Sabaragamuwa,7085,8895,15980,283400,355800,639200
2/28/2025,Tharindu Silva,Kegalle,Kegalle,Sabaragamuwa,7145,2257,9402,285800,90280,376080
3/1/2025,Tharindu Silva,Kegalle,Kegalle,Sabaragamuwa,2709,5576,8285,108360,223040,331400
3/2/2025,Tharindu Silva,Kegalle,Kegalle,Sabaragamuwa,4589,9439,14028,183560,377560,561120
3/3/2025,Tharindu Silva,Kegalle,Kegalle,Sabaragamuwa,4867,3903,8770,194680,156120,350800
3/4/2025,Tharindu Silva,Kegalle,Kegalle,Sabaragamuwa,7554,6535,14089,302160,261400,563560
3/5/2025,Tharindu Silva,Kegalle,Kegalle,Sabaragamuwa,1455,8434,9889,58200,337360,395560
3/6/2025,Tharindu Silva,Kegalle,Kegalle,Sabaragamuwa,4145,659,4804,165800,26360,192160
3/7/2025,Tharindu Silva,Kegalle,Kegalle,Sabaragamuwa,5431,6237,11668,217240,249480,466720
3/8/2025,Tharindu Silva,Kegalle,Kegalle,Sabaragamuwa,3471,9811,13282,138840,392440,531280
3/9/2025,Tharindu Silva,Kegalle,Kegalle,Sabaragamuwa,2289,8502,10791,91560,340080,431640
3/10/2025,Tharindu Silva,Kegalle,Kegalle,Sabaragamuwa,9697,8017,17714,387880,320680,708560
3/11/2025,Tharindu Silva,Kegalle,Kegalle,Sabaragamuwa,1813,1441,3254,72520,57640,130160
3/12/2025,Tharindu Silva,Kegalle,Kegalle,Sabaragamuwa,6140,5071,11211,245600,202840,448440
3/13/2025,Tharindu Silva,Kegalle,Kegalle,Sabaragamuwa,1207,5133,6340,48280,205320,253600
3/14/2025,Tharindu Silva,Kegalle,Kegalle,Sabaragamuwa,2230,5078,7308,89200,203120,292320
3/15/2025,Tharindu Silva,Kegalle,Kegalle,Sabaragamuwa,6946,6453,13399,277840,258120,535960
3/16/2025,Tharindu Silva,Kegalle,Kegalle,Sabaragamuwa,5592,3343,8935,223680,133720,357400
3/17/2025,Tharindu Silva,Kegalle,Kegalle,Sabaragamuwa,4364,4935,9299,174560,197400,371960
3/18/2025,Tharindu Silva,Kegalle,Kegalle,Sabaragamuwa,7157,9858,17015,286280,394320,680600
3/19/2025,Tharindu Silva,Kegalle,Kegalle,Sabaragamuwa,4671,8400,13071,186840,336000,522840
3/20/2025,Tharindu Silva,Kegalle,Kegalle,Sabaragamuwa,7336,5209,12545,293440,208360,501800
3/21/2025,Tharindu Silva,Kegalle,Kegalle,Sabaragamuwa,5366,8568,13934,214640,342720,557360
3/22/2025,Tharindu Silva,Kegalle,Kegalle,Sabaragamuwa,4308,3508,7816,172320,140320,312640
3/23/2025,Tharindu Silva,Kegalle,Kegalle,Sabaragamuwa,1411,6873,8284,56440,274920,331360
3/25/2024,Chandima Perera,Puttalam,Puttalam,North Western,2651,4398,7049,106040,175920,281960
3/26/2024,Chandima Perera,Puttalam,Puttalam,North Western,1449,9279,10728,57960,371160,429120
3/27/2024,Chandima Perera,Puttalam,Puttalam,North Western,6358,3259,9617,254320,130360,384680
3/28/2024,Chandima Perera,Puttalam,Puttalam,North Western,9457,9182,18639,378280,367280,745560
3/29/2024,Chandima Perera,Puttalam,Puttalam,North Western,589,6942,7531,23560,277680,301240
3/30/2024,Chandima Perera,Puttalam,Puttalam,North Western,5267,6466,11733,210680,258640,469320
3/31/2024,Chandima Perera,Puttalam,Puttalam,North Western,9710,2710,12420,388400,108400,496800
4/1/2024,Chandima Perera,Puttalam,Puttalam,North Western,7594,3352,10946,303760,134080,437840
4/2/2024,Chandima Perera,Puttalam,Puttalam,North Western,4034,3963,7997,161360,158520,319880
4/3/2024,Chandima Perera,Puttalam,Puttalam,North Western,8616,4083,12699,344640,163320,507960
4/4/2024,Chandima Perera,Puttalam,Puttalam,North Western,9224,1381,10605,368960,55240,424200
4/5/2024,Chandima Perera,Puttalam,Puttalam,North Western,3196,8422,11618,127840,336880,464720
4/6/2024,Chandima Perera,Puttalam,Puttalam,North Western,9818,5831,15649,392720,233240,625960
4/7/2024,Chandima Perera,Puttalam,Puttalam,North Western,5677,4865,10542,227080,194600,421680
4/8/2024,Chandima Perera,Puttalam,Puttalam,North Western,3878,9930,13808,155120,397200,552320
4/9/2024,Chandima Perera,Puttalam,Puttalam,North Western,3796,4954,8750,151840,198160,350000
4/10/2024,Chandima Perera,Puttalam,Puttalam,North Western,4161,6390,10551,166440,255600,422040
4/11/2024,Chandima Perera,Puttalam,Puttalam,North Western,8671,4380,13051,346840,175200,522040
4/19/2024,Chandima Perera,Puttalam,Puttalam,North Western,6119,8135,14254,244760,325400,570160
4/20/2024,Chandima Perera,Puttalam,Puttalam,North Western,3749,6083,9832,149960,243320,393280
4/21/2024,Chandima Perera,Puttalam,Puttalam,North Western,7007,7754,14761,280280,310160,590440
4/22/2024,Chandima Perera,Puttalam,Puttalam,North Western,8321,7134,15455,332840,285360,618200
4/23/2024,Chandima Perera,Puttalam,Puttalam,North Western,5185,1682,6867,207400,67280,274680
4/24/2024,Chandima Perera,Puttalam,Puttalam,North Western,5713,4011,9724,228520,160440,388960
4/25/2024,Chandima Perera,Puttalam,Puttalam,North Western,7207,6013,13220,288280,240520,528800
4/26/2024,Chandima Perera,Puttalam,Puttalam,North Western,6719,8817,15536,268760,352680,621440
4/27/2024,Chandima Perera,Puttalam,Puttalam,North Western,1403,5768,7171,56120,230720,286840
4/28/2024,Chandima Perera,Puttalam,Puttalam,North Western,6885,8919,15804,275400,356760,632160
4/29/2024,Chandima Perera,Puttalam,Puttalam,North Western,8548,9495,18043,341920,379800,721720
4/30/2024,Chandima Perera,Puttalam,Puttalam,North Western,6532,6581,13113,261280,263240,524520
5/1/2024,Chandima Perera,Puttalam,Puttalam,North Western,7649,7809,15458,305960,312360,618320
5/2/2024,Chandima Perera,Puttalam,Puttalam,North Western,8047,4059,12106,321880,162360,484240
5/3/2024,Chandima Perera,Puttalam,Puttalam,North Western,4767,4998,9765,190680,199920,390600
5/4/2024,Chandima Perera,Puttalam,Puttalam,North Western,8750,1174,9924,350000,46960,396960
5/5/2024,Chandima Perera,Puttalam,Puttalam,North Western,7232,4595,11827,289280,183800,473080
5/6/2024,Chandima Perera,Puttalam,Puttalam,North Western,1185,6326,7511,47400,253040,300440
5/7/2024,Chandima Perera,Puttalam,Puttalam,North Western,9525,7283,16808,381000,291320,672320
5/8/2024,Chandima Perera,Puttalam,Puttalam,North Western,9949,1955,11904,397960,78200,476160
5/9/2024,Chandima Perera,Puttalam,Puttalam,North Western,5675,7007,12682,227000,280280,507280
5/10/2024,Chandima Perera,Puttalam,Puttalam,North Western,7798,4710,12508,311920,188400,500320
5/11/2024,Chandima Perera,Puttalam,Puttalam,North Western,5769,3506,9275,230760,140240,371000
5/12/2024,Chandima Perera,Puttalam,Puttalam,North Western,7621,7010,14631,304840,280400,585240
5/13/2024,Chandima Perera,Puttalam,Puttalam,North Western,3229,760,3989,129160,30400,159560
5/14/2024,Chandima Perera,Puttalam,Puttalam,North Western,1374,5300,6674,54960,212000,266960
5/15/2024,Chandima Perera,Puttalam,Puttalam,North Western,9234,5462,14696,369360,218480,587840
5/16/2024,Chandima Perera,Puttalam,Puttalam,North Western,5330,4283,9613,213200,171320,384520
5/17/2024,Chandima Perera,Puttalam,Puttalam,North Western,5745,1008,6753,229800,40320,270120
5/18/2024,Chandima Perera,Puttalam,Puttalam,North Western,7576,3346,10922,303040,133840,436880
5/19/2024,Chandima Perera,Puttalam,Puttalam,North Western,8033,6604,14637,321320,264160,585480
5/20/2024,Chandima Perera,Puttalam,Puttalam,North Western,1116,9285,10401,44640,371400,416040
5/21/2024,Chandima Perera,Puttalam,Puttalam,North Western,3748,9351,13099,149920,374040,523960
5/22/2024,Chandima Perera,Puttalam,Puttalam,North Western,4204,4026,8230,168160,161040,329200
5/24/2024,Chandima Perera,Puttalam,Puttalam,North Western,7072,808,7880,282880,32320,315200
5/25/2024,Chandima Perera,Puttalam,Puttalam,North Western,8364,8147,16511,334560,325880,660440
5/26/2024,Chandima Perera,Puttalam,Puttalam,North Western,4045,9236,13281,161800,369440,531240
5/27/2024,Chandima Perera,Puttalam,Puttalam,North Western,6646,1880,8526,265840,75200,341040
5/28/2024,Chandima Perera,Puttalam,Puttalam,North Western,3147,1994,5141,125880,79760,205640
5/29/2024,Chandima Perera,Puttalam,Puttalam,North Western,3322,6346,9668,132880,253840,386720
5/30/2024,Chandima Perera,Puttalam,Puttalam,North Western,8991,8560,17551,359640,342400,702040
5/31/2024,Chandima Perera,Puttalam,Puttalam,North Western,2089,2627,4716,83560,105080,188640
6/1/2024,Chandima Perera,Puttalam,Puttalam,North Western,6512,1234,7746,260480,49360,309840
6/2/2024,Chandima Perera,Puttalam,Puttalam,North Western,6094,989,7083,243760,39560,283320
6/3/2024,Chandima Perera,Puttalam,Puttalam,North Western,9173,5368,14541,366920,214720,581640
6/4/2024,Chandima Perera,Puttalam,Puttalam,North Western,7666,9058,16724,306640,362320,668960
6/5/2024,Chandima Perera,Puttalam,Puttalam,North Western,318,702,1020,12720,28080,40800
6/6/2024,Chandima Perera,Puttalam,Puttalam,North Western,7971,5025,12996,318840,201000,519840
6/7/2024,Chandima Perera,Puttalam,Puttalam,North Western,1881,2519,4400,75240,100760,176000
6/8/2024,Chandima Perera,Puttalam,Puttalam,North Western,7539,8034,15573,301560,321360,622920
6/9/2024,Chandima Perera,Puttalam,Puttalam,North Western,8135,8279,16414,325400,331160,656560
6/10/2024,Chandima Perera,Puttalam,Puttalam,North Western,4282,6011,10293,171280,240440,411720
6/11/2024,Chandima Perera,Puttalam,Puttalam,North Western,1783,9462,11245,71320,378480,449800
6/12/2024,Chandima Perera,Puttalam,Puttalam,North Western,9897,5774,15671,395880,230960,626840
6/13/2024,Chandima Perera,Puttalam,Puttalam,North Western,4774,7070,11844,190960,282800,473760
6/14/2024,Chandima Perera,Puttalam,Puttalam,North Western,7844,4569,12413,313760,182760,496520
6/15/2024,Chandima Perera,Puttalam,Puttalam,North Western,9408,2169,11577,376320,86760,463080
6/16/2024,Chandima Perera,Puttalam,Puttalam,North Western,8938,8408,17346,357520,336320,693840
6/17/2024,Chandima Perera,Puttalam,Puttalam,North Western,3679,4837,8516,147160,193480,340640
6/18/2024,Chandima Perera,Puttalam,Puttalam,North Western,1848,5838,7686,73920,233520,307440
6/19/2024,Chandima Perera,Puttalam,Puttalam,North Western,9134,2687,11821,365360,107480,472840
6/20/2024,Chandima Perera,Puttalam,Puttalam,North Western,4295,7942,12237,171800,317680,489480
6/21/2024,Chandima Perera,Puttalam,Puttalam,North Western,6949,9789,16738,277960,391560,669520
6/22/2024,Chandima Perera,Puttalam,Puttalam,North Western,5323,2109,7432,212920,84360,297280
6/23/2024,Chandima Perera,Puttalam,Puttalam,North Western,8374,1135,9509,334960,45400,380360
6/24/2024,Chandima Perera,Puttalam,Puttalam,North Western,8364,4673,13037,334560,186920,521480
6/25/2024,Chandima Perera,Puttalam,Puttalam,North Western,9103,3029,12132,364120,121160,485280
6/26/2024,Chandima Perera,Puttalam,Puttalam,North Western,708,4462,5170,28320,178480,206800
6/27/2024,Chandima Perera,Puttalam,Puttalam,North Western,942,3946,4888,37680,157840,195520
6/28/2024,Chandima Perera,Puttalam,Puttalam,North Western,9795,6290,16085,391800,251600,643400
6/29/2024,Chandima Perera,Puttalam,Puttalam,North Western,1811,1076,2887,72440,43040,115480
6/30/2024,Chandima Perera,Puttalam,Puttalam,North Western,3172,3677,6849,126880,147080,273960
7/1/2024,Chandima Perera,Puttalam,Puttalam,North Western,9835,5014,14849,393400,200560,593960
7/2/2024,Chandima Perera,Puttalam,Puttalam,North Western,8662,357,9019,346480,14280,360760
7/3/2024,Chandima Perera,Puttalam,Puttalam,North Western,198,9111,9309,7920,364440,372360
7/4/2024,Chandima Perera,Puttalam,Puttalam,North Western,2562,2755,5317,102480,110200,212680
7/5/2024,Chandima Perera,Puttalam,Puttalam,North Western,5736,9823,15559,229440,392920,622360
7/6/2024,Chandima Perera,Puttalam,Puttalam,North Western,741,8221,8962,29640,328840,358480
7/7/2024,Chandima Perera,Puttalam,Puttalam,North Western,871,555,1426,34840,22200,57040
7/8/2024,Chandima Perera,Puttalam,Puttalam,North Western,8905,6256,15161,356200,250240,606440
7/9/2024,Chandima Perera,Puttalam,Puttalam,North Western,7083,1064,8147,283320,42560,325880
7/10/2024,Chandima Perera,Puttalam,Puttalam,North Western,1410,4606,6016,56400,184240,240640
7/11/2024,Chandima Perera,Puttalam,Puttalam,North Western,9040,4986,14026,361600,199440,561040
7/12/2024,Chandima Perera,Puttalam,Puttalam,North Western,4572,4686,9258,182880,187440,370320
7/13/2024,Chandima Perera,Puttalam,Puttalam,North Western,5115,2999,8114,204600,119960,324560
7/14/2024,Chandima Perera,Puttalam,Puttalam,North Western,9757,7763,17520,390280,310520,700800
7/15/2024,Chandima Perera,Puttalam,Puttalam,North Western,2625,2104,4729,105000,84160,189160
7/16/2024,Chandima Perera,Puttalam,Puttalam,North Western,4621,338,4959,184840,13520,198360
7/17/2024,Chandima Perera,Puttalam,Puttalam,North Western,7181,5226,12407,287240,209040,496280
7/18/2024,Chandima Perera,Puttalam,Puttalam,North Western,7029,5800,12829,281160,232000,513160
7/19/2024,Chandima Perera,Puttalam,Puttalam,North Western,7549,8546,16095,301960,341840,643800
7/20/2024,Chandima Perera,Puttalam,Puttalam,North Western,2179,3995,6174,87160,159800,246960
7/21/2024,Chandima Perera,Puttalam,Puttalam,North Western,3551,684,4235,142040,27360,169400
7/22/2024,Chandima Perera,Puttalam,Puttalam,North Western,5684,3914,9598,227360,156560,383920
7/23/2024,Chandima Perera,Puttalam,Puttalam,North Western,555,9301,9856,22200,372040,394240
7/24/2024,Chandima Perera,Puttalam,Puttalam,North Western,3168,7454,10622,126720,298160,424880
7/25/2024,Chandima Perera,Puttalam,Puttalam,North Western,636,7912,8548,25440,316480,341920
7/26/2024,Chandima Perera,Puttalam,Puttalam,North Western,4008,2224,6232,160320,88960,249280
7/27/2024,Chandima Perera,Puttalam,Puttalam,North Western,1788,4365,6153,71520,174600,246120
7/28/2024,Chandima Perera,Puttalam,Puttalam,North Western,9520,5364,14884,380800,214560,595360
7/29/2024,Chandima Perera,Puttalam,Puttalam,North Western,3316,9945,13261,132640,397800,530440
7/30/2024,Chandima Perera,Puttalam,Puttalam,North Western,3869,298,4167,154760,11920,166680
7/31/2024,Chandima Perera,Puttalam,Puttalam,North Western,9030,9723,18753,361200,388920,750120
8/1/2024,Chandima Perera,Puttalam,Puttalam,North Western,7643,4554,12197,305720,182160,487880
8/2/2024,Chandima Perera,Puttalam,Puttalam,North Western,1766,9091,10857,70640,363640,434280
8/3/2024,Chandima Perera,Puttalam,Puttalam,North Western,1889,627,2516,75560,25080,100640
8/4/2024,Chandima Perera,Puttalam,Puttalam,North Western,5166,1004,6170,206640,40160,246800
8/5/2024,Chandima Perera,Puttalam,Puttalam,North Western,207,3423,3630,8280,136920,145200
8/6/2024,Chandima Perera,Puttalam,Puttalam,North Western,7927,8168,16095,317080,326720,643800
8/7/2024,Chandima Perera,Puttalam,Puttalam,North Western,282,2648,2930,11280,105920,117200
8/8/2024,Chandima Perera,Puttalam,Puttalam,North Western,867,2028,2895,34680,81120,115800
8/9/2024,Chandima Perera,Puttalam,Puttalam,North Western,140,3773,3913,5600,150920,156520
8/10/2024,Chandima Perera,Puttalam,Puttalam,North Western,5126,1503,6629,205040,60120,265160
8/11/2024,Chandima Perera,Puttalam,Puttalam,North Western,3195,4407,7602,127800,176280,304080
8/12/2024,Chandima Perera,Puttalam,Puttalam,North Western,1069,2773,3842,42760,110920,153680
8/13/2024,Chandima Perera,Puttalam,Puttalam,North Western,7395,3647,11042,295800,145880,441680
8/14/2024,Chandima Perera,Puttalam,Puttalam,North Western,1895,1552,3447,75800,62080,137880
8/15/2024,Chandima Perera,Puttalam,Puttalam,North Western,7158,3354,10512,286320,134160,420480
8/16/2024,Chandima Perera,Puttalam,Puttalam,North Western,5830,5601,11431,233200,224040,457240
8/17/2024,Chandima Perera,Puttalam,Puttalam,North Western,1821,35,1856,72840,1400,74240
8/18/2024,Chandima Perera,Puttalam,Puttalam,North Western,8143,6468,14611,325720,258720,584440
8/19/2024,Chandima Perera,Puttalam,Puttalam,North Western,3796,702,4498,151840,28080,179920
8/20/2024,Chandima Perera,Puttalam,Puttalam,North Western,4297,2724,7021,171880,108960,280840
8/21/2024,Chandima Perera,Puttalam,Puttalam,North Western,5435,193,5628,217400,7720,225120
8/22/2024,Chandima Perera,Puttalam,Puttalam,North Western,1371,8769,10140,54840,350760,405600
8/23/2024,Chandima Perera,Puttalam,Puttalam,North Western,2827,1867,4694,113080,74680,187760
8/24/2024,Chandima Perera,Puttalam,Puttalam,North Western,7096,4072,11168,283840,162880,446720
8/25/2024,Chandima Perera,Puttalam,Puttalam,North Western,8950,4425,13375,358000,177000,535000
8/26/2024,Chandima Perera,Puttalam,Puttalam,North Western,4494,4565,9059,179760,182600,362360
8/27/2024,Chandima Perera,Puttalam,Puttalam,North Western,2650,5599,8249,106000,223960,329960
8/28/2024,Chandima Perera,Puttalam,Puttalam,North Western,4321,1581,5902,172840,63240,236080
8/29/2024,Chandima Perera,Puttalam,Puttalam,North Western,3751,3229,6980,150040,129160,279200
8/30/2024,Chandima Perera,Puttalam,Puttalam,North Western,9458,1005,10463,378320,40200,418520
8/31/2024,Chandima Perera,Puttalam,Puttalam,North Western,6169,4235,10404,246760,169400,416160
9/1/2024,Chandima Perera,Puttalam,Puttalam,North Western,4654,815,5469,186160,32600,218760
9/2/2024,Chandima Perera,Puttalam,Puttalam,North Western,5246,2520,7766,209840,100800,310640
9/3/2024,Chandima Perera,Puttalam,Puttalam,North Western,3132,2702,5834,125280,108080,233360
9/4/2024,Chandima Perera,Puttalam,Puttalam,North Western,3593,9885,13478,143720,395400,539120
9/5/2024,Chandima Perera,Puttalam,Puttalam,North Western,7512,6675,14187,300480,267000,567480
9/6/2024,Chandima Perera,Puttalam,Puttalam,North Western,6574,3142,9716,262960,125680,388640
9/7/2024,Chandima Perera,Puttalam,Puttalam,North Western,4202,6950,11152,168080,278000,446080
9/8/2024,Chandima Perera,Puttalam,Puttalam,North Western,8104,1770,9874,324160,70800,394960
9/9/2024,Chandima Perera,Puttalam,Puttalam,North Western,2192,9801,11993,87680,392040,479720
9/10/2024,Chandima Perera,Puttalam,Puttalam,North Western,1280,7058,8338,51200,282320,333520
9/11/2024,Chandima Perera,Puttalam,Puttalam,North Western,8320,5856,14176,332800,234240,567040
9/12/2024,Chandima Perera,Puttalam,Puttalam,North Western,2137,3605,5742,85480,144200,229680
9/13/2024,Chandima Perera,Puttalam,Puttalam,North Western,4253,6034,10287,170120,241360,411480
9/14/2024,Chandima Perera,Puttalam,Puttalam,North Western,8093,5226,13319,323720,209040,532760
9/15/2024,Chandima Perera,Puttalam,Puttalam,North Western,5253,3953,9206,210120,158120,368240
9/16/2024,Chandima Perera,Puttalam,Puttalam,North Western,6695,9345,16040,267800,373800,641600
9/17/2024,Chandima Perera,Puttalam,Puttalam,North Western,958,8793,9751,38320,351720,390040
9/18/2024,Chandima Perera,Puttalam,Puttalam,North Western,4305,5584,9889,172200,223360,395560
9/19/2024,Chandima Perera,Puttalam,Puttalam,North Western,3960,9587,13547,158400,383480,541880
9/20/2024,Chandima Perera,Puttalam,Puttalam,North Western,5722,2006,7728,228880,80240,309120
9/21/2024,Chandima Perera,Puttalam,Puttalam,North Western,6677,867,7544,267080,34680,301760
9/22/2024,Chandima Perera,Puttalam,Puttalam,North Western,1006,8162,9168,40240,326480,366720
9/23/2024,Chandima Perera,Puttalam,Puttalam,North Western,1226,4801,6027,49040,192040,241080
9/24/2024,Chandima Perera,Puttalam,Puttalam,North Western,5763,4954,10717,230520,198160,428680
9/25/2024,Chandima Perera,Puttalam,Puttalam,North Western,3114,7893,11007,124560,315720,440280
9/26/2024,Chandima Perera,Puttalam,Puttalam,North Western,5661,8816,14477,226440,352640,579080
9/27/2024,Chandima Perera,Puttalam,Puttalam,North Western,4236,9481,13717,169440,379240,548680
9/28/2024,Chandima Perera,Puttalam,Puttalam,North Western,5216,642,5858,208640,25680,234320
9/29/2024,Chandima Perera,Puttalam,Puttalam,North Western,3601,4210,7811,144040,168400,312440
9/30/2024,Chandima Perera,Puttalam,Puttalam,North Western,5560,3076,8636,222400,123040,345440
10/1/2024,Chandima Perera,Puttalam,Puttalam,North Western,6829,7508,14337,273160,300320,573480
10/2/2024,Chandima Perera,Puttalam,Puttalam,North Western,8355,3433,11788,334200,137320,471520
10/3/2024,Chandima Perera,Puttalam,Puttalam,North Western,3815,2150,5965,152600,86000,238600
10/4/2024,Chandima Perera,Puttalam,Puttalam,North Western,2111,2910,5021,84440,116400,200840
10/5/2024,Chandima Perera,Puttalam,Puttalam,North Western,1504,9570,11074,60160,382800,442960
10/6/2024,Chandima Perera,Puttalam,Puttalam,North Western,1409,3205,4614,56360,128200,184560
10/7/2024,Chandima Perera,Puttalam,Puttalam,North Western,7369,7475,14844,294760,299000,593760
10/8/2024,Chandima Perera,Puttalam,Puttalam,North Western,403,8117,8520,16120,324680,340800
10/9/2024,Chandima Perera,Puttalam,Puttalam,North Western,1358,5597,6955,54320,223880,278200
10/10/2024,Chandima Perera,Puttalam,Puttalam,North Western,7537,7340,14877,301480,293600,595080
10/11/2024,Chandima Perera,Puttalam,Puttalam,North Western,670,9229,9899,26800,369160,395960
10/12/2024,Chandima Perera,Puttalam,Puttalam,North Western,3998,6075,10073,159920,243000,402920
10/13/2024,Chandima Perera,Puttalam,Puttalam,North Western,4669,3514,8183,186760,140560,327320
10/14/2024,Chandima Perera,Puttalam,Puttalam,North Western,4583,4753,9336,183320,190120,373440
10/15/2024,Chandima Perera,Puttalam,Puttalam,North Western,6562,2884,9446,262480,115360,377840
10/16/2024,Chandima Perera,Puttalam,Puttalam,North Western,539,3014,3553,21560,120560,142120
10/17/2024,Chandima Perera,Puttalam,Puttalam,North Western,6299,8961,15260,251960,358440,610400
10/18/2024,Chandima Perera,Puttalam,Puttalam,North Western,6661,4294,10955,266440,171760,438200
10/19/2024,Chandima Perera,Puttalam,Puttalam,North Western,2747,7896,10643,109880,315840,425720
10/20/2024,Chandima Perera,Puttalam,Puttalam,North Western,9916,9024,18940,396640,360960,757600
10/21/2024,Chandima Perera,Puttalam,Puttalam,North Western,6790,2447,9237,271600,97880,369480
10/22/2024,Chandima Perera,Puttalam,Puttalam,North Western,7471,2317,9788,298840,92680,391520
10/23/2024,Chandima Perera,Puttalam,Puttalam,North Western,6740,5707,12447,269600,228280,497880
10/24/2024,Chandima Perera,Puttalam,Puttalam,North Western,5185,9208,14393,207400,368320,575720
10/25/2024,Chandima Perera,Puttalam,Puttalam,North Western,9822,8118,17940,392880,324720,717600
10/26/2024,Chandima Perera,Puttalam,Puttalam,North Western,8444,5247,13691,337760,209880,547640
10/27/2024,Chandima Perera,Puttalam,Puttalam,North Western,2215,6967,9182,88600,278680,367280
10/28/2024,Chandima Perera,Puttalam,Puttalam,North Western,7163,1891,9054,286520,75640,362160
10/29/2024,Chandima Perera,Puttalam,Puttalam,North Western,9673,2164,11837,386920,86560,473480
10/30/2024,Chandima Perera,Puttalam,Puttalam,North Western,5601,8235,13836,224040,329400,553440
10/31/2024,Chandima Perera,Puttalam,Puttalam,North Western,2636,586,3222,105440,23440,128880
11/1/2024,Chandima Perera,Puttalam,Puttalam,North Western,8909,5571,14480,356360,222840,579200
11/2/2024,Chandima Perera,Puttalam,Puttalam,North Western,3751,1708,5459,150040,68320,218360
11/3/2024,Chandima Perera,Puttalam,Puttalam,North Western,768,2058,2826,30720,82320,113040
11/4/2024,Chandima Perera,Puttalam,Puttalam,North Western,9269,8257,17526,370760,330280,701040
11/5/2024,Chandima Perera,Puttalam,Puttalam,North Western,647,4462,5109,25880,178480,204360
11/6/2024,Chandima Perera,Puttalam,Puttalam,North Western,3300,1288,4588,132000,51520,183520
11/7/2024,Chandima Perera,Puttalam,Puttalam,North Western,7457,70,7527,298280,2800,301080
11/8/2024,Chandima Perera,Puttalam,Puttalam,North Western,6080,4701,10781,243200,188040,431240
11/9/2024,Chandima Perera,Puttalam,Puttalam,North Western,5904,8666,14570,236160,346640,582800
11/10/2024,Chandima Perera,Puttalam,Puttalam,North Western,5070,3476,8546,202800,139040,341840
11/11/2024,Chandima Perera,Puttalam,Puttalam,North Western,6653,2102,8755,266120,84080,350200
11/12/2024,Chandima Perera,Puttalam,Puttalam,North Western,4530,4905,9435,181200,196200,377400
11/13/2024,Chandima Perera,Puttalam,Puttalam,North Western,9668,4569,14237,386720,182760,569480
11/14/2024,Chandima Perera,Puttalam,Puttalam,North Western,8162,2623,10785,326480,104920,431400
11/15/2024,Chandima Perera,Puttalam,Puttalam,North Western,8798,1590,10388,351920,63600,415520
11/16/2024,Chandima Perera,Puttalam,Puttalam,North Western,3605,2881,6486,144200,115240,259440
11/17/2024,Chandima Perera,Puttalam,Puttalam,North Western,199,4870,5069,7960,194800,202760
11/18/2024,Chandima Perera,Puttalam,Puttalam,North Western,211,8637,8848,8440,345480,353920
11/19/2024,Chandima Perera,Puttalam,Puttalam,North Western,8951,2645,11596,358040,105800,463840
11/20/2024,Chandima Perera,Puttalam,Puttalam,North Western,5689,998,6687,227560,39920,267480
11/21/2024,Chandima Perera,Puttalam,Puttalam,North Western,6857,6741,13598,274280,269640,543920
11/22/2024,Chandima Perera,Puttalam,Puttalam,North Western,3807,8276,12083,152280,331040,483320
11/23/2024,Chandima Perera,Puttalam,Puttalam,North Western,322,3750,4072,12880,150000,162880
11/24/2024,Chandima Perera,Puttalam,Puttalam,North Western,5533,9735,15268,221320,389400,610720
11/25/2024,Chandima Perera,Puttalam,Puttalam,North Western,984,6161,7145,39360,246440,285800
11/26/2024,Chandima Perera,Puttalam,Puttalam,North Western,8999,4366,13365,359960,174640,534600
11/27/2024,Chandima Perera,Puttalam,Puttalam,North Western,5223,9399,14622,208920,375960,584880
11/28/2024,Chandima Perera,Puttalam,Puttalam,North Western,231,3559,3790,9240,142360,151600
11/29/2024,Chandima Perera,Puttalam,Puttalam,North Western,2423,4343,6766,96920,173720,270640
11/30/2024,Chandima Perera,Puttalam,Puttalam,North Western,7618,8124,15742,304720,324960,629680
12/1/2024,Chandima Perera,Puttalam,Puttalam,North Western,1728,5931,7659,69120,237240,306360
12/2/2024,Chandima Perera,Puttalam,Puttalam,North Western,1581,8153,9734,63240,326120,389360
12/3/2024,Chandima Perera,Puttalam,Puttalam,North Western,2123,8866,10989,84920,354640,439560
12/4/2024,Chandima Perera,Puttalam,Puttalam,North Western,4428,7808,12236,177120,312320,489440
12/5/2024,Chandima Perera,Puttalam,Puttalam,North Western,8990,4767,13757,359600,190680,550280
12/6/2024,Chandima Perera,Puttalam,Puttalam,North Western,5844,5642,11486,233760,225680,459440
12/7/2024,Chandima Perera,Puttalam,Puttalam,North Western,1453,191,1644,58120,7640,65760
12/8/2024,Chandima Perera,Puttalam,Puttalam,North Western,8065,6434,14499,322600,257360,579960
12/9/2024,Chandima Perera,Puttalam,Puttalam,North Western,2891,320,3211,115640,12800,128440
12/10/2024,Chandima Perera,Puttalam,Puttalam,North Western,1571,8790,10361,62840,351600,414440
12/11/2024,Chandima Perera,Puttalam,Puttalam,North Western,3454,6642,10096,138160,265680,403840
12/12/2024,Chandima Perera,Puttalam,Puttalam,North Western,3145,2407,5552,125800,96280,222080
12/13/2024,Chandima Perera,Puttalam,Puttalam,North Western,7094,573,7667,283760,22920,306680
12/14/2024,Chandima Perera,Puttalam,Puttalam,North Western,7641,3531,11172,305640,141240,446880
12/15/2024,Chandima Perera,Puttalam,Puttalam,North Western,2405,6822,9227,96200,272880,369080
12/16/2024,Chandima Perera,Puttalam,Puttalam,North Western,5507,4753,10260,220280,190120,410400
12/17/2024,Chandima Perera,Puttalam,Puttalam,North Western,624,1986,2610,24960,79440,104400
12/18/2024,Chandima Perera,Puttalam,Puttalam,North Western,5398,5253,10651,215920,210120,426040
12/19/2024,Chandima Perera,Puttalam,Puttalam,North Western,24,1308,1332,960,52320,53280
12/20/2024,Chandima Perera,Puttalam,Puttalam,North Western,9304,5034,14338,372160,201360,573520
12/21/2024,Chandima Perera,Puttalam,Puttalam,North Western,596,2959,3555,23840,118360,142200
12/22/2024,Chandima Perera,Puttalam,Puttalam,North Western,647,9406,10053,25880,376240,402120
12/23/2024,Chandima Perera,Puttalam,Puttalam,North Western,2418,7930,10348,96720,317200,413920
12/24/2024,Chandima Perera,Puttalam,Puttalam,North Western,7959,3155,11114,318360,126200,444560
12/25/2024,Chandima Perera,Puttalam,Puttalam,North Western,3610,2207,5817,144400,88280,232680
12/26/2024,Chandima Perera,Puttalam,Puttalam,North Western,1642,5005,6647,65680,200200,265880
12/27/2024,Chandima Perera,Puttalam,Puttalam,North Western,5817,4737,10554,232680,189480,422160
12/28/2024,Chandima Perera,Puttalam,Puttalam,North Western,9183,9633,18816,367320,385320,752640
12/29/2024,Chandima Perera,Puttalam,Puttalam,North Western,6625,8293,14918,265000,331720,596720
12/30/2024,Chandima Perera,Puttalam,Puttalam,North Western,1966,6222,8188,78640,248880,327520
12/31/2024,Chandima Perera,Puttalam,Puttalam,North Western,548,7815,8363,21920,312600,334520
1/1/2025,Chandima Perera,Puttalam,Puttalam,North Western,6652,1359,8011,266080,54360,320440
1/2/2025,Chandima Perera,Puttalam,Puttalam,North Western,6677,3423,10100,267080,136920,404000
1/3/2025,Chandima Perera,Puttalam,Puttalam,North Western,6329,8793,15122,253160,351720,604880
1/4/2025,Chandima Perera,Puttalam,Puttalam,North Western,8384,1708,10092,335360,68320,403680
1/5/2025,Chandima Perera,Puttalam,Puttalam,North Western,9932,2277,12209,397280,91080,488360
1/6/2025,Chandima Perera,Puttalam,Puttalam,North Western,2055,8356,10411,82200,334240,416440
1/7/2025,Chandima Perera,Puttalam,Puttalam,North Western,6471,3749,10220,258840,149960,408800
1/8/2025,Chandima Perera,Puttalam,Puttalam,North Western,1762,203,1965,70480,8120,78600
1/9/2025,Chandima Perera,Puttalam,Puttalam,North Western,5011,9533,14544,200440,381320,581760
1/10/2025,Chandima Perera,Puttalam,Puttalam,North Western,6482,6142,12624,259280,245680,504960
1/11/2025,Chandima Perera,Puttalam,Puttalam,North Western,25,4374,4399,1000,174960,175960
1/12/2025,Chandima Perera,Puttalam,Puttalam,North Western,1710,3218,4928,68400,128720,197120
1/13/2025,Chandima Perera,Puttalam,Puttalam,North Western,508,4533,5041,20320,181320,201640
1/14/2025,Chandima Perera,Puttalam,Puttalam,North Western,7156,8619,15775,286240,344760,631000
1/15/2025,Chandima Perera,Puttalam,Puttalam,North Western,4036,20,4056,161440,800,162240
1/16/2025,Chandima Perera,Puttalam,Puttalam,North Western,5420,8754,14174,216800,350160,566960
1/17/2025,Chandima Perera,Puttalam,Puttalam,North Western,9582,8224,17806,383280,328960,712240
1/18/2025,Chandima Perera,Puttalam,Puttalam,North Western,4525,4348,8873,181000,173920,354920
1/19/2025,Chandima Perera,Puttalam,Puttalam,North Western,9527,393,9920,381080,15720,396800
1/20/2025,Chandima Perera,Puttalam,Puttalam,North Western,1539,7905,9444,61560,316200,377760
1/21/2025,Chandima Perera,Puttalam,Puttalam,North Western,6035,8066,14101,241400,322640,564040
1/22/2025,Chandima Perera,Puttalam,Puttalam,North Western,2947,3650,6597,117880,146000,263880
1/23/2025,Chandima Perera,Puttalam,Puttalam,North Western,8592,8466,17058,343680,338640,682320
1/24/2025,Chandima Perera,Puttalam,Puttalam,North Western,2504,1784,4288,100160,71360,171520
1/25/2025,Chandima Perera,Puttalam,Puttalam,North Western,5842,5156,10998,233680,206240,439920
1/26/2025,Chandima Perera,Puttalam,Puttalam,North Western,3568,2085,5653,142720,83400,226120
1/27/2025,Chandima Perera,Puttalam,Puttalam,North Western,6773,6964,13737,270920,278560,549480
1/28/2025,Chandima Perera,Puttalam,Puttalam,North Western,3991,1369,5360,159640,54760,214400
1/29/2025,Chandima Perera,Puttalam,Puttalam,North Western,3532,8884,12416,141280,355360,496640
1/30/2025,Chandima Perera,Puttalam,Puttalam,North Western,6279,4479,10758,251160,179160,430320
1/31/2025,Chandima Perera,Puttalam,Puttalam,North Western,3296,3274,6570,131840,130960,262800
2/1/2025,Chandima Perera,Puttalam,Puttalam,North Western,9297,7055,16352,371880,282200,654080
2/2/2025,Chandima Perera,Puttalam,Puttalam,North Western,6924,8060,14984,276960,322400,599360
2/3/2025,Chandima Perera,Puttalam,Puttalam,North Western,7273,9751,17024,290920,390040,680960
2/4/2025,Chandima Perera,Puttalam,Puttalam,North Western,3114,2394,5508,124560,95760,220320
2/5/2025,Chandima Perera,Puttalam,Puttalam,North Western,6976,9645,16621,279040,385800,664840
2/6/2025,Chandima Perera,Puttalam,Puttalam,North Western,5973,5342,11315,238920,213680,452600
2/7/2025,Chandima Perera,Puttalam,Puttalam,North Western,632,6471,7103,25280,258840,284120
2/8/2025,Chandima Perera,Puttalam,Puttalam,North Western,774,741,1515,30960,29640,60600
2/9/2025,Chandima Perera,Puttalam,Puttalam,North Western,3376,8685,12061,135040,347400,482440
2/10/2025,Chandima Perera,Puttalam,Puttalam,North Western,384,1075,1459,15360,43000,58360
2/11/2025,Chandima Perera,Puttalam,Puttalam,North Western,6422,1723,8145,256880,68920,325800
2/12/2025,Chandima Perera,Puttalam,Puttalam,North Western,4665,5519,10184,186600,220760,407360
2/13/2025,Chandima Perera,Puttalam,Puttalam,North Western,3848,73,3921,153920,2920,156840
2/14/2025,Chandima Perera,Puttalam,Puttalam,North Western,8126,2426,10552,325040,97040,422080
2/15/2025,Chandima Perera,Puttalam,Puttalam,North Western,872,1875,2747,34880,75000,109880
2/16/2025,Chandima Perera,Puttalam,Puttalam,North Western,2950,5820,8770,118000,232800,350800
2/17/2025,Chandima Perera,Puttalam,Puttalam,North Western,8555,5542,14097,342200,221680,563880
2/18/2025,Chandima Perera,Puttalam,Puttalam,North Western,3137,7187,10324,125480,287480,412960
2/19/2025,Chandima Perera,Puttalam,Puttalam,North Western,9546,995,10541,381840,39800,421640
2/20/2025,Chandima Perera,Puttalam,Puttalam,North Western,5551,761,6312,222040,30440,252480
2/21/2025,Chandima Perera,Puttalam,Puttalam,North Western,9868,303,10171,394720,12120,406840
2/22/2025,Chandima Perera,Puttalam,Puttalam,North Western,4686,3551,8237,187440,142040,329480
2/23/2025,Chandima Perera,Puttalam,Puttalam,North Western,2852,2087,4939,114080,83480,197560
2/24/2025,Chandima Perera,Puttalam,Puttalam,North Western,317,2239,2556,12680,89560,102240
2/25/2025,Chandima Perera,Puttalam,Puttalam,North Western,1909,356,2265,76360,14240,90600
2/26/2025,Chandima Perera,Puttalam,Puttalam,North Western,4164,9956,14120,166560,398240,564800
2/27/2025,Chandima Perera,Puttalam,Puttalam,North Western,5324,831,6155,212960,33240,246200
2/28/2025,Chandima Perera,Puttalam,Puttalam,North Western,6724,4064,10788,268960,162560,431520
3/1/2025,Chandima Perera,Puttalam,Puttalam,North Western,1791,7043,8834,71640,281720,353360
3/2/2025,Chandima Perera,Puttalam,Puttalam,North Western,9086,3876,12962,363440,155040,518480
3/3/2025,Chandima Perera,Puttalam,Puttalam,North Western,563,5963,6526,22520,238520,261040
3/4/2025,Chandima Perera,Puttalam,Puttalam,North Western,2012,6029,8041,80480,241160,321640
3/5/2025,Chandima Perera,Puttalam,Puttalam,North Western,4279,4506,8785,171160,180240,351400
3/6/2025,Chandima Perera,Puttalam,Puttalam,North Western,3207,1747,4954,128280,69880,198160
3/7/2025,Chandima Perera,Puttalam,Puttalam,North Western,3000,6012,9012,120000,240480,360480
3/8/2025,Chandima Perera,Puttalam,Puttalam,North Western,9726,6494,16220,389040,259760,648800
3/9/2025,Chandima Perera,Puttalam,Puttalam,North Western,9812,5981,15793,392480,239240,631720
3/10/2025,Chandima Perera,Puttalam,Puttalam,North Western,8677,5848,14525,347080,233920,581000
3/11/2025,Chandima Perera,Puttalam,Puttalam,North Western,7133,4169,11302,285320,166760,452080
3/12/2025,Chandima Perera,Puttalam,Puttalam,North Western,6216,4234,10450,248640,169360,418000
3/13/2025,Chandima Perera,Puttalam,Puttalam,North Western,7146,4386,11532,285840,175440,461280
3/14/2025,Chandima Perera,Puttalam,Puttalam,North Western,260,2049,2309,10400,81960,92360
3/15/2025,Chandima Perera,Puttalam,Puttalam,North Western,7465,4725,12190,298600,189000,487600
3/16/2025,Chandima Perera,Puttalam,Puttalam,North Western,713,6282,6995,28520,251280,279800
3/17/2025,Chandima Perera,Puttalam,Puttalam,North Western,2341,4985,7326,93640,199400,293040
3/18/2025,Chandima Perera,Puttalam,Puttalam,North Western,9255,127,9382,370200,5080,375280
3/19/2025,Chandima Perera,Puttalam,Puttalam,North Western,2915,1724,4639,116600,68960,185560
3/20/2025,Chandima Perera,Puttalam,Puttalam,North Western,8793,5820,14613,351720,232800,584520
3/21/2025,Chandima Perera,Puttalam,Puttalam,North Western,3670,7598,11268,146800,303920,450720
3/22/2025,Chandima Perera,Puttalam,Puttalam,North Western,8266,8286,16552,330640,331440,662080
3/23/2025,Chandima Perera,Puttalam,Puttalam,North Western,7386,4159,11545,295440,166360,461800
3/25/2024,Dinesh Jayawardena,Galle,Baddegama,Southern,1802,9138,10940,72080,365520,437600
3/26/2024,Dinesh Jayawardena,Galle,Baddegama,Southern,7814,7718,15532,312560,308720,621280
3/27/2024,Dinesh Jayawardena,Galle,Baddegama,Southern,561,6600,7161,22440,264000,286440
3/28/2024,Dinesh Jayawardena,Galle,Baddegama,Southern,9789,2335,12124,391560,93400,484960
3/29/2024,Dinesh Jayawardena,Galle,Baddegama,Southern,2043,2723,4766,81720,108920,190640
3/30/2024,Dinesh Jayawardena,Galle,Baddegama,Southern,5258,5351,10609,210320,214040,424360
3/31/2024,Dinesh Jayawardena,Galle,Baddegama,Southern,5889,7974,13863,235560,318960,554520
4/1/2024,Dinesh Jayawardena,Galle,Baddegama,Southern,6702,9719,16421,268080,388760,656840
4/2/2024,Dinesh Jayawardena,Galle,Baddegama,Southern,4093,7427,11520,163720,297080,460800
4/3/2024,Dinesh Jayawardena,Galle,Baddegama,Southern,4111,1787,5898,164440,71480,235920
4/4/2024,Dinesh Jayawardena,Galle,Baddegama,Southern,1942,2866,4808,77680,114640,192320
4/5/2024,Dinesh Jayawardena,Galle,Baddegama,Southern,6464,8909,15373,258560,356360,614920
4/6/2024,Dinesh Jayawardena,Galle,Baddegama,Southern,2268,5848,8116,90720,233920,324640
4/7/2024,Dinesh Jayawardena,Galle,Baddegama,Southern,5257,4517,9774,210280,180680,390960
4/8/2024,Dinesh Jayawardena,Galle,Baddegama,Southern,2388,1144,3532,95520,45760,141280
4/9/2024,Dinesh Jayawardena,Galle,Baddegama,Southern,9052,9304,18356,362080,372160,734240
4/10/2024,Dinesh Jayawardena,Galle,Baddegama,Southern,3282,9924,13206,131280,396960,528240
4/11/2024,Dinesh Jayawardena,Galle,Baddegama,Southern,5786,6119,11905,231440,244760,476200
4/19/2024,Dinesh Jayawardena,Galle,Baddegama,Southern,4807,12,4819,192280,480,192760
4/20/2024,Dinesh Jayawardena,Galle,Baddegama,Southern,3830,5973,9803,153200,238920,392120
4/21/2024,Dinesh Jayawardena,Galle,Baddegama,Southern,9013,2134,11147,360520,85360,445880
4/22/2024,Dinesh Jayawardena,Galle,Baddegama,Southern,545,1489,2034,21800,59560,81360
4/23/2024,Dinesh Jayawardena,Galle,Baddegama,Southern,5071,4346,9417,202840,173840,376680
4/24/2024,Dinesh Jayawardena,Galle,Baddegama,Southern,4173,6941,11114,166920,277640,444560
4/25/2024,Dinesh Jayawardena,Galle,Baddegama,Southern,5352,5989,11341,214080,239560,453640
4/26/2024,Dinesh Jayawardena,Galle,Baddegama,Southern,9854,9221,19075,394160,368840,763000
4/27/2024,Dinesh Jayawardena,Galle,Baddegama,Southern,5119,6665,11784,204760,266600,471360
4/28/2024,Dinesh Jayawardena,Galle,Baddegama,Southern,6231,3017,9248,249240,120680,369920
4/29/2024,Dinesh Jayawardena,Galle,Baddegama,Southern,548,1475,2023,21920,59000,80920
4/30/2024,Dinesh Jayawardena,Galle,Baddegama,Southern,7870,694,8564,314800,27760,342560
5/1/2024,Dinesh Jayawardena,Galle,Baddegama,Southern,3532,1662,5194,141280,66480,207760
5/2/2024,Dinesh Jayawardena,Galle,Baddegama,Southern,7470,8086,15556,298800,323440,622240
5/3/2024,Dinesh Jayawardena,Galle,Baddegama,Southern,1636,7324,8960,65440,292960,358400
5/4/2024,Dinesh Jayawardena,Galle,Baddegama,Southern,6810,7355,14165,272400,294200,566600
5/5/2024,Dinesh Jayawardena,Galle,Baddegama,Southern,7928,3360,11288,317120,134400,451520
5/6/2024,Dinesh Jayawardena,Galle,Baddegama,Southern,3797,3298,7095,151880,131920,283800
5/7/2024,Dinesh Jayawardena,Galle,Baddegama,Southern,5426,1556,6982,217040,62240,279280
5/8/2024,Dinesh Jayawardena,Galle,Baddegama,Southern,9941,8304,18245,397640,332160,729800
5/9/2024,Dinesh Jayawardena,Galle,Baddegama,Southern,1697,2011,3708,67880,80440,148320
5/10/2024,Dinesh Jayawardena,Galle,Baddegama,Southern,1968,3815,5783,78720,152600,231320
5/11/2024,Dinesh Jayawardena,Galle,Baddegama,Southern,729,6454,7183,29160,258160,287320
5/12/2024,Dinesh Jayawardena,Galle,Baddegama,Southern,1931,2281,4212,77240,91240,168480
5/13/2024,Dinesh Jayawardena,Galle,Baddegama,Southern,9737,9345,19082,389480,373800,763280
5/14/2024,Dinesh Jayawardena,Galle,Baddegama,Southern,8415,1317,9732,336600,52680,389280
5/15/2024,Dinesh Jayawardena,Galle,Baddegama,Southern,3883,6489,10372,155320,259560,414880
5/16/2024,Dinesh Jayawardena,Galle,Baddegama,Southern,5124,7532,12656,204960,301280,506240
5/17/2024,Dinesh Jayawardena,Galle,Baddegama,Southern,4111,6901,11012,164440,276040,440480
5/18/2024,Dinesh Jayawardena,Galle,Baddegama,Southern,4165,3619,7784,166600,144760,311360
5/19/2024,Dinesh Jayawardena,Galle,Baddegama,Southern,819,7385,8204,32760,295400,328160
5/20/2024,Dinesh Jayawardena,Galle,Baddegama,Southern,5431,1726,7157,217240,69040,286280
5/21/2024,Dinesh Jayawardena,Galle,Baddegama,Southern,1448,1884,3332,57920,75360,133280
5/22/2024,Dinesh Jayawardena,Galle,Baddegama,Southern,8070,7146,15216,322800,285840,608640
5/24/2024,Dinesh Jayawardena,Galle,Baddegama,Southern,2313,9677,11990,92520,387080,479600
5/25/2024,Dinesh Jayawardena,Galle,Baddegama,Southern,1456,5257,6713,58240,210280,268520
5/26/2024,Dinesh Jayawardena,Galle,Baddegama,Southern,3483,8940,12423,139320,357600,496920
5/27/2024,Dinesh Jayawardena,Galle,Baddegama,Southern,5903,594,6497,236120,23760,259880
5/28/2024,Dinesh Jayawardena,Galle,Baddegama,Southern,8421,477,8898,336840,19080,355920
5/29/2024,Dinesh Jayawardena,Galle,Baddegama,Southern,9607,5338,14945,384280,213520,597800
5/30/2024,Dinesh Jayawardena,Galle,Baddegama,Southern,5319,3392,8711,212760,135680,348440
5/31/2024,Dinesh Jayawardena,Galle,Baddegama,Southern,5659,3915,9574,226360,156600,382960
6/1/2024,Dinesh Jayawardena,Galle,Baddegama,Southern,8061,8848,16909,322440,353920,676360
6/2/2024,Dinesh Jayawardena,Galle,Baddegama,Southern,9662,3586,13248,386480,143440,529920
6/3/2024,Dinesh Jayawardena,Galle,Baddegama,Southern,2928,633,3561,117120,25320,142440
6/4/2024,Dinesh Jayawardena,Galle,Baddegama,Southern,165,1714,1879,6600,68560,75160
6/5/2024,Dinesh Jayawardena,Galle,Baddegama,Southern,373,1084,1457,14920,43360,58280
6/6/2024,Dinesh Jayawardena,Galle,Baddegama,Southern,6901,3209,10110,276040,128360,404400
6/7/2024,Dinesh Jayawardena,Galle,Baddegama,Southern,5211,783,5994,208440,31320,239760
6/8/2024,Dinesh Jayawardena,Galle,Baddegama,Southern,5106,4801,9907,204240,192040,396280
6/9/2024,Dinesh Jayawardena,Galle,Baddegama,Southern,5710,6813,12523,228400,272520,500920
6/10/2024,Dinesh Jayawardena,Galle,Baddegama,Southern,4927,2106,7033,197080,84240,281320
6/11/2024,Dinesh Jayawardena,Galle,Baddegama,Southern,809,732,1541,32360,29280,61640
6/12/2024,Dinesh Jayawardena,Galle,Baddegama,Southern,6550,6854,13404,262000,274160,536160
6/13/2024,Dinesh Jayawardena,Galle,Baddegama,Southern,9648,4898,14546,385920,195920,581840
6/14/2024,Dinesh Jayawardena,Galle,Baddegama,Southern,8732,9011,17743,349280,360440,709720
6/15/2024,Dinesh Jayawardena,Galle,Baddegama,Southern,1489,7441,8930,59560,297640,357200
6/16/2024,Dinesh Jayawardena,Galle,Baddegama,Southern,4788,4923,9711,191520,196920,388440
6/17/2024,Dinesh Jayawardena,Galle,Baddegama,Southern,3702,4222,7924,148080,168880,316960
6/18/2024,Dinesh Jayawardena,Galle,Baddegama,Southern,9934,4185,14119,397360,167400,564760
6/19/2024,Dinesh Jayawardena,Galle,Baddegama,Southern,6161,4185,10346,246440,167400,413840
6/20/2024,Dinesh Jayawardena,Galle,Baddegama,Southern,4447,6848,11295,177880,273920,451800
6/21/2024,Dinesh Jayawardena,Galle,Baddegama,Southern,8853,5357,14210,354120,214280,568400
6/22/2024,Dinesh Jayawardena,Galle,Baddegama,Southern,5520,7298,12818,220800,291920,512720
6/23/2024,Dinesh Jayawardena,Galle,Baddegama,Southern,8807,5723,14530,352280,228920,581200
6/24/2024,Dinesh Jayawardena,Galle,Baddegama,Southern,5104,4271,9375,204160,170840,375000
6/25/2024,Dinesh Jayawardena,Galle,Baddegama,Southern,8340,1968,10308,333600,78720,412320
6/26/2024,Dinesh Jayawardena,Galle,Baddegama,Southern,677,9910,10587,27080,396400,423480
6/27/2024,Dinesh Jayawardena,Galle,Baddegama,Southern,8412,2457,10869,336480,98280,434760
6/28/2024,Dinesh Jayawardena,Galle,Baddegama,Southern,300,6243,6543,12000,249720,261720
6/29/2024,Dinesh Jayawardena,Galle,Baddegama,Southern,4062,4365,8427,162480,174600,337080
6/30/2024,Dinesh Jayawardena,Galle,Baddegama,Southern,1811,4479,6290,72440,179160,251600
7/1/2024,Dinesh Jayawardena,Galle,Baddegama,Southern,7580,1336,8916,303200,53440,356640
7/2/2024,Dinesh Jayawardena,Galle,Baddegama,Southern,2763,5985,8748,110520,239400,349920
7/3/2024,Dinesh Jayawardena,Galle,Baddegama,Southern,1389,1859,3248,55560,74360,129920
7/4/2024,Dinesh Jayawardena,Galle,Baddegama,Southern,4712,4760,9472,188480,190400,378880
7/5/2024,Dinesh Jayawardena,Galle,Baddegama,Southern,6460,2134,8594,258400,85360,343760
7/6/2024,Dinesh Jayawardena,Galle,Baddegama,Southern,315,352,667,12600,14080,26680
7/7/2024,Dinesh Jayawardena,Galle,Baddegama,Southern,7034,5348,12382,281360,213920,495280
7/8/2024,Dinesh Jayawardena,Galle,Baddegama,Southern,7798,9208,17006,311920,368320,680240
7/9/2024,Dinesh Jayawardena,Galle,Baddegama,Southern,3710,1917,5627,148400,76680,225080
7/10/2024,Dinesh Jayawardena,Galle,Baddegama,Southern,8483,5210,13693,339320,208400,547720
7/11/2024,Dinesh Jayawardena,Galle,Baddegama,Southern,4955,1291,6246,198200,51640,249840
7/12/2024,Dinesh Jayawardena,Galle,Baddegama,Southern,5078,5629,10707,203120,225160,428280
7/13/2024,Dinesh Jayawardena,Galle,Baddegama,Southern,4359,2479,6838,174360,99160,273520
7/14/2024,Dinesh Jayawardena,Galle,Baddegama,Southern,2171,9762,11933,86840,390480,477320
7/15/2024,Dinesh Jayawardena,Galle,Baddegama,Southern,9247,5056,14303,369880,202240,572120
7/16/2024,Dinesh Jayawardena,Galle,Baddegama,Southern,2908,257,3165,116320,10280,126600
7/17/2024,Dinesh Jayawardena,Galle,Baddegama,Southern,3708,1520,5228,148320,60800,209120
7/18/2024,Dinesh Jayawardena,Galle,Baddegama,Southern,719,6511,7230,28760,260440,289200
7/19/2024,Dinesh Jayawardena,Galle,Baddegama,Southern,5527,6708,12235,221080,268320,489400
7/20/2024,Dinesh Jayawardena,Galle,Baddegama,Southern,9210,1421,10631,368400,56840,425240
7/21/2024,Dinesh Jayawardena,Galle,Baddegama,Southern,9165,7808,16973,366600,312320,678920
7/22/2024,Dinesh Jayawardena,Galle,Baddegama,Southern,1383,9542,10925,55320,381680,437000
7/23/2024,Dinesh Jayawardena,Galle,Baddegama,Southern,9715,8025,17740,388600,321000,709600
7/24/2024,Dinesh Jayawardena,Galle,Baddegama,Southern,3855,2759,6614,154200,110360,264560
7/25/2024,Dinesh Jayawardena,Galle,Baddegama,Southern,8076,6898,14974,323040,275920,598960
7/26/2024,Dinesh Jayawardena,Galle,Baddegama,Southern,7856,932,8788,314240,37280,351520
7/27/2024,Dinesh Jayawardena,Galle,Baddegama,Southern,1126,3836,4962,45040,153440,198480
7/28/2024,Dinesh Jayawardena,Galle,Baddegama,Southern,9020,5485,14505,360800,219400,580200
7/29/2024,Dinesh Jayawardena,Galle,Baddegama,Southern,9179,4257,13436,367160,170280,537440
7/30/2024,Dinesh Jayawardena,Galle,Baddegama,Southern,4408,6127,10535,176320,245080,421400
7/31/2024,Dinesh Jayawardena,Galle,Baddegama,Southern,9096,7319,16415,363840,292760,656600
8/1/2024,Dinesh Jayawardena,Galle,Baddegama,Southern,7090,1076,8166,283600,43040,326640
8/2/2024,Dinesh Jayawardena,Galle,Baddegama,Southern,8519,7840,16359,340760,313600,654360
8/3/2024,Dinesh Jayawardena,Galle,Baddegama,Southern,4973,805,5778,198920,32200,231120
8/4/2024,Dinesh Jayawardena,Galle,Baddegama,Southern,4116,1005,5121,164640,40200,204840
8/5/2024,Dinesh Jayawardena,Galle,Baddegama,Southern,2763,1022,3785,110520,40880,151400
8/6/2024,Dinesh Jayawardena,Galle,Baddegama,Southern,3100,9296,12396,124000,371840,495840
8/7/2024,Dinesh Jayawardena,Galle,Baddegama,Southern,9072,4916,13988,362880,196640,559520
8/8/2024,Dinesh Jayawardena,Galle,Baddegama,Southern,6979,3132,10111,279160,125280,404440
8/9/2024,Dinesh Jayawardena,Galle,Baddegama,Southern,2280,1863,4143,91200,74520,165720
8/10/2024,Dinesh Jayawardena,Galle,Baddegama,Southern,8672,1040,9712,346880,41600,388480
8/11/2024,Dinesh Jayawardena,Galle,Baddegama,Southern,3005,3821,6826,120200,152840,273040
8/12/2024,Dinesh Jayawardena,Galle,Baddegama,Southern,5784,1025,6809,231360,41000,272360
8/13/2024,Dinesh Jayawardena,Galle,Baddegama,Southern,3528,6661,10189,141120,266440,407560
8/14/2024,Dinesh Jayawardena,Galle,Baddegama,Southern,2925,1264,4189,117000,50560,167560
8/15/2024,Dinesh Jayawardena,Galle,Baddegama,Southern,372,1107,1479,14880,44280,59160
8/16/2024,Dinesh Jayawardena,Galle,Baddegama,Southern,853,8396,9249,34120,335840,369960
8/17/2024,Dinesh Jayawardena,Galle,Baddegama,Southern,2097,3556,5653,83880,142240,226120
8/18/2024,Dinesh Jayawardena,Galle,Baddegama,Southern,4341,931,5272,173640,37240,210880
8/19/2024,Dinesh Jayawardena,Galle,Baddegama,Southern,7121,270,7391,284840,10800,295640
8/20/2024,Dinesh Jayawardena,Galle,Baddegama,Southern,1183,8508,9691,47320,340320,387640
8/21/2024,Dinesh Jayawardena,Galle,Baddegama,Southern,8428,1573,10001,337120,62920,400040
8/22/2024,Dinesh Jayawardena,Galle,Baddegama,Southern,8139,7374,15513,325560,294960,620520
8/23/2024,Dinesh Jayawardena,Galle,Baddegama,Southern,122,3911,4033,4880,156440,161320
8/24/2024,Dinesh Jayawardena,Galle,Baddegama,Southern,149,1133,1282,5960,45320,51280
8/25/2024,Dinesh Jayawardena,Galle,Baddegama,Southern,8055,1790,9845,322200,71600,393800
8/26/2024,Dinesh Jayawardena,Galle,Baddegama,Southern,7176,540,7716,287040,21600,308640
8/27/2024,Dinesh Jayawardena,Galle,Baddegama,Southern,885,124,1009,35400,4960,40360
8/28/2024,Dinesh Jayawardena,Galle,Baddegama,Southern,8637,7695,16332,345480,307800,653280
8/29/2024,Dinesh Jayawardena,Galle,Baddegama,Southern,6345,4624,10969,253800,184960,438760
8/30/2024,Dinesh Jayawardena,Galle,Baddegama,Southern,5430,7081,12511,217200,283240,500440
8/31/2024,Dinesh Jayawardena,Galle,Baddegama,Southern,1609,4347,5956,64360,173880,238240
9/1/2024,Dinesh Jayawardena,Galle,Baddegama,Southern,7769,1545,9314,310760,61800,372560
9/2/2024,Dinesh Jayawardena,Galle,Baddegama,Southern,5629,8343,13972,225160,333720,558880
9/3/2024,Dinesh Jayawardena,Galle,Baddegama,Southern,1784,3599,5383,71360,143960,215320
9/4/2024,Dinesh Jayawardena,Galle,Baddegama,Southern,214,1968,2182,8560,78720,87280
9/5/2024,Dinesh Jayawardena,Galle,Baddegama,Southern,1163,8808,9971,46520,352320,398840
9/6/2024,Dinesh Jayawardena,Galle,Baddegama,Southern,4154,1236,5390,166160,49440,215600
9/7/2024,Dinesh Jayawardena,Galle,Baddegama,Southern,9732,9074,18806,389280,362960,752240
9/8/2024,Dinesh Jayawardena,Galle,Baddegama,Southern,5711,5437,11148,228440,217480,445920
9/9/2024,Dinesh Jayawardena,Galle,Baddegama,Southern,9140,1051,10191,365600,42040,407640
9/10/2024,Dinesh Jayawardena,Galle,Baddegama,Southern,2294,7465,9759,91760,298600,390360
9/11/2024,Dinesh Jayawardena,Galle,Baddegama,Southern,9917,6175,16092,396680,247000,643680
9/12/2024,Dinesh Jayawardena,Galle,Baddegama,Southern,5812,2348,8160,232480,93920,326400
9/13/2024,Dinesh Jayawardena,Galle,Baddegama,Southern,2528,9871,12399,101120,394840,495960
9/14/2024,Dinesh Jayawardena,Galle,Baddegama,Southern,2113,4348,6461,84520,173920,258440
9/15/2024,Dinesh Jayawardena,Galle,Baddegama,Southern,6549,217,6766,261960,8680,270640
9/16/2024,Dinesh Jayawardena,Galle,Baddegama,Southern,181,5960,6141,7240,238400,245640
9/17/2024,Dinesh Jayawardena,Galle,Baddegama,Southern,5578,4825,10403,223120,193000,416120
9/18/2024,Dinesh Jayawardena,Galle,Baddegama,Southern,4738,8430,13168,189520,337200,526720
9/19/2024,Dinesh Jayawardena,Galle,Baddegama,Southern,962,5112,6074,38480,204480,242960
9/20/2024,Dinesh Jayawardena,Galle,Baddegama,Southern,1012,3201,4213,40480,128040,168520
9/21/2024,Dinesh Jayawardena,Galle,Baddegama,Southern,9268,7745,17013,370720,309800,680520
9/22/2024,Dinesh Jayawardena,Galle,Baddegama,Southern,7204,6459,13663,288160,258360,546520
9/23/2024,Dinesh Jayawardena,Galle,Baddegama,Southern,8320,3251,11571,332800,130040,462840
9/24/2024,Dinesh Jayawardena,Galle,Baddegama,Southern,5626,6155,11781,225040,246200,471240
9/25/2024,Dinesh Jayawardena,Galle,Baddegama,Southern,3529,9460,12989,141160,378400,519560
9/26/2024,Dinesh Jayawardena,Galle,Baddegama,Southern,1615,2085,3700,64600,83400,148000
9/27/2024,Dinesh Jayawardena,Galle,Baddegama,Southern,2340,7034,9374,93600,281360,374960
9/28/2024,Dinesh Jayawardena,Galle,Baddegama,Southern,283,8491,8774,11320,339640,350960
9/29/2024,Dinesh Jayawardena,Galle,Baddegama,Southern,2391,4923,7314,95640,196920,292560
9/30/2024,Dinesh Jayawardena,Galle,Baddegama,Southern,7870,9372,17242,314800,374880,689680
10/1/2024,Dinesh Jayawardena,Galle,Baddegama,Southern,8207,7026,15233,328280,281040,609320
10/2/2024,Dinesh Jayawardena,Galle,Baddegama,Southern,8910,546,9456,356400,21840,378240
10/3/2024,Dinesh Jayawardena,Galle,Baddegama,Southern,5585,2116,7701,223400,84640,308040
10/4/2024,Dinesh Jayawardena,Galle,Baddegama,Southern,9001,3611,12612,360040,144440,504480
10/5/2024,Dinesh Jayawardena,Galle,Baddegama,Southern,7543,3586,11129,301720,143440,445160
10/6/2024,Dinesh Jayawardena,Galle,Baddegama,Southern,1175,101,1276,47000,4040,51040
10/7/2024,Dinesh Jayawardena,Galle,Baddegama,Southern,9205,9492,18697,368200,379680,747880
10/8/2024,Dinesh Jayawardena,Galle,Baddegama,Southern,1707,6658,8365,68280,266320,334600
10/9/2024,Dinesh Jayawardena,Galle,Baddegama,Southern,438,7937,8375,17520,317480,335000
10/10/2024,Dinesh Jayawardena,Galle,Baddegama,Southern,1153,1964,3117,46120,78560,124680
10/11/2024,Dinesh Jayawardena,Galle,Baddegama,Southern,5084,1095,6179,203360,43800,247160
10/12/2024,Dinesh Jayawardena,Galle,Baddegama,Southern,9355,3665,13020,374200,146600,520800
10/13/2024,Dinesh Jayawardena,Galle,Baddegama,Southern,8570,8264,16834,342800,330560,673360
10/14/2024,Dinesh Jayawardena,Galle,Baddegama,Southern,3128,583,3711,125120,23320,148440
10/15/2024,Dinesh Jayawardena,Galle,Baddegama,Southern,4000,3730,7730,160000,149200,309200
10/16/2024,Dinesh Jayawardena,Galle,Baddegama,Southern,5968,2485,8453,238720,99400,338120
10/17/2024,Dinesh Jayawardena,Galle,Baddegama,Southern,7925,5609,13534,317000,224360,541360
10/18/2024,Dinesh Jayawardena,Galle,Baddegama,Southern,6458,9346,15804,258320,373840,632160
10/19/2024,Dinesh Jayawardena,Galle,Baddegama,Southern,8816,9102,17918,352640,364080,716720
10/20/2024,Dinesh Jayawardena,Galle,Baddegama,Southern,1886,6991,8877,75440,279640,355080
10/21/2024,Dinesh Jayawardena,Galle,Baddegama,Southern,1930,9119,11049,77200,364760,441960
10/22/2024,Dinesh Jayawardena,Galle,Baddegama,Southern,1977,9100,11077,79080,364000,443080
10/23/2024,Dinesh Jayawardena,Galle,Baddegama,Southern,73,8299,8372,2920,331960,334880
10/24/2024,Dinesh Jayawardena,Galle,Baddegama,Southern,1409,5513,6922,56360,220520,276880
10/25/2024,Dinesh Jayawardena,Galle,Baddegama,Southern,8019,2003,10022,320760,80120,400880
10/26/2024,Dinesh Jayawardena,Galle,Baddegama,Southern,2343,9046,11389,93720,361840,455560
10/27/2024,Dinesh Jayawardena,Galle,Baddegama,Southern,9107,4739,13846,364280,189560,553840
10/28/2024,Dinesh Jayawardena,Galle,Baddegama,Southern,3200,3043,6243,128000,121720,249720
10/29/2024,Dinesh Jayawardena,Galle,Baddegama,Southern,5185,195,5380,207400,7800,215200
10/30/2024,Dinesh Jayawardena,Galle,Baddegama,Southern,1168,6649,7817,46720,265960,312680
10/31/2024,Dinesh Jayawardena,Galle,Baddegama,Southern,3282,3129,6411,131280,125160,256440
11/1/2024,Dinesh Jayawardena,Galle,Baddegama,Southern,4233,4470,8703,169320,178800,348120
11/2/2024,Dinesh Jayawardena,Galle,Baddegama,Southern,5169,2057,7226,206760,82280,289040
11/3/2024,Dinesh Jayawardena,Galle,Baddegama,Southern,8928,332,9260,357120,13280,370400
11/4/2024,Dinesh Jayawardena,Galle,Baddegama,Southern,6938,8193,15131,277520,327720,605240
11/5/2024,Dinesh Jayawardena,Galle,Baddegama,Southern,3295,4259,7554,131800,170360,302160
11/6/2024,Dinesh Jayawardena,Galle,Baddegama,Southern,8514,6740,15254,340560,269600,610160
11/7/2024,Dinesh Jayawardena,Galle,Baddegama,Southern,1515,1167,2682,60600,46680,107280
11/8/2024,Dinesh Jayawardena,Galle,Baddegama,Southern,9910,5132,15042,396400,205280,601680
11/9/2024,Dinesh Jayawardena,Galle,Baddegama,Southern,836,3617,4453,33440,144680,178120
11/10/2024,Dinesh Jayawardena,Galle,Baddegama,Southern,8265,7014,15279,330600,280560,611160
11/11/2024,Dinesh Jayawardena,Galle,Baddegama,Southern,8106,9635,17741,324240,385400,709640
11/12/2024,Dinesh Jayawardena,Galle,Baddegama,Southern,8051,8515,16566,322040,340600,662640
11/13/2024,Dinesh Jayawardena,Galle,Baddegama,Southern,6734,5212,11946,269360,208480,477840
11/14/2024,Dinesh Jayawardena,Galle,Baddegama,Southern,7486,5656,13142,299440,226240,525680
11/15/2024,Dinesh Jayawardena,Galle,Baddegama,Southern,1341,5413,6754,53640,216520,270160
11/16/2024,Dinesh Jayawardena,Galle,Baddegama,Southern,2491,7726,10217,99640,309040,408680
11/17/2024,Dinesh Jayawardena,Galle,Baddegama,Southern,2566,8758,11324,102640,350320,452960
11/18/2024,Dinesh Jayawardena,Galle,Baddegama,Southern,6702,3551,10253,268080,142040,410120
11/19/2024,Dinesh Jayawardena,Galle,Baddegama,Southern,6980,7529,14509,279200,301160,580360
11/20/2024,Dinesh Jayawardena,Galle,Baddegama,Southern,8942,500,9442,357680,20000,377680
11/21/2024,Dinesh Jayawardena,Galle,Baddegama,Southern,3586,8012,11598,143440,320480,463920
11/22/2024,Dinesh Jayawardena,Galle,Baddegama,Southern,7514,632,8146,300560,25280,325840
11/23/2024,Dinesh Jayawardena,Galle,Baddegama,Southern,9143,3494,12637,365720,139760,505480
11/24/2024,Dinesh Jayawardena,Galle,Baddegama,Southern,7785,2376,10161,311400,95040,406440
11/25/2024,Dinesh Jayawardena,Galle,Baddegama,Southern,4070,44,4114,162800,1760,164560
11/26/2024,Dinesh Jayawardena,Galle,Baddegama,Southern,9361,2400,11761,374440,96000,470440
11/27/2024,Dinesh Jayawardena,Galle,Baddegama,Southern,9169,6343,15512,366760,253720,620480
11/28/2024,Dinesh Jayawardena,Galle,Baddegama,Southern,9114,5879,14993,364560,235160,599720
11/29/2024,Dinesh Jayawardena,Galle,Baddegama,Southern,7915,1046,8961,316600,41840,358440
11/30/2024,Dinesh Jayawardena,Galle,Baddegama,Southern,6106,734,6840,244240,29360,273600
12/1/2024,Dinesh Jayawardena,Galle,Baddegama,Southern,8080,8974,17054,323200,358960,682160
12/2/2024,Dinesh Jayawardena,Galle,Baddegama,Southern,1443,6695,8138,57720,267800,325520
12/3/2024,Dinesh Jayawardena,Galle,Baddegama,Southern,2896,7045,9941,115840,281800,397640
12/4/2024,Dinesh Jayawardena,Galle,Baddegama,Southern,500,6621,7121,20000,264840,284840
12/5/2024,Dinesh Jayawardena,Galle,Baddegama,Southern,7469,6406,13875,298760,256240,555000
12/6/2024,Dinesh Jayawardena,Galle,Baddegama,Southern,648,3422,4070,25920,136880,162800
12/7/2024,Dinesh Jayawardena,Galle,Baddegama,Southern,6123,7345,13468,244920,293800,538720
12/8/2024,Dinesh Jayawardena,Galle,Baddegama,Southern,6504,6743,13247,260160,269720,529880
12/9/2024,Dinesh Jayawardena,Galle,Baddegama,Southern,861,5552,6413,34440,222080,256520
12/10/2024,Dinesh Jayawardena,Galle,Baddegama,Southern,3071,9175,12246,122840,367000,489840
12/11/2024,Dinesh Jayawardena,Galle,Baddegama,Southern,8187,8631,16818,327480,345240,672720
12/12/2024,Dinesh Jayawardena,Galle,Baddegama,Southern,2858,6533,9391,114320,261320,375640
12/13/2024,Dinesh Jayawardena,Galle,Baddegama,Southern,7077,1419,8496,283080,56760,339840
12/14/2024,Dinesh Jayawardena,Galle,Baddegama,Southern,1782,8589,10371,71280,343560,414840
12/15/2024,Dinesh Jayawardena,Galle,Baddegama,Southern,956,3477,4433,38240,139080,177320
12/16/2024,Dinesh Jayawardena,Galle,Baddegama,Southern,6652,3901,10553,266080,156040,422120
12/17/2024,Dinesh Jayawardena,Galle,Baddegama,Southern,3095,7459,10554,123800,298360,422160
12/18/2024,Dinesh Jayawardena,Galle,Baddegama,Southern,9490,7484,16974,379600,299360,678960
12/19/2024,Dinesh Jayawardena,Galle,Baddegama,Southern,724,9000,9724,28960,360000,388960
12/20/2024,Dinesh Jayawardena,Galle,Baddegama,Southern,6355,5437,11792,254200,217480,471680
12/21/2024,Dinesh Jayawardena,Galle,Baddegama,Southern,8482,3687,12169,339280,147480,486760
12/22/2024,Dinesh Jayawardena,Galle,Baddegama,Southern,9326,8638,17964,373040,345520,718560
12/23/2024,Dinesh Jayawardena,Galle,Baddegama,Southern,762,9399,10161,30480,375960,406440
12/24/2024,Dinesh Jayawardena,Galle,Baddegama,Southern,8420,276,8696,336800,11040,347840
12/25/2024,Dinesh Jayawardena,Galle,Baddegama,Southern,7321,7870,15191,292840,314800,607640
12/26/2024,Dinesh Jayawardena,Galle,Baddegama,Southern,4836,9737,14573,193440,389480,582920
12/27/2024,Dinesh Jayawardena,Galle,Baddegama,Southern,3733,7472,11205,149320,298880,448200
12/28/2024,Dinesh Jayawardena,Galle,Baddegama,Southern,8670,8282,16952,346800,331280,678080
12/29/2024,Dinesh Jayawardena,Galle,Baddegama,Southern,680,5364,6044,27200,214560,241760
12/30/2024,Dinesh Jayawardena,Galle,Baddegama,Southern,2096,6084,8180,83840,243360,327200
12/31/2024,Dinesh Jayawardena,Galle,Baddegama,Southern,6202,7465,13667,248080,298600,546680
1/1/2025,Dinesh Jayawardena,Galle,Baddegama,Southern,7408,6783,14191,296320,271320,567640
1/2/2025,Dinesh Jayawardena,Galle,Baddegama,Southern,3981,5339,9320,159240,213560,372800
1/3/2025,Dinesh Jayawardena,Galle,Baddegama,Southern,1470,1847,3317,58800,73880,132680
1/4/2025,Dinesh Jayawardena,Galle,Baddegama,Southern,4658,9375,14033,186320,375000,561320
1/5/2025,Dinesh Jayawardena,Galle,Baddegama,Southern,7584,4195,11779,303360,167800,471160
1/6/2025,Dinesh Jayawardena,Galle,Baddegama,Southern,8444,2739,11183,337760,109560,447320
1/7/2025,Dinesh Jayawardena,Galle,Baddegama,Southern,3103,7464,10567,124120,298560,422680
1/8/2025,Dinesh Jayawardena,Galle,Baddegama,Southern,9476,8111,17587,379040,324440,703480
1/9/2025,Dinesh Jayawardena,Galle,Baddegama,Southern,3426,2707,6133,137040,108280,245320
1/10/2025,Dinesh Jayawardena,Galle,Baddegama,Southern,2096,4552,6648,83840,182080,265920
1/11/2025,Dinesh Jayawardena,Galle,Baddegama,Southern,7431,8753,16184,297240,350120,647360
1/12/2025,Dinesh Jayawardena,Galle,Baddegama,Southern,9935,5256,15191,397400,210240,607640
1/13/2025,Dinesh Jayawardena,Galle,Baddegama,Southern,2747,2137,4884,109880,85480,195360
1/14/2025,Dinesh Jayawardena,Galle,Baddegama,Southern,6310,7587,13897,252400,303480,555880
1/15/2025,Dinesh Jayawardena,Galle,Baddegama,Southern,7743,2273,10016,309720,90920,400640
1/16/2025,Dinesh Jayawardena,Galle,Baddegama,Southern,8407,4739,13146,336280,189560,525840
1/17/2025,Dinesh Jayawardena,Galle,Baddegama,Southern,8756,7485,16241,350240,299400,649640
1/18/2025,Dinesh Jayawardena,Galle,Baddegama,Southern,236,2616,2852,9440,104640,114080
1/19/2025,Dinesh Jayawardena,Galle,Baddegama,Southern,1276,1431,2707,51040,57240,108280
1/20/2025,Dinesh Jayawardena,Galle,Baddegama,Southern,692,8589,9281,27680,343560,371240
1/21/2025,Dinesh Jayawardena,Galle,Baddegama,Southern,6398,8191,14589,255920,327640,583560
1/22/2025,Dinesh Jayawardena,Galle,Baddegama,Southern,4360,1337,5697,174400,53480,227880
1/23/2025,Dinesh Jayawardena,Galle,Baddegama,Southern,6698,9883,16581,267920,395320,663240
1/24/2025,Dinesh Jayawardena,Galle,Baddegama,Southern,9316,1689,11005,372640,67560,440200
1/25/2025,Dinesh Jayawardena,Galle,Baddegama,Southern,1121,1281,2402,44840,51240,96080
1/26/2025,Dinesh Jayawardena,Galle,Baddegama,Southern,9385,4076,13461,375400,163040,538440
1/27/2025,Dinesh Jayawardena,Galle,Baddegama,Southern,3606,8185,11791,144240,327400,471640
1/28/2025,Dinesh Jayawardena,Galle,Baddegama,Southern,6718,3249,9967,268720,129960,398680
1/29/2025,Dinesh Jayawardena,Galle,Baddegama,Southern,7710,1855,9565,308400,74200,382600
1/30/2025,Dinesh Jayawardena,Galle,Baddegama,Southern,1800,4998,6798,72000,199920,271920
1/31/2025,Dinesh Jayawardena,Galle,Baddegama,Southern,9310,7869,17179,372400,314760,687160
2/1/2025,Dinesh Jayawardena,Galle,Baddegama,Southern,1761,963,2724,70440,38520,108960
2/2/2025,Dinesh Jayawardena,Galle,Baddegama,Southern,1370,7767,9137,54800,310680,365480
2/3/2025,Dinesh Jayawardena,Galle,Baddegama,Southern,7213,1086,8299,288520,43440,331960
2/4/2025,Dinesh Jayawardena,Galle,Baddegama,Southern,3628,4310,7938,145120,172400,317520
2/5/2025,Dinesh Jayawardena,Galle,Baddegama,Southern,5819,4883,10702,232760,195320,428080
2/6/2025,Dinesh Jayawardena,Galle,Baddegama,Southern,3606,8941,12547,144240,357640,501880
2/7/2025,Dinesh Jayawardena,Galle,Baddegama,Southern,7906,250,8156,316240,10000,326240
2/8/2025,Dinesh Jayawardena,Galle,Baddegama,Southern,3392,771,4163,135680,30840,166520
2/9/2025,Dinesh Jayawardena,Galle,Baddegama,Southern,3265,1944,5209,130600,77760,208360
2/10/2025,Dinesh Jayawardena,Galle,Baddegama,Southern,9281,4029,13310,371240,161160,532400
2/11/2025,Dinesh Jayawardena,Galle,Baddegama,Southern,7056,1021,8077,282240,40840,323080
2/12/2025,Dinesh Jayawardena,Galle,Baddegama,Southern,4432,5967,10399,177280,238680,415960
2/13/2025,Dinesh Jayawardena,Galle,Baddegama,Southern,5504,613,6117,220160,24520,244680
2/14/2025,Dinesh Jayawardena,Galle,Baddegama,Southern,543,2500,3043,21720,100000,121720
2/15/2025,Dinesh Jayawardena,Galle,Baddegama,Southern,3280,7535,10815,131200,301400,432600
2/16/2025,Dinesh Jayawardena,Galle,Baddegama,Southern,9923,8664,18587,396920,346560,743480
2/17/2025,Dinesh Jayawardena,Galle,Baddegama,Southern,84,6683,6767,3360,267320,270680
2/18/2025,Dinesh Jayawardena,Galle,Baddegama,Southern,559,969,1528,22360,38760,61120
2/19/2025,Dinesh Jayawardena,Galle,Baddegama,Southern,1823,6764,8587,72920,270560,343480
2/20/2025,Dinesh Jayawardena,Galle,Baddegama,Southern,5111,2147,7258,204440,85880,290320
2/21/2025,Dinesh Jayawardena,Galle,Baddegama,Southern,5090,3483,8573,203600,139320,342920
2/22/2025,Dinesh Jayawardena,Galle,Baddegama,Southern,5323,1751,7074,212920,70040,282960
2/23/2025,Dinesh Jayawardena,Galle,Baddegama,Southern,2045,7675,9720,81800,307000,388800
2/24/2025,Dinesh Jayawardena,Galle,Baddegama,Southern,6504,6753,13257,260160,270120,530280
2/25/2025,Dinesh Jayawardena,Galle,Baddegama,Southern,659,1274,1933,26360,50960,77320
2/26/2025,Dinesh Jayawardena,Galle,Baddegama,Southern,1490,8485,9975,59600,339400,399000
2/27/2025,Dinesh Jayawardena,Galle,Baddegama,Southern,218,9827,10045,8720,393080,401800
2/28/2025,Dinesh Jayawardena,Galle,Baddegama,Southern,7825,1045,8870,313000,41800,354800
3/1/2025,Dinesh Jayawardena,Galle,Baddegama,Southern,5939,3826,9765,237560,153040,390600
3/2/2025,Dinesh Jayawardena,Galle,Baddegama,Southern,7912,3364,11276,316480,134560,451040
3/3/2025,Dinesh Jayawardena,Galle,Baddegama,Southern,4983,483,5466,199320,19320,218640
3/4/2025,Dinesh Jayawardena,Galle,Baddegama,Southern,6294,1811,8105,251760,72440,324200
3/5/2025,Dinesh Jayawardena,Galle,Baddegama,Southern,6349,9279,15628,253960,371160,625120
3/6/2025,Dinesh Jayawardena,Galle,Baddegama,Southern,5229,6007,11236,209160,240280,449440
3/7/2025,Dinesh Jayawardena,Galle,Baddegama,Southern,44,7912,7956,1760,316480,318240
3/8/2025,Dinesh Jayawardena,Galle,Baddegama,Southern,2770,4641,7411,110800,185640,296440
3/9/2025,Dinesh Jayawardena,Galle,Baddegama,Southern,6497,2208,8705,259880,88320,348200
3/10/2025,Dinesh Jayawardena,Galle,Baddegama,Southern,4411,7180,11591,176440,287200,463640
3/11/2025,Dinesh Jayawardena,Galle,Baddegama,Southern,3347,2871,6218,133880,114840,248720
3/12/2025,Dinesh Jayawardena,Galle,Baddegama,Southern,1118,3599,4717,44720,143960,188680
3/13/2025,Dinesh Jayawardena,Galle,Baddegama,Southern,5850,6702,12552,234000,268080,502080
3/14/2025,Dinesh Jayawardena,Galle,Baddegama,Southern,4318,6965,11283,172720,278600,451320
3/15/2025,Dinesh Jayawardena,Galle,Baddegama,Southern,2160,2811,4971,86400,112440,198840
3/16/2025,Dinesh Jayawardena,Galle,Baddegama,Southern,6054,7888,13942,242160,315520,557680
3/17/2025,Dinesh Jayawardena,Galle,Baddegama,Southern,866,4179,5045,34640,167160,201800
3/18/2025,Dinesh Jayawardena,Galle,Baddegama,Southern,5590,9291,14881,223600,371640,595240
3/19/2025,Dinesh Jayawardena,Galle,Baddegama,Southern,3132,6430,9562,125280,257200,382480
3/20/2025,Dinesh Jayawardena,Galle,Baddegama,Southern,1166,5520,6686,46640,220800,267440
3/21/2025,Dinesh Jayawardena,Galle,Baddegama,Southern,4722,5739,10461,188880,229560,418440
3/22/2025,Dinesh Jayawardena,Galle,Baddegama,Southern,1551,1628,3179,62040,65120,127160
3/23/2025,Dinesh Jayawardena,Galle,Baddegama,Southern,9259,481,9740,370360,19240,389600
3/25/2024,Sushantha Kariyawasam,Gampaha,Ja-Ela,Western,6125,7482,13607,245000,299280,544280
3/26/2024,Sushantha Kariyawasam,Gampaha,Ja-Ela,Western,9609,2146,11755,384360,85840,470200
3/27/2024,Sushantha Kariyawasam,Gampaha,Ja-Ela,Western,8901,6188,15089,356040,247520,603560
3/28/2024,Sushantha Kariyawasam,Gampaha,Ja-Ela,Western,4172,1397,5569,166880,55880,222760
3/29/2024,Sushantha Kariyawasam,Gampaha,Ja-Ela,Western,5416,9258,14674,216640,370320,586960
3/30/2024,Sushantha Kariyawasam,Gampaha,Ja-Ela,Western,1153,4862,6015,46120,194480,240600
3/31/2024,Sushantha Kariyawasam,Gampaha,Ja-Ela,Western,7003,6999,14002,280120,279960,560080
4/1/2024,Sushantha Kariyawasam,Gampaha,Ja-Ela,Western,8300,5317,13617,332000,212680,544680
4/2/2024,Sushantha Kariyawasam,Gampaha,Ja-Ela,Western,6932,978,7910,277280,39120,316400
4/3/2024,Sushantha Kariyawasam,Gampaha,Ja-Ela,Western,6913,3816,10729,276520,152640,429160
4/4/2024,Sushantha Kariyawasam,Gampaha,Ja-Ela,Western,8333,4899,13232,333320,195960,529280
4/5/2024,Sushantha Kariyawasam,Gampaha,Ja-Ela,Western,1063,7468,8531,42520,298720,341240
4/6/2024,Sushantha Kariyawasam,Gampaha,Ja-Ela,Western,1471,3731,5202,58840,149240,208080
4/7/2024,Sushantha Kariyawasam,Gampaha,Ja-Ela,Western,2454,2978,5432,98160,119120,217280
4/8/2024,Sushantha Kariyawasam,Gampaha,Ja-Ela,Western,6956,8043,14999,278240,321720,599960
4/9/2024,Sushantha Kariyawasam,Gampaha,Ja-Ela,Western,3170,9781,12951,126800,391240,518040
4/10/2024,Sushantha Kariyawasam,Gampaha,Ja-Ela,Western,4237,3253,7490,169480,130120,299600
4/11/2024,Sushantha Kariyawasam,Gampaha,Ja-Ela,Western,418,968,1386,16720,38720,55440
4/19/2024,Sushantha Kariyawasam,Gampaha,Ja-Ela,Western,3571,8785,12356,142840,351400,494240
4/20/2024,Sushantha Kariyawasam,Gampaha,Ja-Ela,Western,7494,7888,15382,299760,315520,615280
4/21/2024,Sushantha Kariyawasam,Gampaha,Ja-Ela,Western,2782,4961,7743,111280,198440,309720
4/22/2024,Sushantha Kariyawasam,Gampaha,Ja-Ela,Western,2424,2795,5219,96960,111800,208760
4/23/2024,Sushantha Kariyawasam,Gampaha,Ja-Ela,Western,9262,9599,18861,370480,383960,754440
4/24/2024,Sushantha Kariyawasam,Gampaha,Ja-Ela,Western,758,434,1192,30320,17360,47680
4/25/2024,Sushantha Kariyawasam,Gampaha,Ja-Ela,Western,1705,1808,3513,68200,72320,140520
4/26/2024,Sushantha Kariyawasam,Gampaha,Ja-Ela,Western,7813,3682,11495,312520,147280,459800
4/27/2024,Sushantha Kariyawasam,Gampaha,Ja-Ela,Western,5900,4351,10251,236000,174040,410040
4/28/2024,Sushantha Kariyawasam,Gampaha,Ja-Ela,Western,4383,1218,5601,175320,48720,224040
4/29/2024,Sushantha Kariyawasam,Gampaha,Ja-Ela,Western,6662,7757,14419,266480,310280,576760
4/30/2024,Sushantha Kariyawasam,Gampaha,Ja-Ela,Western,3426,6788,10214,137040,271520,408560
5/1/2024,Sushantha Kariyawasam,Gampaha,Ja-Ela,Western,8711,1651,10362,348440,66040,414480
5/2/2024,Sushantha Kariyawasam,Gampaha,Ja-Ela,Western,6510,9742,16252,260400,389680,650080
5/3/2024,Sushantha Kariyawasam,Gampaha,Ja-Ela,Western,8919,9006,17925,356760,360240,717000
5/4/2024,Sushantha Kariyawasam,Gampaha,Ja-Ela,Western,1900,4520,6420,76000,180800,256800
5/5/2024,Sushantha Kariyawasam,Gampaha,Ja-Ela,Western,6685,2963,9648,267400,118520,385920
5/6/2024,Sushantha Kariyawasam,Gampaha,Ja-Ela,Western,3538,9526,13064,141520,381040,522560
5/7/2024,Sushantha Kariyawasam,Gampaha,Ja-Ela,Western,8491,7731,16222,339640,309240,648880
5/8/2024,Sushantha Kariyawasam,Gampaha,Ja-Ela,Western,1969,563,2532,78760,22520,101280
5/9/2024,Sushantha Kariyawasam,Gampaha,Ja-Ela,Western,6018,9094,15112,240720,363760,604480
5/10/2024,Sushantha Kariyawasam,Gampaha,Ja-Ela,Western,5792,3428,9220,231680,137120,368800
5/11/2024,Sushantha Kariyawasam,Gampaha,Ja-Ela,Western,2496,9894,12390,99840,395760,495600
5/12/2024,Sushantha Kariyawasam,Gampaha,Ja-Ela,Western,5818,3511,9329,232720,140440,373160
5/13/2024,Sushantha Kariyawasam,Gampaha,Ja-Ela,Western,5471,5852,11323,218840,234080,452920
5/14/2024,Sushantha Kariyawasam,Gampaha,Ja-Ela,Western,3876,9151,13027,155040,366040,521080
5/15/2024,Sushantha Kariyawasam,Gampaha,Ja-Ela,Western,4477,7954,12431,179080,318160,497240
5/16/2024,Sushantha Kariyawasam,Gampaha,Ja-Ela,Western,852,9613,10465,34080,384520,418600
5/17/2024,Sushantha Kariyawasam,Gampaha,Ja-Ela,Western,8466,3083,11549,338640,123320,461960
5/18/2024,Sushantha Kariyawasam,Gampaha,Ja-Ela,Western,1656,9462,11118,66240,378480,444720
5/19/2024,Sushantha Kariyawasam,Gampaha,Ja-Ela,Western,7103,662,7765,284120,26480,310600
5/20/2024,Sushantha Kariyawasam,Gampaha,Ja-Ela,Western,5272,8686,13958,210880,347440,558320
5/21/2024,Sushantha Kariyawasam,Gampaha,Ja-Ela,Western,9533,8748,18281,381320,349920,731240
5/22/2024,Sushantha Kariyawasam,Gampaha,Ja-Ela,Western,4432,6948,11380,177280,277920,455200
5/24/2024,Sushantha Kariyawasam,Gampaha,Ja-Ela,Western,1705,6872,8577,68200,274880,343080
5/25/2024,Sushantha Kariyawasam,Gampaha,Ja-Ela,Western,2636,8468,11104,105440,338720,444160
5/26/2024,Sushantha Kariyawasam,Gampaha,Ja-Ela,Western,1664,5955,7619,66560,238200,304760
5/27/2024,Sushantha Kariyawasam,Gampaha,Ja-Ela,Western,4906,6717,11623,196240,268680,464920
5/28/2024,Sushantha Kariyawasam,Gampaha,Ja-Ela,Western,4347,2845,7192,173880,113800,287680
5/29/2024,Sushantha Kariyawasam,Gampaha,Ja-Ela,Western,8938,4167,13105,357520,166680,524200
5/30/2024,Sushantha Kariyawasam,Gampaha,Ja-Ela,Western,1481,9992,11473,59240,399680,458920
5/31/2024,Sushantha Kariyawasam,Gampaha,Ja-Ela,Western,936,206,1142,37440,8240,45680
6/1/2024,Sushantha Kariyawasam,Gampaha,Ja-Ela,Western,6649,6823,13472,265960,272920,538880
6/2/2024,Sushantha Kariyawasam,Gampaha,Ja-Ela,Western,5362,741,6103,214480,29640,244120
6/3/2024,Sushantha Kariyawasam,Gampaha,Ja-Ela,Western,2212,3278,5490,88480,131120,219600
6/4/2024,Sushantha Kariyawasam,Gampaha,Ja-Ela,Western,265,4959,5224,10600,198360,208960
6/5/2024,Sushantha Kariyawasam,Gampaha,Ja-Ela,Western,610,4498,5108,24400,179920,204320
6/6/2024,Sushantha Kariyawasam,Gampaha,Ja-Ela,Western,4504,2548,7052,180160,101920,282080
6/7/2024,Sushantha Kariyawasam,Gampaha,Ja-Ela,Western,8457,5726,14183,338280,229040,567320
6/8/2024,Sushantha Kariyawasam,Gampaha,Ja-Ela,Western,179,939,1118,7160,37560,44720
6/9/2024,Sushantha Kariyawasam,Gampaha,Ja-Ela,Western,2763,2658,5421,110520,106320,216840
6/10/2024,Sushantha Kariyawasam,Gampaha,Ja-Ela,Western,2854,3855,6709,114160,154200,268360
6/11/2024,Sushantha Kariyawasam,Gampaha,Ja-Ela,Western,4499,3490,7989,179960,139600,319560
6/12/2024,Sushantha Kariyawasam,Gampaha,Ja-Ela,Western,5348,6125,11473,213920,245000,458920
6/13/2024,Sushantha Kariyawasam,Gampaha,Ja-Ela,Western,2709,6018,8727,108360,240720,349080
6/14/2024,Sushantha Kariyawasam,Gampaha,Ja-Ela,Western,8446,1442,9888,337840,57680,395520
6/15/2024,Sushantha Kariyawasam,Gampaha,Ja-Ela,Western,6338,4597,10935,253520,183880,437400
6/16/2024,Sushantha Kariyawasam,Gampaha,Ja-Ela,Western,2685,2242,4927,107400,89680,197080
6/17/2024,Sushantha Kariyawasam,Gampaha,Ja-Ela,Western,4634,9464,14098,185360,378560,563920
6/18/2024,Sushantha Kariyawasam,Gampaha,Ja-Ela,Western,1915,1620,3535,76600,64800,141400
6/19/2024,Sushantha Kariyawasam,Gampaha,Ja-Ela,Western,8589,3599,12188,343560,143960,487520
6/20/2024,Sushantha Kariyawasam,Gampaha,Ja-Ela,Western,5449,8147,13596,217960,325880,543840
6/21/2024,Sushantha Kariyawasam,Gampaha,Ja-Ela,Western,2588,6100,8688,103520,244000,347520
6/22/2024,Sushantha Kariyawasam,Gampaha,Ja-Ela,Western,9349,7249,16598,373960,289960,663920
6/23/2024,Sushantha Kariyawasam,Gampaha,Ja-Ela,Western,6736,9839,16575,269440,393560,663000
6/24/2024,Sushantha Kariyawasam,Gampaha,Ja-Ela,Western,376,4531,4907,15040,181240,196280
6/25/2024,Sushantha Kariyawasam,Gampaha,Ja-Ela,Western,8978,6298,15276,359120,251920,611040
6/26/2024,Sushantha Kariyawasam,Gampaha,Ja-Ela,Western,7342,1566,8908,293680,62640,356320
6/27/2024,Sushantha Kariyawasam,Gampaha,Ja-Ela,Western,3320,1069,4389,132800,42760,175560
6/28/2024,Sushantha Kariyawasam,Gampaha,Ja-Ela,Western,7283,2698,9981,291320,107920,399240
6/29/2024,Sushantha Kariyawasam,Gampaha,Ja-Ela,Western,2563,4439,7002,102520,177560,280080
6/30/2024,Sushantha Kariyawasam,Gampaha,Ja-Ela,Western,4303,7724,12027,172120,308960,481080
7/1/2024,Sushantha Kariyawasam,Gampaha,Ja-Ela,Western,9361,2791,12152,374440,111640,486080
7/2/2024,Sushantha Kariyawasam,Gampaha,Ja-Ela,Western,2455,657,3112,98200,26280,124480
7/3/2024,Sushantha Kariyawasam,Gampaha,Ja-Ela,Western,1096,1165,2261,43840,46600,90440
7/4/2024,Sushantha Kariyawasam,Gampaha,Ja-Ela,Western,3877,3593,7470,155080,143720,298800
7/5/2024,Sushantha Kariyawasam,Gampaha,Ja-Ela,Western,3336,8087,11423,133440,323480,456920
7/6/2024,Sushantha Kariyawasam,Gampaha,Ja-Ela,Western,318,3702,4020,12720,148080,160800
7/7/2024,Sushantha Kariyawasam,Gampaha,Ja-Ela,Western,9786,2354,12140,391440,94160,485600
7/8/2024,Sushantha Kariyawasam,Gampaha,Ja-Ela,Western,1029,910,1939,41160,36400,77560
7/9/2024,Sushantha Kariyawasam,Gampaha,Ja-Ela,Western,2147,537,2684,85880,21480,107360
7/10/2024,Sushantha Kariyawasam,Gampaha,Ja-Ela,Western,2213,3761,5974,88520,150440,238960
7/11/2024,Sushantha Kariyawasam,Gampaha,Ja-Ela,Western,532,1179,1711,21280,47160,68440
7/12/2024,Sushantha Kariyawasam,Gampaha,Ja-Ela,Western,8574,9335,17909,342960,373400,716360
7/13/2024,Sushantha Kariyawasam,Gampaha,Ja-Ela,Western,5058,4495,9553,202320,179800,382120
7/14/2024,Sushantha Kariyawasam,Gampaha,Ja-Ela,Western,1347,9174,10521,53880,366960,420840
7/15/2024,Sushantha Kariyawasam,Gampaha,Ja-Ela,Western,5957,575,6532,238280,23000,261280
7/16/2024,Sushantha Kariyawasam,Gampaha,Ja-Ela,Western,9008,4061,13069,360320,162440,522760
7/17/2024,Sushantha Kariyawasam,Gampaha,Ja-Ela,Western,4497,1508,6005,179880,60320,240200
7/18/2024,Sushantha Kariyawasam,Gampaha,Ja-Ela,Western,8827,3412,12239,353080,136480,489560
7/19/2024,Sushantha Kariyawasam,Gampaha,Ja-Ela,Western,1786,830,2616,71440,33200,104640
7/20/2024,Sushantha Kariyawasam,Gampaha,Ja-Ela,Western,9787,3015,12802,391480,120600,512080
7/21/2024,Sushantha Kariyawasam,Gampaha,Ja-Ela,Western,9338,2911,12249,373520,116440,489960
7/22/2024,Sushantha Kariyawasam,Gampaha,Ja-Ela,Western,6844,5986,12830,273760,239440,513200
7/23/2024,Sushantha Kariyawasam,Gampaha,Ja-Ela,Western,2344,1517,3861,93760,60680,154440
7/24/2024,Sushantha Kariyawasam,Gampaha,Ja-Ela,Western,6604,4370,10974,264160,174800,438960
7/25/2024,Sushantha Kariyawasam,Gampaha,Ja-Ela,Western,7683,206,7889,307320,8240,315560
7/26/2024,Sushantha Kariyawasam,Gampaha,Ja-Ela,Western,8605,192,8797,344200,7680,351880
7/27/2024,Sushantha Kariyawasam,Gampaha,Ja-Ela,Western,8949,2529,11478,357960,101160,459120
7/28/2024,Sushantha Kariyawasam,Gampaha,Ja-Ela,Western,5297,4887,10184,211880,195480,407360
7/29/2024,Sushantha Kariyawasam,Gampaha,Ja-Ela,Western,3084,121,3205,123360,4840,128200
7/30/2024,Sushantha Kariyawasam,Gampaha,Ja-Ela,Western,4115,1625,5740,164600,65000,229600
7/31/2024,Sushantha Kariyawasam,Gampaha,Ja-Ela,Western,6275,8874,15149,251000,354960,605960
8/1/2024,Sushantha Kariyawasam,Gampaha,Ja-Ela,Western,5105,9472,14577,204200,378880,583080
8/2/2024,Sushantha Kariyawasam,Gampaha,Ja-Ela,Western,741,7750,8491,29640,310000,339640
8/3/2024,Sushantha Kariyawasam,Gampaha,Ja-Ela,Western,2893,5131,8024,115720,205240,320960
8/4/2024,Sushantha Kariyawasam,Gampaha,Ja-Ela,Western,5153,731,5884,206120,29240,235360
8/5/2024,Sushantha Kariyawasam,Gampaha,Ja-Ela,Western,6413,7112,13525,256520,284480,541000
8/6/2024,Sushantha Kariyawasam,Gampaha,Ja-Ela,Western,979,3150,4129,39160,126000,165160
8/7/2024,Sushantha Kariyawasam,Gampaha,Ja-Ela,Western,7182,726,7908,287280,29040,316320
8/8/2024,Sushantha Kariyawasam,Gampaha,Ja-Ela,Western,1979,8093,10072,79160,323720,402880
8/9/2024,Sushantha Kariyawasam,Gampaha,Ja-Ela,Western,5341,1609,6950,213640,64360,278000
8/10/2024,Sushantha Kariyawasam,Gampaha,Ja-Ela,Western,7998,9892,17890,319920,395680,715600
8/11/2024,Sushantha Kariyawasam,Gampaha,Ja-Ela,Western,2286,4132,6418,91440,165280,256720
8/12/2024,Sushantha Kariyawasam,Gampaha,Ja-Ela,Western,7165,927,8092,286600,37080,323680
8/13/2024,Sushantha Kariyawasam,Gampaha,Ja-Ela,Western,607,4030,4637,24280,161200,185480
8/14/2024,Sushantha Kariyawasam,Gampaha,Ja-Ela,Western,9945,6847,16792,397800,273880,671680
8/15/2024,Sushantha Kariyawasam,Gampaha,Ja-Ela,Western,1090,9247,10337,43600,369880,413480
8/16/2024,Sushantha Kariyawasam,Gampaha,Ja-Ela,Western,5198,4948,10146,207920,197920,405840
8/17/2024,Sushantha Kariyawasam,Gampaha,Ja-Ela,Western,6380,9066,15446,255200,362640,617840
8/18/2024,Sushantha Kariyawasam,Gampaha,Ja-Ela,Western,5800,6490,12290,232000,259600,491600
8/19/2024,Sushantha Kariyawasam,Gampaha,Ja-Ela,Western,3294,1239,4533,131760,49560,181320
8/20/2024,Sushantha Kariyawasam,Gampaha,Ja-Ela,Western,7472,9612,17084,298880,384480,683360
8/21/2024,Sushantha Kariyawasam,Gampaha,Ja-Ela,Western,4646,7752,12398,185840,310080,495920
8/22/2024,Sushantha Kariyawasam,Gampaha,Ja-Ela,Western,5700,1194,6894,228000,47760,275760
8/23/2024,Sushantha Kariyawasam,Gampaha,Ja-Ela,Western,4585,8639,13224,183400,345560,528960
8/24/2024,Sushantha Kariyawasam,Gampaha,Ja-Ela,Western,4596,8926,13522,183840,357040,540880
8/25/2024,Sushantha Kariyawasam,Gampaha,Ja-Ela,Western,4154,7279,11433,166160,291160,457320
8/26/2024,Sushantha Kariyawasam,Gampaha,Ja-Ela,Western,4183,9760,13943,167320,390400,557720
8/27/2024,Sushantha Kariyawasam,Gampaha,Ja-Ela,Western,481,2263,2744,19240,90520,109760
8/28/2024,Sushantha Kariyawasam,Gampaha,Ja-Ela,Western,4780,8794,13574,191200,351760,542960
8/29/2024,Sushantha Kariyawasam,Gampaha,Ja-Ela,Western,1767,6956,8723,70680,278240,348920
8/30/2024,Sushantha Kariyawasam,Gampaha,Ja-Ela,Western,2619,5215,7834,104760,208600,313360
8/31/2024,Sushantha Kariyawasam,Gampaha,Ja-Ela,Western,9062,1316,10378,362480,52640,415120
9/1/2024,Sushantha Kariyawasam,Gampaha,Ja-Ela,Western,1562,245,1807,62480,9800,72280
9/2/2024,Sushantha Kariyawasam,Gampaha,Ja-Ela,Western,4442,8781,13223,177680,351240,528920
9/3/2024,Sushantha Kariyawasam,Gampaha,Ja-Ela,Western,4214,9556,13770,168560,382240,550800
9/4/2024,Sushantha Kariyawasam,Gampaha,Ja-Ela,Western,311,6438,6749,12440,257520,269960
9/5/2024,Sushantha Kariyawasam,Gampaha,Ja-Ela,Western,8400,7420,15820,336000,296800,632800
9/6/2024,Sushantha Kariyawasam,Gampaha,Ja-Ela,Western,6643,903,7546,265720,36120,301840
9/7/2024,Sushantha Kariyawasam,Gampaha,Ja-Ela,Western,8393,7525,15918,335720,301000,636720
9/8/2024,Sushantha Kariyawasam,Gampaha,Ja-Ela,Western,2816,2361,5177,112640,94440,207080
9/9/2024,Sushantha Kariyawasam,Gampaha,Ja-Ela,Western,6602,8825,15427,264080,353000,617080
9/10/2024,Sushantha Kariyawasam,Gampaha,Ja-Ela,Western,888,7234,8122,35520,289360,324880
9/11/2024,Sushantha Kariyawasam,Gampaha,Ja-Ela,Western,5739,4105,9844,229560,164200,393760
9/12/2024,Sushantha Kariyawasam,Gampaha,Ja-Ela,Western,1036,2980,4016,41440,119200,160640
9/13/2024,Sushantha Kariyawasam,Gampaha,Ja-Ela,Western,2402,4179,6581,96080,167160,263240
9/14/2024,Sushantha Kariyawasam,Gampaha,Ja-Ela,Western,6502,6089,12591,260080,243560,503640
9/15/2024,Sushantha Kariyawasam,Gampaha,Ja-Ela,Western,5261,8801,14062,210440,352040,562480
9/16/2024,Sushantha Kariyawasam,Gampaha,Ja-Ela,Western,9543,8198,17741,381720,327920,709640
9/17/2024,Sushantha Kariyawasam,Gampaha,Ja-Ela,Western,4452,8262,12714,178080,330480,508560
9/18/2024,Sushantha Kariyawasam,Gampaha,Ja-Ela,Western,1669,7092,8761,66760,283680,350440
9/19/2024,Sushantha Kariyawasam,Gampaha,Ja-Ela,Western,1758,5627,7385,70320,225080,295400
9/20/2024,Sushantha Kariyawasam,Gampaha,Ja-Ela,Western,6078,8746,14824,243120,349840,592960
9/21/2024,Sushantha Kariyawasam,Gampaha,Ja-Ela,Western,10,7801,7811,400,312040,312440
9/22/2024,Sushantha Kariyawasam,Gampaha,Ja-Ela,Western,7315,5437,12752,292600,217480,510080
9/23/2024,Sushantha Kariyawasam,Gampaha,Ja-Ela,Western,178,7459,7637,7120,298360,305480
9/24/2024,Sushantha Kariyawasam,Gampaha,Ja-Ela,Western,9316,9480,18796,372640,379200,751840
9/25/2024,Sushantha Kariyawasam,Gampaha,Ja-Ela,Western,3821,3010,6831,152840,120400,273240
9/26/2024,Sushantha Kariyawasam,Gampaha,Ja-Ela,Western,4894,3862,8756,195760,154480,350240
9/27/2024,Sushantha Kariyawasam,Gampaha,Ja-Ela,Western,2499,9697,12196,99960,387880,487840
9/28/2024,Sushantha Kariyawasam,Gampaha,Ja-Ela,Western,4604,9736,14340,184160,389440,573600
9/29/2024,Sushantha Kariyawasam,Gampaha,Ja-Ela,Western,3374,3488,6862,134960,139520,274480
9/30/2024,Sushantha Kariyawasam,Gampaha,Ja-Ela,Western,3689,845,4534,147560,33800,181360
10/1/2024,Sushantha Kariyawasam,Gampaha,Ja-Ela,Western,3797,4500,8297,151880,180000,331880
10/2/2024,Sushantha Kariyawasam,Gampaha,Ja-Ela,Western,3131,4063,7194,125240,162520,287760
10/3/2024,Sushantha Kariyawasam,Gampaha,Ja-Ela,Western,3043,5515,8558,121720,220600,342320
10/4/2024,Sushantha Kariyawasam,Gampaha,Ja-Ela,Western,2593,5650,8243,103720,226000,329720
10/5/2024,Sushantha Kariyawasam,Gampaha,Ja-Ela,Western,2054,9033,11087,82160,361320,443480
10/6/2024,Sushantha Kariyawasam,Gampaha,Ja-Ela,Western,9535,4727,14262,381400,189080,570480
10/7/2024,Sushantha Kariyawasam,Gampaha,Ja-Ela,Western,8955,6402,15357,358200,256080,614280
10/8/2024,Sushantha Kariyawasam,Gampaha,Ja-Ela,Western,8889,8091,16980,355560,323640,679200
10/9/2024,Sushantha Kariyawasam,Gampaha,Ja-Ela,Western,3638,9625,13263,145520,385000,530520
10/10/2024,Sushantha Kariyawasam,Gampaha,Ja-Ela,Western,2694,3485,6179,107760,139400,247160
10/11/2024,Sushantha Kariyawasam,Gampaha,Ja-Ela,Western,9222,9845,19067,368880,393800,762680
10/12/2024,Sushantha Kariyawasam,Gampaha,Ja-Ela,Western,2858,4639,7497,114320,185560,299880
10/13/2024,Sushantha Kariyawasam,Gampaha,Ja-Ela,Western,7947,4855,12802,317880,194200,512080
10/14/2024,Sushantha Kariyawasam,Gampaha,Ja-Ela,Western,892,9980,10872,35680,399200,434880
10/15/2024,Sushantha Kariyawasam,Gampaha,Ja-Ela,Western,3669,8250,11919,146760,330000,476760
10/16/2024,Sushantha Kariyawasam,Gampaha,Ja-Ela,Western,6112,2688,8800,244480,107520,352000
10/17/2024,Sushantha Kariyawasam,Gampaha,Ja-Ela,Western,7084,6634,13718,283360,265360,548720
10/18/2024,Sushantha Kariyawasam,Gampaha,Ja-Ela,Western,9203,9361,18564,368120,374440,742560
10/19/2024,Sushantha Kariyawasam,Gampaha,Ja-Ela,Western,8042,3615,11657,321680,144600,466280
10/20/2024,Sushantha Kariyawasam,Gampaha,Ja-Ela,Western,7127,227,7354,285080,9080,294160
10/21/2024,Sushantha Kariyawasam,Gampaha,Ja-Ela,Western,1083,5461,6544,43320,218440,261760
10/22/2024,Sushantha Kariyawasam,Gampaha,Ja-Ela,Western,8708,3741,12449,348320,149640,497960
10/23/2024,Sushantha Kariyawasam,Gampaha,Ja-Ela,Western,1221,5960,7181,48840,238400,287240
10/24/2024,Sushantha Kariyawasam,Gampaha,Ja-Ela,Western,4905,7620,12525,196200,304800,501000
10/25/2024,Sushantha Kariyawasam,Gampaha,Ja-Ela,Western,6206,4185,10391,248240,167400,415640
10/26/2024,Sushantha Kariyawasam,Gampaha,Ja-Ela,Western,1808,87,1895,72320,3480,75800
10/27/2024,Sushantha Kariyawasam,Gampaha,Ja-Ela,Western,5117,9990,15107,204680,399600,604280
10/28/2024,Sushantha Kariyawasam,Gampaha,Ja-Ela,Western,2308,4360,6668,92320,174400,266720
10/29/2024,Sushantha Kariyawasam,Gampaha,Ja-Ela,Western,3634,4196,7830,145360,167840,313200
10/30/2024,Sushantha Kariyawasam,Gampaha,Ja-Ela,Western,9806,1901,11707,392240,76040,468280
10/31/2024,Sushantha Kariyawasam,Gampaha,Ja-Ela,Western,1319,9647,10966,52760,385880,438640
11/1/2024,Sushantha Kariyawasam,Gampaha,Ja-Ela,Western,9035,784,9819,361400,31360,392760
11/2/2024,Sushantha Kariyawasam,Gampaha,Ja-Ela,Western,6445,8912,15357,257800,356480,614280
11/3/2024,Sushantha Kariyawasam,Gampaha,Ja-Ela,Western,7096,1425,8521,283840,57000,340840
11/4/2024,Sushantha Kariyawasam,Gampaha,Ja-Ela,Western,975,4157,5132,39000,166280,205280
11/5/2024,Sushantha Kariyawasam,Gampaha,Ja-Ela,Western,9332,5743,15075,373280,229720,603000
11/6/2024,Sushantha Kariyawasam,Gampaha,Ja-Ela,Western,2701,281,2982,108040,11240,119280
11/7/2024,Sushantha Kariyawasam,Gampaha,Ja-Ela,Western,7957,9109,17066,318280,364360,682640
11/8/2024,Sushantha Kariyawasam,Gampaha,Ja-Ela,Western,2650,300,2950,106000,12000,118000
11/9/2024,Sushantha Kariyawasam,Gampaha,Ja-Ela,Western,1602,189,1791,64080,7560,71640
11/10/2024,Sushantha Kariyawasam,Gampaha,Ja-Ela,Western,7674,4972,12646,306960,198880,505840
11/11/2024,Sushantha Kariyawasam,Gampaha,Ja-Ela,Western,9365,1253,10618,374600,50120,424720
11/12/2024,Sushantha Kariyawasam,Gampaha,Ja-Ela,Western,7895,8449,16344,315800,337960,653760
11/13/2024,Sushantha Kariyawasam,Gampaha,Ja-Ela,Western,3128,3786,6914,125120,151440,276560
11/14/2024,Sushantha Kariyawasam,Gampaha,Ja-Ela,Western,3202,9110,12312,128080,364400,492480
11/15/2024,Sushantha Kariyawasam,Gampaha,Ja-Ela,Western,1457,6294,7751,58280,251760,310040
11/16/2024,Sushantha Kariyawasam,Gampaha,Ja-Ela,Western,4890,1615,6505,195600,64600,260200
11/17/2024,Sushantha Kariyawasam,Gampaha,Ja-Ela,Western,7422,5049,12471,296880,201960,498840
11/18/2024,Sushantha Kariyawasam,Gampaha,Ja-Ela,Western,4110,5117,9227,164400,204680,369080
11/19/2024,Sushantha Kariyawasam,Gampaha,Ja-Ela,Western,576,5818,6394,23040,232720,255760
11/20/2024,Sushantha Kariyawasam,Gampaha,Ja-Ela,Western,256,7358,7614,10240,294320,304560
11/21/2024,Sushantha Kariyawasam,Gampaha,Ja-Ela,Western,5667,7100,12767,226680,284000,510680
11/22/2024,Sushantha Kariyawasam,Gampaha,Ja-Ela,Western,2801,7232,10033,112040,289280,401320
11/23/2024,Sushantha Kariyawasam,Gampaha,Ja-Ela,Western,9794,5939,15733,391760,237560,629320
11/24/2024,Sushantha Kariyawasam,Gampaha,Ja-Ela,Western,4251,6385,10636,170040,255400,425440
11/25/2024,Sushantha Kariyawasam,Gampaha,Ja-Ela,Western,9520,1963,11483,380800,78520,459320
11/26/2024,Sushantha Kariyawasam,Gampaha,Ja-Ela,Western,6283,2365,8648,251320,94600,345920
11/27/2024,Sushantha Kariyawasam,Gampaha,Ja-Ela,Western,5753,2959,8712,230120,118360,348480
11/28/2024,Sushantha Kariyawasam,Gampaha,Ja-Ela,Western,4918,244,5162,196720,9760,206480
11/29/2024,Sushantha Kariyawasam,Gampaha,Ja-Ela,Western,251,7516,7767,10040,300640,310680
11/30/2024,Sushantha Kariyawasam,Gampaha,Ja-Ela,Western,6892,3507,10399,275680,140280,415960
12/1/2024,Sushantha Kariyawasam,Gampaha,Ja-Ela,Western,7021,3316,10337,280840,132640,413480
12/2/2024,Sushantha Kariyawasam,Gampaha,Ja-Ela,Western,9213,8590,17803,368520,343600,712120
12/3/2024,Sushantha Kariyawasam,Gampaha,Ja-Ela,Western,9655,4607,14262,386200,184280,570480
12/4/2024,Sushantha Kariyawasam,Gampaha,Ja-Ela,Western,3458,828,4286,138320,33120,171440
12/5/2024,Sushantha Kariyawasam,Gampaha,Ja-Ela,Western,6320,7473,13793,252800,298920,551720
12/6/2024,Sushantha Kariyawasam,Gampaha,Ja-Ela,Western,2597,7299,9896,103880,291960,395840
12/7/2024,Sushantha Kariyawasam,Gampaha,Ja-Ela,Western,1596,7729,9325,63840,309160,373000
12/8/2024,Sushantha Kariyawasam,Gampaha,Ja-Ela,Western,341,856,1197,13640,34240,47880
12/9/2024,Sushantha Kariyawasam,Gampaha,Ja-Ela,Western,6994,8175,15169,279760,327000,606760
12/10/2024,Sushantha Kariyawasam,Gampaha,Ja-Ela,Western,3843,5514,9357,153720,220560,374280
12/11/2024,Sushantha Kariyawasam,Gampaha,Ja-Ela,Western,3459,3947,7406,138360,157880,296240
12/12/2024,Sushantha Kariyawasam,Gampaha,Ja-Ela,Western,168,4450,4618,6720,178000,184720
12/13/2024,Sushantha Kariyawasam,Gampaha,Ja-Ela,Western,4254,8130,12384,170160,325200,495360
12/14/2024,Sushantha Kariyawasam,Gampaha,Ja-Ela,Western,2587,7079,9666,103480,283160,386640
12/15/2024,Sushantha Kariyawasam,Gampaha,Ja-Ela,Western,4772,4029,8801,190880,161160,352040
12/16/2024,Sushantha Kariyawasam,Gampaha,Ja-Ela,Western,9295,4343,13638,371800,173720,545520
12/17/2024,Sushantha Kariyawasam,Gampaha,Ja-Ela,Western,4470,9203,13673,178800,368120,546920
12/18/2024,Sushantha Kariyawasam,Gampaha,Ja-Ela,Western,1352,3948,5300,54080,157920,212000
12/19/2024,Sushantha Kariyawasam,Gampaha,Ja-Ela,Western,1127,3736,4863,45080,149440,194520
12/20/2024,Sushantha Kariyawasam,Gampaha,Ja-Ela,Western,9246,8150,17396,369840,326000,695840
12/21/2024,Sushantha Kariyawasam,Gampaha,Ja-Ela,Western,9813,5410,15223,392520,216400,608920
12/22/2024,Sushantha Kariyawasam,Gampaha,Ja-Ela,Western,5906,2420,8326,236240,96800,333040
12/23/2024,Sushantha Kariyawasam,Gampaha,Ja-Ela,Western,6798,3652,10450,271920,146080,418000
12/24/2024,Sushantha Kariyawasam,Gampaha,Ja-Ela,Western,5899,3839,9738,235960,153560,389520
12/25/2024,Sushantha Kariyawasam,Gampaha,Ja-Ela,Western,5536,9071,14607,221440,362840,584280
12/26/2024,Sushantha Kariyawasam,Gampaha,Ja-Ela,Western,9881,3366,13247,395240,134640,529880
12/27/2024,Sushantha Kariyawasam,Gampaha,Ja-Ela,Western,8096,2193,10289,323840,87720,411560
12/28/2024,Sushantha Kariyawasam,Gampaha,Ja-Ela,Western,4029,900,4929,161160,36000,197160
12/29/2024,Sushantha Kariyawasam,Gampaha,Ja-Ela,Western,255,445,700,10200,17800,28000
12/30/2024,Sushantha Kariyawasam,Gampaha,Ja-Ela,Western,209,4811,5020,8360,192440,200800
12/31/2024,Sushantha Kariyawasam,Gampaha,Ja-Ela,Western,1775,2242,4017,71000,89680,160680
1/1/2025,Sushantha Kariyawasam,Gampaha,Ja-Ela,Western,5017,2146,7163,200680,85840,286520
1/2/2025,Sushantha Kariyawasam,Gampaha,Ja-Ela,Western,2681,1608,4289,107240,64320,171560
1/3/2025,Sushantha Kariyawasam,Gampaha,Ja-Ela,Western,3156,3729,6885,126240,149160,275400
1/4/2025,Sushantha Kariyawasam,Gampaha,Ja-Ela,Western,1567,8859,10426,62680,354360,417040
1/5/2025,Sushantha Kariyawasam,Gampaha,Ja-Ela,Western,4328,957,5285,173120,38280,211400
1/6/2025,Sushantha Kariyawasam,Gampaha,Ja-Ela,Western,8152,5946,14098,326080,237840,563920
1/7/2025,Sushantha Kariyawasam,Gampaha,Ja-Ela,Western,9078,7973,17051,363120,318920,682040
1/8/2025,Sushantha Kariyawasam,Gampaha,Ja-Ela,Western,1075,7511,8586,43000,300440,343440
1/9/2025,Sushantha Kariyawasam,Gampaha,Ja-Ela,Western,5468,9810,15278,218720,392400,611120
1/10/2025,Sushantha Kariyawasam,Gampaha,Ja-Ela,Western,7547,5264,12811,301880,210560,512440
1/11/2025,Sushantha Kariyawasam,Gampaha,Ja-Ela,Western,6260,4940,11200,250400,197600,448000
1/12/2025,Sushantha Kariyawasam,Gampaha,Ja-Ela,Western,7127,127,7254,285080,5080,290160
1/13/2025,Sushantha Kariyawasam,Gampaha,Ja-Ela,Western,5800,3417,9217,232000,136680,368680
1/14/2025,Sushantha Kariyawasam,Gampaha,Ja-Ela,Western,249,803,1052,9960,32120,42080
1/15/2025,Sushantha Kariyawasam,Gampaha,Ja-Ela,Western,8362,741,9103,334480,29640,364120
1/16/2025,Sushantha Kariyawasam,Gampaha,Ja-Ela,Western,3271,9741,13012,130840,389640,520480
1/17/2025,Sushantha Kariyawasam,Gampaha,Ja-Ela,Western,6670,4374,11044,266800,174960,441760
1/18/2025,Sushantha Kariyawasam,Gampaha,Ja-Ela,Western,3602,555,4157,144080,22200,166280
1/19/2025,Sushantha Kariyawasam,Gampaha,Ja-Ela,Western,3865,6194,10059,154600,247760,402360
1/20/2025,Sushantha Kariyawasam,Gampaha,Ja-Ela,Western,4515,8476,12991,180600,339040,519640
1/21/2025,Sushantha Kariyawasam,Gampaha,Ja-Ela,Western,3505,5474,8979,140200,218960,359160
1/22/2025,Sushantha Kariyawasam,Gampaha,Ja-Ela,Western,1213,6689,7902,48520,267560,316080
1/23/2025,Sushantha Kariyawasam,Gampaha,Ja-Ela,Western,6465,8480,14945,258600,339200,597800
1/24/2025,Sushantha Kariyawasam,Gampaha,Ja-Ela,Western,4932,2021,6953,197280,80840,278120
1/25/2025,Sushantha Kariyawasam,Gampaha,Ja-Ela,Western,2120,4560,6680,84800,182400,267200
1/26/2025,Sushantha Kariyawasam,Gampaha,Ja-Ela,Western,9561,474,10035,382440,18960,401400
1/27/2025,Sushantha Kariyawasam,Gampaha,Ja-Ela,Western,4916,6851,11767,196640,274040,470680
1/28/2025,Sushantha Kariyawasam,Gampaha,Ja-Ela,Western,4768,5614,10382,190720,224560,415280
1/29/2025,Sushantha Kariyawasam,Gampaha,Ja-Ela,Western,2318,8934,11252,92720,357360,450080
1/30/2025,Sushantha Kariyawasam,Gampaha,Ja-Ela,Western,1606,6103,7709,64240,244120,308360
1/31/2025,Sushantha Kariyawasam,Gampaha,Ja-Ela,Western,2163,9273,11436,86520,370920,457440
2/1/2025,Sushantha Kariyawasam,Gampaha,Ja-Ela,Western,1869,4841,6710,74760,193640,268400
2/2/2025,Sushantha Kariyawasam,Gampaha,Ja-Ela,Western,8514,9881,18395,340560,395240,735800
2/3/2025,Sushantha Kariyawasam,Gampaha,Ja-Ela,Western,625,6484,7109,25000,259360,284360
2/4/2025,Sushantha Kariyawasam,Gampaha,Ja-Ela,Western,4037,4704,8741,161480,188160,349640
2/5/2025,Sushantha Kariyawasam,Gampaha,Ja-Ela,Western,5358,4055,9413,214320,162200,376520
2/6/2025,Sushantha Kariyawasam,Gampaha,Ja-Ela,Western,2363,8437,10800,94520,337480,432000
2/7/2025,Sushantha Kariyawasam,Gampaha,Ja-Ela,Western,7962,5730,13692,318480,229200,547680
2/8/2025,Sushantha Kariyawasam,Gampaha,Ja-Ela,Western,8168,2312,10480,326720,92480,419200
2/9/2025,Sushantha Kariyawasam,Gampaha,Ja-Ela,Western,2696,2138,4834,107840,85520,193360
2/10/2025,Sushantha Kariyawasam,Gampaha,Ja-Ela,Western,4948,6062,11010,197920,242480,440400
2/11/2025,Sushantha Kariyawasam,Gampaha,Ja-Ela,Western,1138,6231,7369,45520,249240,294760
2/12/2025,Sushantha Kariyawasam,Gampaha,Ja-Ela,Western,5042,5818,10860,201680,232720,434400
2/13/2025,Sushantha Kariyawasam,Gampaha,Ja-Ela,Western,3444,7982,11426,137760,319280,457040
2/14/2025,Sushantha Kariyawasam,Gampaha,Ja-Ela,Western,7294,4014,11308,291760,160560,452320
2/15/2025,Sushantha Kariyawasam,Gampaha,Ja-Ela,Western,5951,7975,13926,238040,319000,557040
2/16/2025,Sushantha Kariyawasam,Gampaha,Ja-Ela,Western,7700,4401,12101,308000,176040,484040
2/17/2025,Sushantha Kariyawasam,Gampaha,Ja-Ela,Western,4397,8734,13131,175880,349360,525240
2/18/2025,Sushantha Kariyawasam,Gampaha,Ja-Ela,Western,4206,3372,7578,168240,134880,303120
2/19/2025,Sushantha Kariyawasam,Gampaha,Ja-Ela,Western,5070,9247,14317,202800,369880,572680
2/20/2025,Sushantha Kariyawasam,Gampaha,Ja-Ela,Western,9061,2270,11331,362440,90800,453240
2/21/2025,Sushantha Kariyawasam,Gampaha,Ja-Ela,Western,4144,6269,10413,165760,250760,416520
2/22/2025,Sushantha Kariyawasam,Gampaha,Ja-Ela,Western,5291,6162,11453,211640,246480,458120
2/23/2025,Sushantha Kariyawasam,Gampaha,Ja-Ela,Western,859,7300,8159,34360,292000,326360
2/24/2025,Sushantha Kariyawasam,Gampaha,Ja-Ela,Western,144,681,825,5760,27240,33000
2/25/2025,Sushantha Kariyawasam,Gampaha,Ja-Ela,Western,1724,4966,6690,68960,198640,267600
2/26/2025,Sushantha Kariyawasam,Gampaha,Ja-Ela,Western,2942,6925,9867,117680,277000,394680
2/27/2025,Sushantha Kariyawasam,Gampaha,Ja-Ela,Western,2398,6556,8954,95920,262240,358160
2/28/2025,Sushantha Kariyawasam,Gampaha,Ja-Ela,Western,9209,9684,18893,368360,387360,755720
3/1/2025,Sushantha Kariyawasam,Gampaha,Ja-Ela,Western,7836,487,8323,313440,19480,332920
3/2/2025,Sushantha Kariyawasam,Gampaha,Ja-Ela,Western,3427,3435,6862,137080,137400,274480
3/3/2025,Sushantha Kariyawasam,Gampaha,Ja-Ela,Western,9997,9372,19369,399880,374880,774760
3/4/2025,Sushantha Kariyawasam,Gampaha,Ja-Ela,Western,5134,6451,11585,205360,258040,463400
3/5/2025,Sushantha Kariyawasam,Gampaha,Ja-Ela,Western,8250,7629,15879,330000,305160,635160
3/6/2025,Sushantha Kariyawasam,Gampaha,Ja-Ela,Western,7543,8022,15565,301720,320880,622600
3/7/2025,Sushantha Kariyawasam,Gampaha,Ja-Ela,Western,420,3597,4017,16800,143880,160680
3/8/2025,Sushantha Kariyawasam,Gampaha,Ja-Ela,Western,7415,1005,8420,296600,40200,336800
3/9/2025,Sushantha Kariyawasam,Gampaha,Ja-Ela,Western,1341,9359,10700,53640,374360,428000
3/10/2025,Sushantha Kariyawasam,Gampaha,Ja-Ela,Western,8468,3884,12352,338720,155360,494080
3/11/2025,Sushantha Kariyawasam,Gampaha,Ja-Ela,Western,9953,4176,14129,398120,167040,565160
3/12/2025,Sushantha Kariyawasam,Gampaha,Ja-Ela,Western,2743,9612,12355,109720,384480,494200
3/13/2025,Sushantha Kariyawasam,Gampaha,Ja-Ela,Western,932,258,1190,37280,10320,47600
3/14/2025,Sushantha Kariyawasam,Gampaha,Ja-Ela,Western,9888,4906,14794,395520,196240,591760
3/15/2025,Sushantha Kariyawasam,Gampaha,Ja-Ela,Western,3221,4554,7775,128840,182160,311000
3/16/2025,Sushantha Kariyawasam,Gampaha,Ja-Ela,Western,279,574,853,11160,22960,34120
3/17/2025,Sushantha Kariyawasam,Gampaha,Ja-Ela,Western,8009,1893,9902,320360,75720,396080
3/18/2025,Sushantha Kariyawasam,Gampaha,Ja-Ela,Western,1374,1163,2537,54960,46520,101480
3/19/2025,Sushantha Kariyawasam,Gampaha,Ja-Ela,Western,41,3846,3887,1640,153840,155480
3/20/2025,Sushantha Kariyawasam,Gampaha,Ja-Ela,Western,9744,6342,16086,389760,253680,643440
3/21/2025,Sushantha Kariyawasam,Gampaha,Ja-Ela,Western,6069,4472,10541,242760,178880,421640
3/22/2025,Sushantha Kariyawasam,Gampaha,Ja-Ela,Western,2434,7697,10131,97360,307880,405240
3/23/2025,Sushantha Kariyawasam,Gampaha,Ja-Ela,Western,6225,4720,10945,249000,188800,437800
3/25/2024,Sanduni Pathirana,Kegalle,Galigamuwa,Sabaragamuwa,4308,1124,5432,172320,44960,217280
3/26/2024,Sanduni Pathirana,Kegalle,Galigamuwa,Sabaragamuwa,9421,6045,15466,376840,241800,618640
3/27/2024,Sanduni Pathirana,Kegalle,Galigamuwa,Sabaragamuwa,5546,7815,13361,221840,312600,534440
3/28/2024,Sanduni Pathirana,Kegalle,Galigamuwa,Sabaragamuwa,2456,2494,4950,98240,99760,198000
3/29/2024,Sanduni Pathirana,Kegalle,Galigamuwa,Sabaragamuwa,4090,1495,5585,163600,59800,223400
3/30/2024,Sanduni Pathirana,Kegalle,Galigamuwa,Sabaragamuwa,5055,1443,6498,202200,57720,259920
3/31/2024,Sanduni Pathirana,Kegalle,Galigamuwa,Sabaragamuwa,7143,9164,16307,285720,366560,652280
4/1/2024,Sanduni Pathirana,Kegalle,Galigamuwa,Sabaragamuwa,461,5119,5580,18440,204760,223200
4/2/2024,Sanduni Pathirana,Kegalle,Galigamuwa,Sabaragamuwa,7536,7730,15266,301440,309200,610640
4/3/2024,Sanduni Pathirana,Kegalle,Galigamuwa,Sabaragamuwa,7576,30,7606,303040,1200,304240
4/4/2024,Sanduni Pathirana,Kegalle,Galigamuwa,Sabaragamuwa,1810,1257,3067,72400,50280,122680
4/5/2024,Sanduni Pathirana,Kegalle,Galigamuwa,Sabaragamuwa,6023,8277,14300,240920,331080,572000
4/6/2024,Sanduni Pathirana,Kegalle,Galigamuwa,Sabaragamuwa,131,5178,5309,5240,207120,212360
4/7/2024,Sanduni Pathirana,Kegalle,Galigamuwa,Sabaragamuwa,5875,2177,8052,235000,87080,322080
4/8/2024,Sanduni Pathirana,Kegalle,Galigamuwa,Sabaragamuwa,2577,727,3304,103080,29080,132160
4/9/2024,Sanduni Pathirana,Kegalle,Galigamuwa,Sabaragamuwa,4893,9585,14478,195720,383400,579120
4/10/2024,Sanduni Pathirana,Kegalle,Galigamuwa,Sabaragamuwa,1917,7852,9769,76680,314080,390760
4/11/2024,Sanduni Pathirana,Kegalle,Galigamuwa,Sabaragamuwa,2845,264,3109,113800,10560,124360
4/19/2024,Sanduni Pathirana,Kegalle,Galigamuwa,Sabaragamuwa,7691,4610,12301,307640,184400,492040
4/20/2024,Sanduni Pathirana,Kegalle,Galigamuwa,Sabaragamuwa,3462,6888,10350,138480,275520,414000
4/21/2024,Sanduni Pathirana,Kegalle,Galigamuwa,Sabaragamuwa,3713,3284,6997,148520,131360,279880
4/22/2024,Sanduni Pathirana,Kegalle,Galigamuwa,Sabaragamuwa,9155,8956,18111,366200,358240,724440
4/23/2024,Sanduni Pathirana,Kegalle,Galigamuwa,Sabaragamuwa,8936,3690,12626,357440,147600,505040
4/24/2024,Sanduni Pathirana,Kegalle,Galigamuwa,Sabaragamuwa,4209,1571,5780,168360,62840,231200
4/25/2024,Sanduni Pathirana,Kegalle,Galigamuwa,Sabaragamuwa,846,5191,6037,33840,207640,241480
4/26/2024,Sanduni Pathirana,Kegalle,Galigamuwa,Sabaragamuwa,1334,7905,9239,53360,316200,369560
4/27/2024,Sanduni Pathirana,Kegalle,Galigamuwa,Sabaragamuwa,1146,6855,8001,45840,274200,320040
4/28/2024,Sanduni Pathirana,Kegalle,Galigamuwa,Sabaragamuwa,6473,7797,14270,258920,311880,570800
4/29/2024,Sanduni Pathirana,Kegalle,Galigamuwa,Sabaragamuwa,8653,914,9567,346120,36560,382680
4/30/2024,Sanduni Pathirana,Kegalle,Galigamuwa,Sabaragamuwa,433,1101,1534,17320,44040,61360
5/1/2024,Sanduni Pathirana,Kegalle,Galigamuwa,Sabaragamuwa,6043,2554,8597,241720,102160,343880
5/2/2024,Sanduni Pathirana,Kegalle,Galigamuwa,Sabaragamuwa,6676,4721,11397,267040,188840,455880
5/3/2024,Sanduni Pathirana,Kegalle,Galigamuwa,Sabaragamuwa,776,4623,5399,31040,184920,215960
5/4/2024,Sanduni Pathirana,Kegalle,Galigamuwa,Sabaragamuwa,8769,4753,13522,350760,190120,540880
5/5/2024,Sanduni Pathirana,Kegalle,Galigamuwa,Sabaragamuwa,8563,4924,13487,342520,196960,539480
5/6/2024,Sanduni Pathirana,Kegalle,Galigamuwa,Sabaragamuwa,407,5512,5919,16280,220480,236760
5/7/2024,Sanduni Pathirana,Kegalle,Galigamuwa,Sabaragamuwa,2451,36,2487,98040,1440,99480
5/8/2024,Sanduni Pathirana,Kegalle,Galigamuwa,Sabaragamuwa,9066,9039,18105,362640,361560,724200
5/9/2024,Sanduni Pathirana,Kegalle,Galigamuwa,Sabaragamuwa,5915,2046,7961,236600,81840,318440
5/10/2024,Sanduni Pathirana,Kegalle,Galigamuwa,Sabaragamuwa,4976,4266,9242,199040,170640,369680
5/11/2024,Sanduni Pathirana,Kegalle,Galigamuwa,Sabaragamuwa,5660,1135,6795,226400,45400,271800
5/12/2024,Sanduni Pathirana,Kegalle,Galigamuwa,Sabaragamuwa,4511,9977,14488,180440,399080,579520
5/13/2024,Sanduni Pathirana,Kegalle,Galigamuwa,Sabaragamuwa,8277,9529,17806,331080,381160,712240
5/14/2024,Sanduni Pathirana,Kegalle,Galigamuwa,Sabaragamuwa,2057,9280,11337,82280,371200,453480
5/15/2024,Sanduni Pathirana,Kegalle,Galigamuwa,Sabaragamuwa,1506,2197,3703,60240,87880,148120
5/16/2024,Sanduni Pathirana,Kegalle,Galigamuwa,Sabaragamuwa,6376,3062,9438,255040,122480,377520
5/17/2024,Sanduni Pathirana,Kegalle,Galigamuwa,Sabaragamuwa,2301,1146,3447,92040,45840,137880
5/18/2024,Sanduni Pathirana,Kegalle,Galigamuwa,Sabaragamuwa,5153,9463,14616,206120,378520,584640
5/19/2024,Sanduni Pathirana,Kegalle,Galigamuwa,Sabaragamuwa,7758,6221,13979,310320,248840,559160
5/20/2024,Sanduni Pathirana,Kegalle,Galigamuwa,Sabaragamuwa,3957,9471,13428,158280,378840,537120
5/21/2024,Sanduni Pathirana,Kegalle,Galigamuwa,Sabaragamuwa,9872,7705,17577,394880,308200,703080
5/22/2024,Sanduni Pathirana,Kegalle,Galigamuwa,Sabaragamuwa,5024,3192,8216,200960,127680,328640
5/24/2024,Sanduni Pathirana,Kegalle,Galigamuwa,Sabaragamuwa,5343,1038,6381,213720,41520,255240
5/25/2024,Sanduni Pathirana,Kegalle,Galigamuwa,Sabaragamuwa,1535,8975,10510,61400,359000,420400
5/26/2024,Sanduni Pathirana,Kegalle,Galigamuwa,Sabaragamuwa,2143,7068,9211,85720,282720,368440
5/27/2024,Sanduni Pathirana,Kegalle,Galigamuwa,Sabaragamuwa,8031,3642,11673,321240,145680,466920
5/28/2024,Sanduni Pathirana,Kegalle,Galigamuwa,Sabaragamuwa,545,3465,4010,21800,138600,160400
5/29/2024,Sanduni Pathirana,Kegalle,Galigamuwa,Sabaragamuwa,6941,5277,12218,277640,211080,488720
5/30/2024,Sanduni Pathirana,Kegalle,Galigamuwa,Sabaragamuwa,2565,3426,5991,102600,137040,239640
5/31/2024,Sanduni Pathirana,Kegalle,Galigamuwa,Sabaragamuwa,6689,4917,11606,267560,196680,464240
6/1/2024,Sanduni Pathirana,Kegalle,Galigamuwa,Sabaragamuwa,2168,101,2269,86720,4040,90760
6/2/2024,Sanduni Pathirana,Kegalle,Galigamuwa,Sabaragamuwa,4206,6268,10474,168240,250720,418960
6/3/2024,Sanduni Pathirana,Kegalle,Galigamuwa,Sabaragamuwa,6423,5856,12279,256920,234240,491160
6/4/2024,Sanduni Pathirana,Kegalle,Galigamuwa,Sabaragamuwa,1118,6696,7814,44720,267840,312560
6/5/2024,Sanduni Pathirana,Kegalle,Galigamuwa,Sabaragamuwa,513,3390,3903,20520,135600,156120
6/6/2024,Sanduni Pathirana,Kegalle,Galigamuwa,Sabaragamuwa,8935,3221,12156,357400,128840,486240
6/7/2024,Sanduni Pathirana,Kegalle,Galigamuwa,Sabaragamuwa,1967,9895,11862,78680,395800,474480
6/8/2024,Sanduni Pathirana,Kegalle,Galigamuwa,Sabaragamuwa,2941,4217,7158,117640,168680,286320
6/9/2024,Sanduni Pathirana,Kegalle,Galigamuwa,Sabaragamuwa,1474,3667,5141,58960,146680,205640
6/10/2024,Sanduni Pathirana,Kegalle,Galigamuwa,Sabaragamuwa,488,3455,3943,19520,138200,157720
6/11/2024,Sanduni Pathirana,Kegalle,Galigamuwa,Sabaragamuwa,6049,8574,14623,241960,342960,584920
6/12/2024,Sanduni Pathirana,Kegalle,Galigamuwa,Sabaragamuwa,8962,1930,10892,358480,77200,435680
6/13/2024,Sanduni Pathirana,Kegalle,Galigamuwa,Sabaragamuwa,420,9327,9747,16800,373080,389880
6/14/2024,Sanduni Pathirana,Kegalle,Galigamuwa,Sabaragamuwa,3578,5074,8652,143120,202960,346080
6/15/2024,Sanduni Pathirana,Kegalle,Galigamuwa,Sabaragamuwa,9881,4212,14093,395240,168480,563720
6/16/2024,Sanduni Pathirana,Kegalle,Galigamuwa,Sabaragamuwa,6734,693,7427,269360,27720,297080
6/17/2024,Sanduni Pathirana,Kegalle,Galigamuwa,Sabaragamuwa,5162,6531,11693,206480,261240,467720
6/18/2024,Sanduni Pathirana,Kegalle,Galigamuwa,Sabaragamuwa,6653,7928,14581,266120,317120,583240
6/19/2024,Sanduni Pathirana,Kegalle,Galigamuwa,Sabaragamuwa,7713,5213,12926,308520,208520,517040
6/20/2024,Sanduni Pathirana,Kegalle,Galigamuwa,Sabaragamuwa,8647,8621,17268,345880,344840,690720
6/21/2024,Sanduni Pathirana,Kegalle,Galigamuwa,Sabaragamuwa,8223,3892,12115,328920,155680,484600
6/22/2024,Sanduni Pathirana,Kegalle,Galigamuwa,Sabaragamuwa,7706,2272,9978,308240,90880,399120
6/23/2024,Sanduni Pathirana,Kegalle,Galigamuwa,Sabaragamuwa,8916,8888,17804,356640,355520,712160
6/24/2024,Sanduni Pathirana,Kegalle,Galigamuwa,Sabaragamuwa,2078,9049,11127,83120,361960,445080
6/25/2024,Sanduni Pathirana,Kegalle,Galigamuwa,Sabaragamuwa,1319,1183,2502,52760,47320,100080
6/26/2024,Sanduni Pathirana,Kegalle,Galigamuwa,Sabaragamuwa,789,999,1788,31560,39960,71520
6/27/2024,Sanduni Pathirana,Kegalle,Galigamuwa,Sabaragamuwa,4576,5524,10100,183040,220960,404000
6/28/2024,Sanduni Pathirana,Kegalle,Galigamuwa,Sabaragamuwa,3283,1345,4628,131320,53800,185120
6/29/2024,Sanduni Pathirana,Kegalle,Galigamuwa,Sabaragamuwa,8384,2238,10622,335360,89520,424880
6/30/2024,Sanduni Pathirana,Kegalle,Galigamuwa,Sabaragamuwa,533,8197,8730,21320,327880,349200
7/1/2024,Sanduni Pathirana,Kegalle,Galigamuwa,Sabaragamuwa,1606,221,1827,64240,8840,73080
7/2/2024,Sanduni Pathirana,Kegalle,Galigamuwa,Sabaragamuwa,1352,9248,10600,54080,369920,424000
7/3/2024,Sanduni Pathirana,Kegalle,Galigamuwa,Sabaragamuwa,6951,7806,14757,278040,312240,590280
7/4/2024,Sanduni Pathirana,Kegalle,Galigamuwa,Sabaragamuwa,3229,5612,8841,129160,224480,353640
7/5/2024,Sanduni Pathirana,Kegalle,Galigamuwa,Sabaragamuwa,4271,2642,6913,170840,105680,276520
7/6/2024,Sanduni Pathirana,Kegalle,Galigamuwa,Sabaragamuwa,1237,401,1638,49480,16040,65520
7/7/2024,Sanduni Pathirana,Kegalle,Galigamuwa,Sabaragamuwa,9172,6504,15676,366880,260160,627040
7/8/2024,Sanduni Pathirana,Kegalle,Galigamuwa,Sabaragamuwa,9751,3634,13385,390040,145360,535400
7/9/2024,Sanduni Pathirana,Kegalle,Galigamuwa,Sabaragamuwa,8849,4651,13500,353960,186040,540000
7/10/2024,Sanduni Pathirana,Kegalle,Galigamuwa,Sabaragamuwa,6131,2135,8266,245240,85400,330640
7/11/2024,Sanduni Pathirana,Kegalle,Galigamuwa,Sabaragamuwa,3045,8100,11145,121800,324000,445800
7/12/2024,Sanduni Pathirana,Kegalle,Galigamuwa,Sabaragamuwa,6328,6922,13250,253120,276880,530000
7/13/2024,Sanduni Pathirana,Kegalle,Galigamuwa,Sabaragamuwa,3202,3307,6509,128080,132280,260360
7/14/2024,Sanduni Pathirana,Kegalle,Galigamuwa,Sabaragamuwa,4916,3457,8373,196640,138280,334920
7/15/2024,Sanduni Pathirana,Kegalle,Galigamuwa,Sabaragamuwa,4662,913,5575,186480,36520,223000
7/16/2024,Sanduni Pathirana,Kegalle,Galigamuwa,Sabaragamuwa,4284,4192,8476,171360,167680,339040
7/17/2024,Sanduni Pathirana,Kegalle,Galigamuwa,Sabaragamuwa,2611,9735,12346,104440,389400,493840
7/18/2024,Sanduni Pathirana,Kegalle,Galigamuwa,Sabaragamuwa,3719,2983,6702,148760,119320,268080
7/19/2024,Sanduni Pathirana,Kegalle,Galigamuwa,Sabaragamuwa,5280,7998,13278,211200,319920,531120
7/20/2024,Sanduni Pathirana,Kegalle,Galigamuwa,Sabaragamuwa,6001,5455,11456,240040,218200,458240
7/21/2024,Sanduni Pathirana,Kegalle,Galigamuwa,Sabaragamuwa,648,4363,5011,25920,174520,200440
7/22/2024,Sanduni Pathirana,Kegalle,Galigamuwa,Sabaragamuwa,1713,1432,3145,68520,57280,125800
7/23/2024,Sanduni Pathirana,Kegalle,Galigamuwa,Sabaragamuwa,5876,4629,10505,235040,185160,420200
7/24/2024,Sanduni Pathirana,Kegalle,Galigamuwa,Sabaragamuwa,8567,7594,16161,342680,303760,646440
7/25/2024,Sanduni Pathirana,Kegalle,Galigamuwa,Sabaragamuwa,1246,1705,2951,49840,68200,118040
7/26/2024,Sanduni Pathirana,Kegalle,Galigamuwa,Sabaragamuwa,8178,8069,16247,327120,322760,649880
7/27/2024,Sanduni Pathirana,Kegalle,Galigamuwa,Sabaragamuwa,4540,5637,10177,181600,225480,407080
7/28/2024,Sanduni Pathirana,Kegalle,Galigamuwa,Sabaragamuwa,9149,8920,18069,365960,356800,722760
7/29/2024,Sanduni Pathirana,Kegalle,Galigamuwa,Sabaragamuwa,1856,243,2099,74240,9720,83960
7/30/2024,Sanduni Pathirana,Kegalle,Galigamuwa,Sabaragamuwa,3728,1285,5013,149120,51400,200520
7/31/2024,Sanduni Pathirana,Kegalle,Galigamuwa,Sabaragamuwa,6753,7240,13993,270120,289600,559720
8/1/2024,Sanduni Pathirana,Kegalle,Galigamuwa,Sabaragamuwa,5983,127,6110,239320,5080,244400
8/2/2024,Sanduni Pathirana,Kegalle,Galigamuwa,Sabaragamuwa,8195,4374,12569,327800,174960,502760
8/3/2024,Sanduni Pathirana,Kegalle,Galigamuwa,Sabaragamuwa,4979,997,5976,199160,39880,239040
8/4/2024,Sanduni Pathirana,Kegalle,Galigamuwa,Sabaragamuwa,1144,5602,6746,45760,224080,269840
8/5/2024,Sanduni Pathirana,Kegalle,Galigamuwa,Sabaragamuwa,554,856,1410,22160,34240,56400
8/6/2024,Sanduni Pathirana,Kegalle,Galigamuwa,Sabaragamuwa,2523,4471,6994,100920,178840,279760
8/7/2024,Sanduni Pathirana,Kegalle,Galigamuwa,Sabaragamuwa,5915,9329,15244,236600,373160,609760
8/8/2024,Sanduni Pathirana,Kegalle,Galigamuwa,Sabaragamuwa,3544,5761,9305,141760,230440,372200
8/9/2024,Sanduni Pathirana,Kegalle,Galigamuwa,Sabaragamuwa,9416,1836,11252,376640,73440,450080
8/10/2024,Sanduni Pathirana,Kegalle,Galigamuwa,Sabaragamuwa,7108,8021,15129,284320,320840,605160
8/11/2024,Sanduni Pathirana,Kegalle,Galigamuwa,Sabaragamuwa,5869,9952,15821,234760,398080,632840
8/12/2024,Sanduni Pathirana,Kegalle,Galigamuwa,Sabaragamuwa,448,5029,5477,17920,201160,219080
8/13/2024,Sanduni Pathirana,Kegalle,Galigamuwa,Sabaragamuwa,1887,5953,7840,75480,238120,313600
8/14/2024,Sanduni Pathirana,Kegalle,Galigamuwa,Sabaragamuwa,687,4646,5333,27480,185840,213320
8/15/2024,Sanduni Pathirana,Kegalle,Galigamuwa,Sabaragamuwa,8808,5570,14378,352320,222800,575120
8/16/2024,Sanduni Pathirana,Kegalle,Galigamuwa,Sabaragamuwa,1694,1251,2945,67760,50040,117800
8/17/2024,Sanduni Pathirana,Kegalle,Galigamuwa,Sabaragamuwa,153,4319,4472,6120,172760,178880
8/18/2024,Sanduni Pathirana,Kegalle,Galigamuwa,Sabaragamuwa,1430,3502,4932,57200,140080,197280
8/19/2024,Sanduni Pathirana,Kegalle,Galigamuwa,Sabaragamuwa,5981,4036,10017,239240,161440,400680
8/20/2024,Sanduni Pathirana,Kegalle,Galigamuwa,Sabaragamuwa,5445,7361,12806,217800,294440,512240
8/21/2024,Sanduni Pathirana,Kegalle,Galigamuwa,Sabaragamuwa,2832,6580,9412,113280,263200,376480
8/22/2024,Sanduni Pathirana,Kegalle,Galigamuwa,Sabaragamuwa,5830,4536,10366,233200,181440,414640
8/23/2024,Sanduni Pathirana,Kegalle,Galigamuwa,Sabaragamuwa,3963,8245,12208,158520,329800,488320
8/24/2024,Sanduni Pathirana,Kegalle,Galigamuwa,Sabaragamuwa,7154,2580,9734,286160,103200,389360
8/25/2024,Sanduni Pathirana,Kegalle,Galigamuwa,Sabaragamuwa,8734,6778,15512,349360,271120,620480
8/26/2024,Sanduni Pathirana,Kegalle,Galigamuwa,Sabaragamuwa,4561,6013,10574,182440,240520,422960
8/27/2024,Sanduni Pathirana,Kegalle,Galigamuwa,Sabaragamuwa,4334,3938,8272,173360,157520,330880
8/28/2024,Sanduni Pathirana,Kegalle,Galigamuwa,Sabaragamuwa,9969,1295,11264,398760,51800,450560
8/29/2024,Sanduni Pathirana,Kegalle,Galigamuwa,Sabaragamuwa,2221,8206,10427,88840,328240,417080
8/30/2024,Sanduni Pathirana,Kegalle,Galigamuwa,Sabaragamuwa,8536,2132,10668,341440,85280,426720
8/31/2024,Sanduni Pathirana,Kegalle,Galigamuwa,Sabaragamuwa,5099,2855,7954,203960,114200,318160
9/1/2024,Sanduni Pathirana,Kegalle,Galigamuwa,Sabaragamuwa,8215,8653,16868,328600,346120,674720
9/2/2024,Sanduni Pathirana,Kegalle,Galigamuwa,Sabaragamuwa,7871,8481,16352,314840,339240,654080
9/3/2024,Sanduni Pathirana,Kegalle,Galigamuwa,Sabaragamuwa,2303,1799,4102,92120,71960,164080
9/4/2024,Sanduni Pathirana,Kegalle,Galigamuwa,Sabaragamuwa,887,5951,6838,35480,238040,273520
9/5/2024,Sanduni Pathirana,Kegalle,Galigamuwa,Sabaragamuwa,7180,4286,11466,287200,171440,458640
9/6/2024,Sanduni Pathirana,Kegalle,Galigamuwa,Sabaragamuwa,63,2575,2638,2520,103000,105520
9/7/2024,Sanduni Pathirana,Kegalle,Galigamuwa,Sabaragamuwa,876,3669,4545,35040,146760,181800
9/8/2024,Sanduni Pathirana,Kegalle,Galigamuwa,Sabaragamuwa,6549,2064,8613,261960,82560,344520
9/9/2024,Sanduni Pathirana,Kegalle,Galigamuwa,Sabaragamuwa,4564,3992,8556,182560,159680,342240
9/10/2024,Sanduni Pathirana,Kegalle,Galigamuwa,Sabaragamuwa,8257,2160,10417,330280,86400,416680
9/11/2024,Sanduni Pathirana,Kegalle,Galigamuwa,Sabaragamuwa,9482,725,10207,379280,29000,408280
9/12/2024,Sanduni Pathirana,Kegalle,Galigamuwa,Sabaragamuwa,6634,5259,11893,265360,210360,475720
9/13/2024,Sanduni Pathirana,Kegalle,Galigamuwa,Sabaragamuwa,9462,2498,11960,378480,99920,478400
9/14/2024,Sanduni Pathirana,Kegalle,Galigamuwa,Sabaragamuwa,4739,8045,12784,189560,321800,511360
9/15/2024,Sanduni Pathirana,Kegalle,Galigamuwa,Sabaragamuwa,9368,3371,12739,374720,134840,509560
9/16/2024,Sanduni Pathirana,Kegalle,Galigamuwa,Sabaragamuwa,704,4383,5087,28160,175320,203480
9/17/2024,Sanduni Pathirana,Kegalle,Galigamuwa,Sabaragamuwa,7718,2775,10493,308720,111000,419720
9/18/2024,Sanduni Pathirana,Kegalle,Galigamuwa,Sabaragamuwa,4084,2378,6462,163360,95120,258480
9/19/2024,Sanduni Pathirana,Kegalle,Galigamuwa,Sabaragamuwa,9137,641,9778,365480,25640,391120
9/20/2024,Sanduni Pathirana,Kegalle,Galigamuwa,Sabaragamuwa,3927,3361,7288,157080,134440,291520
9/21/2024,Sanduni Pathirana,Kegalle,Galigamuwa,Sabaragamuwa,2345,9360,11705,93800,374400,468200
9/22/2024,Sanduni Pathirana,Kegalle,Galigamuwa,Sabaragamuwa,1286,8168,9454,51440,326720,378160
9/23/2024,Sanduni Pathirana,Kegalle,Galigamuwa,Sabaragamuwa,3761,8611,12372,150440,344440,494880
9/24/2024,Sanduni Pathirana,Kegalle,Galigamuwa,Sabaragamuwa,8142,3618,11760,325680,144720,470400
9/25/2024,Sanduni Pathirana,Kegalle,Galigamuwa,Sabaragamuwa,6847,3838,10685,273880,153520,427400
9/26/2024,Sanduni Pathirana,Kegalle,Galigamuwa,Sabaragamuwa,3300,704,4004,132000,28160,160160
9/27/2024,Sanduni Pathirana,Kegalle,Galigamuwa,Sabaragamuwa,6338,8942,15280,253520,357680,611200
9/28/2024,Sanduni Pathirana,Kegalle,Galigamuwa,Sabaragamuwa,1082,6595,7677,43280,263800,307080
9/29/2024,Sanduni Pathirana,Kegalle,Galigamuwa,Sabaragamuwa,5071,6955,12026,202840,278200,481040
9/30/2024,Sanduni Pathirana,Kegalle,Galigamuwa,Sabaragamuwa,3766,9628,13394,150640,385120,535760
10/1/2024,Sanduni Pathirana,Kegalle,Galigamuwa,Sabaragamuwa,8861,2197,11058,354440,87880,442320
10/2/2024,Sanduni Pathirana,Kegalle,Galigamuwa,Sabaragamuwa,287,5037,5324,11480,201480,212960
10/3/2024,Sanduni Pathirana,Kegalle,Galigamuwa,Sabaragamuwa,7348,1912,9260,293920,76480,370400
10/4/2024,Sanduni Pathirana,Kegalle,Galigamuwa,Sabaragamuwa,9088,5141,14229,363520,205640,569160
10/5/2024,Sanduni Pathirana,Kegalle,Galigamuwa,Sabaragamuwa,5669,3192,8861,226760,127680,354440
10/6/2024,Sanduni Pathirana,Kegalle,Galigamuwa,Sabaragamuwa,5032,6130,11162,201280,245200,446480
10/7/2024,Sanduni Pathirana,Kegalle,Galigamuwa,Sabaragamuwa,8208,487,8695,328320,19480,347800
10/8/2024,Sanduni Pathirana,Kegalle,Galigamuwa,Sabaragamuwa,5298,8454,13752,211920,338160,550080
10/9/2024,Sanduni Pathirana,Kegalle,Galigamuwa,Sabaragamuwa,8162,4560,12722,326480,182400,508880
10/10/2024,Sanduni Pathirana,Kegalle,Galigamuwa,Sabaragamuwa,706,4583,5289,28240,183320,211560
10/11/2024,Sanduni Pathirana,Kegalle,Galigamuwa,Sabaragamuwa,2442,223,2665,97680,8920,106600
10/12/2024,Sanduni Pathirana,Kegalle,Galigamuwa,Sabaragamuwa,9827,9871,19698,393080,394840,787920
10/13/2024,Sanduni Pathirana,Kegalle,Galigamuwa,Sabaragamuwa,4351,9910,14261,174040,396400,570440
10/14/2024,Sanduni Pathirana,Kegalle,Galigamuwa,Sabaragamuwa,9261,1753,11014,370440,70120,440560
10/15/2024,Sanduni Pathirana,Kegalle,Galigamuwa,Sabaragamuwa,7745,3962,11707,309800,158480,468280
10/16/2024,Sanduni Pathirana,Kegalle,Galigamuwa,Sabaragamuwa,6426,7545,13971,257040,301800,558840
10/17/2024,Sanduni Pathirana,Kegalle,Galigamuwa,Sabaragamuwa,1932,8059,9991,77280,322360,399640
10/18/2024,Sanduni Pathirana,Kegalle,Galigamuwa,Sabaragamuwa,3261,3904,7165,130440,156160,286600
10/19/2024,Sanduni Pathirana,Kegalle,Galigamuwa,Sabaragamuwa,3285,5252,8537,131400,210080,341480
10/20/2024,Sanduni Pathirana,Kegalle,Galigamuwa,Sabaragamuwa,4247,23,4270,169880,920,170800
10/21/2024,Sanduni Pathirana,Kegalle,Galigamuwa,Sabaragamuwa,756,1704,2460,30240,68160,98400
10/22/2024,Sanduni Pathirana,Kegalle,Galigamuwa,Sabaragamuwa,6435,8965,15400,257400,358600,616000
10/23/2024,Sanduni Pathirana,Kegalle,Galigamuwa,Sabaragamuwa,970,2884,3854,38800,115360,154160
10/24/2024,Sanduni Pathirana,Kegalle,Galigamuwa,Sabaragamuwa,1551,8093,9644,62040,323720,385760
10/25/2024,Sanduni Pathirana,Kegalle,Galigamuwa,Sabaragamuwa,7909,766,8675,316360,30640,347000
10/26/2024,Sanduni Pathirana,Kegalle,Galigamuwa,Sabaragamuwa,9105,4050,13155,364200,162000,526200
10/27/2024,Sanduni Pathirana,Kegalle,Galigamuwa,Sabaragamuwa,5687,8744,14431,227480,349760,577240
10/28/2024,Sanduni Pathirana,Kegalle,Galigamuwa,Sabaragamuwa,6757,2096,8853,270280,83840,354120
10/29/2024,Sanduni Pathirana,Kegalle,Galigamuwa,Sabaragamuwa,9841,5768,15609,393640,230720,624360
10/30/2024,Sanduni Pathirana,Kegalle,Galigamuwa,Sabaragamuwa,7437,4439,11876,297480,177560,475040
10/31/2024,Sanduni Pathirana,Kegalle,Galigamuwa,Sabaragamuwa,180,2496,2676,7200,99840,107040
11/1/2024,Sanduni Pathirana,Kegalle,Galigamuwa,Sabaragamuwa,6932,4348,11280,277280,173920,451200
11/2/2024,Sanduni Pathirana,Kegalle,Galigamuwa,Sabaragamuwa,704,649,1353,28160,25960,54120
11/3/2024,Sanduni Pathirana,Kegalle,Galigamuwa,Sabaragamuwa,4579,9973,14552,183160,398920,582080
11/4/2024,Sanduni Pathirana,Kegalle,Galigamuwa,Sabaragamuwa,3288,255,3543,131520,10200,141720
11/5/2024,Sanduni Pathirana,Kegalle,Galigamuwa,Sabaragamuwa,117,9329,9446,4680,373160,377840
11/6/2024,Sanduni Pathirana,Kegalle,Galigamuwa,Sabaragamuwa,8704,7041,15745,348160,281640,629800
11/7/2024,Sanduni Pathirana,Kegalle,Galigamuwa,Sabaragamuwa,258,7990,8248,10320,319600,329920
11/8/2024,Sanduni Pathirana,Kegalle,Galigamuwa,Sabaragamuwa,8264,6000,14264,330560,240000,570560
11/9/2024,Sanduni Pathirana,Kegalle,Galigamuwa,Sabaragamuwa,7767,9548,17315,310680,381920,692600
11/10/2024,Sanduni Pathirana,Kegalle,Galigamuwa,Sabaragamuwa,6762,1894,8656,270480,75760,346240
11/11/2024,Sanduni Pathirana,Kegalle,Galigamuwa,Sabaragamuwa,3014,8052,11066,120560,322080,442640
11/12/2024,Sanduni Pathirana,Kegalle,Galigamuwa,Sabaragamuwa,9796,3001,12797,391840,120040,511880
11/13/2024,Sanduni Pathirana,Kegalle,Galigamuwa,Sabaragamuwa,6630,9608,16238,265200,384320,649520
11/14/2024,Sanduni Pathirana,Kegalle,Galigamuwa,Sabaragamuwa,7103,3063,10166,284120,122520,406640
11/15/2024,Sanduni Pathirana,Kegalle,Galigamuwa,Sabaragamuwa,8776,7879,16655,351040,315160,666200
11/16/2024,Sanduni Pathirana,Kegalle,Galigamuwa,Sabaragamuwa,4452,2586,7038,178080,103440,281520
11/17/2024,Sanduni Pathirana,Kegalle,Galigamuwa,Sabaragamuwa,7467,1776,9243,298680,71040,369720
11/18/2024,Sanduni Pathirana,Kegalle,Galigamuwa,Sabaragamuwa,6428,9031,15459,257120,361240,618360
11/19/2024,Sanduni Pathirana,Kegalle,Galigamuwa,Sabaragamuwa,4069,4558,8627,162760,182320,345080
11/20/2024,Sanduni Pathirana,Kegalle,Galigamuwa,Sabaragamuwa,8253,2504,10757,330120,100160,430280
11/21/2024,Sanduni Pathirana,Kegalle,Galigamuwa,Sabaragamuwa,9525,8184,17709,381000,327360,708360
11/22/2024,Sanduni Pathirana,Kegalle,Galigamuwa,Sabaragamuwa,4458,2470,6928,178320,98800,277120
11/23/2024,Sanduni Pathirana,Kegalle,Galigamuwa,Sabaragamuwa,601,6539,7140,24040,261560,285600
11/24/2024,Sanduni Pathirana,Kegalle,Galigamuwa,Sabaragamuwa,9258,6862,16120,370320,274480,644800
11/25/2024,Sanduni Pathirana,Kegalle,Galigamuwa,Sabaragamuwa,9288,6020,15308,371520,240800,612320
11/26/2024,Sanduni Pathirana,Kegalle,Galigamuwa,Sabaragamuwa,8763,6487,15250,350520,259480,610000
11/27/2024,Sanduni Pathirana,Kegalle,Galigamuwa,Sabaragamuwa,8313,1276,9589,332520,51040,383560
11/28/2024,Sanduni Pathirana,Kegalle,Galigamuwa,Sabaragamuwa,9084,4733,13817,363360,189320,552680
11/29/2024,Sanduni Pathirana,Kegalle,Galigamuwa,Sabaragamuwa,9799,3415,13214,391960,136600,528560
11/30/2024,Sanduni Pathirana,Kegalle,Galigamuwa,Sabaragamuwa,4148,6179,10327,165920,247160,413080
12/1/2024,Sanduni Pathirana,Kegalle,Galigamuwa,Sabaragamuwa,4510,1795,6305,180400,71800,252200
12/2/2024,Sanduni Pathirana,Kegalle,Galigamuwa,Sabaragamuwa,4066,1156,5222,162640,46240,208880
12/3/2024,Sanduni Pathirana,Kegalle,Galigamuwa,Sabaragamuwa,4988,4414,9402,199520,176560,376080
12/4/2024,Sanduni Pathirana,Kegalle,Galigamuwa,Sabaragamuwa,3985,8152,12137,159400,326080,485480
12/5/2024,Sanduni Pathirana,Kegalle,Galigamuwa,Sabaragamuwa,696,3321,4017,27840,132840,160680
12/6/2024,Sanduni Pathirana,Kegalle,Galigamuwa,Sabaragamuwa,7829,7296,15125,313160,291840,605000
12/7/2024,Sanduni Pathirana,Kegalle,Galigamuwa,Sabaragamuwa,6818,5502,12320,272720,220080,492800
12/8/2024,Sanduni Pathirana,Kegalle,Galigamuwa,Sabaragamuwa,3837,1611,5448,153480,64440,217920
12/9/2024,Sanduni Pathirana,Kegalle,Galigamuwa,Sabaragamuwa,2752,216,2968,110080,8640,118720
12/10/2024,Sanduni Pathirana,Kegalle,Galigamuwa,Sabaragamuwa,3553,164,3717,142120,6560,148680
12/11/2024,Sanduni Pathirana,Kegalle,Galigamuwa,Sabaragamuwa,8365,6715,15080,334600,268600,603200
12/12/2024,Sanduni Pathirana,Kegalle,Galigamuwa,Sabaragamuwa,2756,8395,11151,110240,335800,446040
12/13/2024,Sanduni Pathirana,Kegalle,Galigamuwa,Sabaragamuwa,1064,6452,7516,42560,258080,300640
12/14/2024,Sanduni Pathirana,Kegalle,Galigamuwa,Sabaragamuwa,2120,414,2534,84800,16560,101360
12/15/2024,Sanduni Pathirana,Kegalle,Galigamuwa,Sabaragamuwa,6938,3077,10015,277520,123080,400600
12/16/2024,Sanduni Pathirana,Kegalle,Galigamuwa,Sabaragamuwa,9085,8593,17678,363400,343720,707120
12/17/2024,Sanduni Pathirana,Kegalle,Galigamuwa,Sabaragamuwa,131,9154,9285,5240,366160,371400
12/18/2024,Sanduni Pathirana,Kegalle,Galigamuwa,Sabaragamuwa,2268,1323,3591,90720,52920,143640
12/19/2024,Sanduni Pathirana,Kegalle,Galigamuwa,Sabaragamuwa,2520,2967,5487,100800,118680,219480
12/20/2024,Sanduni Pathirana,Kegalle,Galigamuwa,Sabaragamuwa,8793,3618,12411,351720,144720,496440
12/21/2024,Sanduni Pathirana,Kegalle,Galigamuwa,Sabaragamuwa,5249,1671,6920,209960,66840,276800
12/22/2024,Sanduni Pathirana,Kegalle,Galigamuwa,Sabaragamuwa,1868,2771,4639,74720,110840,185560
12/23/2024,Sanduni Pathirana,Kegalle,Galigamuwa,Sabaragamuwa,2160,3982,6142,86400,159280,245680
12/24/2024,Sanduni Pathirana,Kegalle,Galigamuwa,Sabaragamuwa,5483,2873,8356,219320,114920,334240
12/25/2024,Sanduni Pathirana,Kegalle,Galigamuwa,Sabaragamuwa,6401,1918,8319,256040,76720,332760
12/26/2024,Sanduni Pathirana,Kegalle,Galigamuwa,Sabaragamuwa,6332,3864,10196,253280,154560,407840
12/27/2024,Sanduni Pathirana,Kegalle,Galigamuwa,Sabaragamuwa,3787,7746,11533,151480,309840,461320
12/28/2024,Sanduni Pathirana,Kegalle,Galigamuwa,Sabaragamuwa,889,4486,5375,35560,179440,215000
12/29/2024,Sanduni Pathirana,Kegalle,Galigamuwa,Sabaragamuwa,2913,5370,8283,116520,214800,331320
12/30/2024,Sanduni Pathirana,Kegalle,Galigamuwa,Sabaragamuwa,6536,6028,12564,261440,241120,502560
12/31/2024,Sanduni Pathirana,Kegalle,Galigamuwa,Sabaragamuwa,6232,5725,11957,249280,229000,478280
1/1/2025,Sanduni Pathirana,Kegalle,Galigamuwa,Sabaragamuwa,1330,7237,8567,53200,289480,342680
1/2/2025,Sanduni Pathirana,Kegalle,Galigamuwa,Sabaragamuwa,4572,1670,6242,182880,66800,249680
1/3/2025,Sanduni Pathirana,Kegalle,Galigamuwa,Sabaragamuwa,9867,9000,18867,394680,360000,754680
1/4/2025,Sanduni Pathirana,Kegalle,Galigamuwa,Sabaragamuwa,9407,5714,15121,376280,228560,604840
1/5/2025,Sanduni Pathirana,Kegalle,Galigamuwa,Sabaragamuwa,8056,3894,11950,322240,155760,478000
1/6/2025,Sanduni Pathirana,Kegalle,Galigamuwa,Sabaragamuwa,8286,3121,11407,331440,124840,456280
1/7/2025,Sanduni Pathirana,Kegalle,Galigamuwa,Sabaragamuwa,2386,9881,12267,95440,395240,490680
1/8/2025,Sanduni Pathirana,Kegalle,Galigamuwa,Sabaragamuwa,1488,5017,6505,59520,200680,260200
1/9/2025,Sanduni Pathirana,Kegalle,Galigamuwa,Sabaragamuwa,1784,4135,5919,71360,165400,236760
1/10/2025,Sanduni Pathirana,Kegalle,Galigamuwa,Sabaragamuwa,4638,2334,6972,185520,93360,278880
1/11/2025,Sanduni Pathirana,Kegalle,Galigamuwa,Sabaragamuwa,5362,2586,7948,214480,103440,317920
1/12/2025,Sanduni Pathirana,Kegalle,Galigamuwa,Sabaragamuwa,9871,2410,12281,394840,96400,491240
1/13/2025,Sanduni Pathirana,Kegalle,Galigamuwa,Sabaragamuwa,5585,4332,9917,223400,173280,396680
1/14/2025,Sanduni Pathirana,Kegalle,Galigamuwa,Sabaragamuwa,7573,1334,8907,302920,53360,356280
1/15/2025,Sanduni Pathirana,Kegalle,Galigamuwa,Sabaragamuwa,6635,1545,8180,265400,61800,327200
1/16/2025,Sanduni Pathirana,Kegalle,Galigamuwa,Sabaragamuwa,642,9040,9682,25680,361600,387280
1/17/2025,Sanduni Pathirana,Kegalle,Galigamuwa,Sabaragamuwa,8591,7557,16148,343640,302280,645920
1/18/2025,Sanduni Pathirana,Kegalle,Galigamuwa,Sabaragamuwa,3436,11,3447,137440,440,137880
1/19/2025,Sanduni Pathirana,Kegalle,Galigamuwa,Sabaragamuwa,5992,7389,13381,239680,295560,535240
1/20/2025,Sanduni Pathirana,Kegalle,Galigamuwa,Sabaragamuwa,1640,8509,10149,65600,340360,405960
1/21/2025,Sanduni Pathirana,Kegalle,Galigamuwa,Sabaragamuwa,4159,8137,12296,166360,325480,491840
1/22/2025,Sanduni Pathirana,Kegalle,Galigamuwa,Sabaragamuwa,4419,6031,10450,176760,241240,418000
1/23/2025,Sanduni Pathirana,Kegalle,Galigamuwa,Sabaragamuwa,4891,9002,13893,195640,360080,555720
1/24/2025,Sanduni Pathirana,Kegalle,Galigamuwa,Sabaragamuwa,6941,5487,12428,277640,219480,497120
1/25/2025,Sanduni Pathirana,Kegalle,Galigamuwa,Sabaragamuwa,7503,8491,15994,300120,339640,639760
1/26/2025,Sanduni Pathirana,Kegalle,Galigamuwa,Sabaragamuwa,7775,2749,10524,311000,109960,420960
1/27/2025,Sanduni Pathirana,Kegalle,Galigamuwa,Sabaragamuwa,681,579,1260,27240,23160,50400
1/28/2025,Sanduni Pathirana,Kegalle,Galigamuwa,Sabaragamuwa,9636,2272,11908,385440,90880,476320
1/29/2025,Sanduni Pathirana,Kegalle,Galigamuwa,Sabaragamuwa,4376,368,4744,175040,14720,189760
1/30/2025,Sanduni Pathirana,Kegalle,Galigamuwa,Sabaragamuwa,8312,2406,10718,332480,96240,428720
1/31/2025,Sanduni Pathirana,Kegalle,Galigamuwa,Sabaragamuwa,8381,3336,11717,335240,133440,468680
2/1/2025,Sanduni Pathirana,Kegalle,Galigamuwa,Sabaragamuwa,7540,6117,13657,301600,244680,546280
2/2/2025,Sanduni Pathirana,Kegalle,Galigamuwa,Sabaragamuwa,1769,3348,5117,70760,133920,204680
2/3/2025,Sanduni Pathirana,Kegalle,Galigamuwa,Sabaragamuwa,5408,2330,7738,216320,93200,309520
2/4/2025,Sanduni Pathirana,Kegalle,Galigamuwa,Sabaragamuwa,2760,5594,8354,110400,223760,334160
2/5/2025,Sanduni Pathirana,Kegalle,Galigamuwa,Sabaragamuwa,9989,1516,11505,399560,60640,460200
2/6/2025,Sanduni Pathirana,Kegalle,Galigamuwa,Sabaragamuwa,1255,7390,8645,50200,295600,345800
2/7/2025,Sanduni Pathirana,Kegalle,Galigamuwa,Sabaragamuwa,1610,7603,9213,64400,304120,368520
2/8/2025,Sanduni Pathirana,Kegalle,Galigamuwa,Sabaragamuwa,4262,2868,7130,170480,114720,285200
2/9/2025,Sanduni Pathirana,Kegalle,Galigamuwa,Sabaragamuwa,3503,4581,8084,140120,183240,323360
2/10/2025,Sanduni Pathirana,Kegalle,Galigamuwa,Sabaragamuwa,9019,5250,14269,360760,210000,570760
2/11/2025,Sanduni Pathirana,Kegalle,Galigamuwa,Sabaragamuwa,5900,752,6652,236000,30080,266080
2/12/2025,Sanduni Pathirana,Kegalle,Galigamuwa,Sabaragamuwa,5408,4774,10182,216320,190960,407280
2/13/2025,Sanduni Pathirana,Kegalle,Galigamuwa,Sabaragamuwa,9164,4107,13271,366560,164280,530840
2/14/2025,Sanduni Pathirana,Kegalle,Galigamuwa,Sabaragamuwa,7384,4990,12374,295360,199600,494960
2/15/2025,Sanduni Pathirana,Kegalle,Galigamuwa,Sabaragamuwa,1874,4807,6681,74960,192280,267240
2/16/2025,Sanduni Pathirana,Kegalle,Galigamuwa,Sabaragamuwa,5273,9109,14382,210920,364360,575280
2/17/2025,Sanduni Pathirana,Kegalle,Galigamuwa,Sabaragamuwa,5145,2237,7382,205800,89480,295280
2/18/2025,Sanduni Pathirana,Kegalle,Galigamuwa,Sabaragamuwa,550,9691,10241,22000,387640,409640
2/19/2025,Sanduni Pathirana,Kegalle,Galigamuwa,Sabaragamuwa,6081,2492,8573,243240,99680,342920
2/20/2025,Sanduni Pathirana,Kegalle,Galigamuwa,Sabaragamuwa,4582,7382,11964,183280,295280,478560
2/21/2025,Sanduni Pathirana,Kegalle,Galigamuwa,Sabaragamuwa,4507,941,5448,180280,37640,217920
2/22/2025,Sanduni Pathirana,Kegalle,Galigamuwa,Sabaragamuwa,7879,5110,12989,315160,204400,519560
2/23/2025,Sanduni Pathirana,Kegalle,Galigamuwa,Sabaragamuwa,494,868,1362,19760,34720,54480
2/24/2025,Sanduni Pathirana,Kegalle,Galigamuwa,Sabaragamuwa,2639,2117,4756,105560,84680,190240
2/25/2025,Sanduni Pathirana,Kegalle,Galigamuwa,Sabaragamuwa,6734,452,7186,269360,18080,287440
2/26/2025,Sanduni Pathirana,Kegalle,Galigamuwa,Sabaragamuwa,3032,9966,12998,121280,398640,519920
2/27/2025,Sanduni Pathirana,Kegalle,Galigamuwa,Sabaragamuwa,2665,4285,6950,106600,171400,278000
2/28/2025,Sanduni Pathirana,Kegalle,Galigamuwa,Sabaragamuwa,7449,2687,10136,297960,107480,405440
3/1/2025,Sanduni Pathirana,Kegalle,Galigamuwa,Sabaragamuwa,1527,2508,4035,61080,100320,161400
3/2/2025,Sanduni Pathirana,Kegalle,Galigamuwa,Sabaragamuwa,7252,367,7619,290080,14680,304760
3/3/2025,Sanduni Pathirana,Kegalle,Galigamuwa,Sabaragamuwa,234,2380,2614,9360,95200,104560
3/4/2025,Sanduni Pathirana,Kegalle,Galigamuwa,Sabaragamuwa,9222,2559,11781,368880,102360,471240
3/5/2025,Sanduni Pathirana,Kegalle,Galigamuwa,Sabaragamuwa,1195,2526,3721,47800,101040,148840
3/6/2025,Sanduni Pathirana,Kegalle,Galigamuwa,Sabaragamuwa,6978,5799,12777,279120,231960,511080
3/7/2025,Sanduni Pathirana,Kegalle,Galigamuwa,Sabaragamuwa,2053,3521,5574,82120,140840,222960
3/8/2025,Sanduni Pathirana,Kegalle,Galigamuwa,Sabaragamuwa,5734,8013,13747,229360,320520,549880
3/9/2025,Sanduni Pathirana,Kegalle,Galigamuwa,Sabaragamuwa,7855,5074,12929,314200,202960,517160
3/10/2025,Sanduni Pathirana,Kegalle,Galigamuwa,Sabaragamuwa,7143,9717,16860,285720,388680,674400
3/11/2025,Sanduni Pathirana,Kegalle,Galigamuwa,Sabaragamuwa,3781,5771,9552,151240,230840,382080
3/12/2025,Sanduni Pathirana,Kegalle,Galigamuwa,Sabaragamuwa,3106,8360,11466,124240,334400,458640
3/13/2025,Sanduni Pathirana,Kegalle,Galigamuwa,Sabaragamuwa,6037,6950,12987,241480,278000,519480
3/14/2025,Sanduni Pathirana,Kegalle,Galigamuwa,Sabaragamuwa,4586,7696,12282,183440,307840,491280
3/15/2025,Sanduni Pathirana,Kegalle,Galigamuwa,Sabaragamuwa,1525,5886,7411,61000,235440,296440
3/16/2025,Sanduni Pathirana,Kegalle,Galigamuwa,Sabaragamuwa,1538,9362,10900,61520,374480,436000
3/17/2025,Sanduni Pathirana,Kegalle,Galigamuwa,Sabaragamuwa,1156,6782,7938,46240,271280,317520
3/18/2025,Sanduni Pathirana,Kegalle,Galigamuwa,Sabaragamuwa,5029,5195,10224,201160,207800,408960
3/19/2025,Sanduni Pathirana,Kegalle,Galigamuwa,Sabaragamuwa,9300,8512,17812,372000,340480,712480
3/20/2025,Sanduni Pathirana,Kegalle,Galigamuwa,Sabaragamuwa,6068,5325,11393,242720,213000,455720
3/21/2025,Sanduni Pathirana,Kegalle,Galigamuwa,Sabaragamuwa,2112,3336,5448,84480,133440,217920
3/22/2025,Sanduni Pathirana,Kegalle,Galigamuwa,Sabaragamuwa,1499,8523,10022,59960,340920,400880
3/23/2025,Sanduni Pathirana,Kegalle,Galigamuwa,Sabaragamuwa,4799,9921,14720,191960,396840,588800
3/25/2024,Ruvini Seneviratne,Hambantota,Ruhunupura,Southern,9126,4498,13624,365040,179920,544960
3/26/2024,Ruvini Seneviratne,Hambantota,Ruhunupura,Southern,5469,5452,10921,218760,218080,436840
3/27/2024,Ruvini Seneviratne,Hambantota,Ruhunupura,Southern,9421,4552,13973,376840,182080,558920
3/28/2024,Ruvini Seneviratne,Hambantota,Ruhunupura,Southern,4107,610,4717,164280,24400,188680
3/29/2024,Ruvini Seneviratne,Hambantota,Ruhunupura,Southern,176,1386,1562,7040,55440,62480
3/30/2024,Ruvini Seneviratne,Hambantota,Ruhunupura,Southern,6775,9927,16702,271000,397080,668080
3/31/2024,Ruvini Seneviratne,Hambantota,Ruhunupura,Southern,8220,7540,15760,328800,301600,630400
4/1/2024,Ruvini Seneviratne,Hambantota,Ruhunupura,Southern,2629,1558,4187,105160,62320,167480
4/2/2024,Ruvini Seneviratne,Hambantota,Ruhunupura,Southern,1331,7336,8667,53240,293440,346680
4/3/2024,Ruvini Seneviratne,Hambantota,Ruhunupura,Southern,6541,5430,11971,261640,217200,478840
4/4/2024,Ruvini Seneviratne,Hambantota,Ruhunupura,Southern,9877,2124,12001,395080,84960,480040
4/5/2024,Ruvini Seneviratne,Hambantota,Ruhunupura,Southern,9575,7241,16816,383000,289640,672640
4/6/2024,Ruvini Seneviratne,Hambantota,Ruhunupura,Southern,2434,3998,6432,97360,159920,257280
4/7/2024,Ruvini Seneviratne,Hambantota,Ruhunupura,Southern,2442,6629,9071,97680,265160,362840
4/8/2024,Ruvini Seneviratne,Hambantota,Ruhunupura,Southern,5058,4138,9196,202320,165520,367840
4/9/2024,Ruvini Seneviratne,Hambantota,Ruhunupura,Southern,4431,4473,8904,177240,178920,356160
4/10/2024,Ruvini Seneviratne,Hambantota,Ruhunupura,Southern,2699,6639,9338,107960,265560,373520
4/11/2024,Ruvini Seneviratne,Hambantota,Ruhunupura,Southern,652,1670,2322,26080,66800,92880
4/19/2024,Ruvini Seneviratne,Hambantota,Ruhunupura,Southern,3094,3527,6621,123760,141080,264840
4/20/2024,Ruvini Seneviratne,Hambantota,Ruhunupura,Southern,7445,2516,9961,297800,100640,398440
4/21/2024,Ruvini Seneviratne,Hambantota,Ruhunupura,Southern,2498,1127,3625,99920,45080,145000
4/22/2024,Ruvini Seneviratne,Hambantota,Ruhunupura,Southern,8854,3187,12041,354160,127480,481640
4/23/2024,Ruvini Seneviratne,Hambantota,Ruhunupura,Southern,9340,6517,15857,373600,260680,634280
4/24/2024,Ruvini Seneviratne,Hambantota,Ruhunupura,Southern,9951,2191,12142,398040,87640,485680
4/25/2024,Ruvini Seneviratne,Hambantota,Ruhunupura,Southern,8254,4871,13125,330160,194840,525000
4/26/2024,Ruvini Seneviratne,Hambantota,Ruhunupura,Southern,3636,2712,6348,145440,108480,253920
4/27/2024,Ruvini Seneviratne,Hambantota,Ruhunupura,Southern,1397,538,1935,55880,21520,77400
4/28/2024,Ruvini Seneviratne,Hambantota,Ruhunupura,Southern,2239,3154,5393,89560,126160,215720
4/29/2024,Ruvini Seneviratne,Hambantota,Ruhunupura,Southern,608,2543,3151,24320,101720,126040
4/30/2024,Ruvini Seneviratne,Hambantota,Ruhunupura,Southern,5972,5033,11005,238880,201320,440200
5/1/2024,Ruvini Seneviratne,Hambantota,Ruhunupura,Southern,8201,8536,16737,328040,341440,669480
5/2/2024,Ruvini Seneviratne,Hambantota,Ruhunupura,Southern,5560,1875,7435,222400,75000,297400
5/3/2024,Ruvini Seneviratne,Hambantota,Ruhunupura,Southern,2921,3696,6617,116840,147840,264680
5/4/2024,Ruvini Seneviratne,Hambantota,Ruhunupura,Southern,1198,9576,10774,47920,383040,430960
5/5/2024,Ruvini Seneviratne,Hambantota,Ruhunupura,Southern,2071,6288,8359,82840,251520,334360
5/6/2024,Ruvini Seneviratne,Hambantota,Ruhunupura,Southern,4910,3197,8107,196400,127880,324280
5/7/2024,Ruvini Seneviratne,Hambantota,Ruhunupura,Southern,6689,774,7463,267560,30960,298520
5/8/2024,Ruvini Seneviratne,Hambantota,Ruhunupura,Southern,3984,9994,13978,159360,399760,559120
5/9/2024,Ruvini Seneviratne,Hambantota,Ruhunupura,Southern,8211,2721,10932,328440,108840,437280
5/10/2024,Ruvini Seneviratne,Hambantota,Ruhunupura,Southern,5310,4930,10240,212400,197200,409600
5/11/2024,Ruvini Seneviratne,Hambantota,Ruhunupura,Southern,3430,8063,11493,137200,322520,459720
5/12/2024,Ruvini Seneviratne,Hambantota,Ruhunupura,Southern,7677,5693,13370,307080,227720,534800
5/13/2024,Ruvini Seneviratne,Hambantota,Ruhunupura,Southern,5590,1382,6972,223600,55280,278880
5/14/2024,Ruvini Seneviratne,Hambantota,Ruhunupura,Southern,1378,3062,4440,55120,122480,177600
5/15/2024,Ruvini Seneviratne,Hambantota,Ruhunupura,Southern,245,6035,6280,9800,241400,251200
5/16/2024,Ruvini Seneviratne,Hambantota,Ruhunupura,Southern,9952,6426,16378,398080,257040,655120
5/17/2024,Ruvini Seneviratne,Hambantota,Ruhunupura,Southern,6527,8366,14893,261080,334640,595720
5/18/2024,Ruvini Seneviratne,Hambantota,Ruhunupura,Southern,8501,6702,15203,340040,268080,608120
5/19/2024,Ruvini Seneviratne,Hambantota,Ruhunupura,Southern,1714,8426,10140,68560,337040,405600
5/20/2024,Ruvini Seneviratne,Hambantota,Ruhunupura,Southern,5690,5181,10871,227600,207240,434840
5/21/2024,Ruvini Seneviratne,Hambantota,Ruhunupura,Southern,5775,8221,13996,231000,328840,559840
5/22/2024,Ruvini Seneviratne,Hambantota,Ruhunupura,Southern,2855,8480,11335,114200,339200,453400
5/24/2024,Ruvini Seneviratne,Hambantota,Ruhunupura,Southern,3746,6720,10466,149840,268800,418640
5/25/2024,Ruvini Seneviratne,Hambantota,Ruhunupura,Southern,8546,3357,11903,341840,134280,476120
5/26/2024,Ruvini Seneviratne,Hambantota,Ruhunupura,Southern,5822,4378,10200,232880,175120,408000
5/27/2024,Ruvini Seneviratne,Hambantota,Ruhunupura,Southern,4244,632,4876,169760,25280,195040
5/28/2024,Ruvini Seneviratne,Hambantota,Ruhunupura,Southern,9402,2003,11405,376080,80120,456200
5/29/2024,Ruvini Seneviratne,Hambantota,Ruhunupura,Southern,770,6302,7072,30800,252080,282880
5/30/2024,Ruvini Seneviratne,Hambantota,Ruhunupura,Southern,4849,2599,7448,193960,103960,297920
5/31/2024,Ruvini Seneviratne,Hambantota,Ruhunupura,Southern,4859,1684,6543,194360,67360,261720
6/1/2024,Ruvini Seneviratne,Hambantota,Ruhunupura,Southern,6546,5705,12251,261840,228200,490040
6/2/2024,Ruvini Seneviratne,Hambantota,Ruhunupura,Southern,8608,1128,9736,344320,45120,389440
6/3/2024,Ruvini Seneviratne,Hambantota,Ruhunupura,Southern,7541,4959,12500,301640,198360,500000
6/4/2024,Ruvini Seneviratne,Hambantota,Ruhunupura,Southern,7733,3821,11554,309320,152840,462160
6/5/2024,Ruvini Seneviratne,Hambantota,Ruhunupura,Southern,3403,9043,12446,136120,361720,497840
6/6/2024,Ruvini Seneviratne,Hambantota,Ruhunupura,Southern,2988,1832,4820,119520,73280,192800
6/7/2024,Ruvini Seneviratne,Hambantota,Ruhunupura,Southern,7357,8519,15876,294280,340760,635040
6/8/2024,Ruvini Seneviratne,Hambantota,Ruhunupura,Southern,7494,7040,14534,299760,281600,581360
6/9/2024,Ruvini Seneviratne,Hambantota,Ruhunupura,Southern,9760,8523,18283,390400,340920,731320
6/10/2024,Ruvini Seneviratne,Hambantota,Ruhunupura,Southern,4107,4706,8813,164280,188240,352520
6/11/2024,Ruvini Seneviratne,Hambantota,Ruhunupura,Southern,9123,6671,15794,364920,266840,631760
6/12/2024,Ruvini Seneviratne,Hambantota,Ruhunupura,Southern,700,3429,4129,28000,137160,165160
6/13/2024,Ruvini Seneviratne,Hambantota,Ruhunupura,Southern,3155,2370,5525,126200,94800,221000
6/14/2024,Ruvini Seneviratne,Hambantota,Ruhunupura,Southern,522,8840,9362,20880,353600,374480
6/15/2024,Ruvini Seneviratne,Hambantota,Ruhunupura,Southern,216,8447,8663,8640,337880,346520
6/16/2024,Ruvini Seneviratne,Hambantota,Ruhunupura,Southern,2108,6714,8822,84320,268560,352880
6/17/2024,Ruvini Seneviratne,Hambantota,Ruhunupura,Southern,5913,2683,8596,236520,107320,343840
6/18/2024,Ruvini Seneviratne,Hambantota,Ruhunupura,Southern,231,6792,7023,9240,271680,280920
6/19/2024,Ruvini Seneviratne,Hambantota,Ruhunupura,Southern,8073,717,8790,322920,28680,351600
6/20/2024,Ruvini Seneviratne,Hambantota,Ruhunupura,Southern,1946,8606,10552,77840,344240,422080
6/21/2024,Ruvini Seneviratne,Hambantota,Ruhunupura,Southern,4963,5605,10568,198520,224200,422720
6/22/2024,Ruvini Seneviratne,Hambantota,Ruhunupura,Southern,8921,4776,13697,356840,191040,547880
6/23/2024,Ruvini Seneviratne,Hambantota,Ruhunupura,Southern,9552,3353,12905,382080,134120,516200
6/24/2024,Ruvini Seneviratne,Hambantota,Ruhunupura,Southern,6149,4308,10457,245960,172320,418280
6/25/2024,Ruvini Seneviratne,Hambantota,Ruhunupura,Southern,8945,2919,11864,357800,116760,474560
6/26/2024,Ruvini Seneviratne,Hambantota,Ruhunupura,Southern,2555,4317,6872,102200,172680,274880
6/27/2024,Ruvini Seneviratne,Hambantota,Ruhunupura,Southern,9204,7397,16601,368160,295880,664040
6/28/2024,Ruvini Seneviratne,Hambantota,Ruhunupura,Southern,2942,2131,5073,117680,85240,202920
6/29/2024,Ruvini Seneviratne,Hambantota,Ruhunupura,Southern,407,9158,9565,16280,366320,382600
6/30/2024,Ruvini Seneviratne,Hambantota,Ruhunupura,Southern,6292,9803,16095,251680,392120,643800
7/1/2024,Ruvini Seneviratne,Hambantota,Ruhunupura,Southern,307,1946,2253,12280,77840,90120
7/2/2024,Ruvini Seneviratne,Hambantota,Ruhunupura,Southern,5169,2426,7595,206760,97040,303800
7/3/2024,Ruvini Seneviratne,Hambantota,Ruhunupura,Southern,5735,6535,12270,229400,261400,490800
7/4/2024,Ruvini Seneviratne,Hambantota,Ruhunupura,Southern,4340,8287,12627,173600,331480,505080
7/5/2024,Ruvini Seneviratne,Hambantota,Ruhunupura,Southern,2518,5526,8044,100720,221040,321760
7/6/2024,Ruvini Seneviratne,Hambantota,Ruhunupura,Southern,7341,5608,12949,293640,224320,517960
7/7/2024,Ruvini Seneviratne,Hambantota,Ruhunupura,Southern,7738,2937,10675,309520,117480,427000
7/8/2024,Ruvini Seneviratne,Hambantota,Ruhunupura,Southern,4386,295,4681,175440,11800,187240
7/9/2024,Ruvini Seneviratne,Hambantota,Ruhunupura,Southern,4744,8531,13275,189760,341240,531000
7/10/2024,Ruvini Seneviratne,Hambantota,Ruhunupura,Southern,5774,6086,11860,230960,243440,474400
7/11/2024,Ruvini Seneviratne,Hambantota,Ruhunupura,Southern,5895,4057,9952,235800,162280,398080
7/12/2024,Ruvini Seneviratne,Hambantota,Ruhunupura,Southern,3779,7538,11317,151160,301520,452680
7/13/2024,Ruvini Seneviratne,Hambantota,Ruhunupura,Southern,5636,2522,8158,225440,100880,326320
7/14/2024,Ruvini Seneviratne,Hambantota,Ruhunupura,Southern,9055,3024,12079,362200,120960,483160
7/15/2024,Ruvini Seneviratne,Hambantota,Ruhunupura,Southern,195,5029,5224,7800,201160,208960
7/16/2024,Ruvini Seneviratne,Hambantota,Ruhunupura,Southern,8869,1918,10787,354760,76720,431480
7/17/2024,Ruvini Seneviratne,Hambantota,Ruhunupura,Southern,3511,2602,6113,140440,104080,244520
7/18/2024,Ruvini Seneviratne,Hambantota,Ruhunupura,Southern,6420,1660,8080,256800,66400,323200
7/19/2024,Ruvini Seneviratne,Hambantota,Ruhunupura,Southern,2275,3220,5495,91000,128800,219800
7/20/2024,Ruvini Seneviratne,Hambantota,Ruhunupura,Southern,7361,9959,17320,294440,398360,692800
7/21/2024,Ruvini Seneviratne,Hambantota,Ruhunupura,Southern,386,4354,4740,15440,174160,189600
7/22/2024,Ruvini Seneviratne,Hambantota,Ruhunupura,Southern,8802,2386,11188,352080,95440,447520
7/23/2024,Ruvini Seneviratne,Hambantota,Ruhunupura,Southern,3957,9947,13904,158280,397880,556160
7/24/2024,Ruvini Seneviratne,Hambantota,Ruhunupura,Southern,7926,3237,11163,317040,129480,446520
7/25/2024,Ruvini Seneviratne,Hambantota,Ruhunupura,Southern,7074,7414,14488,282960,296560,579520
7/26/2024,Ruvini Seneviratne,Hambantota,Ruhunupura,Southern,5579,6578,12157,223160,263120,486280
7/27/2024,Ruvini Seneviratne,Hambantota,Ruhunupura,Southern,149,3313,3462,5960,132520,138480
7/28/2024,Ruvini Seneviratne,Hambantota,Ruhunupura,Southern,6520,6795,13315,260800,271800,532600
7/29/2024,Ruvini Seneviratne,Hambantota,Ruhunupura,Southern,1664,8256,9920,66560,330240,396800
7/30/2024,Ruvini Seneviratne,Hambantota,Ruhunupura,Southern,5102,9467,14569,204080,378680,582760
7/31/2024,Ruvini Seneviratne,Hambantota,Ruhunupura,Southern,1280,1915,3195,51200,76600,127800
8/1/2024,Ruvini Seneviratne,Hambantota,Ruhunupura,Southern,5671,6123,11794,226840,244920,471760
8/2/2024,Ruvini Seneviratne,Hambantota,Ruhunupura,Southern,3021,7925,10946,120840,317000,437840
8/3/2024,Ruvini Seneviratne,Hambantota,Ruhunupura,Southern,6951,615,7566,278040,24600,302640
8/4/2024,Ruvini Seneviratne,Hambantota,Ruhunupura,Southern,1916,734,2650,76640,29360,106000
8/5/2024,Ruvini Seneviratne,Hambantota,Ruhunupura,Southern,2298,59,2357,91920,2360,94280
8/6/2024,Ruvini Seneviratne,Hambantota,Ruhunupura,Southern,8271,7399,15670,330840,295960,626800
8/7/2024,Ruvini Seneviratne,Hambantota,Ruhunupura,Southern,7095,8273,15368,283800,330920,614720
8/8/2024,Ruvini Seneviratne,Hambantota,Ruhunupura,Southern,4546,9118,13664,181840,364720,546560
8/9/2024,Ruvini Seneviratne,Hambantota,Ruhunupura,Southern,9181,808,9989,367240,32320,399560
8/10/2024,Ruvini Seneviratne,Hambantota,Ruhunupura,Southern,4478,7596,12074,179120,303840,482960
8/11/2024,Ruvini Seneviratne,Hambantota,Ruhunupura,Southern,2883,5476,8359,115320,219040,334360
8/12/2024,Ruvini Seneviratne,Hambantota,Ruhunupura,Southern,9321,9143,18464,372840,365720,738560
8/13/2024,Ruvini Seneviratne,Hambantota,Ruhunupura,Southern,6591,5058,11649,263640,202320,465960
8/14/2024,Ruvini Seneviratne,Hambantota,Ruhunupura,Southern,9255,7010,16265,370200,280400,650600
8/15/2024,Ruvini Seneviratne,Hambantota,Ruhunupura,Southern,4096,7279,11375,163840,291160,455000
8/16/2024,Ruvini Seneviratne,Hambantota,Ruhunupura,Southern,3184,5568,8752,127360,222720,350080
8/17/2024,Ruvini Seneviratne,Hambantota,Ruhunupura,Southern,2412,1155,3567,96480,46200,142680
8/18/2024,Ruvini Seneviratne,Hambantota,Ruhunupura,Southern,5539,798,6337,221560,31920,253480
8/19/2024,Ruvini Seneviratne,Hambantota,Ruhunupura,Southern,1490,384,1874,59600,15360,74960
8/20/2024,Ruvini Seneviratne,Hambantota,Ruhunupura,Southern,4401,2231,6632,176040,89240,265280
8/21/2024,Ruvini Seneviratne,Hambantota,Ruhunupura,Southern,7869,5627,13496,314760,225080,539840
8/22/2024,Ruvini Seneviratne,Hambantota,Ruhunupura,Southern,7222,924,8146,288880,36960,325840
8/23/2024,Ruvini Seneviratne,Hambantota,Ruhunupura,Southern,5006,6579,11585,200240,263160,463400
8/24/2024,Ruvini Seneviratne,Hambantota,Ruhunupura,Southern,1663,4734,6397,66520,189360,255880
8/25/2024,Ruvini Seneviratne,Hambantota,Ruhunupura,Southern,6416,3548,9964,256640,141920,398560
8/26/2024,Ruvini Seneviratne,Hambantota,Ruhunupura,Southern,4012,1412,5424,160480,56480,216960
8/27/2024,Ruvini Seneviratne,Hambantota,Ruhunupura,Southern,6767,3895,10662,270680,155800,426480
8/28/2024,Ruvini Seneviratne,Hambantota,Ruhunupura,Southern,4163,3735,7898,166520,149400,315920
8/29/2024,Ruvini Seneviratne,Hambantota,Ruhunupura,Southern,3105,5365,8470,124200,214600,338800
8/30/2024,Ruvini Seneviratne,Hambantota,Ruhunupura,Southern,4084,5013,9097,163360,200520,363880
8/31/2024,Ruvini Seneviratne,Hambantota,Ruhunupura,Southern,10000,2389,12389,400000,95560,495560
9/1/2024,Ruvini Seneviratne,Hambantota,Ruhunupura,Southern,255,7022,7277,10200,280880,291080
9/2/2024,Ruvini Seneviratne,Hambantota,Ruhunupura,Southern,4850,5519,10369,194000,220760,414760
9/3/2024,Ruvini Seneviratne,Hambantota,Ruhunupura,Southern,495,4286,4781,19800,171440,191240
9/4/2024,Ruvini Seneviratne,Hambantota,Ruhunupura,Southern,1560,2555,4115,62400,102200,164600
9/5/2024,Ruvini Seneviratne,Hambantota,Ruhunupura,Southern,5282,7048,12330,211280,281920,493200
9/6/2024,Ruvini Seneviratne,Hambantota,Ruhunupura,Southern,195,2487,2682,7800,99480,107280
9/7/2024,Ruvini Seneviratne,Hambantota,Ruhunupura,Southern,7399,7518,14917,295960,300720,596680
9/8/2024,Ruvini Seneviratne,Hambantota,Ruhunupura,Southern,1359,4242,5601,54360,169680,224040
9/9/2024,Ruvini Seneviratne,Hambantota,Ruhunupura,Southern,1522,2704,4226,60880,108160,169040
9/10/2024,Ruvini Seneviratne,Hambantota,Ruhunupura,Southern,7723,7669,15392,308920,306760,615680
9/11/2024,Ruvini Seneviratne,Hambantota,Ruhunupura,Southern,7296,1292,8588,291840,51680,343520
9/12/2024,Ruvini Seneviratne,Hambantota,Ruhunupura,Southern,8724,2563,11287,348960,102520,451480
9/13/2024,Ruvini Seneviratne,Hambantota,Ruhunupura,Southern,1891,6228,8119,75640,249120,324760
9/14/2024,Ruvini Seneviratne,Hambantota,Ruhunupura,Southern,8578,6657,15235,343120,266280,609400
9/15/2024,Ruvini Seneviratne,Hambantota,Ruhunupura,Southern,1913,168,2081,76520,6720,83240
9/16/2024,Ruvini Seneviratne,Hambantota,Ruhunupura,Southern,8728,3904,12632,349120,156160,505280
9/17/2024,Ruvini Seneviratne,Hambantota,Ruhunupura,Southern,2250,1393,3643,90000,55720,145720
9/18/2024,Ruvini Seneviratne,Hambantota,Ruhunupura,Southern,1310,1098,2408,52400,43920,96320
9/19/2024,Ruvini Seneviratne,Hambantota,Ruhunupura,Southern,2352,8842,11194,94080,353680,447760
9/20/2024,Ruvini Seneviratne,Hambantota,Ruhunupura,Southern,5887,3606,9493,235480,144240,379720
9/21/2024,Ruvini Seneviratne,Hambantota,Ruhunupura,Southern,7976,6105,14081,319040,244200,563240
9/22/2024,Ruvini Seneviratne,Hambantota,Ruhunupura,Southern,4010,7898,11908,160400,315920,476320
9/23/2024,Ruvini Seneviratne,Hambantota,Ruhunupura,Southern,3134,5001,8135,125360,200040,325400
9/24/2024,Ruvini Seneviratne,Hambantota,Ruhunupura,Southern,6887,4396,11283,275480,175840,451320
9/25/2024,Ruvini Seneviratne,Hambantota,Ruhunupura,Southern,5822,1479,7301,232880,59160,292040
9/26/2024,Ruvini Seneviratne,Hambantota,Ruhunupura,Southern,2433,9943,12376,97320,397720,495040
9/27/2024,Ruvini Seneviratne,Hambantota,Ruhunupura,Southern,2898,8212,11110,115920,328480,444400
9/28/2024,Ruvini Seneviratne,Hambantota,Ruhunupura,Southern,3810,2277,6087,152400,91080,243480
9/29/2024,Ruvini Seneviratne,Hambantota,Ruhunupura,Southern,2671,8022,10693,106840,320880,427720
9/30/2024,Ruvini Seneviratne,Hambantota,Ruhunupura,Southern,6581,2140,8721,263240,85600,348840
10/1/2024,Ruvini Seneviratne,Hambantota,Ruhunupura,Southern,7576,4233,11809,303040,169320,472360
10/2/2024,Ruvini Seneviratne,Hambantota,Ruhunupura,Southern,5447,9599,15046,217880,383960,601840
10/3/2024,Ruvini Seneviratne,Hambantota,Ruhunupura,Southern,1810,6939,8749,72400,277560,349960
10/4/2024,Ruvini Seneviratne,Hambantota,Ruhunupura,Southern,552,4236,4788,22080,169440,191520
10/5/2024,Ruvini Seneviratne,Hambantota,Ruhunupura,Southern,1974,8815,10789,78960,352600,431560
10/6/2024,Ruvini Seneviratne,Hambantota,Ruhunupura,Southern,8835,6317,15152,353400,252680,606080
10/7/2024,Ruvini Seneviratne,Hambantota,Ruhunupura,Southern,1376,6619,7995,55040,264760,319800
10/8/2024,Ruvini Seneviratne,Hambantota,Ruhunupura,Southern,4624,3858,8482,184960,154320,339280
10/9/2024,Ruvini Seneviratne,Hambantota,Ruhunupura,Southern,1518,8845,10363,60720,353800,414520
10/10/2024,Ruvini Seneviratne,Hambantota,Ruhunupura,Southern,7896,5849,13745,315840,233960,549800
10/11/2024,Ruvini Seneviratne,Hambantota,Ruhunupura,Southern,6328,1489,7817,253120,59560,312680
10/12/2024,Ruvini Seneviratne,Hambantota,Ruhunupura,Southern,2291,1687,3978,91640,67480,159120
10/13/2024,Ruvini Seneviratne,Hambantota,Ruhunupura,Southern,6857,4046,10903,274280,161840,436120
10/14/2024,Ruvini Seneviratne,Hambantota,Ruhunupura,Southern,7537,4916,12453,301480,196640,498120
10/15/2024,Ruvini Seneviratne,Hambantota,Ruhunupura,Southern,3746,5127,8873,149840,205080,354920
10/16/2024,Ruvini Seneviratne,Hambantota,Ruhunupura,Southern,8896,9219,18115,355840,368760,724600
10/17/2024,Ruvini Seneviratne,Hambantota,Ruhunupura,Southern,3831,8721,12552,153240,348840,502080
10/18/2024,Ruvini Seneviratne,Hambantota,Ruhunupura,Southern,3798,121,3919,151920,4840,156760
10/19/2024,Ruvini Seneviratne,Hambantota,Ruhunupura,Southern,3927,6007,9934,157080,240280,397360
10/20/2024,Ruvini Seneviratne,Hambantota,Ruhunupura,Southern,8100,8076,16176,324000,323040,647040
10/21/2024,Ruvini Seneviratne,Hambantota,Ruhunupura,Southern,3686,6659,10345,147440,266360,413800
10/22/2024,Ruvini Seneviratne,Hambantota,Ruhunupura,Southern,1814,9838,11652,72560,393520,466080
10/23/2024,Ruvini Seneviratne,Hambantota,Ruhunupura,Southern,799,7684,8483,31960,307360,339320
10/24/2024,Ruvini Seneviratne,Hambantota,Ruhunupura,Southern,6989,9637,16626,279560,385480,665040
10/25/2024,Ruvini Seneviratne,Hambantota,Ruhunupura,Southern,3446,9533,12979,137840,381320,519160
10/26/2024,Ruvini Seneviratne,Hambantota,Ruhunupura,Southern,1168,5646,6814,46720,225840,272560
10/27/2024,Ruvini Seneviratne,Hambantota,Ruhunupura,Southern,3437,7027,10464,137480,281080,418560
10/28/2024,Ruvini Seneviratne,Hambantota,Ruhunupura,Southern,2939,137,3076,117560,5480,123040
10/29/2024,Ruvini Seneviratne,Hambantota,Ruhunupura,Southern,4175,4004,8179,167000,160160,327160
10/30/2024,Ruvini Seneviratne,Hambantota,Ruhunupura,Southern,2311,5840,8151,92440,233600,326040
10/31/2024,Ruvini Seneviratne,Hambantota,Ruhunupura,Southern,4148,1184,5332,165920,47360,213280
11/1/2024,Ruvini Seneviratne,Hambantota,Ruhunupura,Southern,28,2292,2320,1120,91680,92800
11/2/2024,Ruvini Seneviratne,Hambantota,Ruhunupura,Southern,5561,1792,7353,222440,71680,294120
11/3/2024,Ruvini Seneviratne,Hambantota,Ruhunupura,Southern,4318,8705,13023,172720,348200,520920
11/4/2024,Ruvini Seneviratne,Hambantota,Ruhunupura,Southern,6866,4812,11678,274640,192480,467120
11/5/2024,Ruvini Seneviratne,Hambantota,Ruhunupura,Southern,8006,3639,11645,320240,145560,465800
11/6/2024,Ruvini Seneviratne,Hambantota,Ruhunupura,Southern,8808,2992,11800,352320,119680,472000
11/7/2024,Ruvini Seneviratne,Hambantota,Ruhunupura,Southern,3961,1610,5571,158440,64400,222840
11/8/2024,Ruvini Seneviratne,Hambantota,Ruhunupura,Southern,2732,277,3009,109280,11080,120360
11/9/2024,Ruvini Seneviratne,Hambantota,Ruhunupura,Southern,7952,4921,12873,318080,196840,514920
11/10/2024,Ruvini Seneviratne,Hambantota,Ruhunupura,Southern,4879,6630,11509,195160,265200,460360
11/11/2024,Ruvini Seneviratne,Hambantota,Ruhunupura,Southern,7018,6468,13486,280720,258720,539440
11/12/2024,Ruvini Seneviratne,Hambantota,Ruhunupura,Southern,3640,212,3852,145600,8480,154080
11/13/2024,Ruvini Seneviratne,Hambantota,Ruhunupura,Southern,6438,3248,9686,257520,129920,387440
11/14/2024,Ruvini Seneviratne,Hambantota,Ruhunupura,Southern,8421,8414,16835,336840,336560,673400
11/15/2024,Ruvini Seneviratne,Hambantota,Ruhunupura,Southern,2549,5794,8343,101960,231760,333720
11/16/2024,Ruvini Seneviratne,Hambantota,Ruhunupura,Southern,2214,503,2717,88560,20120,108680
11/17/2024,Ruvini Seneviratne,Hambantota,Ruhunupura,Southern,1109,3122,4231,44360,124880,169240
11/18/2024,Ruvini Seneviratne,Hambantota,Ruhunupura,Southern,6669,9169,15838,266760,366760,633520
11/19/2024,Ruvini Seneviratne,Hambantota,Ruhunupura,Southern,748,4403,5151,29920,176120,206040
11/20/2024,Ruvini Seneviratne,Hambantota,Ruhunupura,Southern,8208,6603,14811,328320,264120,592440
11/21/2024,Ruvini Seneviratne,Hambantota,Ruhunupura,Southern,2880,8998,11878,115200,359920,475120
11/22/2024,Ruvini Seneviratne,Hambantota,Ruhunupura,Southern,7153,1011,8164,286120,40440,326560
11/23/2024,Ruvini Seneviratne,Hambantota,Ruhunupura,Southern,8895,8252,17147,355800,330080,685880
11/24/2024,Ruvini Seneviratne,Hambantota,Ruhunupura,Southern,6084,7699,13783,243360,307960,551320
11/25/2024,Ruvini Seneviratne,Hambantota,Ruhunupura,Southern,3506,564,4070,140240,22560,162800
11/26/2024,Ruvini Seneviratne,Hambantota,Ruhunupura,Southern,7671,5669,13340,306840,226760,533600
11/27/2024,Ruvini Seneviratne,Hambantota,Ruhunupura,Southern,3754,4048,7802,150160,161920,312080
11/28/2024,Ruvini Seneviratne,Hambantota,Ruhunupura,Southern,4736,1744,6480,189440,69760,259200
11/29/2024,Ruvini Seneviratne,Hambantota,Ruhunupura,Southern,2897,1115,4012,115880,44600,160480
11/30/2024,Ruvini Seneviratne,Hambantota,Ruhunupura,Southern,4565,420,4985,182600,16800,199400
12/1/2024,Ruvini Seneviratne,Hambantota,Ruhunupura,Southern,5773,5116,10889,230920,204640,435560
12/2/2024,Ruvini Seneviratne,Hambantota,Ruhunupura,Southern,5317,7023,12340,212680,280920,493600
12/3/2024,Ruvini Seneviratne,Hambantota,Ruhunupura,Southern,318,7780,8098,12720,311200,323920
12/4/2024,Ruvini Seneviratne,Hambantota,Ruhunupura,Southern,8595,9165,17760,343800,366600,710400
12/5/2024,Ruvini Seneviratne,Hambantota,Ruhunupura,Southern,6238,8720,14958,249520,348800,598320
12/6/2024,Ruvini Seneviratne,Hambantota,Ruhunupura,Southern,1714,3113,4827,68560,124520,193080
12/7/2024,Ruvini Seneviratne,Hambantota,Ruhunupura,Southern,7550,7467,15017,302000,298680,600680
12/8/2024,Ruvini Seneviratne,Hambantota,Ruhunupura,Southern,4768,504,5272,190720,20160,210880
12/9/2024,Ruvini Seneviratne,Hambantota,Ruhunupura,Southern,1456,7071,8527,58240,282840,341080
12/10/2024,Ruvini Seneviratne,Hambantota,Ruhunupura,Southern,5663,9641,15304,226520,385640,612160
12/11/2024,Ruvini Seneviratne,Hambantota,Ruhunupura,Southern,6559,8615,15174,262360,344600,606960
12/12/2024,Ruvini Seneviratne,Hambantota,Ruhunupura,Southern,8047,9681,17728,321880,387240,709120
12/13/2024,Ruvini Seneviratne,Hambantota,Ruhunupura,Southern,2143,4455,6598,85720,178200,263920
12/14/2024,Ruvini Seneviratne,Hambantota,Ruhunupura,Southern,9037,2686,11723,361480,107440,468920
12/15/2024,Ruvini Seneviratne,Hambantota,Ruhunupura,Southern,8954,5497,14451,358160,219880,578040
12/16/2024,Ruvini Seneviratne,Hambantota,Ruhunupura,Southern,205,3088,3293,8200,123520,131720
12/17/2024,Ruvini Seneviratne,Hambantota,Ruhunupura,Southern,4777,6654,11431,191080,266160,457240
12/18/2024,Ruvini Seneviratne,Hambantota,Ruhunupura,Southern,2256,8797,11053,90240,351880,442120
12/19/2024,Ruvini Seneviratne,Hambantota,Ruhunupura,Southern,3353,2945,6298,134120,117800,251920
12/20/2024,Ruvini Seneviratne,Hambantota,Ruhunupura,Southern,9476,6647,16123,379040,265880,644920
12/21/2024,Ruvini Seneviratne,Hambantota,Ruhunupura,Southern,4419,6009,10428,176760,240360,417120
12/22/2024,Ruvini Seneviratne,Hambantota,Ruhunupura,Southern,2164,7220,9384,86560,288800,375360
12/23/2024,Ruvini Seneviratne,Hambantota,Ruhunupura,Southern,2491,2623,5114,99640,104920,204560
12/24/2024,Ruvini Seneviratne,Hambantota,Ruhunupura,Southern,7154,5601,12755,286160,224040,510200
12/25/2024,Ruvini Seneviratne,Hambantota,Ruhunupura,Southern,5587,4870,10457,223480,194800,418280
12/26/2024,Ruvini Seneviratne,Hambantota,Ruhunupura,Southern,8346,3812,12158,333840,152480,486320
12/27/2024,Ruvini Seneviratne,Hambantota,Ruhunupura,Southern,533,6777,7310,21320,271080,292400
12/28/2024,Ruvini Seneviratne,Hambantota,Ruhunupura,Southern,5091,1283,6374,203640,51320,254960
12/29/2024,Ruvini Seneviratne,Hambantota,Ruhunupura,Southern,9098,81,9179,363920,3240,367160
12/30/2024,Ruvini Seneviratne,Hambantota,Ruhunupura,Southern,203,9436,9639,8120,377440,385560
12/31/2024,Ruvini Seneviratne,Hambantota,Ruhunupura,Southern,5056,5416,10472,202240,216640,418880
1/1/2025,Ruvini Seneviratne,Hambantota,Ruhunupura,Southern,4053,9790,13843,162120,391600,553720
1/2/2025,Ruvini Seneviratne,Hambantota,Ruhunupura,Southern,6074,4639,10713,242960,185560,428520
1/3/2025,Ruvini Seneviratne,Hambantota,Ruhunupura,Southern,9505,1723,11228,380200,68920,449120
1/4/2025,Ruvini Seneviratne,Hambantota,Ruhunupura,Southern,4,421,425,160,16840,17000
1/5/2025,Ruvini Seneviratne,Hambantota,Ruhunupura,Southern,8852,9287,18139,354080,371480,725560
1/6/2025,Ruvini Seneviratne,Hambantota,Ruhunupura,Southern,1927,4440,6367,77080,177600,254680
1/7/2025,Ruvini Seneviratne,Hambantota,Ruhunupura,Southern,6903,8539,15442,276120,341560,617680
1/8/2025,Ruvini Seneviratne,Hambantota,Ruhunupura,Southern,7766,9982,17748,310640,399280,709920
1/9/2025,Ruvini Seneviratne,Hambantota,Ruhunupura,Southern,8441,7632,16073,337640,305280,642920
1/10/2025,Ruvini Seneviratne,Hambantota,Ruhunupura,Southern,8892,5900,14792,355680,236000,591680
1/11/2025,Ruvini Seneviratne,Hambantota,Ruhunupura,Southern,3045,9982,13027,121800,399280,521080
1/12/2025,Ruvini Seneviratne,Hambantota,Ruhunupura,Southern,2506,5510,8016,100240,220400,320640
1/13/2025,Ruvini Seneviratne,Hambantota,Ruhunupura,Southern,3795,5928,9723,151800,237120,388920
1/14/2025,Ruvini Seneviratne,Hambantota,Ruhunupura,Southern,6296,5592,11888,251840,223680,475520
1/15/2025,Ruvini Seneviratne,Hambantota,Ruhunupura,Southern,5976,2036,8012,239040,81440,320480
1/16/2025,Ruvini Seneviratne,Hambantota,Ruhunupura,Southern,2766,2523,5289,110640,100920,211560
1/17/2025,Ruvini Seneviratne,Hambantota,Ruhunupura,Southern,4727,2433,7160,189080,97320,286400
1/18/2025,Ruvini Seneviratne,Hambantota,Ruhunupura,Southern,6289,6253,12542,251560,250120,501680
1/19/2025,Ruvini Seneviratne,Hambantota,Ruhunupura,Southern,5201,1092,6293,208040,43680,251720
1/20/2025,Ruvini Seneviratne,Hambantota,Ruhunupura,Southern,5888,681,6569,235520,27240,262760
1/21/2025,Ruvini Seneviratne,Hambantota,Ruhunupura,Southern,3250,2131,5381,130000,85240,215240
1/22/2025,Ruvini Seneviratne,Hambantota,Ruhunupura,Southern,3375,2450,5825,135000,98000,233000
1/23/2025,Ruvini Seneviratne,Hambantota,Ruhunupura,Southern,6049,7906,13955,241960,316240,558200
1/24/2025,Ruvini Seneviratne,Hambantota,Ruhunupura,Southern,2089,9182,11271,83560,367280,450840
1/25/2025,Ruvini Seneviratne,Hambantota,Ruhunupura,Southern,4023,9954,13977,160920,398160,559080
1/26/2025,Ruvini Seneviratne,Hambantota,Ruhunupura,Southern,5736,8441,14177,229440,337640,567080
1/27/2025,Ruvini Seneviratne,Hambantota,Ruhunupura,Southern,1995,2692,4687,79800,107680,187480
1/28/2025,Ruvini Seneviratne,Hambantota,Ruhunupura,Southern,6834,3091,9925,273360,123640,397000
1/29/2025,Ruvini Seneviratne,Hambantota,Ruhunupura,Southern,2338,5504,7842,93520,220160,313680
1/30/2025,Ruvini Seneviratne,Hambantota,Ruhunupura,Southern,4897,1077,5974,195880,43080,238960
1/31/2025,Ruvini Seneviratne,Hambantota,Ruhunupura,Southern,6378,6915,13293,255120,276600,531720
2/1/2025,Ruvini Seneviratne,Hambantota,Ruhunupura,Southern,3024,9985,13009,120960,399400,520360
2/2/2025,Ruvini Seneviratne,Hambantota,Ruhunupura,Southern,4532,7635,12167,181280,305400,486680
2/3/2025,Ruvini Seneviratne,Hambantota,Ruhunupura,Southern,5778,4317,10095,231120,172680,403800
2/4/2025,Ruvini Seneviratne,Hambantota,Ruhunupura,Southern,7929,4434,12363,317160,177360,494520
2/5/2025,Ruvini Seneviratne,Hambantota,Ruhunupura,Southern,9999,1866,11865,399960,74640,474600
2/6/2025,Ruvini Seneviratne,Hambantota,Ruhunupura,Southern,875,9663,10538,35000,386520,421520
2/7/2025,Ruvini Seneviratne,Hambantota,Ruhunupura,Southern,7399,5287,12686,295960,211480,507440
2/8/2025,Ruvini Seneviratne,Hambantota,Ruhunupura,Southern,1513,2713,4226,60520,108520,169040
2/9/2025,Ruvini Seneviratne,Hambantota,Ruhunupura,Southern,5985,3378,9363,239400,135120,374520
2/10/2025,Ruvini Seneviratne,Hambantota,Ruhunupura,Southern,4800,5715,10515,192000,228600,420600
2/11/2025,Ruvini Seneviratne,Hambantota,Ruhunupura,Southern,20,3578,3598,800,143120,143920
2/12/2025,Ruvini Seneviratne,Hambantota,Ruhunupura,Southern,3871,216,4087,154840,8640,163480
2/13/2025,Ruvini Seneviratne,Hambantota,Ruhunupura,Southern,8509,2662,11171,340360,106480,446840
2/14/2025,Ruvini Seneviratne,Hambantota,Ruhunupura,Southern,2164,6876,9040,86560,275040,361600
2/15/2025,Ruvini Seneviratne,Hambantota,Ruhunupura,Southern,4507,8278,12785,180280,331120,511400
2/16/2025,Ruvini Seneviratne,Hambantota,Ruhunupura,Southern,5705,9353,15058,228200,374120,602320
2/17/2025,Ruvini Seneviratne,Hambantota,Ruhunupura,Southern,276,498,774,11040,19920,30960
2/18/2025,Ruvini Seneviratne,Hambantota,Ruhunupura,Southern,8988,7054,16042,359520,282160,641680
2/19/2025,Ruvini Seneviratne,Hambantota,Ruhunupura,Southern,6736,5078,11814,269440,203120,472560
2/20/2025,Ruvini Seneviratne,Hambantota,Ruhunupura,Southern,9791,1441,11232,391640,57640,449280
2/21/2025,Ruvini Seneviratne,Hambantota,Ruhunupura,Southern,4103,8937,13040,164120,357480,521600
2/22/2025,Ruvini Seneviratne,Hambantota,Ruhunupura,Southern,1425,1625,3050,57000,65000,122000
2/23/2025,Ruvini Seneviratne,Hambantota,Ruhunupura,Southern,2690,368,3058,107600,14720,122320
2/24/2025,Ruvini Seneviratne,Hambantota,Ruhunupura,Southern,7346,9390,16736,293840,375600,669440
2/25/2025,Ruvini Seneviratne,Hambantota,Ruhunupura,Southern,141,6854,6995,5640,274160,279800
2/26/2025,Ruvini Seneviratne,Hambantota,Ruhunupura,Southern,7781,9791,17572,311240,391640,702880
2/27/2025,Ruvini Seneviratne,Hambantota,Ruhunupura,Southern,8590,9207,17797,343600,368280,711880
2/28/2025,Ruvini Seneviratne,Hambantota,Ruhunupura,Southern,2182,1547,3729,87280,61880,149160
3/1/2025,Ruvini Seneviratne,Hambantota,Ruhunupura,Southern,3905,1427,5332,156200,57080,213280
3/2/2025,Ruvini Seneviratne,Hambantota,Ruhunupura,Southern,6288,2725,9013,251520,109000,360520
3/3/2025,Ruvini Seneviratne,Hambantota,Ruhunupura,Southern,546,3004,3550,21840,120160,142000
3/4/2025,Ruvini Seneviratne,Hambantota,Ruhunupura,Southern,1891,7628,9519,75640,305120,380760
3/5/2025,Ruvini Seneviratne,Hambantota,Ruhunupura,Southern,3346,1586,4932,133840,63440,197280
3/6/2025,Ruvini Seneviratne,Hambantota,Ruhunupura,Southern,6684,371,7055,267360,14840,282200
3/7/2025,Ruvini Seneviratne,Hambantota,Ruhunupura,Southern,7404,8185,15589,296160,327400,623560
3/8/2025,Ruvini Seneviratne,Hambantota,Ruhunupura,Southern,2652,7462,10114,106080,298480,404560
3/9/2025,Ruvini Seneviratne,Hambantota,Ruhunupura,Southern,2678,4874,7552,107120,194960,302080
3/10/2025,Ruvini Seneviratne,Hambantota,Ruhunupura,Southern,9528,2452,11980,381120,98080,479200
3/11/2025,Ruvini Seneviratne,Hambantota,Ruhunupura,Southern,3808,4184,7992,152320,167360,319680
3/12/2025,Ruvini Seneviratne,Hambantota,Ruhunupura,Southern,808,6574,7382,32320,262960,295280
3/13/2025,Ruvini Seneviratne,Hambantota,Ruhunupura,Southern,6661,9571,16232,266440,382840,649280
3/14/2025,Ruvini Seneviratne,Hambantota,Ruhunupura,Southern,3488,6387,9875,139520,255480,395000
3/15/2025,Ruvini Seneviratne,Hambantota,Ruhunupura,Southern,2505,4712,7217,100200,188480,288680
3/16/2025,Ruvini Seneviratne,Hambantota,Ruhunupura,Southern,9565,8931,18496,382600,357240,739840
3/17/2025,Ruvini Seneviratne,Hambantota,Ruhunupura,Southern,608,2999,3607,24320,119960,144280
3/18/2025,Ruvini Seneviratne,Hambantota,Ruhunupura,Southern,9859,7258,17117,394360,290320,684680
3/19/2025,Ruvini Seneviratne,Hambantota,Ruhunupura,Southern,7593,2252,9845,303720,90080,393800
3/20/2025,Ruvini Seneviratne,Hambantota,Ruhunupura,Southern,845,9274,10119,33800,370960,404760
3/21/2025,Ruvini Seneviratne,Hambantota,Ruhunupura,Southern,3847,6165,10012,153880,246600,400480
3/22/2025,Ruvini Seneviratne,Hambantota,Ruhunupura,Southern,606,2246,2852,24240,89840,114080
3/23/2025,Ruvini Seneviratne,Hambantota,Ruhunupura,Southern,6290,1174,7464,251600,46960,298560
3/25/2024,Vishal Wijekoon,Kandy,Teldeniya,Central,2682,9095,11777,107280,363800,471080
3/26/2024,Vishal Wijekoon,Kandy,Teldeniya,Central,6873,5549,12422,274920,221960,496880
3/27/2024,Vishal Wijekoon,Kandy,Teldeniya,Central,3747,8973,12720,149880,358920,508800
3/28/2024,Vishal Wijekoon,Kandy,Teldeniya,Central,2245,8544,10789,89800,341760,431560
3/29/2024,Vishal Wijekoon,Kandy,Teldeniya,Central,9159,9145,18304,366360,365800,732160
3/30/2024,Vishal Wijekoon,Kandy,Teldeniya,Central,7530,3903,11433,301200,156120,457320
3/31/2024,Vishal Wijekoon,Kandy,Teldeniya,Central,2228,5713,7941,89120,228520,317640
4/1/2024,Vishal Wijekoon,Kandy,Teldeniya,Central,1381,5214,6595,55240,208560,263800
4/2/2024,Vishal Wijekoon,Kandy,Teldeniya,Central,9635,4379,14014,385400,175160,560560
4/3/2024,Vishal Wijekoon,Kandy,Teldeniya,Central,4519,7754,12273,180760,310160,490920
4/4/2024,Vishal Wijekoon,Kandy,Teldeniya,Central,1480,5020,6500,59200,200800,260000
4/5/2024,Vishal Wijekoon,Kandy,Teldeniya,Central,8467,7271,15738,338680,290840,629520
4/6/2024,Vishal Wijekoon,Kandy,Teldeniya,Central,5496,7804,13300,219840,312160,532000
4/7/2024,Vishal Wijekoon,Kandy,Teldeniya,Central,2781,1483,4264,111240,59320,170560
4/8/2024,Vishal Wijekoon,Kandy,Teldeniya,Central,2678,9052,11730,107120,362080,469200
4/9/2024,Vishal Wijekoon,Kandy,Teldeniya,Central,3014,3691,6705,120560,147640,268200
4/10/2024,Vishal Wijekoon,Kandy,Teldeniya,Central,9225,4830,14055,369000,193200,562200
4/11/2024,Vishal Wijekoon,Kandy,Teldeniya,Central,3027,5350,8377,121080,214000,335080
4/19/2024,Vishal Wijekoon,Kandy,Teldeniya,Central,3325,4235,7560,133000,169400,302400
4/20/2024,Vishal Wijekoon,Kandy,Teldeniya,Central,8754,3408,12162,350160,136320,486480
4/21/2024,Vishal Wijekoon,Kandy,Teldeniya,Central,6785,5567,12352,271400,222680,494080
4/22/2024,Vishal Wijekoon,Kandy,Teldeniya,Central,7679,585,8264,307160,23400,330560
4/23/2024,Vishal Wijekoon,Kandy,Teldeniya,Central,3973,9490,13463,158920,379600,538520
4/24/2024,Vishal Wijekoon,Kandy,Teldeniya,Central,4607,8253,12860,184280,330120,514400
4/25/2024,Vishal Wijekoon,Kandy,Teldeniya,Central,9063,5712,14775,362520,228480,591000
4/26/2024,Vishal Wijekoon,Kandy,Teldeniya,Central,3195,5970,9165,127800,238800,366600
4/27/2024,Vishal Wijekoon,Kandy,Teldeniya,Central,8906,8663,17569,356240,346520,702760
4/28/2024,Vishal Wijekoon,Kandy,Teldeniya,Central,2434,3586,6020,97360,143440,240800
4/29/2024,Vishal Wijekoon,Kandy,Teldeniya,Central,6559,6485,13044,262360,259400,521760
4/30/2024,Vishal Wijekoon,Kandy,Teldeniya,Central,3939,2564,6503,157560,102560,260120
5/1/2024,Vishal Wijekoon,Kandy,Teldeniya,Central,3753,6081,9834,150120,243240,393360
5/2/2024,Vishal Wijekoon,Kandy,Teldeniya,Central,4082,5534,9616,163280,221360,384640
5/3/2024,Vishal Wijekoon,Kandy,Teldeniya,Central,8347,1894,10241,333880,75760,409640
5/4/2024,Vishal Wijekoon,Kandy,Teldeniya,Central,4942,5146,10088,197680,205840,403520
5/5/2024,Vishal Wijekoon,Kandy,Teldeniya,Central,4132,4592,8724,165280,183680,348960
5/6/2024,Vishal Wijekoon,Kandy,Teldeniya,Central,868,8967,9835,34720,358680,393400
5/7/2024,Vishal Wijekoon,Kandy,Teldeniya,Central,6008,8608,14616,240320,344320,584640
5/8/2024,Vishal Wijekoon,Kandy,Teldeniya,Central,8628,1379,10007,345120,55160,400280
5/9/2024,Vishal Wijekoon,Kandy,Teldeniya,Central,3691,6472,10163,147640,258880,406520
5/10/2024,Vishal Wijekoon,Kandy,Teldeniya,Central,4142,7483,11625,165680,299320,465000
5/11/2024,Vishal Wijekoon,Kandy,Teldeniya,Central,7893,5217,13110,315720,208680,524400
5/12/2024,Vishal Wijekoon,Kandy,Teldeniya,Central,4157,26,4183,166280,1040,167320
5/13/2024,Vishal Wijekoon,Kandy,Teldeniya,Central,5930,517,6447,237200,20680,257880
5/14/2024,Vishal Wijekoon,Kandy,Teldeniya,Central,1574,8712,10286,62960,348480,411440
5/15/2024,Vishal Wijekoon,Kandy,Teldeniya,Central,6951,101,7052,278040,4040,282080
5/16/2024,Vishal Wijekoon,Kandy,Teldeniya,Central,4331,622,4953,173240,24880,198120
5/17/2024,Vishal Wijekoon,Kandy,Teldeniya,Central,6301,1212,7513,252040,48480,300520
5/18/2024,Vishal Wijekoon,Kandy,Teldeniya,Central,2245,5689,7934,89800,227560,317360
5/19/2024,Vishal Wijekoon,Kandy,Teldeniya,Central,2647,4177,6824,105880,167080,272960
5/20/2024,Vishal Wijekoon,Kandy,Teldeniya,Central,7112,3213,10325,284480,128520,413000
5/21/2024,Vishal Wijekoon,Kandy,Teldeniya,Central,8467,5690,14157,338680,227600,566280
5/22/2024,Vishal Wijekoon,Kandy,Teldeniya,Central,9551,614,10165,382040,24560,406600
5/24/2024,Vishal Wijekoon,Kandy,Teldeniya,Central,6262,9924,16186,250480,396960,647440
5/25/2024,Vishal Wijekoon,Kandy,Teldeniya,Central,2609,2929,5538,104360,117160,221520
5/26/2024,Vishal Wijekoon,Kandy,Teldeniya,Central,4623,5857,10480,184920,234280,419200
5/27/2024,Vishal Wijekoon,Kandy,Teldeniya,Central,8928,1056,9984,357120,42240,399360
5/28/2024,Vishal Wijekoon,Kandy,Teldeniya,Central,3904,9647,13551,156160,385880,542040
5/29/2024,Vishal Wijekoon,Kandy,Teldeniya,Central,9492,8064,17556,379680,322560,702240
5/30/2024,Vishal Wijekoon,Kandy,Teldeniya,Central,5349,1439,6788,213960,57560,271520
5/31/2024,Vishal Wijekoon,Kandy,Teldeniya,Central,3987,5485,9472,159480,219400,378880
6/1/2024,Vishal Wijekoon,Kandy,Teldeniya,Central,1408,4473,5881,56320,178920,235240
6/2/2024,Vishal Wijekoon,Kandy,Teldeniya,Central,7863,2228,10091,314520,89120,403640
6/3/2024,Vishal Wijekoon,Kandy,Teldeniya,Central,6895,144,7039,275800,5760,281560
6/4/2024,Vishal Wijekoon,Kandy,Teldeniya,Central,2305,4978,7283,92200,199120,291320
6/5/2024,Vishal Wijekoon,Kandy,Teldeniya,Central,8884,4375,13259,355360,175000,530360
6/6/2024,Vishal Wijekoon,Kandy,Teldeniya,Central,7650,714,8364,306000,28560,334560
6/7/2024,Vishal Wijekoon,Kandy,Teldeniya,Central,2476,473,2949,99040,18920,117960
6/8/2024,Vishal Wijekoon,Kandy,Teldeniya,Central,2133,9685,11818,85320,387400,472720
6/9/2024,Vishal Wijekoon,Kandy,Teldeniya,Central,8482,7994,16476,339280,319760,659040
6/10/2024,Vishal Wijekoon,Kandy,Teldeniya,Central,627,6116,6743,25080,244640,269720
6/11/2024,Vishal Wijekoon,Kandy,Teldeniya,Central,6074,4967,11041,242960,198680,441640
6/12/2024,Vishal Wijekoon,Kandy,Teldeniya,Central,6864,8411,15275,274560,336440,611000
6/13/2024,Vishal Wijekoon,Kandy,Teldeniya,Central,4505,2627,7132,180200,105080,285280
6/14/2024,Vishal Wijekoon,Kandy,Teldeniya,Central,4000,334,4334,160000,13360,173360
6/15/2024,Vishal Wijekoon,Kandy,Teldeniya,Central,5225,1250,6475,209000,50000,259000
6/16/2024,Vishal Wijekoon,Kandy,Teldeniya,Central,539,6098,6637,21560,243920,265480
6/17/2024,Vishal Wijekoon,Kandy,Teldeniya,Central,7507,1069,8576,300280,42760,343040
6/18/2024,Vishal Wijekoon,Kandy,Teldeniya,Central,5562,801,6363,222480,32040,254520
6/19/2024,Vishal Wijekoon,Kandy,Teldeniya,Central,6152,1227,7379,246080,49080,295160
6/20/2024,Vishal Wijekoon,Kandy,Teldeniya,Central,3242,1753,4995,129680,70120,199800
6/21/2024,Vishal Wijekoon,Kandy,Teldeniya,Central,9608,1949,11557,384320,77960,462280
6/22/2024,Vishal Wijekoon,Kandy,Teldeniya,Central,3046,3572,6618,121840,142880,264720
6/23/2024,Vishal Wijekoon,Kandy,Teldeniya,Central,4602,9353,13955,184080,374120,558200
6/24/2024,Vishal Wijekoon,Kandy,Teldeniya,Central,945,3175,4120,37800,127000,164800
6/25/2024,Vishal Wijekoon,Kandy,Teldeniya,Central,6302,9306,15608,252080,372240,624320
6/26/2024,Vishal Wijekoon,Kandy,Teldeniya,Central,9093,5132,14225,363720,205280,569000
6/27/2024,Vishal Wijekoon,Kandy,Teldeniya,Central,7867,3113,10980,314680,124520,439200
6/28/2024,Vishal Wijekoon,Kandy,Teldeniya,Central,8659,4987,13646,346360,199480,545840
6/29/2024,Vishal Wijekoon,Kandy,Teldeniya,Central,7115,5471,12586,284600,218840,503440
6/30/2024,Vishal Wijekoon,Kandy,Teldeniya,Central,4266,1228,5494,170640,49120,219760
7/1/2024,Vishal Wijekoon,Kandy,Teldeniya,Central,590,9843,10433,23600,393720,417320
7/2/2024,Vishal Wijekoon,Kandy,Teldeniya,Central,9361,5597,14958,374440,223880,598320
7/3/2024,Vishal Wijekoon,Kandy,Teldeniya,Central,5381,3416,8797,215240,136640,351880
7/4/2024,Vishal Wijekoon,Kandy,Teldeniya,Central,3169,7796,10965,126760,311840,438600
7/5/2024,Vishal Wijekoon,Kandy,Teldeniya,Central,1859,32,1891,74360,1280,75640
7/6/2024,Vishal Wijekoon,Kandy,Teldeniya,Central,5040,5691,10731,201600,227640,429240
7/7/2024,Vishal Wijekoon,Kandy,Teldeniya,Central,5240,8008,13248,209600,320320,529920
7/8/2024,Vishal Wijekoon,Kandy,Teldeniya,Central,5248,7106,12354,209920,284240,494160
7/9/2024,Vishal Wijekoon,Kandy,Teldeniya,Central,3842,5071,8913,153680,202840,356520
7/10/2024,Vishal Wijekoon,Kandy,Teldeniya,Central,3648,9485,13133,145920,379400,525320
7/11/2024,Vishal Wijekoon,Kandy,Teldeniya,Central,3539,6735,10274,141560,269400,410960
7/12/2024,Vishal Wijekoon,Kandy,Teldeniya,Central,5552,7512,13064,222080,300480,522560
7/13/2024,Vishal Wijekoon,Kandy,Teldeniya,Central,4303,106,4409,172120,4240,176360
7/14/2024,Vishal Wijekoon,Kandy,Teldeniya,Central,3648,4054,7702,145920,162160,308080
7/15/2024,Vishal Wijekoon,Kandy,Teldeniya,Central,3630,7049,10679,145200,281960,427160
7/16/2024,Vishal Wijekoon,Kandy,Teldeniya,Central,5796,6301,12097,231840,252040,483880
7/17/2024,Vishal Wijekoon,Kandy,Teldeniya,Central,9912,7370,17282,396480,294800,691280
7/18/2024,Vishal Wijekoon,Kandy,Teldeniya,Central,7100,9050,16150,284000,362000,646000
7/19/2024,Vishal Wijekoon,Kandy,Teldeniya,Central,4111,3277,7388,164440,131080,295520
7/20/2024,Vishal Wijekoon,Kandy,Teldeniya,Central,6412,4245,10657,256480,169800,426280
7/21/2024,Vishal Wijekoon,Kandy,Teldeniya,Central,805,3154,3959,32200,126160,158360
7/22/2024,Vishal Wijekoon,Kandy,Teldeniya,Central,3915,7307,11222,156600,292280,448880
7/23/2024,Vishal Wijekoon,Kandy,Teldeniya,Central,2654,6449,9103,106160,257960,364120
7/24/2024,Vishal Wijekoon,Kandy,Teldeniya,Central,6495,7499,13994,259800,299960,559760
7/25/2024,Vishal Wijekoon,Kandy,Teldeniya,Central,9093,6480,15573,363720,259200,622920
7/26/2024,Vishal Wijekoon,Kandy,Teldeniya,Central,1751,2677,4428,70040,107080,177120
7/27/2024,Vishal Wijekoon,Kandy,Teldeniya,Central,8712,3155,11867,348480,126200,474680
7/28/2024,Vishal Wijekoon,Kandy,Teldeniya,Central,7310,7049,14359,292400,281960,574360
7/29/2024,Vishal Wijekoon,Kandy,Teldeniya,Central,3666,2451,6117,146640,98040,244680
7/30/2024,Vishal Wijekoon,Kandy,Teldeniya,Central,8084,496,8580,323360,19840,343200
7/31/2024,Vishal Wijekoon,Kandy,Teldeniya,Central,2983,4679,7662,119320,187160,306480
8/1/2024,Vishal Wijekoon,Kandy,Teldeniya,Central,3683,1879,5562,147320,75160,222480
8/2/2024,Vishal Wijekoon,Kandy,Teldeniya,Central,403,2909,3312,16120,116360,132480
8/3/2024,Vishal Wijekoon,Kandy,Teldeniya,Central,442,2549,2991,17680,101960,119640
8/4/2024,Vishal Wijekoon,Kandy,Teldeniya,Central,1096,3418,4514,43840,136720,180560
8/5/2024,Vishal Wijekoon,Kandy,Teldeniya,Central,5329,2394,7723,213160,95760,308920
8/6/2024,Vishal Wijekoon,Kandy,Teldeniya,Central,4996,2182,7178,199840,87280,287120
8/7/2024,Vishal Wijekoon,Kandy,Teldeniya,Central,3064,1441,4505,122560,57640,180200
8/8/2024,Vishal Wijekoon,Kandy,Teldeniya,Central,4418,9225,13643,176720,369000,545720
8/9/2024,Vishal Wijekoon,Kandy,Teldeniya,Central,5348,5720,11068,213920,228800,442720
8/10/2024,Vishal Wijekoon,Kandy,Teldeniya,Central,1068,6431,7499,42720,257240,299960
8/11/2024,Vishal Wijekoon,Kandy,Teldeniya,Central,7624,4864,12488,304960,194560,499520
8/12/2024,Vishal Wijekoon,Kandy,Teldeniya,Central,4610,8679,13289,184400,347160,531560
8/13/2024,Vishal Wijekoon,Kandy,Teldeniya,Central,8435,4572,13007,337400,182880,520280
8/14/2024,Vishal Wijekoon,Kandy,Teldeniya,Central,6906,7473,14379,276240,298920,575160
8/15/2024,Vishal Wijekoon,Kandy,Teldeniya,Central,9167,5775,14942,366680,231000,597680
8/16/2024,Vishal Wijekoon,Kandy,Teldeniya,Central,1194,7292,8486,47760,291680,339440
8/17/2024,Vishal Wijekoon,Kandy,Teldeniya,Central,1766,8461,10227,70640,338440,409080
8/18/2024,Vishal Wijekoon,Kandy,Teldeniya,Central,7903,7914,15817,316120,316560,632680
8/19/2024,Vishal Wijekoon,Kandy,Teldeniya,Central,1344,6963,8307,53760,278520,332280
8/20/2024,Vishal Wijekoon,Kandy,Teldeniya,Central,9513,2823,12336,380520,112920,493440
8/21/2024,Vishal Wijekoon,Kandy,Teldeniya,Central,3319,1741,5060,132760,69640,202400
8/22/2024,Vishal Wijekoon,Kandy,Teldeniya,Central,1571,6886,8457,62840,275440,338280
8/23/2024,Vishal Wijekoon,Kandy,Teldeniya,Central,6704,2088,8792,268160,83520,351680
8/24/2024,Vishal Wijekoon,Kandy,Teldeniya,Central,3688,349,4037,147520,13960,161480
8/25/2024,Vishal Wijekoon,Kandy,Teldeniya,Central,8866,5119,13985,354640,204760,559400
8/26/2024,Vishal Wijekoon,Kandy,Teldeniya,Central,8289,119,8408,331560,4760,336320
8/27/2024,Vishal Wijekoon,Kandy,Teldeniya,Central,8402,4025,12427,336080,161000,497080
8/28/2024,Vishal Wijekoon,Kandy,Teldeniya,Central,3338,9238,12576,133520,369520,503040
8/29/2024,Vishal Wijekoon,Kandy,Teldeniya,Central,5948,2470,8418,237920,98800,336720
8/30/2024,Vishal Wijekoon,Kandy,Teldeniya,Central,3521,5594,9115,140840,223760,364600
8/31/2024,Vishal Wijekoon,Kandy,Teldeniya,Central,1658,2447,4105,66320,97880,164200
9/1/2024,Vishal Wijekoon,Kandy,Teldeniya,Central,2638,589,3227,105520,23560,129080
9/2/2024,Vishal Wijekoon,Kandy,Teldeniya,Central,2808,6386,9194,112320,255440,367760
9/3/2024,Vishal Wijekoon,Kandy,Teldeniya,Central,9291,7291,16582,371640,291640,663280
9/4/2024,Vishal Wijekoon,Kandy,Teldeniya,Central,6508,5037,11545,260320,201480,461800
9/5/2024,Vishal Wijekoon,Kandy,Teldeniya,Central,1439,4506,5945,57560,180240,237800
9/6/2024,Vishal Wijekoon,Kandy,Teldeniya,Central,8505,6544,15049,340200,261760,601960
9/7/2024,Vishal Wijekoon,Kandy,Teldeniya,Central,989,9670,10659,39560,386800,426360
9/8/2024,Vishal Wijekoon,Kandy,Teldeniya,Central,771,3517,4288,30840,140680,171520
9/9/2024,Vishal Wijekoon,Kandy,Teldeniya,Central,9625,756,10381,385000,30240,415240
9/10/2024,Vishal Wijekoon,Kandy,Teldeniya,Central,7532,8694,16226,301280,347760,649040
9/11/2024,Vishal Wijekoon,Kandy,Teldeniya,Central,1902,3065,4967,76080,122600,198680
9/12/2024,Vishal Wijekoon,Kandy,Teldeniya,Central,1155,9253,10408,46200,370120,416320
9/13/2024,Vishal Wijekoon,Kandy,Teldeniya,Central,8484,5827,14311,339360,233080,572440
9/14/2024,Vishal Wijekoon,Kandy,Teldeniya,Central,4898,940,5838,195920,37600,233520
9/15/2024,Vishal Wijekoon,Kandy,Teldeniya,Central,6956,5729,12685,278240,229160,507400
9/16/2024,Vishal Wijekoon,Kandy,Teldeniya,Central,1361,7412,8773,54440,296480,350920
9/17/2024,Vishal Wijekoon,Kandy,Teldeniya,Central,5176,4082,9258,207040,163280,370320
9/18/2024,Vishal Wijekoon,Kandy,Teldeniya,Central,4790,796,5586,191600,31840,223440
9/19/2024,Vishal Wijekoon,Kandy,Teldeniya,Central,6295,8192,14487,251800,327680,579480
9/20/2024,Vishal Wijekoon,Kandy,Teldeniya,Central,2656,6704,9360,106240,268160,374400
9/21/2024,Vishal Wijekoon,Kandy,Teldeniya,Central,7155,775,7930,286200,31000,317200
9/22/2024,Vishal Wijekoon,Kandy,Teldeniya,Central,695,7939,8634,27800,317560,345360
9/23/2024,Vishal Wijekoon,Kandy,Teldeniya,Central,362,8129,8491,14480,325160,339640
9/24/2024,Vishal Wijekoon,Kandy,Teldeniya,Central,8653,1381,10034,346120,55240,401360
9/25/2024,Vishal Wijekoon,Kandy,Teldeniya,Central,1784,9458,11242,71360,378320,449680
9/26/2024,Vishal Wijekoon,Kandy,Teldeniya,Central,400,8203,8603,16000,328120,344120
9/27/2024,Vishal Wijekoon,Kandy,Teldeniya,Central,6031,1187,7218,241240,47480,288720
9/28/2024,Vishal Wijekoon,Kandy,Teldeniya,Central,1089,2052,3141,43560,82080,125640
9/29/2024,Vishal Wijekoon,Kandy,Teldeniya,Central,148,3676,3824,5920,147040,152960
9/30/2024,Vishal Wijekoon,Kandy,Teldeniya,Central,5103,4083,9186,204120,163320,367440
10/1/2024,Vishal Wijekoon,Kandy,Teldeniya,Central,7889,8360,16249,315560,334400,649960
10/2/2024,Vishal Wijekoon,Kandy,Teldeniya,Central,846,8898,9744,33840,355920,389760
10/3/2024,Vishal Wijekoon,Kandy,Teldeniya,Central,8898,5347,14245,355920,213880,569800
10/4/2024,Vishal Wijekoon,Kandy,Teldeniya,Central,487,7924,8411,19480,316960,336440
10/5/2024,Vishal Wijekoon,Kandy,Teldeniya,Central,3208,4126,7334,128320,165040,293360
10/6/2024,Vishal Wijekoon,Kandy,Teldeniya,Central,5230,3666,8896,209200,146640,355840
10/7/2024,Vishal Wijekoon,Kandy,Teldeniya,Central,6952,4425,11377,278080,177000,455080
10/8/2024,Vishal Wijekoon,Kandy,Teldeniya,Central,4439,9536,13975,177560,381440,559000
10/9/2024,Vishal Wijekoon,Kandy,Teldeniya,Central,3389,3852,7241,135560,154080,289640
10/10/2024,Vishal Wijekoon,Kandy,Teldeniya,Central,9608,7649,17257,384320,305960,690280
10/11/2024,Vishal Wijekoon,Kandy,Teldeniya,Central,3714,5353,9067,148560,214120,362680
10/12/2024,Vishal Wijekoon,Kandy,Teldeniya,Central,3782,4740,8522,151280,189600,340880
10/13/2024,Vishal Wijekoon,Kandy,Teldeniya,Central,9511,8103,17614,380440,324120,704560
10/14/2024,Vishal Wijekoon,Kandy,Teldeniya,Central,2786,6915,9701,111440,276600,388040
10/15/2024,Vishal Wijekoon,Kandy,Teldeniya,Central,4628,3229,7857,185120,129160,314280
10/16/2024,Vishal Wijekoon,Kandy,Teldeniya,Central,9336,5745,15081,373440,229800,603240
10/17/2024,Vishal Wijekoon,Kandy,Teldeniya,Central,7081,8181,15262,283240,327240,610480
10/18/2024,Vishal Wijekoon,Kandy,Teldeniya,Central,8348,3697,12045,333920,147880,481800
10/19/2024,Vishal Wijekoon,Kandy,Teldeniya,Central,7307,8387,15694,292280,335480,627760
10/20/2024,Vishal Wijekoon,Kandy,Teldeniya,Central,637,9817,10454,25480,392680,418160
10/21/2024,Vishal Wijekoon,Kandy,Teldeniya,Central,2500,4379,6879,100000,175160,275160
10/22/2024,Vishal Wijekoon,Kandy,Teldeniya,Central,9139,4055,13194,365560,162200,527760
10/23/2024,Vishal Wijekoon,Kandy,Teldeniya,Central,8475,3818,12293,339000,152720,491720
10/24/2024,Vishal Wijekoon,Kandy,Teldeniya,Central,6548,7017,13565,261920,280680,542600
10/25/2024,Vishal Wijekoon,Kandy,Teldeniya,Central,8349,52,8401,333960,2080,336040
10/26/2024,Vishal Wijekoon,Kandy,Teldeniya,Central,7308,7021,14329,292320,280840,573160
10/27/2024,Vishal Wijekoon,Kandy,Teldeniya,Central,9741,8960,18701,389640,358400,748040
10/28/2024,Vishal Wijekoon,Kandy,Teldeniya,Central,2663,2960,5623,106520,118400,224920
10/29/2024,Vishal Wijekoon,Kandy,Teldeniya,Central,6492,5574,12066,259680,222960,482640
10/30/2024,Vishal Wijekoon,Kandy,Teldeniya,Central,6514,8894,15408,260560,355760,616320
10/31/2024,Vishal Wijekoon,Kandy,Teldeniya,Central,6984,3092,10076,279360,123680,403040
11/1/2024,Vishal Wijekoon,Kandy,Teldeniya,Central,9876,8834,18710,395040,353360,748400
11/2/2024,Vishal Wijekoon,Kandy,Teldeniya,Central,2912,2093,5005,116480,83720,200200
11/3/2024,Vishal Wijekoon,Kandy,Teldeniya,Central,1972,686,2658,78880,27440,106320
11/4/2024,Vishal Wijekoon,Kandy,Teldeniya,Central,9497,3556,13053,379880,142240,522120
11/5/2024,Vishal Wijekoon,Kandy,Teldeniya,Central,4587,5386,9973,183480,215440,398920
11/6/2024,Vishal Wijekoon,Kandy,Teldeniya,Central,577,6567,7144,23080,262680,285760
11/7/2024,Vishal Wijekoon,Kandy,Teldeniya,Central,7609,4040,11649,304360,161600,465960
11/8/2024,Vishal Wijekoon,Kandy,Teldeniya,Central,3253,7129,10382,130120,285160,415280
11/9/2024,Vishal Wijekoon,Kandy,Teldeniya,Central,555,5857,6412,22200,234280,256480
11/10/2024,Vishal Wijekoon,Kandy,Teldeniya,Central,4024,2655,6679,160960,106200,267160
11/11/2024,Vishal Wijekoon,Kandy,Teldeniya,Central,8358,5275,13633,334320,211000,545320
11/12/2024,Vishal Wijekoon,Kandy,Teldeniya,Central,9333,9761,19094,373320,390440,763760
11/13/2024,Vishal Wijekoon,Kandy,Teldeniya,Central,6778,6565,13343,271120,262600,533720
11/14/2024,Vishal Wijekoon,Kandy,Teldeniya,Central,5147,8847,13994,205880,353880,559760
11/15/2024,Vishal Wijekoon,Kandy,Teldeniya,Central,5430,2936,8366,217200,117440,334640
11/16/2024,Vishal Wijekoon,Kandy,Teldeniya,Central,5325,216,5541,213000,8640,221640
11/17/2024,Vishal Wijekoon,Kandy,Teldeniya,Central,922,8245,9167,36880,329800,366680
11/18/2024,Vishal Wijekoon,Kandy,Teldeniya,Central,2595,3711,6306,103800,148440,252240
11/19/2024,Vishal Wijekoon,Kandy,Teldeniya,Central,9324,4471,13795,372960,178840,551800
11/20/2024,Vishal Wijekoon,Kandy,Teldeniya,Central,8292,8756,17048,331680,350240,681920
11/21/2024,Vishal Wijekoon,Kandy,Teldeniya,Central,2940,2710,5650,117600,108400,226000
11/22/2024,Vishal Wijekoon,Kandy,Teldeniya,Central,5267,2929,8196,210680,117160,327840
11/23/2024,Vishal Wijekoon,Kandy,Teldeniya,Central,7367,8125,15492,294680,325000,619680
11/24/2024,Vishal Wijekoon,Kandy,Teldeniya,Central,2798,2653,5451,111920,106120,218040
11/25/2024,Vishal Wijekoon,Kandy,Teldeniya,Central,1169,9954,11123,46760,398160,444920
11/26/2024,Vishal Wijekoon,Kandy,Teldeniya,Central,5758,350,6108,230320,14000,244320
11/27/2024,Vishal Wijekoon,Kandy,Teldeniya,Central,5140,4557,9697,205600,182280,387880
11/28/2024,Vishal Wijekoon,Kandy,Teldeniya,Central,7213,6213,13426,288520,248520,537040
11/29/2024,Vishal Wijekoon,Kandy,Teldeniya,Central,6595,1505,8100,263800,60200,324000
11/30/2024,Vishal Wijekoon,Kandy,Teldeniya,Central,5378,6441,11819,215120,257640,472760
12/1/2024,Vishal Wijekoon,Kandy,Teldeniya,Central,8190,3945,12135,327600,157800,485400
12/2/2024,Vishal Wijekoon,Kandy,Teldeniya,Central,6223,6030,12253,248920,241200,490120
12/3/2024,Vishal Wijekoon,Kandy,Teldeniya,Central,7928,3719,11647,317120,148760,465880
12/4/2024,Vishal Wijekoon,Kandy,Teldeniya,Central,9018,4815,13833,360720,192600,553320
12/5/2024,Vishal Wijekoon,Kandy,Teldeniya,Central,8329,7177,15506,333160,287080,620240
12/6/2024,Vishal Wijekoon,Kandy,Teldeniya,Central,6034,4149,10183,241360,165960,407320
12/7/2024,Vishal Wijekoon,Kandy,Teldeniya,Central,7128,69,7197,285120,2760,287880
12/8/2024,Vishal Wijekoon,Kandy,Teldeniya,Central,7316,718,8034,292640,28720,321360
12/9/2024,Vishal Wijekoon,Kandy,Teldeniya,Central,2155,3881,6036,86200,155240,241440
12/10/2024,Vishal Wijekoon,Kandy,Teldeniya,Central,8035,7023,15058,321400,280920,602320
12/11/2024,Vishal Wijekoon,Kandy,Teldeniya,Central,6335,2816,9151,253400,112640,366040
12/12/2024,Vishal Wijekoon,Kandy,Teldeniya,Central,8929,5487,14416,357160,219480,576640
12/13/2024,Vishal Wijekoon,Kandy,Teldeniya,Central,8204,3331,11535,328160,133240,461400
12/14/2024,Vishal Wijekoon,Kandy,Teldeniya,Central,1556,9737,11293,62240,389480,451720
12/15/2024,Vishal Wijekoon,Kandy,Teldeniya,Central,5394,4313,9707,215760,172520,388280
12/16/2024,Vishal Wijekoon,Kandy,Teldeniya,Central,3450,3005,6455,138000,120200,258200
12/17/2024,Vishal Wijekoon,Kandy,Teldeniya,Central,9906,8785,18691,396240,351400,747640
12/18/2024,Vishal Wijekoon,Kandy,Teldeniya,Central,7742,3453,11195,309680,138120,447800
12/19/2024,Vishal Wijekoon,Kandy,Teldeniya,Central,1136,4854,5990,45440,194160,239600
12/20/2024,Vishal Wijekoon,Kandy,Teldeniya,Central,4103,2945,7048,164120,117800,281920
12/21/2024,Vishal Wijekoon,Kandy,Teldeniya,Central,6754,6969,13723,270160,278760,548920
12/22/2024,Vishal Wijekoon,Kandy,Teldeniya,Central,3893,206,4099,155720,8240,163960
12/23/2024,Vishal Wijekoon,Kandy,Teldeniya,Central,683,1023,1706,27320,40920,68240
12/24/2024,Vishal Wijekoon,Kandy,Teldeniya,Central,6867,6312,13179,274680,252480,527160
12/25/2024,Vishal Wijekoon,Kandy,Teldeniya,Central,5966,9380,15346,238640,375200,613840
12/26/2024,Vishal Wijekoon,Kandy,Teldeniya,Central,2102,8028,10130,84080,321120,405200
12/27/2024,Vishal Wijekoon,Kandy,Teldeniya,Central,1824,1720,3544,72960,68800,141760
12/28/2024,Vishal Wijekoon,Kandy,Teldeniya,Central,4189,8040,12229,167560,321600,489160
12/29/2024,Vishal Wijekoon,Kandy,Teldeniya,Central,3814,314,4128,152560,12560,165120
12/30/2024,Vishal Wijekoon,Kandy,Teldeniya,Central,9458,9994,19452,378320,399760,778080
12/31/2024,Vishal Wijekoon,Kandy,Teldeniya,Central,2583,8033,10616,103320,321320,424640
1/1/2025,Vishal Wijekoon,Kandy,Teldeniya,Central,8045,952,8997,321800,38080,359880
1/2/2025,Vishal Wijekoon,Kandy,Teldeniya,Central,7363,8165,15528,294520,326600,621120
1/3/2025,Vishal Wijekoon,Kandy,Teldeniya,Central,3773,3161,6934,150920,126440,277360
1/4/2025,Vishal Wijekoon,Kandy,Teldeniya,Central,2298,6737,9035,91920,269480,361400
1/5/2025,Vishal Wijekoon,Kandy,Teldeniya,Central,9939,4260,14199,397560,170400,567960
1/6/2025,Vishal Wijekoon,Kandy,Teldeniya,Central,5622,8504,14126,224880,340160,565040
1/7/2025,Vishal Wijekoon,Kandy,Teldeniya,Central,1777,740,2517,71080,29600,100680
1/8/2025,Vishal Wijekoon,Kandy,Teldeniya,Central,6230,1347,7577,249200,53880,303080
1/9/2025,Vishal Wijekoon,Kandy,Teldeniya,Central,3099,7932,11031,123960,317280,441240
1/10/2025,Vishal Wijekoon,Kandy,Teldeniya,Central,5676,4,5680,227040,160,227200
1/11/2025,Vishal Wijekoon,Kandy,Teldeniya,Central,6710,1823,8533,268400,72920,341320
1/12/2025,Vishal Wijekoon,Kandy,Teldeniya,Central,4080,8243,12323,163200,329720,492920
1/13/2025,Vishal Wijekoon,Kandy,Teldeniya,Central,1823,6577,8400,72920,263080,336000
1/14/2025,Vishal Wijekoon,Kandy,Teldeniya,Central,252,4995,5247,10080,199800,209880
1/15/2025,Vishal Wijekoon,Kandy,Teldeniya,Central,3178,8364,11542,127120,334560,461680
1/16/2025,Vishal Wijekoon,Kandy,Teldeniya,Central,2,9157,9159,80,366280,366360
1/17/2025,Vishal Wijekoon,Kandy,Teldeniya,Central,6233,924,7157,249320,36960,286280
1/18/2025,Vishal Wijekoon,Kandy,Teldeniya,Central,3643,3152,6795,145720,126080,271800
1/19/2025,Vishal Wijekoon,Kandy,Teldeniya,Central,2341,229,2570,93640,9160,102800
1/20/2025,Vishal Wijekoon,Kandy,Teldeniya,Central,4585,5389,9974,183400,215560,398960
1/21/2025,Vishal Wijekoon,Kandy,Teldeniya,Central,5074,1129,6203,202960,45160,248120
1/22/2025,Vishal Wijekoon,Kandy,Teldeniya,Central,2896,3857,6753,115840,154280,270120
1/23/2025,Vishal Wijekoon,Kandy,Teldeniya,Central,5983,7410,13393,239320,296400,535720
1/24/2025,Vishal Wijekoon,Kandy,Teldeniya,Central,4008,3211,7219,160320,128440,288760
1/25/2025,Vishal Wijekoon,Kandy,Teldeniya,Central,8359,2697,11056,334360,107880,442240
1/26/2025,Vishal Wijekoon,Kandy,Teldeniya,Central,161,3363,3524,6440,134520,140960
1/27/2025,Vishal Wijekoon,Kandy,Teldeniya,Central,6002,7305,13307,240080,292200,532280
1/28/2025,Vishal Wijekoon,Kandy,Teldeniya,Central,6630,5742,12372,265200,229680,494880
1/29/2025,Vishal Wijekoon,Kandy,Teldeniya,Central,5214,7397,12611,208560,295880,504440
1/30/2025,Vishal Wijekoon,Kandy,Teldeniya,Central,886,6490,7376,35440,259600,295040
1/31/2025,Vishal Wijekoon,Kandy,Teldeniya,Central,6926,4637,11563,277040,185480,462520
2/1/2025,Vishal Wijekoon,Kandy,Teldeniya,Central,8078,5335,13413,323120,213400,536520
2/2/2025,Vishal Wijekoon,Kandy,Teldeniya,Central,1038,5121,6159,41520,204840,246360
2/3/2025,Vishal Wijekoon,Kandy,Teldeniya,Central,4395,3890,8285,175800,155600,331400
2/4/2025,Vishal Wijekoon,Kandy,Teldeniya,Central,8976,4573,13549,359040,182920,541960
2/5/2025,Vishal Wijekoon,Kandy,Teldeniya,Central,2222,1689,3911,88880,67560,156440
2/6/2025,Vishal Wijekoon,Kandy,Teldeniya,Central,6095,9404,15499,243800,376160,619960
2/7/2025,Vishal Wijekoon,Kandy,Teldeniya,Central,9606,7006,16612,384240,280240,664480
2/8/2025,Vishal Wijekoon,Kandy,Teldeniya,Central,1665,971,2636,66600,38840,105440
2/9/2025,Vishal Wijekoon,Kandy,Teldeniya,Central,1726,8716,10442,69040,348640,417680
2/10/2025,Vishal Wijekoon,Kandy,Teldeniya,Central,6543,5224,11767,261720,208960,470680
2/11/2025,Vishal Wijekoon,Kandy,Teldeniya,Central,5954,3177,9131,238160,127080,365240
2/12/2025,Vishal Wijekoon,Kandy,Teldeniya,Central,5697,3867,9564,227880,154680,382560
2/13/2025,Vishal Wijekoon,Kandy,Teldeniya,Central,3856,63,3919,154240,2520,156760
2/14/2025,Vishal Wijekoon,Kandy,Teldeniya,Central,2854,7392,10246,114160,295680,409840
2/15/2025,Vishal Wijekoon,Kandy,Teldeniya,Central,4698,3987,8685,187920,159480,347400
2/16/2025,Vishal Wijekoon,Kandy,Teldeniya,Central,2991,7251,10242,119640,290040,409680
2/17/2025,Vishal Wijekoon,Kandy,Teldeniya,Central,8148,7502,15650,325920,300080,626000
2/18/2025,Vishal Wijekoon,Kandy,Teldeniya,Central,9037,9379,18416,361480,375160,736640
2/19/2025,Vishal Wijekoon,Kandy,Teldeniya,Central,4959,8850,13809,198360,354000,552360
2/20/2025,Vishal Wijekoon,Kandy,Teldeniya,Central,4321,869,5190,172840,34760,207600
2/21/2025,Vishal Wijekoon,Kandy,Teldeniya,Central,376,8997,9373,15040,359880,374920
2/22/2025,Vishal Wijekoon,Kandy,Teldeniya,Central,8220,785,9005,328800,31400,360200
2/23/2025,Vishal Wijekoon,Kandy,Teldeniya,Central,4126,6892,11018,165040,275680,440720
2/24/2025,Vishal Wijekoon,Kandy,Teldeniya,Central,8800,5365,14165,352000,214600,566600
2/25/2025,Vishal Wijekoon,Kandy,Teldeniya,Central,1081,9165,10246,43240,366600,409840
2/26/2025,Vishal Wijekoon,Kandy,Teldeniya,Central,7267,9787,17054,290680,391480,682160
2/27/2025,Vishal Wijekoon,Kandy,Teldeniya,Central,9092,842,9934,363680,33680,397360
2/28/2025,Vishal Wijekoon,Kandy,Teldeniya,Central,808,9980,10788,32320,399200,431520
3/1/2025,Vishal Wijekoon,Kandy,Teldeniya,Central,964,6776,7740,38560,271040,309600
3/2/2025,Vishal Wijekoon,Kandy,Teldeniya,Central,8929,3199,12128,357160,127960,485120
3/3/2025,Vishal Wijekoon,Kandy,Teldeniya,Central,98,4123,4221,3920,164920,168840
3/4/2025,Vishal Wijekoon,Kandy,Teldeniya,Central,6649,5548,12197,265960,221920,487880
3/5/2025,Vishal Wijekoon,Kandy,Teldeniya,Central,2245,1619,3864,89800,64760,154560
3/6/2025,Vishal Wijekoon,Kandy,Teldeniya,Central,9834,3657,13491,393360,146280,539640
3/7/2025,Vishal Wijekoon,Kandy,Teldeniya,Central,4606,2612,7218,184240,104480,288720
3/8/2025,Vishal Wijekoon,Kandy,Teldeniya,Central,2785,2966,5751,111400,118640,230040
3/9/2025,Vishal Wijekoon,Kandy,Teldeniya,Central,4077,2278,6355,163080,91120,254200
3/10/2025,Vishal Wijekoon,Kandy,Teldeniya,Central,4610,3420,8030,184400,136800,321200
3/11/2025,Vishal Wijekoon,Kandy,Teldeniya,Central,7221,919,8140,288840,36760,325600
3/12/2025,Vishal Wijekoon,Kandy,Teldeniya,Central,8031,2578,10609,321240,103120,424360
3/13/2025,Vishal Wijekoon,Kandy,Teldeniya,Central,8648,8174,16822,345920,326960,672880
3/14/2025,Vishal Wijekoon,Kandy,Teldeniya,Central,703,8246,8949,28120,329840,357960
3/15/2025,Vishal Wijekoon,Kandy,Teldeniya,Central,6552,7672,14224,262080,306880,568960
3/16/2025,Vishal Wijekoon,Kandy,Teldeniya,Central,5617,2484,8101,224680,99360,324040
3/17/2025,Vishal Wijekoon,Kandy,Teldeniya,Central,9081,8572,17653,363240,342880,706120
3/18/2025,Vishal Wijekoon,Kandy,Teldeniya,Central,1358,9984,11342,54320,399360,453680
3/19/2025,Vishal Wijekoon,Kandy,Teldeniya,Central,6823,2667,9490,272920,106680,379600
3/20/2025,Vishal Wijekoon,Kandy,Teldeniya,Central,9623,8225,17848,384920,329000,713920
3/21/2025,Vishal Wijekoon,Kandy,Teldeniya,Central,534,7310,7844,21360,292400,313760
3/22/2025,Vishal Wijekoon,Kandy,Teldeniya,Central,313,3692,4005,12520,147680,160200
3/23/2025,Vishal Wijekoon,Kandy,Teldeniya,Central,5494,1234,6728,219760,49360,269120
3/25/2024,Duminda Weerasinghe,Ampara,Ampara,Eastern,3914,6125,10039,156560,245000,401560
3/26/2024,Duminda Weerasinghe,Ampara,Ampara,Eastern,3289,2794,6083,131560,111760,243320
3/27/2024,Duminda Weerasinghe,Ampara,Ampara,Eastern,8988,9134,18122,359520,365360,724880
3/28/2024,Duminda Weerasinghe,Ampara,Ampara,Eastern,8475,7789,16264,339000,311560,650560
3/29/2024,Duminda Weerasinghe,Ampara,Ampara,Eastern,5985,2753,8738,239400,110120,349520
3/30/2024,Duminda Weerasinghe,Ampara,Ampara,Eastern,4070,493,4563,162800,19720,182520
3/31/2024,Duminda Weerasinghe,Ampara,Ampara,Eastern,2319,9742,12061,92760,389680,482440
4/1/2024,Duminda Weerasinghe,Ampara,Ampara,Eastern,9795,9052,18847,391800,362080,753880
4/2/2024,Duminda Weerasinghe,Ampara,Ampara,Eastern,1274,1672,2946,50960,66880,117840
4/3/2024,Duminda Weerasinghe,Ampara,Ampara,Eastern,1323,2658,3981,52920,106320,159240
4/4/2024,Duminda Weerasinghe,Ampara,Ampara,Eastern,1647,6143,7790,65880,245720,311600
4/5/2024,Duminda Weerasinghe,Ampara,Ampara,Eastern,859,5423,6282,34360,216920,251280
4/6/2024,Duminda Weerasinghe,Ampara,Ampara,Eastern,7980,5619,13599,319200,224760,543960
4/7/2024,Duminda Weerasinghe,Ampara,Ampara,Eastern,5141,4530,9671,205640,181200,386840
4/8/2024,Duminda Weerasinghe,Ampara,Ampara,Eastern,8520,6644,15164,340800,265760,606560
4/9/2024,Duminda Weerasinghe,Ampara,Ampara,Eastern,3654,389,4043,146160,15560,161720
4/10/2024,Duminda Weerasinghe,Ampara,Ampara,Eastern,5170,5417,10587,206800,216680,423480
4/11/2024,Duminda Weerasinghe,Ampara,Ampara,Eastern,8260,6875,15135,330400,275000,605400
4/19/2024,Duminda Weerasinghe,Ampara,Ampara,Eastern,8657,324,8981,346280,12960,359240
4/20/2024,Duminda Weerasinghe,Ampara,Ampara,Eastern,4556,6542,11098,182240,261680,443920
4/21/2024,Duminda Weerasinghe,Ampara,Ampara,Eastern,8467,8402,16869,338680,336080,674760
4/22/2024,Duminda Weerasinghe,Ampara,Ampara,Eastern,8554,274,8828,342160,10960,353120
4/23/2024,Duminda Weerasinghe,Ampara,Ampara,Eastern,9133,6810,15943,365320,272400,637720
4/24/2024,Duminda Weerasinghe,Ampara,Ampara,Eastern,575,7048,7623,23000,281920,304920
4/25/2024,Duminda Weerasinghe,Ampara,Ampara,Eastern,6810,2490,9300,272400,99600,372000
4/26/2024,Duminda Weerasinghe,Ampara,Ampara,Eastern,4511,2203,6714,180440,88120,268560
4/27/2024,Duminda Weerasinghe,Ampara,Ampara,Eastern,3389,4199,7588,135560,167960,303520
4/28/2024,Duminda Weerasinghe,Ampara,Ampara,Eastern,4069,43,4112,162760,1720,164480
4/29/2024,Duminda Weerasinghe,Ampara,Ampara,Eastern,6548,7845,14393,261920,313800,575720
4/30/2024,Duminda Weerasinghe,Ampara,Ampara,Eastern,3258,2422,5680,130320,96880,227200
5/1/2024,Duminda Weerasinghe,Ampara,Ampara,Eastern,4868,8555,13423,194720,342200,536920
5/2/2024,Duminda Weerasinghe,Ampara,Ampara,Eastern,461,4320,4781,18440,172800,191240
5/3/2024,Duminda Weerasinghe,Ampara,Ampara,Eastern,8309,5833,14142,332360,233320,565680
5/4/2024,Duminda Weerasinghe,Ampara,Ampara,Eastern,6376,1928,8304,255040,77120,332160
5/5/2024,Duminda Weerasinghe,Ampara,Ampara,Eastern,1084,9544,10628,43360,381760,425120
5/6/2024,Duminda Weerasinghe,Ampara,Ampara,Eastern,9054,1298,10352,362160,51920,414080
5/7/2024,Duminda Weerasinghe,Ampara,Ampara,Eastern,3723,1153,4876,148920,46120,195040
5/8/2024,Duminda Weerasinghe,Ampara,Ampara,Eastern,7321,9373,16694,292840,374920,667760
5/9/2024,Duminda Weerasinghe,Ampara,Ampara,Eastern,7893,262,8155,315720,10480,326200
5/10/2024,Duminda Weerasinghe,Ampara,Ampara,Eastern,7571,806,8377,302840,32240,335080
5/11/2024,Duminda Weerasinghe,Ampara,Ampara,Eastern,3259,8319,11578,130360,332760,463120
5/12/2024,Duminda Weerasinghe,Ampara,Ampara,Eastern,2714,3922,6636,108560,156880,265440
5/13/2024,Duminda Weerasinghe,Ampara,Ampara,Eastern,7602,2442,10044,304080,97680,401760
5/14/2024,Duminda Weerasinghe,Ampara,Ampara,Eastern,2158,8314,10472,86320,332560,418880
5/15/2024,Duminda Weerasinghe,Ampara,Ampara,Eastern,8908,8225,17133,356320,329000,685320
5/16/2024,Duminda Weerasinghe,Ampara,Ampara,Eastern,1525,5613,7138,61000,224520,285520
5/17/2024,Duminda Weerasinghe,Ampara,Ampara,Eastern,6642,1481,8123,265680,59240,324920
5/18/2024,Duminda Weerasinghe,Ampara,Ampara,Eastern,8430,9733,18163,337200,389320,726520
5/19/2024,Duminda Weerasinghe,Ampara,Ampara,Eastern,509,4734,5243,20360,189360,209720
5/20/2024,Duminda Weerasinghe,Ampara,Ampara,Eastern,1262,4043,5305,50480,161720,212200
5/21/2024,Duminda Weerasinghe,Ampara,Ampara,Eastern,7356,6825,14181,294240,273000,567240
5/22/2024,Duminda Weerasinghe,Ampara,Ampara,Eastern,3306,7146,10452,132240,285840,418080
5/24/2024,Duminda Weerasinghe,Ampara,Ampara,Eastern,9253,7424,16677,370120,296960,667080
5/25/2024,Duminda Weerasinghe,Ampara,Ampara,Eastern,3591,804,4395,143640,32160,175800
5/26/2024,Duminda Weerasinghe,Ampara,Ampara,Eastern,7813,928,8741,312520,37120,349640
5/27/2024,Duminda Weerasinghe,Ampara,Ampara,Eastern,5650,9627,15277,226000,385080,611080
5/28/2024,Duminda Weerasinghe,Ampara,Ampara,Eastern,2921,1318,4239,116840,52720,169560
5/29/2024,Duminda Weerasinghe,Ampara,Ampara,Eastern,2736,8223,10959,109440,328920,438360
5/30/2024,Duminda Weerasinghe,Ampara,Ampara,Eastern,5131,6862,11993,205240,274480,479720
5/31/2024,Duminda Weerasinghe,Ampara,Ampara,Eastern,4743,2223,6966,189720,88920,278640
6/1/2024,Duminda Weerasinghe,Ampara,Ampara,Eastern,5012,6108,11120,200480,244320,444800
6/2/2024,Duminda Weerasinghe,Ampara,Ampara,Eastern,8305,2360,10665,332200,94400,426600
6/3/2024,Duminda Weerasinghe,Ampara,Ampara,Eastern,9286,1347,10633,371440,53880,425320
6/4/2024,Duminda Weerasinghe,Ampara,Ampara,Eastern,7959,5940,13899,318360,237600,555960
6/5/2024,Duminda Weerasinghe,Ampara,Ampara,Eastern,2023,5987,8010,80920,239480,320400
6/6/2024,Duminda Weerasinghe,Ampara,Ampara,Eastern,8988,4566,13554,359520,182640,542160
6/7/2024,Duminda Weerasinghe,Ampara,Ampara,Eastern,8338,8597,16935,333520,343880,677400
6/8/2024,Duminda Weerasinghe,Ampara,Ampara,Eastern,7361,4053,11414,294440,162120,456560
6/9/2024,Duminda Weerasinghe,Ampara,Ampara,Eastern,8984,3131,12115,359360,125240,484600
6/10/2024,Duminda Weerasinghe,Ampara,Ampara,Eastern,9799,238,10037,391960,9520,401480
6/11/2024,Duminda Weerasinghe,Ampara,Ampara,Eastern,9814,5412,15226,392560,216480,609040
6/12/2024,Duminda Weerasinghe,Ampara,Ampara,Eastern,7315,7590,14905,292600,303600,596200
6/13/2024,Duminda Weerasinghe,Ampara,Ampara,Eastern,24,2066,2090,960,82640,83600
6/14/2024,Duminda Weerasinghe,Ampara,Ampara,Eastern,3333,3845,7178,133320,153800,287120
6/15/2024,Duminda Weerasinghe,Ampara,Ampara,Eastern,3423,5123,8546,136920,204920,341840
6/16/2024,Duminda Weerasinghe,Ampara,Ampara,Eastern,7607,5375,12982,304280,215000,519280
6/17/2024,Duminda Weerasinghe,Ampara,Ampara,Eastern,1250,8048,9298,50000,321920,371920
6/18/2024,Duminda Weerasinghe,Ampara,Ampara,Eastern,5238,2797,8035,209520,111880,321400
6/19/2024,Duminda Weerasinghe,Ampara,Ampara,Eastern,3511,321,3832,140440,12840,153280
6/20/2024,Duminda Weerasinghe,Ampara,Ampara,Eastern,7623,8367,15990,304920,334680,639600
6/21/2024,Duminda Weerasinghe,Ampara,Ampara,Eastern,7005,1275,8280,280200,51000,331200
6/22/2024,Duminda Weerasinghe,Ampara,Ampara,Eastern,6085,1285,7370,243400,51400,294800
6/23/2024,Duminda Weerasinghe,Ampara,Ampara,Eastern,7208,9370,16578,288320,374800,663120
6/24/2024,Duminda Weerasinghe,Ampara,Ampara,Eastern,4216,5004,9220,168640,200160,368800
6/25/2024,Duminda Weerasinghe,Ampara,Ampara,Eastern,4013,4551,8564,160520,182040,342560
6/26/2024,Duminda Weerasinghe,Ampara,Ampara,Eastern,3270,6004,9274,130800,240160,370960
6/27/2024,Duminda Weerasinghe,Ampara,Ampara,Eastern,8153,3646,11799,326120,145840,471960
6/28/2024,Duminda Weerasinghe,Ampara,Ampara,Eastern,2180,3238,5418,87200,129520,216720
6/29/2024,Duminda Weerasinghe,Ampara,Ampara,Eastern,1934,7102,9036,77360,284080,361440
6/30/2024,Duminda Weerasinghe,Ampara,Ampara,Eastern,58,2336,2394,2320,93440,95760
7/1/2024,Duminda Weerasinghe,Ampara,Ampara,Eastern,1920,2576,4496,76800,103040,179840
7/2/2024,Duminda Weerasinghe,Ampara,Ampara,Eastern,9966,2515,12481,398640,100600,499240
7/3/2024,Duminda Weerasinghe,Ampara,Ampara,Eastern,1090,7388,8478,43600,295520,339120
7/4/2024,Duminda Weerasinghe,Ampara,Ampara,Eastern,1033,6439,7472,41320,257560,298880
7/5/2024,Duminda Weerasinghe,Ampara,Ampara,Eastern,2606,1398,4004,104240,55920,160160
7/6/2024,Duminda Weerasinghe,Ampara,Ampara,Eastern,4307,3198,7505,172280,127920,300200
7/7/2024,Duminda Weerasinghe,Ampara,Ampara,Eastern,4021,9547,13568,160840,381880,542720
7/8/2024,Duminda Weerasinghe,Ampara,Ampara,Eastern,7059,6613,13672,282360,264520,546880
7/9/2024,Duminda Weerasinghe,Ampara,Ampara,Eastern,9963,6352,16315,398520,254080,652600
7/10/2024,Duminda Weerasinghe,Ampara,Ampara,Eastern,9949,719,10668,397960,28760,426720
7/11/2024,Duminda Weerasinghe,Ampara,Ampara,Eastern,3355,8943,12298,134200,357720,491920
7/12/2024,Duminda Weerasinghe,Ampara,Ampara,Eastern,7070,2640,9710,282800,105600,388400
7/13/2024,Duminda Weerasinghe,Ampara,Ampara,Eastern,867,5929,6796,34680,237160,271840
7/14/2024,Duminda Weerasinghe,Ampara,Ampara,Eastern,4582,7817,12399,183280,312680,495960
7/15/2024,Duminda Weerasinghe,Ampara,Ampara,Eastern,5512,3601,9113,220480,144040,364520
7/16/2024,Duminda Weerasinghe,Ampara,Ampara,Eastern,8741,1411,10152,349640,56440,406080
7/17/2024,Duminda Weerasinghe,Ampara,Ampara,Eastern,3950,9780,13730,158000,391200,549200
7/18/2024,Duminda Weerasinghe,Ampara,Ampara,Eastern,6388,8286,14674,255520,331440,586960
7/19/2024,Duminda Weerasinghe,Ampara,Ampara,Eastern,2711,624,3335,108440,24960,133400
7/20/2024,Duminda Weerasinghe,Ampara,Ampara,Eastern,9196,1227,10423,367840,49080,416920
7/21/2024,Duminda Weerasinghe,Ampara,Ampara,Eastern,6913,8475,15388,276520,339000,615520
7/22/2024,Duminda Weerasinghe,Ampara,Ampara,Eastern,7235,3763,10998,289400,150520,439920
7/23/2024,Duminda Weerasinghe,Ampara,Ampara,Eastern,6882,5639,12521,275280,225560,500840
7/24/2024,Duminda Weerasinghe,Ampara,Ampara,Eastern,6498,6893,13391,259920,275720,535640
7/25/2024,Duminda Weerasinghe,Ampara,Ampara,Eastern,4642,7499,12141,185680,299960,485640
7/26/2024,Duminda Weerasinghe,Ampara,Ampara,Eastern,3743,5621,9364,149720,224840,374560
7/27/2024,Duminda Weerasinghe,Ampara,Ampara,Eastern,9572,40,9612,382880,1600,384480
7/28/2024,Duminda Weerasinghe,Ampara,Ampara,Eastern,7719,2770,10489,308760,110800,419560
7/29/2024,Duminda Weerasinghe,Ampara,Ampara,Eastern,8621,8702,17323,344840,348080,692920
7/30/2024,Duminda Weerasinghe,Ampara,Ampara,Eastern,4949,8555,13504,197960,342200,540160
7/31/2024,Duminda Weerasinghe,Ampara,Ampara,Eastern,1399,8447,9846,55960,337880,393840
8/1/2024,Duminda Weerasinghe,Ampara,Ampara,Eastern,2081,6354,8435,83240,254160,337400
8/2/2024,Duminda Weerasinghe,Ampara,Ampara,Eastern,5690,6670,12360,227600,266800,494400
8/3/2024,Duminda Weerasinghe,Ampara,Ampara,Eastern,9487,6526,16013,379480,261040,640520
8/4/2024,Duminda Weerasinghe,Ampara,Ampara,Eastern,7441,6264,13705,297640,250560,548200
8/5/2024,Duminda Weerasinghe,Ampara,Ampara,Eastern,7593,7688,15281,303720,307520,611240
8/6/2024,Duminda Weerasinghe,Ampara,Ampara,Eastern,664,8124,8788,26560,324960,351520
8/7/2024,Duminda Weerasinghe,Ampara,Ampara,Eastern,987,5675,6662,39480,227000,266480
8/8/2024,Duminda Weerasinghe,Ampara,Ampara,Eastern,608,7375,7983,24320,295000,319320
8/9/2024,Duminda Weerasinghe,Ampara,Ampara,Eastern,8975,3637,12612,359000,145480,504480
8/10/2024,Duminda Weerasinghe,Ampara,Ampara,Eastern,9908,4263,14171,396320,170520,566840
8/11/2024,Duminda Weerasinghe,Ampara,Ampara,Eastern,5222,2743,7965,208880,109720,318600
8/12/2024,Duminda Weerasinghe,Ampara,Ampara,Eastern,7399,30,7429,295960,1200,297160
8/13/2024,Duminda Weerasinghe,Ampara,Ampara,Eastern,5342,9697,15039,213680,387880,601560
8/14/2024,Duminda Weerasinghe,Ampara,Ampara,Eastern,28,1928,1956,1120,77120,78240
8/15/2024,Duminda Weerasinghe,Ampara,Ampara,Eastern,5148,8334,13482,205920,333360,539280
8/16/2024,Duminda Weerasinghe,Ampara,Ampara,Eastern,8179,4953,13132,327160,198120,525280
8/17/2024,Duminda Weerasinghe,Ampara,Ampara,Eastern,7663,3498,11161,306520,139920,446440
8/18/2024,Duminda Weerasinghe,Ampara,Ampara,Eastern,9782,9556,19338,391280,382240,773520
8/19/2024,Duminda Weerasinghe,Ampara,Ampara,Eastern,627,2528,3155,25080,101120,126200
8/20/2024,Duminda Weerasinghe,Ampara,Ampara,Eastern,4096,8476,12572,163840,339040,502880
8/21/2024,Duminda Weerasinghe,Ampara,Ampara,Eastern,4396,935,5331,175840,37400,213240
8/22/2024,Duminda Weerasinghe,Ampara,Ampara,Eastern,1758,3546,5304,70320,141840,212160
8/23/2024,Duminda Weerasinghe,Ampara,Ampara,Eastern,9762,934,10696,390480,37360,427840
8/24/2024,Duminda Weerasinghe,Ampara,Ampara,Eastern,914,1669,2583,36560,66760,103320
8/25/2024,Duminda Weerasinghe,Ampara,Ampara,Eastern,9675,5198,14873,387000,207920,594920
8/26/2024,Duminda Weerasinghe,Ampara,Ampara,Eastern,1023,5698,6721,40920,227920,268840
8/27/2024,Duminda Weerasinghe,Ampara,Ampara,Eastern,8987,6445,15432,359480,257800,617280
8/28/2024,Duminda Weerasinghe,Ampara,Ampara,Eastern,8613,7757,16370,344520,310280,654800
8/29/2024,Duminda Weerasinghe,Ampara,Ampara,Eastern,5204,8908,14112,208160,356320,564480
8/30/2024,Duminda Weerasinghe,Ampara,Ampara,Eastern,806,6771,7577,32240,270840,303080
8/31/2024,Duminda Weerasinghe,Ampara,Ampara,Eastern,6110,1435,7545,244400,57400,301800
9/1/2024,Duminda Weerasinghe,Ampara,Ampara,Eastern,6084,125,6209,243360,5000,248360
9/2/2024,Duminda Weerasinghe,Ampara,Ampara,Eastern,1274,4623,5897,50960,184920,235880
9/3/2024,Duminda Weerasinghe,Ampara,Ampara,Eastern,2018,1669,3687,80720,66760,147480
9/4/2024,Duminda Weerasinghe,Ampara,Ampara,Eastern,699,3348,4047,27960,133920,161880
9/5/2024,Duminda Weerasinghe,Ampara,Ampara,Eastern,5350,666,6016,214000,26640,240640
9/6/2024,Duminda Weerasinghe,Ampara,Ampara,Eastern,2027,4992,7019,81080,199680,280760
9/7/2024,Duminda Weerasinghe,Ampara,Ampara,Eastern,1300,843,2143,52000,33720,85720
9/8/2024,Duminda Weerasinghe,Ampara,Ampara,Eastern,1684,3601,5285,67360,144040,211400
9/9/2024,Duminda Weerasinghe,Ampara,Ampara,Eastern,3753,2005,5758,150120,80200,230320
9/10/2024,Duminda Weerasinghe,Ampara,Ampara,Eastern,9176,5111,14287,367040,204440,571480
9/11/2024,Duminda Weerasinghe,Ampara,Ampara,Eastern,6333,9359,15692,253320,374360,627680
9/12/2024,Duminda Weerasinghe,Ampara,Ampara,Eastern,4254,7537,11791,170160,301480,471640
9/13/2024,Duminda Weerasinghe,Ampara,Ampara,Eastern,1906,9450,11356,76240,378000,454240
9/14/2024,Duminda Weerasinghe,Ampara,Ampara,Eastern,8627,9725,18352,345080,389000,734080
9/15/2024,Duminda Weerasinghe,Ampara,Ampara,Eastern,644,2782,3426,25760,111280,137040
9/16/2024,Duminda Weerasinghe,Ampara,Ampara,Eastern,6236,6953,13189,249440,278120,527560
9/17/2024,Duminda Weerasinghe,Ampara,Ampara,Eastern,39,5919,5958,1560,236760,238320
9/18/2024,Duminda Weerasinghe,Ampara,Ampara,Eastern,1781,9352,11133,71240,374080,445320
9/19/2024,Duminda Weerasinghe,Ampara,Ampara,Eastern,463,6114,6577,18520,244560,263080
9/20/2024,Duminda Weerasinghe,Ampara,Ampara,Eastern,8020,1452,9472,320800,58080,378880
9/21/2024,Duminda Weerasinghe,Ampara,Ampara,Eastern,7744,6512,14256,309760,260480,570240
9/22/2024,Duminda Weerasinghe,Ampara,Ampara,Eastern,8910,2782,11692,356400,111280,467680
9/23/2024,Duminda Weerasinghe,Ampara,Ampara,Eastern,3619,2053,5672,144760,82120,226880
9/24/2024,Duminda Weerasinghe,Ampara,Ampara,Eastern,1745,3466,5211,69800,138640,208440
9/25/2024,Duminda Weerasinghe,Ampara,Ampara,Eastern,9209,5648,14857,368360,225920,594280
9/26/2024,Duminda Weerasinghe,Ampara,Ampara,Eastern,6446,9461,15907,257840,378440,636280
9/27/2024,Duminda Weerasinghe,Ampara,Ampara,Eastern,3967,7832,11799,158680,313280,471960
9/28/2024,Duminda Weerasinghe,Ampara,Ampara,Eastern,3817,2205,6022,152680,88200,240880
9/29/2024,Duminda Weerasinghe,Ampara,Ampara,Eastern,6452,358,6810,258080,14320,272400
9/30/2024,Duminda Weerasinghe,Ampara,Ampara,Eastern,2321,1777,4098,92840,71080,163920
10/1/2024,Duminda Weerasinghe,Ampara,Ampara,Eastern,6098,9044,15142,243920,361760,605680
10/2/2024,Duminda Weerasinghe,Ampara,Ampara,Eastern,1461,5259,6720,58440,210360,268800
10/3/2024,Duminda Weerasinghe,Ampara,Ampara,Eastern,3712,5966,9678,148480,238640,387120
10/4/2024,Duminda Weerasinghe,Ampara,Ampara,Eastern,6286,9930,16216,251440,397200,648640
10/5/2024,Duminda Weerasinghe,Ampara,Ampara,Eastern,5581,2680,8261,223240,107200,330440
10/6/2024,Duminda Weerasinghe,Ampara,Ampara,Eastern,1444,9503,10947,57760,380120,437880
10/7/2024,Duminda Weerasinghe,Ampara,Ampara,Eastern,8824,9108,17932,352960,364320,717280
10/8/2024,Duminda Weerasinghe,Ampara,Ampara,Eastern,9332,5399,14731,373280,215960,589240
10/9/2024,Duminda Weerasinghe,Ampara,Ampara,Eastern,6418,2182,8600,256720,87280,344000
10/10/2024,Duminda Weerasinghe,Ampara,Ampara,Eastern,8908,7266,16174,356320,290640,646960
10/11/2024,Duminda Weerasinghe,Ampara,Ampara,Eastern,8920,5051,13971,356800,202040,558840
10/12/2024,Duminda Weerasinghe,Ampara,Ampara,Eastern,668,639,1307,26720,25560,52280
10/13/2024,Duminda Weerasinghe,Ampara,Ampara,Eastern,9048,170,9218,361920,6800,368720
10/14/2024,Duminda Weerasinghe,Ampara,Ampara,Eastern,4437,6752,11189,177480,270080,447560
10/15/2024,Duminda Weerasinghe,Ampara,Ampara,Eastern,5156,1271,6427,206240,50840,257080
10/16/2024,Duminda Weerasinghe,Ampara,Ampara,Eastern,5712,3781,9493,228480,151240,379720
10/17/2024,Duminda Weerasinghe,Ampara,Ampara,Eastern,1758,7463,9221,70320,298520,368840
10/18/2024,Duminda Weerasinghe,Ampara,Ampara,Eastern,9781,517,10298,391240,20680,411920
10/19/2024,Duminda Weerasinghe,Ampara,Ampara,Eastern,9554,798,10352,382160,31920,414080
10/20/2024,Duminda Weerasinghe,Ampara,Ampara,Eastern,8554,2793,11347,342160,111720,453880
10/21/2024,Duminda Weerasinghe,Ampara,Ampara,Eastern,7505,7540,15045,300200,301600,601800
10/22/2024,Duminda Weerasinghe,Ampara,Ampara,Eastern,9111,9887,18998,364440,395480,759920
10/23/2024,Duminda Weerasinghe,Ampara,Ampara,Eastern,9162,8727,17889,366480,349080,715560
10/24/2024,Duminda Weerasinghe,Ampara,Ampara,Eastern,2591,8775,11366,103640,351000,454640
10/25/2024,Duminda Weerasinghe,Ampara,Ampara,Eastern,945,6001,6946,37800,240040,277840
10/26/2024,Duminda Weerasinghe,Ampara,Ampara,Eastern,2631,4937,7568,105240,197480,302720
10/27/2024,Duminda Weerasinghe,Ampara,Ampara,Eastern,9103,1722,10825,364120,68880,433000
10/28/2024,Duminda Weerasinghe,Ampara,Ampara,Eastern,292,6320,6612,11680,252800,264480
10/29/2024,Duminda Weerasinghe,Ampara,Ampara,Eastern,7471,5143,12614,298840,205720,504560
10/30/2024,Duminda Weerasinghe,Ampara,Ampara,Eastern,2040,5363,7403,81600,214520,296120
10/31/2024,Duminda Weerasinghe,Ampara,Ampara,Eastern,2452,3790,6242,98080,151600,249680
11/1/2024,Duminda Weerasinghe,Ampara,Ampara,Eastern,4355,9897,14252,174200,395880,570080
11/2/2024,Duminda Weerasinghe,Ampara,Ampara,Eastern,8970,4199,13169,358800,167960,526760
11/3/2024,Duminda Weerasinghe,Ampara,Ampara,Eastern,3382,7866,11248,135280,314640,449920
11/4/2024,Duminda Weerasinghe,Ampara,Ampara,Eastern,4596,9712,14308,183840,388480,572320
11/5/2024,Duminda Weerasinghe,Ampara,Ampara,Eastern,3476,4545,8021,139040,181800,320840
11/6/2024,Duminda Weerasinghe,Ampara,Ampara,Eastern,2155,5910,8065,86200,236400,322600
11/7/2024,Duminda Weerasinghe,Ampara,Ampara,Eastern,1370,4464,5834,54800,178560,233360
11/8/2024,Duminda Weerasinghe,Ampara,Ampara,Eastern,2724,2996,5720,108960,119840,228800
11/9/2024,Duminda Weerasinghe,Ampara,Ampara,Eastern,4989,7631,12620,199560,305240,504800
11/10/2024,Duminda Weerasinghe,Ampara,Ampara,Eastern,8303,6631,14934,332120,265240,597360
11/11/2024,Duminda Weerasinghe,Ampara,Ampara,Eastern,7876,5316,13192,315040,212640,527680
11/12/2024,Duminda Weerasinghe,Ampara,Ampara,Eastern,8447,6676,15123,337880,267040,604920
11/13/2024,Duminda Weerasinghe,Ampara,Ampara,Eastern,92,4409,4501,3680,176360,180040
11/14/2024,Duminda Weerasinghe,Ampara,Ampara,Eastern,6071,353,6424,242840,14120,256960
11/15/2024,Duminda Weerasinghe,Ampara,Ampara,Eastern,6759,3399,10158,270360,135960,406320
11/16/2024,Duminda Weerasinghe,Ampara,Ampara,Eastern,8801,4125,12926,352040,165000,517040
11/17/2024,Duminda Weerasinghe,Ampara,Ampara,Eastern,5928,3603,9531,237120,144120,381240
11/18/2024,Duminda Weerasinghe,Ampara,Ampara,Eastern,8700,2556,11256,348000,102240,450240
11/19/2024,Duminda Weerasinghe,Ampara,Ampara,Eastern,1086,486,1572,43440,19440,62880
11/20/2024,Duminda Weerasinghe,Ampara,Ampara,Eastern,1809,8701,10510,72360,348040,420400
11/21/2024,Duminda Weerasinghe,Ampara,Ampara,Eastern,5906,150,6056,236240,6000,242240
11/22/2024,Duminda Weerasinghe,Ampara,Ampara,Eastern,7067,482,7549,282680,19280,301960
11/23/2024,Duminda Weerasinghe,Ampara,Ampara,Eastern,8743,1051,9794,349720,42040,391760
11/24/2024,Duminda Weerasinghe,Ampara,Ampara,Eastern,2697,6861,9558,107880,274440,382320
11/25/2024,Duminda Weerasinghe,Ampara,Ampara,Eastern,2375,8104,10479,95000,324160,419160
11/26/2024,Duminda Weerasinghe,Ampara,Ampara,Eastern,3974,431,4405,158960,17240,176200
11/27/2024,Duminda Weerasinghe,Ampara,Ampara,Eastern,3700,7970,11670,148000,318800,466800
11/28/2024,Duminda Weerasinghe,Ampara,Ampara,Eastern,2631,8790,11421,105240,351600,456840
11/29/2024,Duminda Weerasinghe,Ampara,Ampara,Eastern,7353,2436,9789,294120,97440,391560
11/30/2024,Duminda Weerasinghe,Ampara,Ampara,Eastern,1699,539,2238,67960,21560,89520
12/1/2024,Duminda Weerasinghe,Ampara,Ampara,Eastern,7727,7735,15462,309080,309400,618480
12/2/2024,Duminda Weerasinghe,Ampara,Ampara,Eastern,6319,571,6890,252760,22840,275600
12/3/2024,Duminda Weerasinghe,Ampara,Ampara,Eastern,8202,3856,12058,328080,154240,482320
12/4/2024,Duminda Weerasinghe,Ampara,Ampara,Eastern,4738,4762,9500,189520,190480,380000
12/5/2024,Duminda Weerasinghe,Ampara,Ampara,Eastern,8995,7768,16763,359800,310720,670520
12/6/2024,Duminda Weerasinghe,Ampara,Ampara,Eastern,7989,4049,12038,319560,161960,481520
12/7/2024,Duminda Weerasinghe,Ampara,Ampara,Eastern,5378,1287,6665,215120,51480,266600
12/8/2024,Duminda Weerasinghe,Ampara,Ampara,Eastern,367,4883,5250,14680,195320,210000
12/9/2024,Duminda Weerasinghe,Ampara,Ampara,Eastern,2111,2574,4685,84440,102960,187400
12/10/2024,Duminda Weerasinghe,Ampara,Ampara,Eastern,6787,4096,10883,271480,163840,435320
12/11/2024,Duminda Weerasinghe,Ampara,Ampara,Eastern,4349,1481,5830,173960,59240,233200
12/12/2024,Duminda Weerasinghe,Ampara,Ampara,Eastern,5093,300,5393,203720,12000,215720
12/13/2024,Duminda Weerasinghe,Ampara,Ampara,Eastern,9701,9795,19496,388040,391800,779840
12/14/2024,Duminda Weerasinghe,Ampara,Ampara,Eastern,5597,2318,7915,223880,92720,316600
12/15/2024,Duminda Weerasinghe,Ampara,Ampara,Eastern,2177,7491,9668,87080,299640,386720
12/16/2024,Duminda Weerasinghe,Ampara,Ampara,Eastern,8895,6491,15386,355800,259640,615440
12/17/2024,Duminda Weerasinghe,Ampara,Ampara,Eastern,432,676,1108,17280,27040,44320
12/18/2024,Duminda Weerasinghe,Ampara,Ampara,Eastern,2655,2240,4895,106200,89600,195800
12/19/2024,Duminda Weerasinghe,Ampara,Ampara,Eastern,4557,9600,14157,182280,384000,566280
12/20/2024,Duminda Weerasinghe,Ampara,Ampara,Eastern,9999,5894,15893,399960,235760,635720
12/21/2024,Duminda Weerasinghe,Ampara,Ampara,Eastern,6351,7869,14220,254040,314760,568800
12/22/2024,Duminda Weerasinghe,Ampara,Ampara,Eastern,640,294,934,25600,11760,37360
12/23/2024,Duminda Weerasinghe,Ampara,Ampara,Eastern,5503,5335,10838,220120,213400,433520
12/24/2024,Duminda Weerasinghe,Ampara,Ampara,Eastern,7807,6795,14602,312280,271800,584080
12/25/2024,Duminda Weerasinghe,Ampara,Ampara,Eastern,1743,5305,7048,69720,212200,281920
12/26/2024,Duminda Weerasinghe,Ampara,Ampara,Eastern,7371,8804,16175,294840,352160,647000
12/27/2024,Duminda Weerasinghe,Ampara,Ampara,Eastern,2619,7111,9730,104760,284440,389200
12/28/2024,Duminda Weerasinghe,Ampara,Ampara,Eastern,2387,71,2458,95480,2840,98320
12/29/2024,Duminda Weerasinghe,Ampara,Ampara,Eastern,5202,2766,7968,208080,110640,318720
12/30/2024,Duminda Weerasinghe,Ampara,Ampara,Eastern,3373,9996,13369,134920,399840,534760
12/31/2024,Duminda Weerasinghe,Ampara,Ampara,Eastern,6889,3467,10356,275560,138680,414240
1/1/2025,Duminda Weerasinghe,Ampara,Ampara,Eastern,8481,3365,11846,339240,134600,473840
1/2/2025,Duminda Weerasinghe,Ampara,Ampara,Eastern,766,6206,6972,30640,248240,278880
1/3/2025,Duminda Weerasinghe,Ampara,Ampara,Eastern,7620,754,8374,304800,30160,334960
1/4/2025,Duminda Weerasinghe,Ampara,Ampara,Eastern,3077,7388,10465,123080,295520,418600
1/5/2025,Duminda Weerasinghe,Ampara,Ampara,Eastern,1825,3470,5295,73000,138800,211800
1/6/2025,Duminda Weerasinghe,Ampara,Ampara,Eastern,432,2530,2962,17280,101200,118480
1/7/2025,Duminda Weerasinghe,Ampara,Ampara,Eastern,8058,3082,11140,322320,123280,445600
1/8/2025,Duminda Weerasinghe,Ampara,Ampara,Eastern,1284,9301,10585,51360,372040,423400
1/9/2025,Duminda Weerasinghe,Ampara,Ampara,Eastern,9949,5209,15158,397960,208360,606320
1/10/2025,Duminda Weerasinghe,Ampara,Ampara,Eastern,7566,3874,11440,302640,154960,457600
1/11/2025,Duminda Weerasinghe,Ampara,Ampara,Eastern,7291,3877,11168,291640,155080,446720
1/12/2025,Duminda Weerasinghe,Ampara,Ampara,Eastern,5545,4198,9743,221800,167920,389720
1/13/2025,Duminda Weerasinghe,Ampara,Ampara,Eastern,7106,1316,8422,284240,52640,336880
1/14/2025,Duminda Weerasinghe,Ampara,Ampara,Eastern,7280,898,8178,291200,35920,327120
1/15/2025,Duminda Weerasinghe,Ampara,Ampara,Eastern,893,3607,4500,35720,144280,180000
1/16/2025,Duminda Weerasinghe,Ampara,Ampara,Eastern,6665,6259,12924,266600,250360,516960
1/17/2025,Duminda Weerasinghe,Ampara,Ampara,Eastern,1680,6502,8182,67200,260080,327280
1/18/2025,Duminda Weerasinghe,Ampara,Ampara,Eastern,2958,7963,10921,118320,318520,436840
1/19/2025,Duminda Weerasinghe,Ampara,Ampara,Eastern,4998,4105,9103,199920,164200,364120
1/20/2025,Duminda Weerasinghe,Ampara,Ampara,Eastern,4268,5920,10188,170720,236800,407520
1/21/2025,Duminda Weerasinghe,Ampara,Ampara,Eastern,6671,3139,9810,266840,125560,392400
1/22/2025,Duminda Weerasinghe,Ampara,Ampara,Eastern,1392,4992,6384,55680,199680,255360
1/23/2025,Duminda Weerasinghe,Ampara,Ampara,Eastern,4621,4880,9501,184840,195200,380040
1/24/2025,Duminda Weerasinghe,Ampara,Ampara,Eastern,9465,7602,17067,378600,304080,682680
1/25/2025,Duminda Weerasinghe,Ampara,Ampara,Eastern,4044,883,4927,161760,35320,197080
1/26/2025,Duminda Weerasinghe,Ampara,Ampara,Eastern,1289,6761,8050,51560,270440,322000
1/27/2025,Duminda Weerasinghe,Ampara,Ampara,Eastern,1479,9318,10797,59160,372720,431880
1/28/2025,Duminda Weerasinghe,Ampara,Ampara,Eastern,9167,8351,17518,366680,334040,700720
1/29/2025,Duminda Weerasinghe,Ampara,Ampara,Eastern,2097,3174,5271,83880,126960,210840
1/30/2025,Duminda Weerasinghe,Ampara,Ampara,Eastern,6035,9424,15459,241400,376960,618360
1/31/2025,Duminda Weerasinghe,Ampara,Ampara,Eastern,5509,2823,8332,220360,112920,333280
2/1/2025,Duminda Weerasinghe,Ampara,Ampara,Eastern,9353,5432,14785,374120,217280,591400
2/2/2025,Duminda Weerasinghe,Ampara,Ampara,Eastern,4296,2619,6915,171840,104760,276600
2/3/2025,Duminda Weerasinghe,Ampara,Ampara,Eastern,3304,6372,9676,132160,254880,387040
2/4/2025,Duminda Weerasinghe,Ampara,Ampara,Eastern,8621,9099,17720,344840,363960,708800
2/5/2025,Duminda Weerasinghe,Ampara,Ampara,Eastern,8531,5155,13686,341240,206200,547440
2/6/2025,Duminda Weerasinghe,Ampara,Ampara,Eastern,1699,9882,11581,67960,395280,463240
2/7/2025,Duminda Weerasinghe,Ampara,Ampara,Eastern,6760,8441,15201,270400,337640,608040
2/8/2025,Duminda Weerasinghe,Ampara,Ampara,Eastern,6837,3812,10649,273480,152480,425960
2/9/2025,Duminda Weerasinghe,Ampara,Ampara,Eastern,1729,1244,2973,69160,49760,118920
2/10/2025,Duminda Weerasinghe,Ampara,Ampara,Eastern,9423,1214,10637,376920,48560,425480
2/11/2025,Duminda Weerasinghe,Ampara,Ampara,Eastern,9248,6920,16168,369920,276800,646720
2/12/2025,Duminda Weerasinghe,Ampara,Ampara,Eastern,2512,8529,11041,100480,341160,441640
2/13/2025,Duminda Weerasinghe,Ampara,Ampara,Eastern,7143,1074,8217,285720,42960,328680
2/14/2025,Duminda Weerasinghe,Ampara,Ampara,Eastern,5326,7092,12418,213040,283680,496720
2/15/2025,Duminda Weerasinghe,Ampara,Ampara,Eastern,5238,8576,13814,209520,343040,552560
2/16/2025,Duminda Weerasinghe,Ampara,Ampara,Eastern,7976,5384,13360,319040,215360,534400
2/17/2025,Duminda Weerasinghe,Ampara,Ampara,Eastern,2329,7049,9378,93160,281960,375120
2/18/2025,Duminda Weerasinghe,Ampara,Ampara,Eastern,1592,5078,6670,63680,203120,266800
2/19/2025,Duminda Weerasinghe,Ampara,Ampara,Eastern,3726,7658,11384,149040,306320,455360
2/20/2025,Duminda Weerasinghe,Ampara,Ampara,Eastern,5872,6087,11959,234880,243480,478360
2/21/2025,Duminda Weerasinghe,Ampara,Ampara,Eastern,4561,4995,9556,182440,199800,382240
2/22/2025,Duminda Weerasinghe,Ampara,Ampara,Eastern,6128,5074,11202,245120,202960,448080
2/23/2025,Duminda Weerasinghe,Ampara,Ampara,Eastern,1370,5034,6404,54800,201360,256160
2/24/2025,Duminda Weerasinghe,Ampara,Ampara,Eastern,6314,862,7176,252560,34480,287040
2/25/2025,Duminda Weerasinghe,Ampara,Ampara,Eastern,3928,973,4901,157120,38920,196040
2/26/2025,Duminda Weerasinghe,Ampara,Ampara,Eastern,3957,5910,9867,158280,236400,394680
2/27/2025,Duminda Weerasinghe,Ampara,Ampara,Eastern,291,9261,9552,11640,370440,382080
2/28/2025,Duminda Weerasinghe,Ampara,Ampara,Eastern,6781,9485,16266,271240,379400,650640
3/1/2025,Duminda Weerasinghe,Ampara,Ampara,Eastern,9658,779,10437,386320,31160,417480
3/2/2025,Duminda Weerasinghe,Ampara,Ampara,Eastern,8246,9856,18102,329840,394240,724080
3/3/2025,Duminda Weerasinghe,Ampara,Ampara,Eastern,4919,4707,9626,196760,188280,385040
3/4/2025,Duminda Weerasinghe,Ampara,Ampara,Eastern,7784,978,8762,311360,39120,350480
3/5/2025,Duminda Weerasinghe,Ampara,Ampara,Eastern,5310,7070,12380,212400,282800,495200
3/6/2025,Duminda Weerasinghe,Ampara,Ampara,Eastern,6237,8830,15067,249480,353200,602680
3/7/2025,Duminda Weerasinghe,Ampara,Ampara,Eastern,3858,2173,6031,154320,86920,241240
3/8/2025,Duminda Weerasinghe,Ampara,Ampara,Eastern,1664,8585,10249,66560,343400,409960
3/9/2025,Duminda Weerasinghe,Ampara,Ampara,Eastern,8611,4333,12944,344440,173320,517760
3/10/2025,Duminda Weerasinghe,Ampara,Ampara,Eastern,5259,4660,9919,210360,186400,396760
3/11/2025,Duminda Weerasinghe,Ampara,Ampara,Eastern,6690,9133,15823,267600,365320,632920
3/12/2025,Duminda Weerasinghe,Ampara,Ampara,Eastern,8674,5972,14646,346960,238880,585840
3/13/2025,Duminda Weerasinghe,Ampara,Ampara,Eastern,1722,6725,8447,68880,269000,337880
3/14/2025,Duminda Weerasinghe,Ampara,Ampara,Eastern,7833,4868,12701,313320,194720,508040
3/15/2025,Duminda Weerasinghe,Ampara,Ampara,Eastern,3935,8468,12403,157400,338720,496120
3/16/2025,Duminda Weerasinghe,Ampara,Ampara,Eastern,8176,6793,14969,327040,271720,598760
3/17/2025,Duminda Weerasinghe,Ampara,Ampara,Eastern,7049,5373,12422,281960,214920,496880
3/18/2025,Duminda Weerasinghe,Ampara,Ampara,Eastern,5053,7747,12800,202120,309880,512000
3/19/2025,Duminda Weerasinghe,Ampara,Ampara,Eastern,895,8980,9875,35800,359200,395000
3/20/2025,Duminda Weerasinghe,Ampara,Ampara,Eastern,1567,8352,9919,62680,334080,396760
3/21/2025,Duminda Weerasinghe,Ampara,Ampara,Eastern,214,6760,6974,8560,270400,278960
3/22/2025,Duminda Weerasinghe,Ampara,Ampara,Eastern,3404,417,3821,136160,16680,152840
3/23/2025,Duminda Weerasinghe,Ampara,Ampara,Eastern,8923,8912,17835,356920,356480,713400
3/25/2024,Anusha Dissanayake,Moneragala,Kataragama,Uva,3344,5337,8681,133760,213480,347240
3/26/2024,Anusha Dissanayake,Moneragala,Kataragama,Uva,2107,8027,10134,84280,321080,405360
3/27/2024,Anusha Dissanayake,Moneragala,Kataragama,Uva,6947,7106,14053,277880,284240,562120
3/28/2024,Anusha Dissanayake,Moneragala,Kataragama,Uva,9274,8306,17580,370960,332240,703200
3/29/2024,Anusha Dissanayake,Moneragala,Kataragama,Uva,4233,9665,13898,169320,386600,555920
3/30/2024,Anusha Dissanayake,Moneragala,Kataragama,Uva,8109,1437,9546,324360,57480,381840
3/31/2024,Anusha Dissanayake,Moneragala,Kataragama,Uva,7696,5681,13377,307840,227240,535080
4/1/2024,Anusha Dissanayake,Moneragala,Kataragama,Uva,9048,9644,18692,361920,385760,747680
4/2/2024,Anusha Dissanayake,Moneragala,Kataragama,Uva,1981,66,2047,79240,2640,81880
4/3/2024,Anusha Dissanayake,Moneragala,Kataragama,Uva,6997,9622,16619,279880,384880,664760
4/4/2024,Anusha Dissanayake,Moneragala,Kataragama,Uva,2029,112,2141,81160,4480,85640
4/5/2024,Anusha Dissanayake,Moneragala,Kataragama,Uva,9774,9201,18975,390960,368040,759000
4/6/2024,Anusha Dissanayake,Moneragala,Kataragama,Uva,9591,9774,19365,383640,390960,774600
4/7/2024,Anusha Dissanayake,Moneragala,Kataragama,Uva,3933,9361,13294,157320,374440,531760
4/8/2024,Anusha Dissanayake,Moneragala,Kataragama,Uva,4778,177,4955,191120,7080,198200
4/9/2024,Anusha Dissanayake,Moneragala,Kataragama,Uva,6435,4276,10711,257400,171040,428440
4/10/2024,Anusha Dissanayake,Moneragala,Kataragama,Uva,4110,5585,9695,164400,223400,387800
4/11/2024,Anusha Dissanayake,Moneragala,Kataragama,Uva,9671,9139,18810,386840,365560,752400
4/19/2024,Anusha Dissanayake,Moneragala,Kataragama,Uva,192,6540,6732,7680,261600,269280
4/20/2024,Anusha Dissanayake,Moneragala,Kataragama,Uva,5262,9934,15196,210480,397360,607840
4/21/2024,Anusha Dissanayake,Moneragala,Kataragama,Uva,4686,4430,9116,187440,177200,364640
4/22/2024,Anusha Dissanayake,Moneragala,Kataragama,Uva,3641,337,3978,145640,13480,159120
4/23/2024,Anusha Dissanayake,Moneragala,Kataragama,Uva,4878,8350,13228,195120,334000,529120
4/24/2024,Anusha Dissanayake,Moneragala,Kataragama,Uva,2022,8905,10927,80880,356200,437080
4/25/2024,Anusha Dissanayake,Moneragala,Kataragama,Uva,1935,2974,4909,77400,118960,196360
4/26/2024,Anusha Dissanayake,Moneragala,Kataragama,Uva,7646,3897,11543,305840,155880,461720
4/27/2024,Anusha Dissanayake,Moneragala,Kataragama,Uva,2633,4273,6906,105320,170920,276240
4/28/2024,Anusha Dissanayake,Moneragala,Kataragama,Uva,8590,8847,17437,343600,353880,697480
4/29/2024,Anusha Dissanayake,Moneragala,Kataragama,Uva,8319,334,8653,332760,13360,346120
4/30/2024,Anusha Dissanayake,Moneragala,Kataragama,Uva,3650,4299,7949,146000,171960,317960
5/1/2024,Anusha Dissanayake,Moneragala,Kataragama,Uva,456,9373,9829,18240,374920,393160
5/2/2024,Anusha Dissanayake,Moneragala,Kataragama,Uva,1276,9450,10726,51040,378000,429040
5/3/2024,Anusha Dissanayake,Moneragala,Kataragama,Uva,5201,56,5257,208040,2240,210280
5/4/2024,Anusha Dissanayake,Moneragala,Kataragama,Uva,5378,896,6274,215120,35840,250960
5/5/2024,Anusha Dissanayake,Moneragala,Kataragama,Uva,2801,2015,4816,112040,80600,192640
5/6/2024,Anusha Dissanayake,Moneragala,Kataragama,Uva,5993,1689,7682,239720,67560,307280
5/7/2024,Anusha Dissanayake,Moneragala,Kataragama,Uva,9359,7364,16723,374360,294560,668920
5/8/2024,Anusha Dissanayake,Moneragala,Kataragama,Uva,6612,4214,10826,264480,168560,433040
5/9/2024,Anusha Dissanayake,Moneragala,Kataragama,Uva,3455,7118,10573,138200,284720,422920
5/10/2024,Anusha Dissanayake,Moneragala,Kataragama,Uva,6755,7688,14443,270200,307520,577720
5/11/2024,Anusha Dissanayake,Moneragala,Kataragama,Uva,209,2002,2211,8360,80080,88440
5/12/2024,Anusha Dissanayake,Moneragala,Kataragama,Uva,7097,906,8003,283880,36240,320120
5/13/2024,Anusha Dissanayake,Moneragala,Kataragama,Uva,8996,5192,14188,359840,207680,567520
5/14/2024,Anusha Dissanayake,Moneragala,Kataragama,Uva,6388,4517,10905,255520,180680,436200
5/15/2024,Anusha Dissanayake,Moneragala,Kataragama,Uva,8864,7136,16000,354560,285440,640000
5/16/2024,Anusha Dissanayake,Moneragala,Kataragama,Uva,123,1166,1289,4920,46640,51560
5/17/2024,Anusha Dissanayake,Moneragala,Kataragama,Uva,6856,9552,16408,274240,382080,656320
5/18/2024,Anusha Dissanayake,Moneragala,Kataragama,Uva,3665,9780,13445,146600,391200,537800
5/19/2024,Anusha Dissanayake,Moneragala,Kataragama,Uva,3065,233,3298,122600,9320,131920
5/20/2024,Anusha Dissanayake,Moneragala,Kataragama,Uva,186,8882,9068,7440,355280,362720
5/21/2024,Anusha Dissanayake,Moneragala,Kataragama,Uva,7442,1650,9092,297680,66000,363680
5/22/2024,Anusha Dissanayake,Moneragala,Kataragama,Uva,9947,305,10252,397880,12200,410080
5/24/2024,Anusha Dissanayake,Moneragala,Kataragama,Uva,448,7340,7788,17920,293600,311520
5/25/2024,Anusha Dissanayake,Moneragala,Kataragama,Uva,676,8113,8789,27040,324520,351560
5/26/2024,Anusha Dissanayake,Moneragala,Kataragama,Uva,7265,4902,12167,290600,196080,486680
5/27/2024,Anusha Dissanayake,Moneragala,Kataragama,Uva,2795,352,3147,111800,14080,125880
5/28/2024,Anusha Dissanayake,Moneragala,Kataragama,Uva,7465,7773,15238,298600,310920,609520
5/29/2024,Anusha Dissanayake,Moneragala,Kataragama,Uva,9536,2014,11550,381440,80560,462000
5/30/2024,Anusha Dissanayake,Moneragala,Kataragama,Uva,6867,1565,8432,274680,62600,337280
5/31/2024,Anusha Dissanayake,Moneragala,Kataragama,Uva,5906,4665,10571,236240,186600,422840
6/1/2024,Anusha Dissanayake,Moneragala,Kataragama,Uva,2632,8372,11004,105280,334880,440160
6/2/2024,Anusha Dissanayake,Moneragala,Kataragama,Uva,406,6363,6769,16240,254520,270760
6/3/2024,Anusha Dissanayake,Moneragala,Kataragama,Uva,2206,4184,6390,88240,167360,255600
6/4/2024,Anusha Dissanayake,Moneragala,Kataragama,Uva,1758,5252,7010,70320,210080,280400
6/5/2024,Anusha Dissanayake,Moneragala,Kataragama,Uva,9373,3082,12455,374920,123280,498200
6/6/2024,Anusha Dissanayake,Moneragala,Kataragama,Uva,425,7115,7540,17000,284600,301600
6/7/2024,Anusha Dissanayake,Moneragala,Kataragama,Uva,9780,8381,18161,391200,335240,726440
6/8/2024,Anusha Dissanayake,Moneragala,Kataragama,Uva,8758,8259,17017,350320,330360,680680
6/9/2024,Anusha Dissanayake,Moneragala,Kataragama,Uva,9671,8767,18438,386840,350680,737520
6/10/2024,Anusha Dissanayake,Moneragala,Kataragama,Uva,5761,1827,7588,230440,73080,303520
6/11/2024,Anusha Dissanayake,Moneragala,Kataragama,Uva,9920,4946,14866,396800,197840,594640
6/12/2024,Anusha Dissanayake,Moneragala,Kataragama,Uva,4376,3067,7443,175040,122680,297720
6/13/2024,Anusha Dissanayake,Moneragala,Kataragama,Uva,5987,2738,8725,239480,109520,349000
6/14/2024,Anusha Dissanayake,Moneragala,Kataragama,Uva,2831,7747,10578,113240,309880,423120
6/15/2024,Anusha Dissanayake,Moneragala,Kataragama,Uva,8206,1129,9335,328240,45160,373400
6/16/2024,Anusha Dissanayake,Moneragala,Kataragama,Uva,2068,8425,10493,82720,337000,419720
6/17/2024,Anusha Dissanayake,Moneragala,Kataragama,Uva,8010,7697,15707,320400,307880,628280
6/18/2024,Anusha Dissanayake,Moneragala,Kataragama,Uva,9412,1729,11141,376480,69160,445640
6/19/2024,Anusha Dissanayake,Moneragala,Kataragama,Uva,6470,1662,8132,258800,66480,325280
6/20/2024,Anusha Dissanayake,Moneragala,Kataragama,Uva,1072,5858,6930,42880,234320,277200
6/21/2024,Anusha Dissanayake,Moneragala,Kataragama,Uva,4036,4033,8069,161440,161320,322760
6/22/2024,Anusha Dissanayake,Moneragala,Kataragama,Uva,2535,6484,9019,101400,259360,360760
6/23/2024,Anusha Dissanayake,Moneragala,Kataragama,Uva,3120,5127,8247,124800,205080,329880
6/24/2024,Anusha Dissanayake,Moneragala,Kataragama,Uva,222,5011,5233,8880,200440,209320
6/25/2024,Anusha Dissanayake,Moneragala,Kataragama,Uva,479,8678,9157,19160,347120,366280
6/26/2024,Anusha Dissanayake,Moneragala,Kataragama,Uva,3228,8477,11705,129120,339080,468200
6/27/2024,Anusha Dissanayake,Moneragala,Kataragama,Uva,1850,9563,11413,74000,382520,456520
6/28/2024,Anusha Dissanayake,Moneragala,Kataragama,Uva,6649,4515,11164,265960,180600,446560
6/29/2024,Anusha Dissanayake,Moneragala,Kataragama,Uva,8060,5436,13496,322400,217440,539840
6/30/2024,Anusha Dissanayake,Moneragala,Kataragama,Uva,4754,7447,12201,190160,297880,488040
7/1/2024,Anusha Dissanayake,Moneragala,Kataragama,Uva,2453,304,2757,98120,12160,110280
7/2/2024,Anusha Dissanayake,Moneragala,Kataragama,Uva,7884,5586,13470,315360,223440,538800
7/3/2024,Anusha Dissanayake,Moneragala,Kataragama,Uva,7672,2023,9695,306880,80920,387800
7/4/2024,Anusha Dissanayake,Moneragala,Kataragama,Uva,5375,9213,14588,215000,368520,583520
7/5/2024,Anusha Dissanayake,Moneragala,Kataragama,Uva,3246,2645,5891,129840,105800,235640
7/6/2024,Anusha Dissanayake,Moneragala,Kataragama,Uva,9777,8017,17794,391080,320680,711760
7/7/2024,Anusha Dissanayake,Moneragala,Kataragama,Uva,311,6330,6641,12440,253200,265640
7/8/2024,Anusha Dissanayake,Moneragala,Kataragama,Uva,2262,2988,5250,90480,119520,210000
7/9/2024,Anusha Dissanayake,Moneragala,Kataragama,Uva,882,1688,2570,35280,67520,102800
7/10/2024,Anusha Dissanayake,Moneragala,Kataragama,Uva,5157,3316,8473,206280,132640,338920
7/11/2024,Anusha Dissanayake,Moneragala,Kataragama,Uva,8834,5235,14069,353360,209400,562760
7/12/2024,Anusha Dissanayake,Moneragala,Kataragama,Uva,8916,8254,17170,356640,330160,686800
7/13/2024,Anusha Dissanayake,Moneragala,Kataragama,Uva,9111,3223,12334,364440,128920,493360
7/14/2024,Anusha Dissanayake,Moneragala,Kataragama,Uva,690,3238,3928,27600,129520,157120
7/15/2024,Anusha Dissanayake,Moneragala,Kataragama,Uva,4472,2071,6543,178880,82840,261720
7/16/2024,Anusha Dissanayake,Moneragala,Kataragama,Uva,1562,8877,10439,62480,355080,417560
7/17/2024,Anusha Dissanayake,Moneragala,Kataragama,Uva,2708,5835,8543,108320,233400,341720
7/18/2024,Anusha Dissanayake,Moneragala,Kataragama,Uva,5528,1190,6718,221120,47600,268720
7/19/2024,Anusha Dissanayake,Moneragala,Kataragama,Uva,1815,8529,10344,72600,341160,413760
7/20/2024,Anusha Dissanayake,Moneragala,Kataragama,Uva,9880,9313,19193,395200,372520,767720
7/21/2024,Anusha Dissanayake,Moneragala,Kataragama,Uva,3993,5755,9748,159720,230200,389920
7/22/2024,Anusha Dissanayake,Moneragala,Kataragama,Uva,52,3127,3179,2080,125080,127160
7/23/2024,Anusha Dissanayake,Moneragala,Kataragama,Uva,3373,6063,9436,134920,242520,377440
7/24/2024,Anusha Dissanayake,Moneragala,Kataragama,Uva,1907,6743,8650,76280,269720,346000
7/25/2024,Anusha Dissanayake,Moneragala,Kataragama,Uva,1859,9242,11101,74360,369680,444040
7/26/2024,Anusha Dissanayake,Moneragala,Kataragama,Uva,7709,3421,11130,308360,136840,445200
7/27/2024,Anusha Dissanayake,Moneragala,Kataragama,Uva,1338,1694,3032,53520,67760,121280
7/28/2024,Anusha Dissanayake,Moneragala,Kataragama,Uva,6607,7398,14005,264280,295920,560200
7/29/2024,Anusha Dissanayake,Moneragala,Kataragama,Uva,8234,4780,13014,329360,191200,520560
7/30/2024,Anusha Dissanayake,Moneragala,Kataragama,Uva,4264,6431,10695,170560,257240,427800
7/31/2024,Anusha Dissanayake,Moneragala,Kataragama,Uva,7644,9862,17506,305760,394480,700240
8/1/2024,Anusha Dissanayake,Moneragala,Kataragama,Uva,9139,7711,16850,365560,308440,674000
8/2/2024,Anusha Dissanayake,Moneragala,Kataragama,Uva,2574,6074,8648,102960,242960,345920
8/3/2024,Anusha Dissanayake,Moneragala,Kataragama,Uva,3201,2075,5276,128040,83000,211040
8/4/2024,Anusha Dissanayake,Moneragala,Kataragama,Uva,7742,4229,11971,309680,169160,478840
8/5/2024,Anusha Dissanayake,Moneragala,Kataragama,Uva,1424,5890,7314,56960,235600,292560
8/6/2024,Anusha Dissanayake,Moneragala,Kataragama,Uva,453,8744,9197,18120,349760,367880
8/7/2024,Anusha Dissanayake,Moneragala,Kataragama,Uva,4452,5199,9651,178080,207960,386040
8/8/2024,Anusha Dissanayake,Moneragala,Kataragama,Uva,2878,7007,9885,115120,280280,395400
8/9/2024,Anusha Dissanayake,Moneragala,Kataragama,Uva,801,2786,3587,32040,111440,143480
8/10/2024,Anusha Dissanayake,Moneragala,Kataragama,Uva,2696,5123,7819,107840,204920,312760
8/11/2024,Anusha Dissanayake,Moneragala,Kataragama,Uva,2557,2046,4603,102280,81840,184120
8/12/2024,Anusha Dissanayake,Moneragala,Kataragama,Uva,889,1266,2155,35560,50640,86200
8/13/2024,Anusha Dissanayake,Moneragala,Kataragama,Uva,3125,3047,6172,125000,121880,246880
8/14/2024,Anusha Dissanayake,Moneragala,Kataragama,Uva,5221,1142,6363,208840,45680,254520
8/15/2024,Anusha Dissanayake,Moneragala,Kataragama,Uva,5709,5118,10827,228360,204720,433080
8/16/2024,Anusha Dissanayake,Moneragala,Kataragama,Uva,6113,2926,9039,244520,117040,361560
8/17/2024,Anusha Dissanayake,Moneragala,Kataragama,Uva,5256,7707,12963,210240,308280,518520
8/18/2024,Anusha Dissanayake,Moneragala,Kataragama,Uva,9274,3248,12522,370960,129920,500880
8/19/2024,Anusha Dissanayake,Moneragala,Kataragama,Uva,8168,150,8318,326720,6000,332720
8/20/2024,Anusha Dissanayake,Moneragala,Kataragama,Uva,9448,9475,18923,377920,379000,756920
8/21/2024,Anusha Dissanayake,Moneragala,Kataragama,Uva,7901,8490,16391,316040,339600,655640
8/22/2024,Anusha Dissanayake,Moneragala,Kataragama,Uva,2976,7445,10421,119040,297800,416840
8/23/2024,Anusha Dissanayake,Moneragala,Kataragama,Uva,3539,7615,11154,141560,304600,446160
8/24/2024,Anusha Dissanayake,Moneragala,Kataragama,Uva,7128,8420,15548,285120,336800,621920
8/25/2024,Anusha Dissanayake,Moneragala,Kataragama,Uva,4897,2142,7039,195880,85680,281560
8/26/2024,Anusha Dissanayake,Moneragala,Kataragama,Uva,7760,3003,10763,310400,120120,430520
8/27/2024,Anusha Dissanayake,Moneragala,Kataragama,Uva,6222,5683,11905,248880,227320,476200
8/28/2024,Anusha Dissanayake,Moneragala,Kataragama,Uva,7985,439,8424,319400,17560,336960
8/29/2024,Anusha Dissanayake,Moneragala,Kataragama,Uva,4667,7078,11745,186680,283120,469800
8/30/2024,Anusha Dissanayake,Moneragala,Kataragama,Uva,1132,3288,4420,45280,131520,176800
8/31/2024,Anusha Dissanayake,Moneragala,Kataragama,Uva,8580,6819,15399,343200,272760,615960
9/1/2024,Anusha Dissanayake,Moneragala,Kataragama,Uva,2806,3371,6177,112240,134840,247080
9/2/2024,Anusha Dissanayake,Moneragala,Kataragama,Uva,4628,7500,12128,185120,300000,485120
9/3/2024,Anusha Dissanayake,Moneragala,Kataragama,Uva,4784,5869,10653,191360,234760,426120
9/4/2024,Anusha Dissanayake,Moneragala,Kataragama,Uva,554,2822,3376,22160,112880,135040
9/5/2024,Anusha Dissanayake,Moneragala,Kataragama,Uva,4648,2269,6917,185920,90760,276680
9/6/2024,Anusha Dissanayake,Moneragala,Kataragama,Uva,2018,8899,10917,80720,355960,436680
9/7/2024,Anusha Dissanayake,Moneragala,Kataragama,Uva,2597,486,3083,103880,19440,123320
9/8/2024,Anusha Dissanayake,Moneragala,Kataragama,Uva,1073,1492,2565,42920,59680,102600
9/9/2024,Anusha Dissanayake,Moneragala,Kataragama,Uva,7724,1934,9658,308960,77360,386320
9/10/2024,Anusha Dissanayake,Moneragala,Kataragama,Uva,4217,1780,5997,168680,71200,239880
9/11/2024,Anusha Dissanayake,Moneragala,Kataragama,Uva,3601,1402,5003,144040,56080,200120
9/12/2024,Anusha Dissanayake,Moneragala,Kataragama,Uva,8266,4308,12574,330640,172320,502960
9/13/2024,Anusha Dissanayake,Moneragala,Kataragama,Uva,8452,832,9284,338080,33280,371360
9/14/2024,Anusha Dissanayake,Moneragala,Kataragama,Uva,571,6691,7262,22840,267640,290480
9/15/2024,Anusha Dissanayake,Moneragala,Kataragama,Uva,9990,8734,18724,399600,349360,748960
9/16/2024,Anusha Dissanayake,Moneragala,Kataragama,Uva,9570,4147,13717,382800,165880,548680
9/17/2024,Anusha Dissanayake,Moneragala,Kataragama,Uva,2206,8453,10659,88240,338120,426360
9/18/2024,Anusha Dissanayake,Moneragala,Kataragama,Uva,6168,3752,9920,246720,150080,396800
9/19/2024,Anusha Dissanayake,Moneragala,Kataragama,Uva,4313,5945,10258,172520,237800,410320
9/20/2024,Anusha Dissanayake,Moneragala,Kataragama,Uva,4051,9829,13880,162040,393160,555200
9/21/2024,Anusha Dissanayake,Moneragala,Kataragama,Uva,7704,4062,11766,308160,162480,470640
9/22/2024,Anusha Dissanayake,Moneragala,Kataragama,Uva,5396,8696,14092,215840,347840,563680
9/23/2024,Anusha Dissanayake,Moneragala,Kataragama,Uva,7633,9379,17012,305320,375160,680480
9/24/2024,Anusha Dissanayake,Moneragala,Kataragama,Uva,6752,2376,9128,270080,95040,365120
9/25/2024,Anusha Dissanayake,Moneragala,Kataragama,Uva,1920,4385,6305,76800,175400,252200
9/26/2024,Anusha Dissanayake,Moneragala,Kataragama,Uva,9775,3694,13469,391000,147760,538760
9/27/2024,Anusha Dissanayake,Moneragala,Kataragama,Uva,2790,2706,5496,111600,108240,219840
9/28/2024,Anusha Dissanayake,Moneragala,Kataragama,Uva,2236,3362,5598,89440,134480,223920
9/29/2024,Anusha Dissanayake,Moneragala,Kataragama,Uva,2078,8917,10995,83120,356680,439800
9/30/2024,Anusha Dissanayake,Moneragala,Kataragama,Uva,5170,8779,13949,206800,351160,557960
10/1/2024,Anusha Dissanayake,Moneragala,Kataragama,Uva,965,3924,4889,38600,156960,195560
10/2/2024,Anusha Dissanayake,Moneragala,Kataragama,Uva,1443,3774,5217,57720,150960,208680
10/3/2024,Anusha Dissanayake,Moneragala,Kataragama,Uva,7783,9441,17224,311320,377640,688960
10/4/2024,Anusha Dissanayake,Moneragala,Kataragama,Uva,9849,6347,16196,393960,253880,647840
10/5/2024,Anusha Dissanayake,Moneragala,Kataragama,Uva,1353,1043,2396,54120,41720,95840
10/6/2024,Anusha Dissanayake,Moneragala,Kataragama,Uva,2334,5926,8260,93360,237040,330400
10/7/2024,Anusha Dissanayake,Moneragala,Kataragama,Uva,3653,2291,5944,146120,91640,237760
10/8/2024,Anusha Dissanayake,Moneragala,Kataragama,Uva,6525,7681,14206,261000,307240,568240
10/9/2024,Anusha Dissanayake,Moneragala,Kataragama,Uva,6574,1874,8448,262960,74960,337920
10/10/2024,Anusha Dissanayake,Moneragala,Kataragama,Uva,4005,7280,11285,160200,291200,451400
10/11/2024,Anusha Dissanayake,Moneragala,Kataragama,Uva,4455,9848,14303,178200,393920,572120
10/12/2024,Anusha Dissanayake,Moneragala,Kataragama,Uva,875,4617,5492,35000,184680,219680
10/13/2024,Anusha Dissanayake,Moneragala,Kataragama,Uva,4811,8028,12839,192440,321120,513560
10/14/2024,Anusha Dissanayake,Moneragala,Kataragama,Uva,4387,5511,9898,175480,220440,395920
10/15/2024,Anusha Dissanayake,Moneragala,Kataragama,Uva,6048,3024,9072,241920,120960,362880
10/16/2024,Anusha Dissanayake,Moneragala,Kataragama,Uva,2693,9015,11708,107720,360600,468320
10/17/2024,Anusha Dissanayake,Moneragala,Kataragama,Uva,5482,8091,13573,219280,323640,542920
10/18/2024,Anusha Dissanayake,Moneragala,Kataragama,Uva,1839,2964,4803,73560,118560,192120
10/19/2024,Anusha Dissanayake,Moneragala,Kataragama,Uva,5587,8110,13697,223480,324400,547880
10/20/2024,Anusha Dissanayake,Moneragala,Kataragama,Uva,6090,2731,8821,243600,109240,352840
10/21/2024,Anusha Dissanayake,Moneragala,Kataragama,Uva,4558,3725,8283,182320,149000,331320
10/22/2024,Anusha Dissanayake,Moneragala,Kataragama,Uva,2899,3738,6637,115960,149520,265480
10/23/2024,Anusha Dissanayake,Moneragala,Kataragama,Uva,5181,1846,7027,207240,73840,281080
10/24/2024,Anusha Dissanayake,Moneragala,Kataragama,Uva,6547,3659,10206,261880,146360,408240
10/25/2024,Anusha Dissanayake,Moneragala,Kataragama,Uva,9321,2562,11883,372840,102480,475320
10/26/2024,Anusha Dissanayake,Moneragala,Kataragama,Uva,689,2812,3501,27560,112480,140040
10/27/2024,Anusha Dissanayake,Moneragala,Kataragama,Uva,2635,5685,8320,105400,227400,332800
10/28/2024,Anusha Dissanayake,Moneragala,Kataragama,Uva,4275,225,4500,171000,9000,180000
10/29/2024,Anusha Dissanayake,Moneragala,Kataragama,Uva,7107,1244,8351,284280,49760,334040
10/30/2024,Anusha Dissanayake,Moneragala,Kataragama,Uva,8082,8680,16762,323280,347200,670480
10/31/2024,Anusha Dissanayake,Moneragala,Kataragama,Uva,7763,9778,17541,310520,391120,701640
11/1/2024,Anusha Dissanayake,Moneragala,Kataragama,Uva,9967,7937,17904,398680,317480,716160
11/2/2024,Anusha Dissanayake,Moneragala,Kataragama,Uva,1149,1494,2643,45960,59760,105720
11/3/2024,Anusha Dissanayake,Moneragala,Kataragama,Uva,6782,7781,14563,271280,311240,582520
11/4/2024,Anusha Dissanayake,Moneragala,Kataragama,Uva,7468,6798,14266,298720,271920,570640
11/5/2024,Anusha Dissanayake,Moneragala,Kataragama,Uva,7887,23,7910,315480,920,316400
11/6/2024,Anusha Dissanayake,Moneragala,Kataragama,Uva,5141,8257,13398,205640,330280,535920
11/7/2024,Anusha Dissanayake,Moneragala,Kataragama,Uva,4093,9833,13926,163720,393320,557040
11/8/2024,Anusha Dissanayake,Moneragala,Kataragama,Uva,9720,1652,11372,388800,66080,454880
11/9/2024,Anusha Dissanayake,Moneragala,Kataragama,Uva,4265,6087,10352,170600,243480,414080
11/10/2024,Anusha Dissanayake,Moneragala,Kataragama,Uva,7892,4185,12077,315680,167400,483080
11/11/2024,Anusha Dissanayake,Moneragala,Kataragama,Uva,4983,4885,9868,199320,195400,394720
11/12/2024,Anusha Dissanayake,Moneragala,Kataragama,Uva,2013,1948,3961,80520,77920,158440
11/13/2024,Anusha Dissanayake,Moneragala,Kataragama,Uva,8306,9426,17732,332240,377040,709280
11/14/2024,Anusha Dissanayake,Moneragala,Kataragama,Uva,3735,1929,5664,149400,77160,226560
11/15/2024,Anusha Dissanayake,Moneragala,Kataragama,Uva,4873,5691,10564,194920,227640,422560
11/16/2024,Anusha Dissanayake,Moneragala,Kataragama,Uva,9430,1173,10603,377200,46920,424120
11/17/2024,Anusha Dissanayake,Moneragala,Kataragama,Uva,7190,5121,12311,287600,204840,492440
11/18/2024,Anusha Dissanayake,Moneragala,Kataragama,Uva,3184,578,3762,127360,23120,150480
11/19/2024,Anusha Dissanayake,Moneragala,Kataragama,Uva,6558,5824,12382,262320,232960,495280
11/20/2024,Anusha Dissanayake,Moneragala,Kataragama,Uva,8101,9889,17990,324040,395560,719600
11/21/2024,Anusha Dissanayake,Moneragala,Kataragama,Uva,5970,7492,13462,238800,299680,538480
11/22/2024,Anusha Dissanayake,Moneragala,Kataragama,Uva,6885,8735,15620,275400,349400,624800
11/23/2024,Anusha Dissanayake,Moneragala,Kataragama,Uva,2177,5952,8129,87080,238080,325160
11/24/2024,Anusha Dissanayake,Moneragala,Kataragama,Uva,8398,7817,16215,335920,312680,648600
11/25/2024,Anusha Dissanayake,Moneragala,Kataragama,Uva,9561,7059,16620,382440,282360,664800
11/26/2024,Anusha Dissanayake,Moneragala,Kataragama,Uva,4132,3340,7472,165280,133600,298880
11/27/2024,Anusha Dissanayake,Moneragala,Kataragama,Uva,3804,4869,8673,152160,194760,346920
11/28/2024,Anusha Dissanayake,Moneragala,Kataragama,Uva,252,6399,6651,10080,255960,266040
11/29/2024,Anusha Dissanayake,Moneragala,Kataragama,Uva,158,4707,4865,6320,188280,194600
11/30/2024,Anusha Dissanayake,Moneragala,Kataragama,Uva,8886,9354,18240,355440,374160,729600
12/1/2024,Anusha Dissanayake,Moneragala,Kataragama,Uva,2225,5601,7826,89000,224040,313040
12/2/2024,Anusha Dissanayake,Moneragala,Kataragama,Uva,9004,8209,17213,360160,328360,688520
12/3/2024,Anusha Dissanayake,Moneragala,Kataragama,Uva,6366,3151,9517,254640,126040,380680
12/4/2024,Anusha Dissanayake,Moneragala,Kataragama,Uva,9127,3185,12312,365080,127400,492480
12/5/2024,Anusha Dissanayake,Moneragala,Kataragama,Uva,2111,1970,4081,84440,78800,163240
12/6/2024,Anusha Dissanayake,Moneragala,Kataragama,Uva,8360,4668,13028,334400,186720,521120
12/7/2024,Anusha Dissanayake,Moneragala,Kataragama,Uva,4599,1781,6380,183960,71240,255200
12/8/2024,Anusha Dissanayake,Moneragala,Kataragama,Uva,270,9511,9781,10800,380440,391240
12/9/2024,Anusha Dissanayake,Moneragala,Kataragama,Uva,9766,1427,11193,390640,57080,447720
12/10/2024,Anusha Dissanayake,Moneragala,Kataragama,Uva,13,1532,1545,520,61280,61800
12/11/2024,Anusha Dissanayake,Moneragala,Kataragama,Uva,8098,6521,14619,323920,260840,584760
12/12/2024,Anusha Dissanayake,Moneragala,Kataragama,Uva,2858,8508,11366,114320,340320,454640
12/13/2024,Anusha Dissanayake,Moneragala,Kataragama,Uva,267,8326,8593,10680,333040,343720
12/14/2024,Anusha Dissanayake,Moneragala,Kataragama,Uva,9979,2170,12149,399160,86800,485960
12/15/2024,Anusha Dissanayake,Moneragala,Kataragama,Uva,644,6600,7244,25760,264000,289760
12/16/2024,Anusha Dissanayake,Moneragala,Kataragama,Uva,9314,2891,12205,372560,115640,488200
12/17/2024,Anusha Dissanayake,Moneragala,Kataragama,Uva,8445,4958,13403,337800,198320,536120
12/18/2024,Anusha Dissanayake,Moneragala,Kataragama,Uva,7989,5121,13110,319560,204840,524400
12/19/2024,Anusha Dissanayake,Moneragala,Kataragama,Uva,3016,6810,9826,120640,272400,393040
12/20/2024,Anusha Dissanayake,Moneragala,Kataragama,Uva,7353,867,8220,294120,34680,328800
12/21/2024,Anusha Dissanayake,Moneragala,Kataragama,Uva,8981,5650,14631,359240,226000,585240
12/22/2024,Anusha Dissanayake,Moneragala,Kataragama,Uva,6672,1638,8310,266880,65520,332400
12/23/2024,Anusha Dissanayake,Moneragala,Kataragama,Uva,1491,9305,10796,59640,372200,431840
12/24/2024,Anusha Dissanayake,Moneragala,Kataragama,Uva,506,4951,5457,20240,198040,218280
12/25/2024,Anusha Dissanayake,Moneragala,Kataragama,Uva,4885,6217,11102,195400,248680,444080
12/26/2024,Anusha Dissanayake,Moneragala,Kataragama,Uva,4354,6976,11330,174160,279040,453200
12/27/2024,Anusha Dissanayake,Moneragala,Kataragama,Uva,367,40,407,14680,1600,16280
12/28/2024,Anusha Dissanayake,Moneragala,Kataragama,Uva,5919,6294,12213,236760,251760,488520
12/29/2024,Anusha Dissanayake,Moneragala,Kataragama,Uva,3855,9592,13447,154200,383680,537880
12/30/2024,Anusha Dissanayake,Moneragala,Kataragama,Uva,2736,4980,7716,109440,199200,308640
12/31/2024,Anusha Dissanayake,Moneragala,Kataragama,Uva,4007,5700,9707,160280,228000,388280
1/1/2025,Anusha Dissanayake,Moneragala,Kataragama,Uva,3420,4991,8411,136800,199640,336440
1/2/2025,Anusha Dissanayake,Moneragala,Kataragama,Uva,7064,8034,15098,282560,321360,603920
1/3/2025,Anusha Dissanayake,Moneragala,Kataragama,Uva,7318,1370,8688,292720,54800,347520
1/4/2025,Anusha Dissanayake,Moneragala,Kataragama,Uva,9662,4649,14311,386480,185960,572440
1/5/2025,Anusha Dissanayake,Moneragala,Kataragama,Uva,3547,8748,12295,141880,349920,491800
1/6/2025,Anusha Dissanayake,Moneragala,Kataragama,Uva,6029,5953,11982,241160,238120,479280
1/7/2025,Anusha Dissanayake,Moneragala,Kataragama,Uva,7484,3055,10539,299360,122200,421560
1/8/2025,Anusha Dissanayake,Moneragala,Kataragama,Uva,791,9411,10202,31640,376440,408080
1/9/2025,Anusha Dissanayake,Moneragala,Kataragama,Uva,693,9278,9971,27720,371120,398840
1/10/2025,Anusha Dissanayake,Moneragala,Kataragama,Uva,2358,8203,10561,94320,328120,422440
1/11/2025,Anusha Dissanayake,Moneragala,Kataragama,Uva,8518,255,8773,340720,10200,350920
1/12/2025,Anusha Dissanayake,Moneragala,Kataragama,Uva,6352,224,6576,254080,8960,263040
1/13/2025,Anusha Dissanayake,Moneragala,Kataragama,Uva,8661,7690,16351,346440,307600,654040
1/14/2025,Anusha Dissanayake,Moneragala,Kataragama,Uva,3608,564,4172,144320,22560,166880
1/15/2025,Anusha Dissanayake,Moneragala,Kataragama,Uva,7861,3332,11193,314440,133280,447720
1/16/2025,Anusha Dissanayake,Moneragala,Kataragama,Uva,2618,6491,9109,104720,259640,364360
1/17/2025,Anusha Dissanayake,Moneragala,Kataragama,Uva,3341,7528,10869,133640,301120,434760
1/18/2025,Anusha Dissanayake,Moneragala,Kataragama,Uva,8467,3222,11689,338680,128880,467560
1/19/2025,Anusha Dissanayake,Moneragala,Kataragama,Uva,9993,8057,18050,399720,322280,722000
1/20/2025,Anusha Dissanayake,Moneragala,Kataragama,Uva,1410,5414,6824,56400,216560,272960
1/21/2025,Anusha Dissanayake,Moneragala,Kataragama,Uva,1060,7854,8914,42400,314160,356560
1/22/2025,Anusha Dissanayake,Moneragala,Kataragama,Uva,8470,7062,15532,338800,282480,621280
1/23/2025,Anusha Dissanayake,Moneragala,Kataragama,Uva,9805,3861,13666,392200,154440,546640
1/24/2025,Anusha Dissanayake,Moneragala,Kataragama,Uva,2503,9204,11707,100120,368160,468280
1/25/2025,Anusha Dissanayake,Moneragala,Kataragama,Uva,8251,7144,15395,330040,285760,615800
1/26/2025,Anusha Dissanayake,Moneragala,Kataragama,Uva,2541,8961,11502,101640,358440,460080
1/27/2025,Anusha Dissanayake,Moneragala,Kataragama,Uva,7330,8501,15831,293200,340040,633240
1/28/2025,Anusha Dissanayake,Moneragala,Kataragama,Uva,8446,7675,16121,337840,307000,644840
1/29/2025,Anusha Dissanayake,Moneragala,Kataragama,Uva,68,9507,9575,2720,380280,383000
1/30/2025,Anusha Dissanayake,Moneragala,Kataragama,Uva,39,1536,1575,1560,61440,63000
1/31/2025,Anusha Dissanayake,Moneragala,Kataragama,Uva,7700,9388,17088,308000,375520,683520
2/1/2025,Anusha Dissanayake,Moneragala,Kataragama,Uva,9967,8224,18191,398680,328960,727640
2/2/2025,Anusha Dissanayake,Moneragala,Kataragama,Uva,9466,1722,11188,378640,68880,447520
2/3/2025,Anusha Dissanayake,Moneragala,Kataragama,Uva,6606,8372,14978,264240,334880,599120
2/4/2025,Anusha Dissanayake,Moneragala,Kataragama,Uva,3765,1105,4870,150600,44200,194800
2/5/2025,Anusha Dissanayake,Moneragala,Kataragama,Uva,1017,5402,6419,40680,216080,256760
2/6/2025,Anusha Dissanayake,Moneragala,Kataragama,Uva,2277,7451,9728,91080,298040,389120
2/7/2025,Anusha Dissanayake,Moneragala,Kataragama,Uva,2484,9466,11950,99360,378640,478000
2/8/2025,Anusha Dissanayake,Moneragala,Kataragama,Uva,7318,4063,11381,292720,162520,455240
2/9/2025,Anusha Dissanayake,Moneragala,Kataragama,Uva,9056,7056,16112,362240,282240,644480
2/10/2025,Anusha Dissanayake,Moneragala,Kataragama,Uva,3084,3168,6252,123360,126720,250080
2/11/2025,Anusha Dissanayake,Moneragala,Kataragama,Uva,5272,3050,8322,210880,122000,332880
2/12/2025,Anusha Dissanayake,Moneragala,Kataragama,Uva,9840,5073,14913,393600,202920,596520
2/13/2025,Anusha Dissanayake,Moneragala,Kataragama,Uva,5448,5196,10644,217920,207840,425760
2/14/2025,Anusha Dissanayake,Moneragala,Kataragama,Uva,5427,7468,12895,217080,298720,515800
2/15/2025,Anusha Dissanayake,Moneragala,Kataragama,Uva,1105,2609,3714,44200,104360,148560
2/16/2025,Anusha Dissanayake,Moneragala,Kataragama,Uva,7291,4180,11471,291640,167200,458840
2/17/2025,Anusha Dissanayake,Moneragala,Kataragama,Uva,5239,8337,13576,209560,333480,543040
2/18/2025,Anusha Dissanayake,Moneragala,Kataragama,Uva,9166,7054,16220,366640,282160,648800
2/19/2025,Anusha Dissanayake,Moneragala,Kataragama,Uva,2153,3021,5174,86120,120840,206960
2/20/2025,Anusha Dissanayake,Moneragala,Kataragama,Uva,7713,603,8316,308520,24120,332640
2/21/2025,Anusha Dissanayake,Moneragala,Kataragama,Uva,790,8554,9344,31600,342160,373760
2/22/2025,Anusha Dissanayake,Moneragala,Kataragama,Uva,4233,6837,11070,169320,273480,442800
2/23/2025,Anusha Dissanayake,Moneragala,Kataragama,Uva,8938,4236,13174,357520,169440,526960
2/24/2025,Anusha Dissanayake,Moneragala,Kataragama,Uva,6385,7892,14277,255400,315680,571080
2/25/2025,Anusha Dissanayake,Moneragala,Kataragama,Uva,4436,9408,13844,177440,376320,553760
2/26/2025,Anusha Dissanayake,Moneragala,Kataragama,Uva,7075,7973,15048,283000,318920,601920
2/27/2025,Anusha Dissanayake,Moneragala,Kataragama,Uva,4285,4571,8856,171400,182840,354240
2/28/2025,Anusha Dissanayake,Moneragala,Kataragama,Uva,2773,8585,11358,110920,343400,454320
3/1/2025,Anusha Dissanayake,Moneragala,Kataragama,Uva,4331,3025,7356,173240,121000,294240
3/2/2025,Anusha Dissanayake,Moneragala,Kataragama,Uva,5469,8356,13825,218760,334240,553000
3/3/2025,Anusha Dissanayake,Moneragala,Kataragama,Uva,4942,2693,7635,197680,107720,305400
3/4/2025,Anusha Dissanayake,Moneragala,Kataragama,Uva,8742,5930,14672,349680,237200,586880
3/5/2025,Anusha Dissanayake,Moneragala,Kataragama,Uva,8142,5533,13675,325680,221320,547000
3/6/2025,Anusha Dissanayake,Moneragala,Kataragama,Uva,2659,2650,5309,106360,106000,212360
3/7/2025,Anusha Dissanayake,Moneragala,Kataragama,Uva,1190,4944,6134,47600,197760,245360
3/8/2025,Anusha Dissanayake,Moneragala,Kataragama,Uva,5152,8779,13931,206080,351160,557240
3/9/2025,Anusha Dissanayake,Moneragala,Kataragama,Uva,1778,1605,3383,71120,64200,135320
3/10/2025,Anusha Dissanayake,Moneragala,Kataragama,Uva,5750,6658,12408,230000,266320,496320
3/11/2025,Anusha Dissanayake,Moneragala,Kataragama,Uva,9941,905,10846,397640,36200,433840
3/12/2025,Anusha Dissanayake,Moneragala,Kataragama,Uva,5435,6747,12182,217400,269880,487280
3/13/2025,Anusha Dissanayake,Moneragala,Kataragama,Uva,9989,7709,17698,399560,308360,707920
3/14/2025,Anusha Dissanayake,Moneragala,Kataragama,Uva,6404,666,7070,256160,26640,282800
3/15/2025,Anusha Dissanayake,Moneragala,Kataragama,Uva,8099,3959,12058,323960,158360,482320
3/16/2025,Anusha Dissanayake,Moneragala,Kataragama,Uva,8673,6219,14892,346920,248760,595680
3/17/2025,Anusha Dissanayake,Moneragala,Kataragama,Uva,7352,2234,9586,294080,89360,383440
3/18/2025,Anusha Dissanayake,Moneragala,Kataragama,Uva,4991,3874,8865,199640,154960,354600
3/19/2025,Anusha Dissanayake,Moneragala,Kataragama,Uva,9535,3129,12664,381400,125160,506560
3/20/2025,Anusha Dissanayake,Moneragala,Kataragama,Uva,5737,7993,13730,229480,319720,549200
3/21/2025,Anusha Dissanayake,Moneragala,Kataragama,Uva,2537,143,2680,101480,5720,107200
3/22/2025,Anusha Dissanayake,Moneragala,Kataragama,Uva,3335,137,3472,133400,5480,138880
3/23/2025,Anusha Dissanayake,Moneragala,Kataragama,Uva,599,9852,10451,23960,394080,418040
3/25/2024,Rashmi Herath,Matara,Matara,Southern,3884,105,3989,155360,4200,159560
3/26/2024,Rashmi Herath,Matara,Matara,Southern,1470,4372,5842,58800,174880,233680
3/27/2024,Rashmi Herath,Matara,Matara,Southern,9796,2611,12407,391840,104440,496280
3/28/2024,Rashmi Herath,Matara,Matara,Southern,9398,7348,16746,375920,293920,669840
3/29/2024,Rashmi Herath,Matara,Matara,Southern,610,7125,7735,24400,285000,309400
3/30/2024,Rashmi Herath,Matara,Matara,Southern,7734,354,8088,309360,14160,323520
3/31/2024,Rashmi Herath,Matara,Matara,Southern,3148,3288,6436,125920,131520,257440
4/1/2024,Rashmi Herath,Matara,Matara,Southern,9679,3066,12745,387160,122640,509800
4/2/2024,Rashmi Herath,Matara,Matara,Southern,3501,5716,9217,140040,228640,368680
4/3/2024,Rashmi Herath,Matara,Matara,Southern,7102,1324,8426,284080,52960,337040
4/4/2024,Rashmi Herath,Matara,Matara,Southern,8338,8554,16892,333520,342160,675680
4/5/2024,Rashmi Herath,Matara,Matara,Southern,1603,9865,11468,64120,394600,458720
4/6/2024,Rashmi Herath,Matara,Matara,Southern,2395,3382,5777,95800,135280,231080
4/7/2024,Rashmi Herath,Matara,Matara,Southern,8661,477,9138,346440,19080,365520
4/8/2024,Rashmi Herath,Matara,Matara,Southern,6062,2734,8796,242480,109360,351840
4/9/2024,Rashmi Herath,Matara,Matara,Southern,6754,7873,14627,270160,314920,585080
4/10/2024,Rashmi Herath,Matara,Matara,Southern,489,4134,4623,19560,165360,184920
4/11/2024,Rashmi Herath,Matara,Matara,Southern,5026,941,5967,201040,37640,238680
4/19/2024,Rashmi Herath,Matara,Matara,Southern,9843,7199,17042,393720,287960,681680
4/20/2024,Rashmi Herath,Matara,Matara,Southern,2899,923,3822,115960,36920,152880
4/21/2024,Rashmi Herath,Matara,Matara,Southern,3332,7325,10657,133280,293000,426280
4/22/2024,Rashmi Herath,Matara,Matara,Southern,8346,6384,14730,333840,255360,589200
4/23/2024,Rashmi Herath,Matara,Matara,Southern,2902,9553,12455,116080,382120,498200
4/24/2024,Rashmi Herath,Matara,Matara,Southern,3640,6191,9831,145600,247640,393240
4/25/2024,Rashmi Herath,Matara,Matara,Southern,7513,2482,9995,300520,99280,399800
4/26/2024,Rashmi Herath,Matara,Matara,Southern,8002,7622,15624,320080,304880,624960
4/27/2024,Rashmi Herath,Matara,Matara,Southern,6778,5444,12222,271120,217760,488880
4/28/2024,Rashmi Herath,Matara,Matara,Southern,3262,9967,13229,130480,398680,529160
4/29/2024,Rashmi Herath,Matara,Matara,Southern,1590,8377,9967,63600,335080,398680
4/30/2024,Rashmi Herath,Matara,Matara,Southern,2057,4219,6276,82280,168760,251040
5/1/2024,Rashmi Herath,Matara,Matara,Southern,9508,4842,14350,380320,193680,574000
5/2/2024,Rashmi Herath,Matara,Matara,Southern,9415,9345,18760,376600,373800,750400
5/3/2024,Rashmi Herath,Matara,Matara,Southern,1174,2854,4028,46960,114160,161120
5/4/2024,Rashmi Herath,Matara,Matara,Southern,147,721,868,5880,28840,34720
5/5/2024,Rashmi Herath,Matara,Matara,Southern,1363,3516,4879,54520,140640,195160
5/6/2024,Rashmi Herath,Matara,Matara,Southern,7377,657,8034,295080,26280,321360
5/7/2024,Rashmi Herath,Matara,Matara,Southern,4437,7081,11518,177480,283240,460720
5/8/2024,Rashmi Herath,Matara,Matara,Southern,5328,6331,11659,213120,253240,466360
5/9/2024,Rashmi Herath,Matara,Matara,Southern,6973,1680,8653,278920,67200,346120
5/10/2024,Rashmi Herath,Matara,Matara,Southern,7514,5957,13471,300560,238280,538840
5/11/2024,Rashmi Herath,Matara,Matara,Southern,8265,2673,10938,330600,106920,437520
5/12/2024,Rashmi Herath,Matara,Matara,Southern,6299,5045,11344,251960,201800,453760
5/13/2024,Rashmi Herath,Matara,Matara,Southern,2540,3859,6399,101600,154360,255960
5/14/2024,Rashmi Herath,Matara,Matara,Southern,608,6649,7257,24320,265960,290280
5/15/2024,Rashmi Herath,Matara,Matara,Southern,3952,4929,8881,158080,197160,355240
5/16/2024,Rashmi Herath,Matara,Matara,Southern,3845,5432,9277,153800,217280,371080
5/17/2024,Rashmi Herath,Matara,Matara,Southern,7525,1209,8734,301000,48360,349360
5/18/2024,Rashmi Herath,Matara,Matara,Southern,2548,5713,8261,101920,228520,330440
5/19/2024,Rashmi Herath,Matara,Matara,Southern,6048,7002,13050,241920,280080,522000
5/20/2024,Rashmi Herath,Matara,Matara,Southern,7497,9396,16893,299880,375840,675720
5/21/2024,Rashmi Herath,Matara,Matara,Southern,6555,1629,8184,262200,65160,327360
5/22/2024,Rashmi Herath,Matara,Matara,Southern,3718,5867,9585,148720,234680,383400
5/24/2024,Rashmi Herath,Matara,Matara,Southern,5228,4893,10121,209120,195720,404840
5/25/2024,Rashmi Herath,Matara,Matara,Southern,4117,2149,6266,164680,85960,250640
5/26/2024,Rashmi Herath,Matara,Matara,Southern,6066,155,6221,242640,6200,248840
5/27/2024,Rashmi Herath,Matara,Matara,Southern,7277,4335,11612,291080,173400,464480
5/28/2024,Rashmi Herath,Matara,Matara,Southern,8273,3681,11954,330920,147240,478160
5/29/2024,Rashmi Herath,Matara,Matara,Southern,3663,7633,11296,146520,305320,451840
5/30/2024,Rashmi Herath,Matara,Matara,Southern,986,3335,4321,39440,133400,172840
5/31/2024,Rashmi Herath,Matara,Matara,Southern,5119,8520,13639,204760,340800,545560
6/1/2024,Rashmi Herath,Matara,Matara,Southern,3934,4828,8762,157360,193120,350480
6/2/2024,Rashmi Herath,Matara,Matara,Southern,2887,2072,4959,115480,82880,198360
6/3/2024,Rashmi Herath,Matara,Matara,Southern,3544,5598,9142,141760,223920,365680
6/4/2024,Rashmi Herath,Matara,Matara,Southern,4280,6836,11116,171200,273440,444640
6/5/2024,Rashmi Herath,Matara,Matara,Southern,1203,5712,6915,48120,228480,276600
6/6/2024,Rashmi Herath,Matara,Matara,Southern,5338,3160,8498,213520,126400,339920
6/7/2024,Rashmi Herath,Matara,Matara,Southern,3261,7855,11116,130440,314200,444640
6/8/2024,Rashmi Herath,Matara,Matara,Southern,7203,1360,8563,288120,54400,342520
6/9/2024,Rashmi Herath,Matara,Matara,Southern,6673,7889,14562,266920,315560,582480
6/10/2024,Rashmi Herath,Matara,Matara,Southern,9236,9002,18238,369440,360080,729520
6/11/2024,Rashmi Herath,Matara,Matara,Southern,240,1899,2139,9600,75960,85560
6/12/2024,Rashmi Herath,Matara,Matara,Southern,8241,1285,9526,329640,51400,381040
6/13/2024,Rashmi Herath,Matara,Matara,Southern,5361,8580,13941,214440,343200,557640
6/14/2024,Rashmi Herath,Matara,Matara,Southern,5463,3545,9008,218520,141800,360320
6/15/2024,Rashmi Herath,Matara,Matara,Southern,8096,6577,14673,323840,263080,586920
6/16/2024,Rashmi Herath,Matara,Matara,Southern,6175,6116,12291,247000,244640,491640
6/17/2024,Rashmi Herath,Matara,Matara,Southern,9960,7288,17248,398400,291520,689920
6/18/2024,Rashmi Herath,Matara,Matara,Southern,3136,1098,4234,125440,43920,169360
6/19/2024,Rashmi Herath,Matara,Matara,Southern,5359,9120,14479,214360,364800,579160
6/20/2024,Rashmi Herath,Matara,Matara,Southern,9994,9975,19969,399760,399000,798760
6/21/2024,Rashmi Herath,Matara,Matara,Southern,4708,6606,11314,188320,264240,452560
6/22/2024,Rashmi Herath,Matara,Matara,Southern,4006,1656,5662,160240,66240,226480
6/23/2024,Rashmi Herath,Matara,Matara,Southern,5483,5015,10498,219320,200600,419920
6/24/2024,Rashmi Herath,Matara,Matara,Southern,7260,3313,10573,290400,132520,422920
6/25/2024,Rashmi Herath,Matara,Matara,Southern,2725,1527,4252,109000,61080,170080
6/26/2024,Rashmi Herath,Matara,Matara,Southern,4367,4662,9029,174680,186480,361160
6/27/2024,Rashmi Herath,Matara,Matara,Southern,119,8619,8738,4760,344760,349520
6/28/2024,Rashmi Herath,Matara,Matara,Southern,5301,9193,14494,212040,367720,579760
6/29/2024,Rashmi Herath,Matara,Matara,Southern,6334,2750,9084,253360,110000,363360
6/30/2024,Rashmi Herath,Matara,Matara,Southern,5794,7484,13278,231760,299360,531120
7/1/2024,Rashmi Herath,Matara,Matara,Southern,6347,326,6673,253880,13040,266920
7/2/2024,Rashmi Herath,Matara,Matara,Southern,7399,5500,12899,295960,220000,515960
7/3/2024,Rashmi Herath,Matara,Matara,Southern,169,431,600,6760,17240,24000
7/4/2024,Rashmi Herath,Matara,Matara,Southern,8692,9633,18325,347680,385320,733000
7/5/2024,Rashmi Herath,Matara,Matara,Southern,8538,4099,12637,341520,163960,505480
7/6/2024,Rashmi Herath,Matara,Matara,Southern,2717,3924,6641,108680,156960,265640
7/7/2024,Rashmi Herath,Matara,Matara,Southern,4990,8683,13673,199600,347320,546920
7/8/2024,Rashmi Herath,Matara,Matara,Southern,1515,7887,9402,60600,315480,376080
7/9/2024,Rashmi Herath,Matara,Matara,Southern,201,9638,9839,8040,385520,393560
7/10/2024,Rashmi Herath,Matara,Matara,Southern,5649,401,6050,225960,16040,242000
7/11/2024,Rashmi Herath,Matara,Matara,Southern,4986,3495,8481,199440,139800,339240
7/12/2024,Rashmi Herath,Matara,Matara,Southern,8723,2830,11553,348920,113200,462120
7/13/2024,Rashmi Herath,Matara,Matara,Southern,1664,5809,7473,66560,232360,298920
7/14/2024,Rashmi Herath,Matara,Matara,Southern,5833,4579,10412,233320,183160,416480
7/15/2024,Rashmi Herath,Matara,Matara,Southern,231,6750,6981,9240,270000,279240
7/16/2024,Rashmi Herath,Matara,Matara,Southern,3381,9801,13182,135240,392040,527280
7/17/2024,Rashmi Herath,Matara,Matara,Southern,5377,8737,14114,215080,349480,564560
7/18/2024,Rashmi Herath,Matara,Matara,Southern,5519,1434,6953,220760,57360,278120
7/19/2024,Rashmi Herath,Matara,Matara,Southern,6217,7094,13311,248680,283760,532440
7/20/2024,Rashmi Herath,Matara,Matara,Southern,2185,7598,9783,87400,303920,391320
7/21/2024,Rashmi Herath,Matara,Matara,Southern,8424,6686,15110,336960,267440,604400
7/22/2024,Rashmi Herath,Matara,Matara,Southern,9592,6263,15855,383680,250520,634200
7/23/2024,Rashmi Herath,Matara,Matara,Southern,2377,1314,3691,95080,52560,147640
7/24/2024,Rashmi Herath,Matara,Matara,Southern,7118,6272,13390,284720,250880,535600
7/25/2024,Rashmi Herath,Matara,Matara,Southern,8779,896,9675,351160,35840,387000
7/26/2024,Rashmi Herath,Matara,Matara,Southern,5518,7333,12851,220720,293320,514040
7/27/2024,Rashmi Herath,Matara,Matara,Southern,176,2912,3088,7040,116480,123520
7/28/2024,Rashmi Herath,Matara,Matara,Southern,9241,664,9905,369640,26560,396200
7/29/2024,Rashmi Herath,Matara,Matara,Southern,7756,6450,14206,310240,258000,568240
7/30/2024,Rashmi Herath,Matara,Matara,Southern,1059,2652,3711,42360,106080,148440
7/31/2024,Rashmi Herath,Matara,Matara,Southern,6054,7392,13446,242160,295680,537840
8/1/2024,Rashmi Herath,Matara,Matara,Southern,8436,7372,15808,337440,294880,632320
8/2/2024,Rashmi Herath,Matara,Matara,Southern,8531,3145,11676,341240,125800,467040
8/3/2024,Rashmi Herath,Matara,Matara,Southern,2156,7115,9271,86240,284600,370840
8/4/2024,Rashmi Herath,Matara,Matara,Southern,4142,6338,10480,165680,253520,419200
8/5/2024,Rashmi Herath,Matara,Matara,Southern,3161,6701,9862,126440,268040,394480
8/6/2024,Rashmi Herath,Matara,Matara,Southern,3073,6924,9997,122920,276960,399880
8/7/2024,Rashmi Herath,Matara,Matara,Southern,9121,1446,10567,364840,57840,422680
8/8/2024,Rashmi Herath,Matara,Matara,Southern,6969,1969,8938,278760,78760,357520
8/9/2024,Rashmi Herath,Matara,Matara,Southern,5486,2412,7898,219440,96480,315920
8/10/2024,Rashmi Herath,Matara,Matara,Southern,345,8597,8942,13800,343880,357680
8/11/2024,Rashmi Herath,Matara,Matara,Southern,5239,4879,10118,209560,195160,404720
8/12/2024,Rashmi Herath,Matara,Matara,Southern,5392,5821,11213,215680,232840,448520
8/13/2024,Rashmi Herath,Matara,Matara,Southern,1425,8528,9953,57000,341120,398120
8/14/2024,Rashmi Herath,Matara,Matara,Southern,5495,7056,12551,219800,282240,502040
8/15/2024,Rashmi Herath,Matara,Matara,Southern,4115,231,4346,164600,9240,173840
8/16/2024,Rashmi Herath,Matara,Matara,Southern,191,7553,7744,7640,302120,309760
8/17/2024,Rashmi Herath,Matara,Matara,Southern,7233,8134,15367,289320,325360,614680
8/18/2024,Rashmi Herath,Matara,Matara,Southern,9840,203,10043,393600,8120,401720
8/19/2024,Rashmi Herath,Matara,Matara,Southern,3532,3690,7222,141280,147600,288880
8/20/2024,Rashmi Herath,Matara,Matara,Southern,4435,1621,6056,177400,64840,242240
8/21/2024,Rashmi Herath,Matara,Matara,Southern,9820,517,10337,392800,20680,413480
8/22/2024,Rashmi Herath,Matara,Matara,Southern,6280,2062,8342,251200,82480,333680
8/23/2024,Rashmi Herath,Matara,Matara,Southern,1982,9797,11779,79280,391880,471160
8/24/2024,Rashmi Herath,Matara,Matara,Southern,4234,5997,10231,169360,239880,409240
8/25/2024,Rashmi Herath,Matara,Matara,Southern,7644,2243,9887,305760,89720,395480
8/26/2024,Rashmi Herath,Matara,Matara,Southern,1528,401,1929,61120,16040,77160
8/27/2024,Rashmi Herath,Matara,Matara,Southern,1764,1586,3350,70560,63440,134000
8/28/2024,Rashmi Herath,Matara,Matara,Southern,4832,8632,13464,193280,345280,538560
8/29/2024,Rashmi Herath,Matara,Matara,Southern,9019,4810,13829,360760,192400,553160
8/30/2024,Rashmi Herath,Matara,Matara,Southern,8974,3298,12272,358960,131920,490880
8/31/2024,Rashmi Herath,Matara,Matara,Southern,9550,2872,12422,382000,114880,496880
9/1/2024,Rashmi Herath,Matara,Matara,Southern,1418,9436,10854,56720,377440,434160
9/2/2024,Rashmi Herath,Matara,Matara,Southern,8086,1350,9436,323440,54000,377440
9/3/2024,Rashmi Herath,Matara,Matara,Southern,5922,3752,9674,236880,150080,386960
9/4/2024,Rashmi Herath,Matara,Matara,Southern,401,9215,9616,16040,368600,384640
9/5/2024,Rashmi Herath,Matara,Matara,Southern,7230,7890,15120,289200,315600,604800
9/6/2024,Rashmi Herath,Matara,Matara,Southern,2253,9563,11816,90120,382520,472640
9/7/2024,Rashmi Herath,Matara,Matara,Southern,4726,4400,9126,189040,176000,365040
9/8/2024,Rashmi Herath,Matara,Matara,Southern,5834,4531,10365,233360,181240,414600
9/9/2024,Rashmi Herath,Matara,Matara,Southern,4975,6450,11425,199000,258000,457000
9/10/2024,Rashmi Herath,Matara,Matara,Southern,3580,153,3733,143200,6120,149320
9/11/2024,Rashmi Herath,Matara,Matara,Southern,3763,1757,5520,150520,70280,220800
9/12/2024,Rashmi Herath,Matara,Matara,Southern,7606,610,8216,304240,24400,328640
9/13/2024,Rashmi Herath,Matara,Matara,Southern,5643,2105,7748,225720,84200,309920
9/14/2024,Rashmi Herath,Matara,Matara,Southern,522,4382,4904,20880,175280,196160
9/15/2024,Rashmi Herath,Matara,Matara,Southern,1725,2421,4146,69000,96840,165840
9/16/2024,Rashmi Herath,Matara,Matara,Southern,7962,4424,12386,318480,176960,495440
9/17/2024,Rashmi Herath,Matara,Matara,Southern,1659,9614,11273,66360,384560,450920
9/18/2024,Rashmi Herath,Matara,Matara,Southern,9145,1164,10309,365800,46560,412360
9/19/2024,Rashmi Herath,Matara,Matara,Southern,7390,5956,13346,295600,238240,533840
9/20/2024,Rashmi Herath,Matara,Matara,Southern,6679,7183,13862,267160,287320,554480
9/21/2024,Rashmi Herath,Matara,Matara,Southern,5549,7689,13238,221960,307560,529520
9/22/2024,Rashmi Herath,Matara,Matara,Southern,6344,5873,12217,253760,234920,488680
9/23/2024,Rashmi Herath,Matara,Matara,Southern,1615,8232,9847,64600,329280,393880
9/24/2024,Rashmi Herath,Matara,Matara,Southern,2269,8688,10957,90760,347520,438280
9/25/2024,Rashmi Herath,Matara,Matara,Southern,4390,5478,9868,175600,219120,394720
9/26/2024,Rashmi Herath,Matara,Matara,Southern,1165,8547,9712,46600,341880,388480
9/27/2024,Rashmi Herath,Matara,Matara,Southern,1805,6969,8774,72200,278760,350960
9/28/2024,Rashmi Herath,Matara,Matara,Southern,6169,7455,13624,246760,298200,544960
9/29/2024,Rashmi Herath,Matara,Matara,Southern,4573,9223,13796,182920,368920,551840
9/30/2024,Rashmi Herath,Matara,Matara,Southern,3818,9262,13080,152720,370480,523200
10/1/2024,Rashmi Herath,Matara,Matara,Southern,5143,459,5602,205720,18360,224080
10/2/2024,Rashmi Herath,Matara,Matara,Southern,657,2295,2952,26280,91800,118080
10/3/2024,Rashmi Herath,Matara,Matara,Southern,4815,6665,11480,192600,266600,459200
10/4/2024,Rashmi Herath,Matara,Matara,Southern,3062,1824,4886,122480,72960,195440
10/5/2024,Rashmi Herath,Matara,Matara,Southern,2057,1072,3129,82280,42880,125160
10/6/2024,Rashmi Herath,Matara,Matara,Southern,780,8097,8877,31200,323880,355080
10/7/2024,Rashmi Herath,Matara,Matara,Southern,5399,228,5627,215960,9120,225080
10/8/2024,Rashmi Herath,Matara,Matara,Southern,8455,6277,14732,338200,251080,589280
10/9/2024,Rashmi Herath,Matara,Matara,Southern,7676,3359,11035,307040,134360,441400
10/10/2024,Rashmi Herath,Matara,Matara,Southern,5596,221,5817,223840,8840,232680
10/11/2024,Rashmi Herath,Matara,Matara,Southern,8026,6287,14313,321040,251480,572520
10/12/2024,Rashmi Herath,Matara,Matara,Southern,1572,9800,11372,62880,392000,454880
10/13/2024,Rashmi Herath,Matara,Matara,Southern,1508,5374,6882,60320,214960,275280
10/14/2024,Rashmi Herath,Matara,Matara,Southern,3373,8613,11986,134920,344520,479440
10/15/2024,Rashmi Herath,Matara,Matara,Southern,6675,1960,8635,267000,78400,345400
10/16/2024,Rashmi Herath,Matara,Matara,Southern,5961,2841,8802,238440,113640,352080
10/17/2024,Rashmi Herath,Matara,Matara,Southern,6155,7376,13531,246200,295040,541240
10/18/2024,Rashmi Herath,Matara,Matara,Southern,4577,5121,9698,183080,204840,387920
10/19/2024,Rashmi Herath,Matara,Matara,Southern,111,9826,9937,4440,393040,397480
10/20/2024,Rashmi Herath,Matara,Matara,Southern,5273,9699,14972,210920,387960,598880
10/21/2024,Rashmi Herath,Matara,Matara,Southern,7074,2379,9453,282960,95160,378120
10/22/2024,Rashmi Herath,Matara,Matara,Southern,5234,6843,12077,209360,273720,483080
10/23/2024,Rashmi Herath,Matara,Matara,Southern,6093,1552,7645,243720,62080,305800
10/24/2024,Rashmi Herath,Matara,Matara,Southern,9358,4780,14138,374320,191200,565520
10/25/2024,Rashmi Herath,Matara,Matara,Southern,9833,7344,17177,393320,293760,687080
10/26/2024,Rashmi Herath,Matara,Matara,Southern,5263,6090,11353,210520,243600,454120
10/27/2024,Rashmi Herath,Matara,Matara,Southern,6736,9480,16216,269440,379200,648640
10/28/2024,Rashmi Herath,Matara,Matara,Southern,8585,8750,17335,343400,350000,693400
10/29/2024,Rashmi Herath,Matara,Matara,Southern,361,5476,5837,14440,219040,233480
10/30/2024,Rashmi Herath,Matara,Matara,Southern,1280,4153,5433,51200,166120,217320
10/31/2024,Rashmi Herath,Matara,Matara,Southern,20,8574,8594,800,342960,343760
11/1/2024,Rashmi Herath,Matara,Matara,Southern,1321,4320,5641,52840,172800,225640
11/2/2024,Rashmi Herath,Matara,Matara,Southern,3188,2560,5748,127520,102400,229920
11/3/2024,Rashmi Herath,Matara,Matara,Southern,2377,3416,5793,95080,136640,231720
11/4/2024,Rashmi Herath,Matara,Matara,Southern,4340,2234,6574,173600,89360,262960
11/5/2024,Rashmi Herath,Matara,Matara,Southern,3908,8793,12701,156320,351720,508040
11/6/2024,Rashmi Herath,Matara,Matara,Southern,9479,1850,11329,379160,74000,453160
11/7/2024,Rashmi Herath,Matara,Matara,Southern,7344,1793,9137,293760,71720,365480
11/8/2024,Rashmi Herath,Matara,Matara,Southern,8647,3661,12308,345880,146440,492320
11/9/2024,Rashmi Herath,Matara,Matara,Southern,2604,1176,3780,104160,47040,151200
11/10/2024,Rashmi Herath,Matara,Matara,Southern,2545,4613,7158,101800,184520,286320
11/11/2024,Rashmi Herath,Matara,Matara,Southern,3160,5080,8240,126400,203200,329600
11/12/2024,Rashmi Herath,Matara,Matara,Southern,5537,8439,13976,221480,337560,559040
11/13/2024,Rashmi Herath,Matara,Matara,Southern,3306,7596,10902,132240,303840,436080
11/14/2024,Rashmi Herath,Matara,Matara,Southern,1868,2628,4496,74720,105120,179840
11/15/2024,Rashmi Herath,Matara,Matara,Southern,754,64,818,30160,2560,32720
11/16/2024,Rashmi Herath,Matara,Matara,Southern,8223,8263,16486,328920,330520,659440
11/17/2024,Rashmi Herath,Matara,Matara,Southern,6898,6518,13416,275920,260720,536640
11/18/2024,Rashmi Herath,Matara,Matara,Southern,5223,7245,12468,208920,289800,498720
11/19/2024,Rashmi Herath,Matara,Matara,Southern,6586,6991,13577,263440,279640,543080
11/20/2024,Rashmi Herath,Matara,Matara,Southern,3135,5744,8879,125400,229760,355160
11/21/2024,Rashmi Herath,Matara,Matara,Southern,4987,1286,6273,199480,51440,250920
11/22/2024,Rashmi Herath,Matara,Matara,Southern,3861,1891,5752,154440,75640,230080
11/23/2024,Rashmi Herath,Matara,Matara,Southern,8974,9040,18014,358960,361600,720560
11/24/2024,Rashmi Herath,Matara,Matara,Southern,7739,6393,14132,309560,255720,565280
11/25/2024,Rashmi Herath,Matara,Matara,Southern,5294,4476,9770,211760,179040,390800
11/26/2024,Rashmi Herath,Matara,Matara,Southern,2673,1708,4381,106920,68320,175240
11/27/2024,Rashmi Herath,Matara,Matara,Southern,4405,4199,8604,176200,167960,344160
11/28/2024,Rashmi Herath,Matara,Matara,Southern,8457,9511,17968,338280,380440,718720
11/29/2024,Rashmi Herath,Matara,Matara,Southern,2903,321,3224,116120,12840,128960
11/30/2024,Rashmi Herath,Matara,Matara,Southern,7265,6600,13865,290600,264000,554600
12/1/2024,Rashmi Herath,Matara,Matara,Southern,1450,2311,3761,58000,92440,150440
12/2/2024,Rashmi Herath,Matara,Matara,Southern,3620,2137,5757,144800,85480,230280
12/3/2024,Rashmi Herath,Matara,Matara,Southern,7134,5967,13101,285360,238680,524040
12/4/2024,Rashmi Herath,Matara,Matara,Southern,4281,2508,6789,171240,100320,271560
12/5/2024,Rashmi Herath,Matara,Matara,Southern,5778,7965,13743,231120,318600,549720
12/6/2024,Rashmi Herath,Matara,Matara,Southern,9078,8431,17509,363120,337240,700360
12/7/2024,Rashmi Herath,Matara,Matara,Southern,1761,9212,10973,70440,368480,438920
12/8/2024,Rashmi Herath,Matara,Matara,Southern,8925,1556,10481,357000,62240,419240
12/9/2024,Rashmi Herath,Matara,Matara,Southern,444,8712,9156,17760,348480,366240
12/10/2024,Rashmi Herath,Matara,Matara,Southern,168,5283,5451,6720,211320,218040
12/11/2024,Rashmi Herath,Matara,Matara,Southern,6150,6659,12809,246000,266360,512360
12/12/2024,Rashmi Herath,Matara,Matara,Southern,8520,7432,15952,340800,297280,638080
12/13/2024,Rashmi Herath,Matara,Matara,Southern,1177,5628,6805,47080,225120,272200
12/14/2024,Rashmi Herath,Matara,Matara,Southern,1526,1267,2793,61040,50680,111720
12/15/2024,Rashmi Herath,Matara,Matara,Southern,9434,3109,12543,377360,124360,501720
12/16/2024,Rashmi Herath,Matara,Matara,Southern,8522,6456,14978,340880,258240,599120
12/17/2024,Rashmi Herath,Matara,Matara,Southern,9839,6678,16517,393560,267120,660680
12/18/2024,Rashmi Herath,Matara,Matara,Southern,3774,1112,4886,150960,44480,195440
12/19/2024,Rashmi Herath,Matara,Matara,Southern,2111,3087,5198,84440,123480,207920
12/20/2024,Rashmi Herath,Matara,Matara,Southern,2364,9017,11381,94560,360680,455240
12/21/2024,Rashmi Herath,Matara,Matara,Southern,2361,1142,3503,94440,45680,140120
12/22/2024,Rashmi Herath,Matara,Matara,Southern,8118,7605,15723,324720,304200,628920
12/23/2024,Rashmi Herath,Matara,Matara,Southern,3632,6225,9857,145280,249000,394280
12/24/2024,Rashmi Herath,Matara,Matara,Southern,1513,4254,5767,60520,170160,230680
12/25/2024,Rashmi Herath,Matara,Matara,Southern,2539,1121,3660,101560,44840,146400
12/26/2024,Rashmi Herath,Matara,Matara,Southern,4053,2469,6522,162120,98760,260880
12/27/2024,Rashmi Herath,Matara,Matara,Southern,4867,2556,7423,194680,102240,296920
12/28/2024,Rashmi Herath,Matara,Matara,Southern,8536,7050,15586,341440,282000,623440
12/29/2024,Rashmi Herath,Matara,Matara,Southern,3485,4002,7487,139400,160080,299480
12/30/2024,Rashmi Herath,Matara,Matara,Southern,5411,6007,11418,216440,240280,456720
12/31/2024,Rashmi Herath,Matara,Matara,Southern,7462,3738,11200,298480,149520,448000
1/1/2025,Rashmi Herath,Matara,Matara,Southern,8251,1059,9310,330040,42360,372400
1/2/2025,Rashmi Herath,Matara,Matara,Southern,6992,7586,14578,279680,303440,583120
1/3/2025,Rashmi Herath,Matara,Matara,Southern,1985,6204,8189,79400,248160,327560
1/4/2025,Rashmi Herath,Matara,Matara,Southern,2139,5375,7514,85560,215000,300560
1/5/2025,Rashmi Herath,Matara,Matara,Southern,8604,6568,15172,344160,262720,606880
1/6/2025,Rashmi Herath,Matara,Matara,Southern,3574,6011,9585,142960,240440,383400
1/7/2025,Rashmi Herath,Matara,Matara,Southern,3428,5025,8453,137120,201000,338120
1/8/2025,Rashmi Herath,Matara,Matara,Southern,4157,3470,7627,166280,138800,305080
1/9/2025,Rashmi Herath,Matara,Matara,Southern,5991,3229,9220,239640,129160,368800
1/10/2025,Rashmi Herath,Matara,Matara,Southern,6897,3602,10499,275880,144080,419960
1/11/2025,Rashmi Herath,Matara,Matara,Southern,3015,1429,4444,120600,57160,177760
1/12/2025,Rashmi Herath,Matara,Matara,Southern,4396,2708,7104,175840,108320,284160
1/13/2025,Rashmi Herath,Matara,Matara,Southern,975,3484,4459,39000,139360,178360
1/14/2025,Rashmi Herath,Matara,Matara,Southern,905,2826,3731,36200,113040,149240
1/15/2025,Rashmi Herath,Matara,Matara,Southern,4888,3969,8857,195520,158760,354280
1/16/2025,Rashmi Herath,Matara,Matara,Southern,1045,2226,3271,41800,89040,130840
1/17/2025,Rashmi Herath,Matara,Matara,Southern,5478,7701,13179,219120,308040,527160
1/18/2025,Rashmi Herath,Matara,Matara,Southern,9646,5112,14758,385840,204480,590320
1/19/2025,Rashmi Herath,Matara,Matara,Southern,8838,4911,13749,353520,196440,549960
1/20/2025,Rashmi Herath,Matara,Matara,Southern,1395,8978,10373,55800,359120,414920
1/21/2025,Rashmi Herath,Matara,Matara,Southern,7133,2790,9923,285320,111600,396920
1/22/2025,Rashmi Herath,Matara,Matara,Southern,9106,8406,17512,364240,336240,700480
1/23/2025,Rashmi Herath,Matara,Matara,Southern,5290,7241,12531,211600,289640,501240
1/24/2025,Rashmi Herath,Matara,Matara,Southern,467,8487,8954,18680,339480,358160
1/25/2025,Rashmi Herath,Matara,Matara,Southern,5812,9487,15299,232480,379480,611960
1/26/2025,Rashmi Herath,Matara,Matara,Southern,9823,7471,17294,392920,298840,691760
1/27/2025,Rashmi Herath,Matara,Matara,Southern,4783,7700,12483,191320,308000,499320
1/28/2025,Rashmi Herath,Matara,Matara,Southern,5596,6642,12238,223840,265680,489520
1/29/2025,Rashmi Herath,Matara,Matara,Southern,846,1648,2494,33840,65920,99760
1/30/2025,Rashmi Herath,Matara,Matara,Southern,4844,5916,10760,193760,236640,430400
1/31/2025,Rashmi Herath,Matara,Matara,Southern,6681,9506,16187,267240,380240,647480
2/1/2025,Rashmi Herath,Matara,Matara,Southern,202,6636,6838,8080,265440,273520
2/2/2025,Rashmi Herath,Matara,Matara,Southern,6435,3478,9913,257400,139120,396520
2/3/2025,Rashmi Herath,Matara,Matara,Southern,3509,995,4504,140360,39800,180160
2/4/2025,Rashmi Herath,Matara,Matara,Southern,2419,4167,6586,96760,166680,263440
2/5/2025,Rashmi Herath,Matara,Matara,Southern,8753,9928,18681,350120,397120,747240
2/6/2025,Rashmi Herath,Matara,Matara,Southern,9062,6260,15322,362480,250400,612880
2/7/2025,Rashmi Herath,Matara,Matara,Southern,2939,4601,7540,117560,184040,301600
2/8/2025,Rashmi Herath,Matara,Matara,Southern,1163,4111,5274,46520,164440,210960
2/9/2025,Rashmi Herath,Matara,Matara,Southern,9820,2461,12281,392800,98440,491240
2/10/2025,Rashmi Herath,Matara,Matara,Southern,5430,9928,15358,217200,397120,614320
2/11/2025,Rashmi Herath,Matara,Matara,Southern,6349,104,6453,253960,4160,258120
2/12/2025,Rashmi Herath,Matara,Matara,Southern,6934,9218,16152,277360,368720,646080
2/13/2025,Rashmi Herath,Matara,Matara,Southern,1255,7485,8740,50200,299400,349600
2/14/2025,Rashmi Herath,Matara,Matara,Southern,6730,5495,12225,269200,219800,489000
2/15/2025,Rashmi Herath,Matara,Matara,Southern,8608,3672,12280,344320,146880,491200
2/16/2025,Rashmi Herath,Matara,Matara,Southern,5153,261,5414,206120,10440,216560
2/17/2025,Rashmi Herath,Matara,Matara,Southern,3383,4439,7822,135320,177560,312880
2/18/2025,Rashmi Herath,Matara,Matara,Southern,2087,9127,11214,83480,365080,448560
2/19/2025,Rashmi Herath,Matara,Matara,Southern,836,3661,4497,33440,146440,179880
2/20/2025,Rashmi Herath,Matara,Matara,Southern,2934,4027,6961,117360,161080,278440
2/21/2025,Rashmi Herath,Matara,Matara,Southern,2471,2871,5342,98840,114840,213680
2/22/2025,Rashmi Herath,Matara,Matara,Southern,594,3470,4064,23760,138800,162560
2/23/2025,Rashmi Herath,Matara,Matara,Southern,7766,7559,15325,310640,302360,613000
2/24/2025,Rashmi Herath,Matara,Matara,Southern,7218,2693,9911,288720,107720,396440
2/25/2025,Rashmi Herath,Matara,Matara,Southern,9953,31,9984,398120,1240,399360
2/26/2025,Rashmi Herath,Matara,Matara,Southern,2979,4285,7264,119160,171400,290560
2/27/2025,Rashmi Herath,Matara,Matara,Southern,887,2714,3601,35480,108560,144040
2/28/2025,Rashmi Herath,Matara,Matara,Southern,655,18,673,26200,720,26920
3/1/2025,Rashmi Herath,Matara,Matara,Southern,2602,8738,11340,104080,349520,453600
3/2/2025,Rashmi Herath,Matara,Matara,Southern,2660,8232,10892,106400,329280,435680
3/3/2025,Rashmi Herath,Matara,Matara,Southern,2309,1952,4261,92360,78080,170440
3/4/2025,Rashmi Herath,Matara,Matara,Southern,4268,4064,8332,170720,162560,333280
3/5/2025,Rashmi Herath,Matara,Matara,Southern,1384,2958,4342,55360,118320,173680
3/6/2025,Rashmi Herath,Matara,Matara,Southern,7420,9603,17023,296800,384120,680920
3/7/2025,Rashmi Herath,Matara,Matara,Southern,4942,4554,9496,197680,182160,379840
3/8/2025,Rashmi Herath,Matara,Matara,Southern,6333,8554,14887,253320,342160,595480
3/9/2025,Rashmi Herath,Matara,Matara,Southern,9894,3163,13057,395760,126520,522280
3/10/2025,Rashmi Herath,Matara,Matara,Southern,5014,3149,8163,200560,125960,326520
3/11/2025,Rashmi Herath,Matara,Matara,Southern,1392,2564,3956,55680,102560,158240
3/12/2025,Rashmi Herath,Matara,Matara,Southern,9928,9294,19222,397120,371760,768880
3/13/2025,Rashmi Herath,Matara,Matara,Southern,4893,4009,8902,195720,160360,356080
3/14/2025,Rashmi Herath,Matara,Matara,Southern,5982,7281,13263,239280,291240,530520
3/15/2025,Rashmi Herath,Matara,Matara,Southern,197,1964,2161,7880,78560,86440
3/16/2025,Rashmi Herath,Matara,Matara,Southern,7190,707,7897,287600,28280,315880
3/17/2025,Rashmi Herath,Matara,Matara,Southern,8525,4203,12728,341000,168120,509120
3/18/2025,Rashmi Herath,Matara,Matara,Southern,6351,9933,16284,254040,397320,651360
3/19/2025,Rashmi Herath,Matara,Matara,Southern,2328,8214,10542,93120,328560,421680
3/20/2025,Rashmi Herath,Matara,Matara,Southern,1814,6354,8168,72560,254160,326720
3/21/2025,Rashmi Herath,Matara,Matara,Southern,2997,4946,7943,119880,197840,317720
3/22/2025,Rashmi Herath,Matara,Matara,Southern,369,3230,3599,14760,129200,143960
3/23/2025,Rashmi Herath,Matara,Matara,Southern,5956,1900,7856,238240,76000,314240
3/25/2024,Lahiru Perera,Jaffna,Karainagar,Northern,8538,1713,10251,341520,68520,410040
3/26/2024,Lahiru Perera,Jaffna,Karainagar,Northern,1171,1910,3081,46840,76400,123240
3/27/2024,Lahiru Perera,Jaffna,Karainagar,Northern,5116,6635,11751,204640,265400,470040
3/28/2024,Lahiru Perera,Jaffna,Karainagar,Northern,5743,3577,9320,229720,143080,372800
3/29/2024,Lahiru Perera,Jaffna,Karainagar,Northern,17,6345,6362,680,253800,254480
3/30/2024,Lahiru Perera,Jaffna,Karainagar,Northern,9783,4479,14262,391320,179160,570480
3/31/2024,Lahiru Perera,Jaffna,Karainagar,Northern,9936,1500,11436,397440,60000,457440
4/1/2024,Lahiru Perera,Jaffna,Karainagar,Northern,9441,4971,14412,377640,198840,576480
4/2/2024,Lahiru Perera,Jaffna,Karainagar,Northern,5650,2820,8470,226000,112800,338800
4/3/2024,Lahiru Perera,Jaffna,Karainagar,Northern,4761,6290,11051,190440,251600,442040
4/4/2024,Lahiru Perera,Jaffna,Karainagar,Northern,419,2391,2810,16760,95640,112400
4/5/2024,Lahiru Perera,Jaffna,Karainagar,Northern,2384,6314,8698,95360,252560,347920
4/6/2024,Lahiru Perera,Jaffna,Karainagar,Northern,1594,6739,8333,63760,269560,333320
4/7/2024,Lahiru Perera,Jaffna,Karainagar,Northern,3382,7931,11313,135280,317240,452520
4/8/2024,Lahiru Perera,Jaffna,Karainagar,Northern,7253,8281,15534,290120,331240,621360
4/9/2024,Lahiru Perera,Jaffna,Karainagar,Northern,33,4493,4526,1320,179720,181040
4/10/2024,Lahiru Perera,Jaffna,Karainagar,Northern,3121,4233,7354,124840,169320,294160
4/11/2024,Lahiru Perera,Jaffna,Karainagar,Northern,4590,442,5032,183600,17680,201280
4/19/2024,Lahiru Perera,Jaffna,Karainagar,Northern,6630,3964,10594,265200,158560,423760
4/20/2024,Lahiru Perera,Jaffna,Karainagar,Northern,3430,6958,10388,137200,278320,415520
4/21/2024,Lahiru Perera,Jaffna,Karainagar,Northern,9573,6211,15784,382920,248440,631360
4/22/2024,Lahiru Perera,Jaffna,Karainagar,Northern,8765,5284,14049,350600,211360,561960
4/23/2024,Lahiru Perera,Jaffna,Karainagar,Northern,5113,1608,6721,204520,64320,268840
4/24/2024,Lahiru Perera,Jaffna,Karainagar,Northern,9819,26,9845,392760,1040,393800
4/25/2024,Lahiru Perera,Jaffna,Karainagar,Northern,3031,301,3332,121240,12040,133280
4/26/2024,Lahiru Perera,Jaffna,Karainagar,Northern,8154,6023,14177,326160,240920,567080
4/27/2024,Lahiru Perera,Jaffna,Karainagar,Northern,6334,6482,12816,253360,259280,512640
4/28/2024,Lahiru Perera,Jaffna,Karainagar,Northern,4780,8544,13324,191200,341760,532960
4/29/2024,Lahiru Perera,Jaffna,Karainagar,Northern,974,8356,9330,38960,334240,373200
4/30/2024,Lahiru Perera,Jaffna,Karainagar,Northern,7904,2085,9989,316160,83400,399560
5/1/2024,Lahiru Perera,Jaffna,Karainagar,Northern,8635,9966,18601,345400,398640,744040
5/2/2024,Lahiru Perera,Jaffna,Karainagar,Northern,5985,1156,7141,239400,46240,285640
5/3/2024,Lahiru Perera,Jaffna,Karainagar,Northern,2629,3228,5857,105160,129120,234280
5/4/2024,Lahiru Perera,Jaffna,Karainagar,Northern,2982,266,3248,119280,10640,129920
5/5/2024,Lahiru Perera,Jaffna,Karainagar,Northern,7960,857,8817,318400,34280,352680
5/6/2024,Lahiru Perera,Jaffna,Karainagar,Northern,3280,3179,6459,131200,127160,258360
5/7/2024,Lahiru Perera,Jaffna,Karainagar,Northern,2396,815,3211,95840,32600,128440
5/8/2024,Lahiru Perera,Jaffna,Karainagar,Northern,8701,5086,13787,348040,203440,551480
5/9/2024,Lahiru Perera,Jaffna,Karainagar,Northern,9076,2931,12007,363040,117240,480280
5/10/2024,Lahiru Perera,Jaffna,Karainagar,Northern,4532,523,5055,181280,20920,202200
5/11/2024,Lahiru Perera,Jaffna,Karainagar,Northern,5768,3881,9649,230720,155240,385960
5/12/2024,Lahiru Perera,Jaffna,Karainagar,Northern,5846,6675,12521,233840,267000,500840
5/13/2024,Lahiru Perera,Jaffna,Karainagar,Northern,8575,37,8612,343000,1480,344480
5/14/2024,Lahiru Perera,Jaffna,Karainagar,Northern,6362,7801,14163,254480,312040,566520
5/15/2024,Lahiru Perera,Jaffna,Karainagar,Northern,111,9603,9714,4440,384120,388560
5/16/2024,Lahiru Perera,Jaffna,Karainagar,Northern,4573,4909,9482,182920,196360,379280
5/17/2024,Lahiru Perera,Jaffna,Karainagar,Northern,6741,1568,8309,269640,62720,332360
5/18/2024,Lahiru Perera,Jaffna,Karainagar,Northern,3479,9177,12656,139160,367080,506240
5/19/2024,Lahiru Perera,Jaffna,Karainagar,Northern,6914,3383,10297,276560,135320,411880
5/20/2024,Lahiru Perera,Jaffna,Karainagar,Northern,3865,6250,10115,154600,250000,404600
5/21/2024,Lahiru Perera,Jaffna,Karainagar,Northern,1567,5347,6914,62680,213880,276560
5/22/2024,Lahiru Perera,Jaffna,Karainagar,Northern,3088,3767,6855,123520,150680,274200
5/24/2024,Lahiru Perera,Jaffna,Karainagar,Northern,2299,4332,6631,91960,173280,265240
5/25/2024,Lahiru Perera,Jaffna,Karainagar,Northern,5763,4290,10053,230520,171600,402120
5/26/2024,Lahiru Perera,Jaffna,Karainagar,Northern,482,2591,3073,19280,103640,122920
5/27/2024,Lahiru Perera,Jaffna,Karainagar,Northern,9033,4886,13919,361320,195440,556760
5/28/2024,Lahiru Perera,Jaffna,Karainagar,Northern,2048,3843,5891,81920,153720,235640
5/29/2024,Lahiru Perera,Jaffna,Karainagar,Northern,7208,9086,16294,288320,363440,651760
5/30/2024,Lahiru Perera,Jaffna,Karainagar,Northern,571,6374,6945,22840,254960,277800
5/31/2024,Lahiru Perera,Jaffna,Karainagar,Northern,773,1704,2477,30920,68160,99080
6/1/2024,Lahiru Perera,Jaffna,Karainagar,Northern,6908,3410,10318,276320,136400,412720
6/2/2024,Lahiru Perera,Jaffna,Karainagar,Northern,2560,1869,4429,102400,74760,177160
6/3/2024,Lahiru Perera,Jaffna,Karainagar,Northern,2526,4577,7103,101040,183080,284120
6/4/2024,Lahiru Perera,Jaffna,Karainagar,Northern,4845,9110,13955,193800,364400,558200
6/5/2024,Lahiru Perera,Jaffna,Karainagar,Northern,9531,7875,17406,381240,315000,696240
6/6/2024,Lahiru Perera,Jaffna,Karainagar,Northern,9969,3360,13329,398760,134400,533160
6/7/2024,Lahiru Perera,Jaffna,Karainagar,Northern,8005,3634,11639,320200,145360,465560
6/8/2024,Lahiru Perera,Jaffna,Karainagar,Northern,8859,2841,11700,354360,113640,468000
6/9/2024,Lahiru Perera,Jaffna,Karainagar,Northern,5018,5416,10434,200720,216640,417360
6/10/2024,Lahiru Perera,Jaffna,Karainagar,Northern,4770,144,4914,190800,5760,196560
6/11/2024,Lahiru Perera,Jaffna,Karainagar,Northern,2943,3526,6469,117720,141040,258760
6/12/2024,Lahiru Perera,Jaffna,Karainagar,Northern,5243,1094,6337,209720,43760,253480
6/13/2024,Lahiru Perera,Jaffna,Karainagar,Northern,2648,3957,6605,105920,158280,264200
6/14/2024,Lahiru Perera,Jaffna,Karainagar,Northern,1515,102,1617,60600,4080,64680
6/15/2024,Lahiru Perera,Jaffna,Karainagar,Northern,6743,5982,12725,269720,239280,509000
6/16/2024,Lahiru Perera,Jaffna,Karainagar,Northern,4240,9348,13588,169600,373920,543520
6/17/2024,Lahiru Perera,Jaffna,Karainagar,Northern,4981,5803,10784,199240,232120,431360
6/18/2024,Lahiru Perera,Jaffna,Karainagar,Northern,9759,1258,11017,390360,50320,440680
6/19/2024,Lahiru Perera,Jaffna,Karainagar,Northern,6142,7536,13678,245680,301440,547120
6/20/2024,Lahiru Perera,Jaffna,Karainagar,Northern,1053,7471,8524,42120,298840,340960
6/21/2024,Lahiru Perera,Jaffna,Karainagar,Northern,7055,4221,11276,282200,168840,451040
6/22/2024,Lahiru Perera,Jaffna,Karainagar,Northern,86,4391,4477,3440,175640,179080
6/23/2024,Lahiru Perera,Jaffna,Karainagar,Northern,2110,5036,7146,84400,201440,285840
6/24/2024,Lahiru Perera,Jaffna,Karainagar,Northern,8824,5300,14124,352960,212000,564960
6/25/2024,Lahiru Perera,Jaffna,Karainagar,Northern,2622,3967,6589,104880,158680,263560
6/26/2024,Lahiru Perera,Jaffna,Karainagar,Northern,6539,2475,9014,261560,99000,360560
6/27/2024,Lahiru Perera,Jaffna,Karainagar,Northern,3273,6313,9586,130920,252520,383440
6/28/2024,Lahiru Perera,Jaffna,Karainagar,Northern,9982,5574,15556,399280,222960,622240
6/29/2024,Lahiru Perera,Jaffna,Karainagar,Northern,3826,8574,12400,153040,342960,496000
6/30/2024,Lahiru Perera,Jaffna,Karainagar,Northern,6429,6243,12672,257160,249720,506880
7/1/2024,Lahiru Perera,Jaffna,Karainagar,Northern,5029,8033,13062,201160,321320,522480
7/2/2024,Lahiru Perera,Jaffna,Karainagar,Northern,8093,6674,14767,323720,266960,590680
7/3/2024,Lahiru Perera,Jaffna,Karainagar,Northern,7728,846,8574,309120,33840,342960
7/4/2024,Lahiru Perera,Jaffna,Karainagar,Northern,8527,8969,17496,341080,358760,699840
7/5/2024,Lahiru Perera,Jaffna,Karainagar,Northern,703,8512,9215,28120,340480,368600
7/6/2024,Lahiru Perera,Jaffna,Karainagar,Northern,181,2839,3020,7240,113560,120800
7/7/2024,Lahiru Perera,Jaffna,Karainagar,Northern,2557,7982,10539,102280,319280,421560
7/8/2024,Lahiru Perera,Jaffna,Karainagar,Northern,6045,249,6294,241800,9960,251760
7/9/2024,Lahiru Perera,Jaffna,Karainagar,Northern,2961,850,3811,118440,34000,152440
7/10/2024,Lahiru Perera,Jaffna,Karainagar,Northern,2089,1186,3275,83560,47440,131000
7/11/2024,Lahiru Perera,Jaffna,Karainagar,Northern,9337,4683,14020,373480,187320,560800
7/12/2024,Lahiru Perera,Jaffna,Karainagar,Northern,5767,9061,14828,230680,362440,593120
7/13/2024,Lahiru Perera,Jaffna,Karainagar,Northern,6896,4543,11439,275840,181720,457560
7/14/2024,Lahiru Perera,Jaffna,Karainagar,Northern,8455,4403,12858,338200,176120,514320
7/15/2024,Lahiru Perera,Jaffna,Karainagar,Northern,3790,9439,13229,151600,377560,529160
7/16/2024,Lahiru Perera,Jaffna,Karainagar,Northern,2426,6717,9143,97040,268680,365720
7/17/2024,Lahiru Perera,Jaffna,Karainagar,Northern,6304,9867,16171,252160,394680,646840
7/18/2024,Lahiru Perera,Jaffna,Karainagar,Northern,2280,8527,10807,91200,341080,432280
7/19/2024,Lahiru Perera,Jaffna,Karainagar,Northern,2926,9941,12867,117040,397640,514680
7/20/2024,Lahiru Perera,Jaffna,Karainagar,Northern,5991,5979,11970,239640,239160,478800
7/21/2024,Lahiru Perera,Jaffna,Karainagar,Northern,9021,5487,14508,360840,219480,580320
7/22/2024,Lahiru Perera,Jaffna,Karainagar,Northern,7266,6739,14005,290640,269560,560200
7/23/2024,Lahiru Perera,Jaffna,Karainagar,Northern,4302,9897,14199,172080,395880,567960
7/24/2024,Lahiru Perera,Jaffna,Karainagar,Northern,9709,677,10386,388360,27080,415440
7/25/2024,Lahiru Perera,Jaffna,Karainagar,Northern,3614,5600,9214,144560,224000,368560
7/26/2024,Lahiru Perera,Jaffna,Karainagar,Northern,5495,8609,14104,219800,344360,564160
7/27/2024,Lahiru Perera,Jaffna,Karainagar,Northern,6375,8447,14822,255000,337880,592880
7/28/2024,Lahiru Perera,Jaffna,Karainagar,Northern,4116,2079,6195,164640,83160,247800
7/29/2024,Lahiru Perera,Jaffna,Karainagar,Northern,2335,9680,12015,93400,387200,480600
7/30/2024,Lahiru Perera,Jaffna,Karainagar,Northern,6094,3639,9733,243760,145560,389320
7/31/2024,Lahiru Perera,Jaffna,Karainagar,Northern,3518,5529,9047,140720,221160,361880
8/1/2024,Lahiru Perera,Jaffna,Karainagar,Northern,7659,4770,12429,306360,190800,497160
8/2/2024,Lahiru Perera,Jaffna,Karainagar,Northern,7189,3703,10892,287560,148120,435680
8/3/2024,Lahiru Perera,Jaffna,Karainagar,Northern,7654,1426,9080,306160,57040,363200
8/4/2024,Lahiru Perera,Jaffna,Karainagar,Northern,3116,8026,11142,124640,321040,445680
8/5/2024,Lahiru Perera,Jaffna,Karainagar,Northern,86,1031,1117,3440,41240,44680
8/6/2024,Lahiru Perera,Jaffna,Karainagar,Northern,2129,8810,10939,85160,352400,437560
8/7/2024,Lahiru Perera,Jaffna,Karainagar,Northern,5012,9908,14920,200480,396320,596800
8/8/2024,Lahiru Perera,Jaffna,Karainagar,Northern,491,5362,5853,19640,214480,234120
8/9/2024,Lahiru Perera,Jaffna,Karainagar,Northern,4772,9254,14026,190880,370160,561040
8/10/2024,Lahiru Perera,Jaffna,Karainagar,Northern,1706,5094,6800,68240,203760,272000
8/11/2024,Lahiru Perera,Jaffna,Karainagar,Northern,5608,906,6514,224320,36240,260560
8/12/2024,Lahiru Perera,Jaffna,Karainagar,Northern,3803,9765,13568,152120,390600,542720
8/13/2024,Lahiru Perera,Jaffna,Karainagar,Northern,1072,9699,10771,42880,387960,430840
8/14/2024,Lahiru Perera,Jaffna,Karainagar,Northern,6532,8045,14577,261280,321800,583080
8/15/2024,Lahiru Perera,Jaffna,Karainagar,Northern,3110,8812,11922,124400,352480,476880
8/16/2024,Lahiru Perera,Jaffna,Karainagar,Northern,8496,2090,10586,339840,83600,423440
8/17/2024,Lahiru Perera,Jaffna,Karainagar,Northern,7211,5419,12630,288440,216760,505200
8/18/2024,Lahiru Perera,Jaffna,Karainagar,Northern,5081,8781,13862,203240,351240,554480
8/19/2024,Lahiru Perera,Jaffna,Karainagar,Northern,8938,5067,14005,357520,202680,560200
8/20/2024,Lahiru Perera,Jaffna,Karainagar,Northern,6682,1525,8207,267280,61000,328280
8/21/2024,Lahiru Perera,Jaffna,Karainagar,Northern,7049,3136,10185,281960,125440,407400
8/22/2024,Lahiru Perera,Jaffna,Karainagar,Northern,5752,8396,14148,230080,335840,565920
8/23/2024,Lahiru Perera,Jaffna,Karainagar,Northern,5930,5684,11614,237200,227360,464560
8/24/2024,Lahiru Perera,Jaffna,Karainagar,Northern,9028,6163,15191,361120,246520,607640
8/25/2024,Lahiru Perera,Jaffna,Karainagar,Northern,1686,7842,9528,67440,313680,381120
8/26/2024,Lahiru Perera,Jaffna,Karainagar,Northern,6198,8780,14978,247920,351200,599120
8/27/2024,Lahiru Perera,Jaffna,Karainagar,Northern,1839,807,2646,73560,32280,105840
8/28/2024,Lahiru Perera,Jaffna,Karainagar,Northern,9217,5229,14446,368680,209160,577840
8/29/2024,Lahiru Perera,Jaffna,Karainagar,Northern,714,8101,8815,28560,324040,352600
8/30/2024,Lahiru Perera,Jaffna,Karainagar,Northern,2730,2848,5578,109200,113920,223120
8/31/2024,Lahiru Perera,Jaffna,Karainagar,Northern,328,4818,5146,13120,192720,205840
9/1/2024,Lahiru Perera,Jaffna,Karainagar,Northern,9982,8503,18485,399280,340120,739400
9/2/2024,Lahiru Perera,Jaffna,Karainagar,Northern,9537,4758,14295,381480,190320,571800
9/3/2024,Lahiru Perera,Jaffna,Karainagar,Northern,5939,7023,12962,237560,280920,518480
9/4/2024,Lahiru Perera,Jaffna,Karainagar,Northern,4287,8144,12431,171480,325760,497240
9/5/2024,Lahiru Perera,Jaffna,Karainagar,Northern,398,5247,5645,15920,209880,225800
9/6/2024,Lahiru Perera,Jaffna,Karainagar,Northern,2407,2366,4773,96280,94640,190920
9/7/2024,Lahiru Perera,Jaffna,Karainagar,Northern,7370,9832,17202,294800,393280,688080
9/8/2024,Lahiru Perera,Jaffna,Karainagar,Northern,6955,1770,8725,278200,70800,349000
9/9/2024,Lahiru Perera,Jaffna,Karainagar,Northern,3993,4466,8459,159720,178640,338360
9/10/2024,Lahiru Perera,Jaffna,Karainagar,Northern,7657,1057,8714,306280,42280,348560
9/11/2024,Lahiru Perera,Jaffna,Karainagar,Northern,3587,9961,13548,143480,398440,541920
9/12/2024,Lahiru Perera,Jaffna,Karainagar,Northern,7971,7031,15002,318840,281240,600080
9/13/2024,Lahiru Perera,Jaffna,Karainagar,Northern,9399,8263,17662,375960,330520,706480
9/14/2024,Lahiru Perera,Jaffna,Karainagar,Northern,1739,8297,10036,69560,331880,401440
9/15/2024,Lahiru Perera,Jaffna,Karainagar,Northern,5891,9946,15837,235640,397840,633480
9/16/2024,Lahiru Perera,Jaffna,Karainagar,Northern,6410,7024,13434,256400,280960,537360
9/17/2024,Lahiru Perera,Jaffna,Karainagar,Northern,7700,5841,13541,308000,233640,541640
9/18/2024,Lahiru Perera,Jaffna,Karainagar,Northern,457,6033,6490,18280,241320,259600
9/19/2024,Lahiru Perera,Jaffna,Karainagar,Northern,8792,4629,13421,351680,185160,536840
9/20/2024,Lahiru Perera,Jaffna,Karainagar,Northern,3803,9063,12866,152120,362520,514640
9/21/2024,Lahiru Perera,Jaffna,Karainagar,Northern,9889,2621,12510,395560,104840,500400
9/22/2024,Lahiru Perera,Jaffna,Karainagar,Northern,3054,7295,10349,122160,291800,413960
9/23/2024,Lahiru Perera,Jaffna,Karainagar,Northern,2382,3991,6373,95280,159640,254920
9/24/2024,Lahiru Perera,Jaffna,Karainagar,Northern,9378,8758,18136,375120,350320,725440
9/25/2024,Lahiru Perera,Jaffna,Karainagar,Northern,1634,8487,10121,65360,339480,404840
9/26/2024,Lahiru Perera,Jaffna,Karainagar,Northern,994,3014,4008,39760,120560,160320
9/27/2024,Lahiru Perera,Jaffna,Karainagar,Northern,5796,2006,7802,231840,80240,312080
9/28/2024,Lahiru Perera,Jaffna,Karainagar,Northern,9697,6256,15953,387880,250240,638120
9/29/2024,Lahiru Perera,Jaffna,Karainagar,Northern,529,4210,4739,21160,168400,189560
9/30/2024,Lahiru Perera,Jaffna,Karainagar,Northern,7675,5848,13523,307000,233920,540920
10/1/2024,Lahiru Perera,Jaffna,Karainagar,Northern,7923,9210,17133,316920,368400,685320
10/2/2024,Lahiru Perera,Jaffna,Karainagar,Northern,8739,6639,15378,349560,265560,615120
10/3/2024,Lahiru Perera,Jaffna,Karainagar,Northern,4613,824,5437,184520,32960,217480
10/4/2024,Lahiru Perera,Jaffna,Karainagar,Northern,7173,9994,17167,286920,399760,686680
10/5/2024,Lahiru Perera,Jaffna,Karainagar,Northern,8112,122,8234,324480,4880,329360
10/6/2024,Lahiru Perera,Jaffna,Karainagar,Northern,3607,5657,9264,144280,226280,370560
10/7/2024,Lahiru Perera,Jaffna,Karainagar,Northern,6828,3854,10682,273120,154160,427280
10/8/2024,Lahiru Perera,Jaffna,Karainagar,Northern,2383,9982,12365,95320,399280,494600
10/9/2024,Lahiru Perera,Jaffna,Karainagar,Northern,4997,753,5750,199880,30120,230000
10/10/2024,Lahiru Perera,Jaffna,Karainagar,Northern,2768,910,3678,110720,36400,147120
10/11/2024,Lahiru Perera,Jaffna,Karainagar,Northern,9971,8004,17975,398840,320160,719000
10/12/2024,Lahiru Perera,Jaffna,Karainagar,Northern,5000,5270,10270,200000,210800,410800
10/13/2024,Lahiru Perera,Jaffna,Karainagar,Northern,7420,6613,14033,296800,264520,561320
10/14/2024,Lahiru Perera,Jaffna,Karainagar,Northern,6737,8069,14806,269480,322760,592240
10/15/2024,Lahiru Perera,Jaffna,Karainagar,Northern,6453,4360,10813,258120,174400,432520
10/16/2024,Lahiru Perera,Jaffna,Karainagar,Northern,755,6104,6859,30200,244160,274360
10/17/2024,Lahiru Perera,Jaffna,Karainagar,Northern,3725,1421,5146,149000,56840,205840
10/18/2024,Lahiru Perera,Jaffna,Karainagar,Northern,9325,3633,12958,373000,145320,518320
10/19/2024,Lahiru Perera,Jaffna,Karainagar,Northern,6943,6279,13222,277720,251160,528880
10/20/2024,Lahiru Perera,Jaffna,Karainagar,Northern,7797,9343,17140,311880,373720,685600
10/21/2024,Lahiru Perera,Jaffna,Karainagar,Northern,1257,3042,4299,50280,121680,171960
10/22/2024,Lahiru Perera,Jaffna,Karainagar,Northern,2593,8681,11274,103720,347240,450960
10/23/2024,Lahiru Perera,Jaffna,Karainagar,Northern,1928,7121,9049,77120,284840,361960
10/24/2024,Lahiru Perera,Jaffna,Karainagar,Northern,2335,999,3334,93400,39960,133360
10/25/2024,Lahiru Perera,Jaffna,Karainagar,Northern,6950,2651,9601,278000,106040,384040
10/26/2024,Lahiru Perera,Jaffna,Karainagar,Northern,3733,2250,5983,149320,90000,239320
10/27/2024,Lahiru Perera,Jaffna,Karainagar,Northern,2754,1118,3872,110160,44720,154880
10/28/2024,Lahiru Perera,Jaffna,Karainagar,Northern,191,2577,2768,7640,103080,110720
10/29/2024,Lahiru Perera,Jaffna,Karainagar,Northern,8488,686,9174,339520,27440,366960
10/30/2024,Lahiru Perera,Jaffna,Karainagar,Northern,5914,8981,14895,236560,359240,595800
10/31/2024,Lahiru Perera,Jaffna,Karainagar,Northern,9352,2943,12295,374080,117720,491800
11/1/2024,Lahiru Perera,Jaffna,Karainagar,Northern,8294,6285,14579,331760,251400,583160
11/2/2024,Lahiru Perera,Jaffna,Karainagar,Northern,6100,9792,15892,244000,391680,635680
11/3/2024,Lahiru Perera,Jaffna,Karainagar,Northern,6582,4724,11306,263280,188960,452240
11/4/2024,Lahiru Perera,Jaffna,Karainagar,Northern,9777,5539,15316,391080,221560,612640
11/5/2024,Lahiru Perera,Jaffna,Karainagar,Northern,512,7615,8127,20480,304600,325080
11/6/2024,Lahiru Perera,Jaffna,Karainagar,Northern,5291,6633,11924,211640,265320,476960
11/7/2024,Lahiru Perera,Jaffna,Karainagar,Northern,5215,565,5780,208600,22600,231200
11/8/2024,Lahiru Perera,Jaffna,Karainagar,Northern,7718,6516,14234,308720,260640,569360
11/9/2024,Lahiru Perera,Jaffna,Karainagar,Northern,8814,8131,16945,352560,325240,677800
11/10/2024,Lahiru Perera,Jaffna,Karainagar,Northern,5030,9208,14238,201200,368320,569520
11/11/2024,Lahiru Perera,Jaffna,Karainagar,Northern,2700,5664,8364,108000,226560,334560
11/12/2024,Lahiru Perera,Jaffna,Karainagar,Northern,8739,8942,17681,349560,357680,707240
11/13/2024,Lahiru Perera,Jaffna,Karainagar,Northern,4386,5189,9575,175440,207560,383000
11/14/2024,Lahiru Perera,Jaffna,Karainagar,Northern,7429,5799,13228,297160,231960,529120
11/15/2024,Lahiru Perera,Jaffna,Karainagar,Northern,9470,5360,14830,378800,214400,593200
11/16/2024,Lahiru Perera,Jaffna,Karainagar,Northern,9114,3746,12860,364560,149840,514400
11/17/2024,Lahiru Perera,Jaffna,Karainagar,Northern,4481,347,4828,179240,13880,193120
11/18/2024,Lahiru Perera,Jaffna,Karainagar,Northern,844,9176,10020,33760,367040,400800
11/19/2024,Lahiru Perera,Jaffna,Karainagar,Northern,4640,3688,8328,185600,147520,333120
11/20/2024,Lahiru Perera,Jaffna,Karainagar,Northern,5208,3873,9081,208320,154920,363240
11/21/2024,Lahiru Perera,Jaffna,Karainagar,Northern,9183,695,9878,367320,27800,395120
11/22/2024,Lahiru Perera,Jaffna,Karainagar,Northern,1626,4069,5695,65040,162760,227800
11/23/2024,Lahiru Perera,Jaffna,Karainagar,Northern,6110,4500,10610,244400,180000,424400
11/24/2024,Lahiru Perera,Jaffna,Karainagar,Northern,1366,2594,3960,54640,103760,158400
11/25/2024,Lahiru Perera,Jaffna,Karainagar,Northern,8630,9849,18479,345200,393960,739160
11/26/2024,Lahiru Perera,Jaffna,Karainagar,Northern,7783,2673,10456,311320,106920,418240
11/27/2024,Lahiru Perera,Jaffna,Karainagar,Northern,7718,3774,11492,308720,150960,459680
11/28/2024,Lahiru Perera,Jaffna,Karainagar,Northern,1218,3157,4375,48720,126280,175000
11/29/2024,Lahiru Perera,Jaffna,Karainagar,Northern,5990,6682,12672,239600,267280,506880
11/30/2024,Lahiru Perera,Jaffna,Karainagar,Northern,3930,4533,8463,157200,181320,338520
12/1/2024,Lahiru Perera,Jaffna,Karainagar,Northern,4763,6039,10802,190520,241560,432080
12/2/2024,Lahiru Perera,Jaffna,Karainagar,Northern,741,6596,7337,29640,263840,293480
12/3/2024,Lahiru Perera,Jaffna,Karainagar,Northern,9235,3781,13016,369400,151240,520640
12/4/2024,Lahiru Perera,Jaffna,Karainagar,Northern,3532,8930,12462,141280,357200,498480
12/5/2024,Lahiru Perera,Jaffna,Karainagar,Northern,2547,5278,7825,101880,211120,313000
12/6/2024,Lahiru Perera,Jaffna,Karainagar,Northern,1678,1253,2931,67120,50120,117240
12/7/2024,Lahiru Perera,Jaffna,Karainagar,Northern,77,2894,2971,3080,115760,118840
12/8/2024,Lahiru Perera,Jaffna,Karainagar,Northern,2508,1880,4388,100320,75200,175520
12/9/2024,Lahiru Perera,Jaffna,Karainagar,Northern,5850,7939,13789,234000,317560,551560
12/10/2024,Lahiru Perera,Jaffna,Karainagar,Northern,6230,4739,10969,249200,189560,438760
12/11/2024,Lahiru Perera,Jaffna,Karainagar,Northern,9006,865,9871,360240,34600,394840
12/12/2024,Lahiru Perera,Jaffna,Karainagar,Northern,8064,6821,14885,322560,272840,595400
12/13/2024,Lahiru Perera,Jaffna,Karainagar,Northern,267,5598,5865,10680,223920,234600
12/14/2024,Lahiru Perera,Jaffna,Karainagar,Northern,3180,1944,5124,127200,77760,204960
12/15/2024,Lahiru Perera,Jaffna,Karainagar,Northern,7841,7096,14937,313640,283840,597480
12/16/2024,Lahiru Perera,Jaffna,Karainagar,Northern,1166,6576,7742,46640,263040,309680
12/17/2024,Lahiru Perera,Jaffna,Karainagar,Northern,2221,5050,7271,88840,202000,290840
12/18/2024,Lahiru Perera,Jaffna,Karainagar,Northern,4650,5573,10223,186000,222920,408920
12/19/2024,Lahiru Perera,Jaffna,Karainagar,Northern,5880,4522,10402,235200,180880,416080
12/20/2024,Lahiru Perera,Jaffna,Karainagar,Northern,1033,4645,5678,41320,185800,227120
12/21/2024,Lahiru Perera,Jaffna,Karainagar,Northern,9211,7805,17016,368440,312200,680640
12/22/2024,Lahiru Perera,Jaffna,Karainagar,Northern,7799,6890,14689,311960,275600,587560
12/23/2024,Lahiru Perera,Jaffna,Karainagar,Northern,6050,9826,15876,242000,393040,635040
12/24/2024,Lahiru Perera,Jaffna,Karainagar,Northern,3975,5639,9614,159000,225560,384560
12/25/2024,Lahiru Perera,Jaffna,Karainagar,Northern,6948,2058,9006,277920,82320,360240
12/26/2024,Lahiru Perera,Jaffna,Karainagar,Northern,4229,932,5161,169160,37280,206440
12/27/2024,Lahiru Perera,Jaffna,Karainagar,Northern,1796,241,2037,71840,9640,81480
12/28/2024,Lahiru Perera,Jaffna,Karainagar,Northern,218,1350,1568,8720,54000,62720
12/29/2024,Lahiru Perera,Jaffna,Karainagar,Northern,4261,4473,8734,170440,178920,349360
12/30/2024,Lahiru Perera,Jaffna,Karainagar,Northern,361,192,553,14440,7680,22120
12/31/2024,Lahiru Perera,Jaffna,Karainagar,Northern,8926,4665,13591,357040,186600,543640
1/1/2025,Lahiru Perera,Jaffna,Karainagar,Northern,6328,7515,13843,253120,300600,553720
1/2/2025,Lahiru Perera,Jaffna,Karainagar,Northern,375,4545,4920,15000,181800,196800
1/3/2025,Lahiru Perera,Jaffna,Karainagar,Northern,9828,7715,17543,393120,308600,701720
1/4/2025,Lahiru Perera,Jaffna,Karainagar,Northern,4618,9020,13638,184720,360800,545520
1/5/2025,Lahiru Perera,Jaffna,Karainagar,Northern,7686,2164,9850,307440,86560,394000
1/6/2025,Lahiru Perera,Jaffna,Karainagar,Northern,554,1051,1605,22160,42040,64200
1/7/2025,Lahiru Perera,Jaffna,Karainagar,Northern,8869,5895,14764,354760,235800,590560
1/8/2025,Lahiru Perera,Jaffna,Karainagar,Northern,8945,928,9873,357800,37120,394920
1/9/2025,Lahiru Perera,Jaffna,Karainagar,Northern,5025,3244,8269,201000,129760,330760
1/10/2025,Lahiru Perera,Jaffna,Karainagar,Northern,5378,2763,8141,215120,110520,325640
1/11/2025,Lahiru Perera,Jaffna,Karainagar,Northern,3638,346,3984,145520,13840,159360
1/12/2025,Lahiru Perera,Jaffna,Karainagar,Northern,858,1000,1858,34320,40000,74320
1/13/2025,Lahiru Perera,Jaffna,Karainagar,Northern,4545,471,5016,181800,18840,200640
1/14/2025,Lahiru Perera,Jaffna,Karainagar,Northern,5765,6344,12109,230600,253760,484360
1/15/2025,Lahiru Perera,Jaffna,Karainagar,Northern,6965,488,7453,278600,19520,298120
1/16/2025,Lahiru Perera,Jaffna,Karainagar,Northern,5253,9627,14880,210120,385080,595200
1/17/2025,Lahiru Perera,Jaffna,Karainagar,Northern,4102,1240,5342,164080,49600,213680
1/18/2025,Lahiru Perera,Jaffna,Karainagar,Northern,1946,6682,8628,77840,267280,345120
1/19/2025,Lahiru Perera,Jaffna,Karainagar,Northern,6444,4464,10908,257760,178560,436320
1/20/2025,Lahiru Perera,Jaffna,Karainagar,Northern,3958,5951,9909,158320,238040,396360
1/21/2025,Lahiru Perera,Jaffna,Karainagar,Northern,7011,9291,16302,280440,371640,652080
1/22/2025,Lahiru Perera,Jaffna,Karainagar,Northern,5807,3271,9078,232280,130840,363120
1/23/2025,Lahiru Perera,Jaffna,Karainagar,Northern,7558,6377,13935,302320,255080,557400
1/24/2025,Lahiru Perera,Jaffna,Karainagar,Northern,9928,9163,19091,397120,366520,763640
1/25/2025,Lahiru Perera,Jaffna,Karainagar,Northern,2505,805,3310,100200,32200,132400
1/26/2025,Lahiru Perera,Jaffna,Karainagar,Northern,1045,3475,4520,41800,139000,180800
1/27/2025,Lahiru Perera,Jaffna,Karainagar,Northern,5854,3301,9155,234160,132040,366200
1/28/2025,Lahiru Perera,Jaffna,Karainagar,Northern,3805,4985,8790,152200,199400,351600
1/29/2025,Lahiru Perera,Jaffna,Karainagar,Northern,7040,834,7874,281600,33360,314960
1/30/2025,Lahiru Perera,Jaffna,Karainagar,Northern,2292,4528,6820,91680,181120,272800
1/31/2025,Lahiru Perera,Jaffna,Karainagar,Northern,3386,5401,8787,135440,216040,351480
2/1/2025,Lahiru Perera,Jaffna,Karainagar,Northern,7616,4103,11719,304640,164120,468760
2/2/2025,Lahiru Perera,Jaffna,Karainagar,Northern,2274,6971,9245,90960,278840,369800
2/3/2025,Lahiru Perera,Jaffna,Karainagar,Northern,9941,4443,14384,397640,177720,575360
2/4/2025,Lahiru Perera,Jaffna,Karainagar,Northern,8241,7342,15583,329640,293680,623320
2/5/2025,Lahiru Perera,Jaffna,Karainagar,Northern,4591,529,5120,183640,21160,204800
2/6/2025,Lahiru Perera,Jaffna,Karainagar,Northern,6168,6498,12666,246720,259920,506640
2/7/2025,Lahiru Perera,Jaffna,Karainagar,Northern,962,6719,7681,38480,268760,307240
2/8/2025,Lahiru Perera,Jaffna,Karainagar,Northern,6132,248,6380,245280,9920,255200
2/9/2025,Lahiru Perera,Jaffna,Karainagar,Northern,9119,1565,10684,364760,62600,427360
2/10/2025,Lahiru Perera,Jaffna,Karainagar,Northern,7369,2955,10324,294760,118200,412960
2/11/2025,Lahiru Perera,Jaffna,Karainagar,Northern,5320,4669,9989,212800,186760,399560
2/12/2025,Lahiru Perera,Jaffna,Karainagar,Northern,7693,5958,13651,307720,238320,546040
2/13/2025,Lahiru Perera,Jaffna,Karainagar,Northern,1714,1733,3447,68560,69320,137880
2/14/2025,Lahiru Perera,Jaffna,Karainagar,Northern,2997,1913,4910,119880,76520,196400
2/15/2025,Lahiru Perera,Jaffna,Karainagar,Northern,5173,2039,7212,206920,81560,288480
2/16/2025,Lahiru Perera,Jaffna,Karainagar,Northern,8161,3573,11734,326440,142920,469360
2/17/2025,Lahiru Perera,Jaffna,Karainagar,Northern,6746,4547,11293,269840,181880,451720
2/18/2025,Lahiru Perera,Jaffna,Karainagar,Northern,5661,7667,13328,226440,306680,533120
2/19/2025,Lahiru Perera,Jaffna,Karainagar,Northern,5234,1516,6750,209360,60640,270000
2/20/2025,Lahiru Perera,Jaffna,Karainagar,Northern,4981,8666,13647,199240,346640,545880
2/21/2025,Lahiru Perera,Jaffna,Karainagar,Northern,6289,5978,12267,251560,239120,490680
2/22/2025,Lahiru Perera,Jaffna,Karainagar,Northern,2161,4571,6732,86440,182840,269280
2/23/2025,Lahiru Perera,Jaffna,Karainagar,Northern,8303,5856,14159,332120,234240,566360
2/24/2025,Lahiru Perera,Jaffna,Karainagar,Northern,9514,8443,17957,380560,337720,718280
2/25/2025,Lahiru Perera,Jaffna,Karainagar,Northern,2318,9094,11412,92720,363760,456480
2/26/2025,Lahiru Perera,Jaffna,Karainagar,Northern,7931,5815,13746,317240,232600,549840
2/27/2025,Lahiru Perera,Jaffna,Karainagar,Northern,7392,4089,11481,295680,163560,459240
2/28/2025,Lahiru Perera,Jaffna,Karainagar,Northern,6699,6400,13099,267960,256000,523960
3/1/2025,Lahiru Perera,Jaffna,Karainagar,Northern,7094,4736,11830,283760,189440,473200
3/2/2025,Lahiru Perera,Jaffna,Karainagar,Northern,4749,425,5174,189960,17000,206960
3/3/2025,Lahiru Perera,Jaffna,Karainagar,Northern,7647,6177,13824,305880,247080,552960
3/4/2025,Lahiru Perera,Jaffna,Karainagar,Northern,2164,8457,10621,86560,338280,424840
3/5/2025,Lahiru Perera,Jaffna,Karainagar,Northern,1229,8474,9703,49160,338960,388120
3/6/2025,Lahiru Perera,Jaffna,Karainagar,Northern,4943,6309,11252,197720,252360,450080
3/7/2025,Lahiru Perera,Jaffna,Karainagar,Northern,5873,7309,13182,234920,292360,527280
3/8/2025,Lahiru Perera,Jaffna,Karainagar,Northern,428,6110,6538,17120,244400,261520
3/9/2025,Lahiru Perera,Jaffna,Karainagar,Northern,800,3898,4698,32000,155920,187920
3/10/2025,Lahiru Perera,Jaffna,Karainagar,Northern,4392,3278,7670,175680,131120,306800
3/11/2025,Lahiru Perera,Jaffna,Karainagar,Northern,2398,1005,3403,95920,40200,136120
3/12/2025,Lahiru Perera,Jaffna,Karainagar,Northern,3450,7500,10950,138000,300000,438000
3/13/2025,Lahiru Perera,Jaffna,Karainagar,Northern,4754,2264,7018,190160,90560,280720
3/14/2025,Lahiru Perera,Jaffna,Karainagar,Northern,7799,4547,12346,311960,181880,493840
3/15/2025,Lahiru Perera,Jaffna,Karainagar,Northern,7538,5161,12699,301520,206440,507960
3/16/2025,Lahiru Perera,Jaffna,Karainagar,Northern,7683,9961,17644,307320,398440,705760
3/17/2025,Lahiru Perera,Jaffna,Karainagar,Northern,5269,5402,10671,210760,216080,426840
3/18/2025,Lahiru Perera,Jaffna,Karainagar,Northern,515,6950,7465,20600,278000,298600
3/19/2025,Lahiru Perera,Jaffna,Karainagar,Northern,4019,6498,10517,160760,259920,420680
3/20/2025,Lahiru Perera,Jaffna,Karainagar,Northern,7013,868,7881,280520,34720,315240
3/21/2025,Lahiru Perera,Jaffna,Karainagar,Northern,5781,666,6447,231240,26640,257880
3/22/2025,Lahiru Perera,Jaffna,Karainagar,Northern,6564,9359,15923,262560,374360,636920
3/23/2025,Lahiru Perera,Jaffna,Karainagar,Northern,6085,6142,12227,243400,245680,489080
3/25/2024,Madhusanka Malwattage,Gampaha,Minuwangoda,Western,1376,7569,8945,55040,302760,357800
3/26/2024,Madhusanka Malwattage,Gampaha,Minuwangoda,Western,4269,7414,11683,170760,296560,467320
3/27/2024,Madhusanka Malwattage,Gampaha,Minuwangoda,Western,1852,4406,6258,74080,176240,250320
3/28/2024,Madhusanka Malwattage,Gampaha,Minuwangoda,Western,6387,5958,12345,255480,238320,493800
3/29/2024,Madhusanka Malwattage,Gampaha,Minuwangoda,Western,2088,6836,8924,83520,273440,356960
3/30/2024,Madhusanka Malwattage,Gampaha,Minuwangoda,Western,2216,4836,7052,88640,193440,282080
3/31/2024,Madhusanka Malwattage,Gampaha,Minuwangoda,Western,7899,8111,16010,315960,324440,640400
4/1/2024,Madhusanka Malwattage,Gampaha,Minuwangoda,Western,1413,5115,6528,56520,204600,261120
4/2/2024,Madhusanka Malwattage,Gampaha,Minuwangoda,Western,5331,5721,11052,213240,228840,442080
4/3/2024,Madhusanka Malwattage,Gampaha,Minuwangoda,Western,254,4624,4878,10160,184960,195120
4/4/2024,Madhusanka Malwattage,Gampaha,Minuwangoda,Western,590,9666,10256,23600,386640,410240
4/5/2024,Madhusanka Malwattage,Gampaha,Minuwangoda,Western,8874,9281,18155,354960,371240,726200
4/6/2024,Madhusanka Malwattage,Gampaha,Minuwangoda,Western,1461,8645,10106,58440,345800,404240
4/7/2024,Madhusanka Malwattage,Gampaha,Minuwangoda,Western,4836,3539,8375,193440,141560,335000
4/8/2024,Madhusanka Malwattage,Gampaha,Minuwangoda,Western,688,2220,2908,27520,88800,116320
4/9/2024,Madhusanka Malwattage,Gampaha,Minuwangoda,Western,4363,6456,10819,174520,258240,432760
4/10/2024,Madhusanka Malwattage,Gampaha,Minuwangoda,Western,2967,1206,4173,118680,48240,166920
4/11/2024,Madhusanka Malwattage,Gampaha,Minuwangoda,Western,1412,6639,8051,56480,265560,322040
4/19/2024,Madhusanka Malwattage,Gampaha,Minuwangoda,Western,1164,9561,10725,46560,382440,429000
4/20/2024,Madhusanka Malwattage,Gampaha,Minuwangoda,Western,1748,9683,11431,69920,387320,457240
4/21/2024,Madhusanka Malwattage,Gampaha,Minuwangoda,Western,9420,4308,13728,376800,172320,549120
4/22/2024,Madhusanka Malwattage,Gampaha,Minuwangoda,Western,949,5525,6474,37960,221000,258960
4/23/2024,Madhusanka Malwattage,Gampaha,Minuwangoda,Western,1163,9829,10992,46520,393160,439680
4/24/2024,Madhusanka Malwattage,Gampaha,Minuwangoda,Western,420,6646,7066,16800,265840,282640
4/25/2024,Madhusanka Malwattage,Gampaha,Minuwangoda,Western,3830,2217,6047,153200,88680,241880
4/26/2024,Madhusanka Malwattage,Gampaha,Minuwangoda,Western,7813,6471,14284,312520,258840,571360
4/27/2024,Madhusanka Malwattage,Gampaha,Minuwangoda,Western,3349,7784,11133,133960,311360,445320
4/28/2024,Madhusanka Malwattage,Gampaha,Minuwangoda,Western,151,3136,3287,6040,125440,131480
4/29/2024,Madhusanka Malwattage,Gampaha,Minuwangoda,Western,4963,588,5551,198520,23520,222040
4/30/2024,Madhusanka Malwattage,Gampaha,Minuwangoda,Western,8442,5754,14196,337680,230160,567840
5/1/2024,Madhusanka Malwattage,Gampaha,Minuwangoda,Western,3524,3186,6710,140960,127440,268400
5/2/2024,Madhusanka Malwattage,Gampaha,Minuwangoda,Western,5364,7749,13113,214560,309960,524520
5/3/2024,Madhusanka Malwattage,Gampaha,Minuwangoda,Western,3377,4840,8217,135080,193600,328680
5/4/2024,Madhusanka Malwattage,Gampaha,Minuwangoda,Western,4581,5335,9916,183240,213400,396640
5/5/2024,Madhusanka Malwattage,Gampaha,Minuwangoda,Western,3962,5599,9561,158480,223960,382440
5/6/2024,Madhusanka Malwattage,Gampaha,Minuwangoda,Western,9050,9369,18419,362000,374760,736760
5/7/2024,Madhusanka Malwattage,Gampaha,Minuwangoda,Western,6523,6038,12561,260920,241520,502440
5/8/2024,Madhusanka Malwattage,Gampaha,Minuwangoda,Western,4922,6553,11475,196880,262120,459000
5/9/2024,Madhusanka Malwattage,Gampaha,Minuwangoda,Western,7596,8402,15998,303840,336080,639920
5/10/2024,Madhusanka Malwattage,Gampaha,Minuwangoda,Western,5834,2992,8826,233360,119680,353040
5/11/2024,Madhusanka Malwattage,Gampaha,Minuwangoda,Western,2709,6935,9644,108360,277400,385760
5/12/2024,Madhusanka Malwattage,Gampaha,Minuwangoda,Western,7350,7846,15196,294000,313840,607840
5/13/2024,Madhusanka Malwattage,Gampaha,Minuwangoda,Western,3065,7646,10711,122600,305840,428440
5/14/2024,Madhusanka Malwattage,Gampaha,Minuwangoda,Western,9901,4391,14292,396040,175640,571680
5/15/2024,Madhusanka Malwattage,Gampaha,Minuwangoda,Western,5078,2969,8047,203120,118760,321880
5/16/2024,Madhusanka Malwattage,Gampaha,Minuwangoda,Western,1942,5626,7568,77680,225040,302720
5/17/2024,Madhusanka Malwattage,Gampaha,Minuwangoda,Western,2068,4586,6654,82720,183440,266160
5/18/2024,Madhusanka Malwattage,Gampaha,Minuwangoda,Western,4565,2134,6699,182600,85360,267960
5/19/2024,Madhusanka Malwattage,Gampaha,Minuwangoda,Western,6997,6010,13007,279880,240400,520280
5/20/2024,Madhusanka Malwattage,Gampaha,Minuwangoda,Western,7175,3781,10956,287000,151240,438240
5/21/2024,Madhusanka Malwattage,Gampaha,Minuwangoda,Western,6155,8275,14430,246200,331000,577200
5/22/2024,Madhusanka Malwattage,Gampaha,Minuwangoda,Western,3519,4009,7528,140760,160360,301120
5/24/2024,Madhusanka Malwattage,Gampaha,Minuwangoda,Western,1807,6938,8745,72280,277520,349800
5/25/2024,Madhusanka Malwattage,Gampaha,Minuwangoda,Western,1183,7086,8269,47320,283440,330760
5/26/2024,Madhusanka Malwattage,Gampaha,Minuwangoda,Western,2966,4518,7484,118640,180720,299360
5/27/2024,Madhusanka Malwattage,Gampaha,Minuwangoda,Western,3777,6216,9993,151080,248640,399720
5/28/2024,Madhusanka Malwattage,Gampaha,Minuwangoda,Western,8565,8239,16804,342600,329560,672160
5/29/2024,Madhusanka Malwattage,Gampaha,Minuwangoda,Western,4728,1712,6440,189120,68480,257600
5/30/2024,Madhusanka Malwattage,Gampaha,Minuwangoda,Western,4875,5482,10357,195000,219280,414280
5/31/2024,Madhusanka Malwattage,Gampaha,Minuwangoda,Western,9057,6598,15655,362280,263920,626200
6/1/2024,Madhusanka Malwattage,Gampaha,Minuwangoda,Western,2592,203,2795,103680,8120,111800
6/2/2024,Madhusanka Malwattage,Gampaha,Minuwangoda,Western,2865,902,3767,114600,36080,150680
6/3/2024,Madhusanka Malwattage,Gampaha,Minuwangoda,Western,985,9031,10016,39400,361240,400640
6/4/2024,Madhusanka Malwattage,Gampaha,Minuwangoda,Western,9738,9466,19204,389520,378640,768160
6/5/2024,Madhusanka Malwattage,Gampaha,Minuwangoda,Western,3241,3554,6795,129640,142160,271800
6/6/2024,Madhusanka Malwattage,Gampaha,Minuwangoda,Western,1039,9660,10699,41560,386400,427960
6/7/2024,Madhusanka Malwattage,Gampaha,Minuwangoda,Western,8538,9764,18302,341520,390560,732080
6/8/2024,Madhusanka Malwattage,Gampaha,Minuwangoda,Western,9121,1287,10408,364840,51480,416320
6/9/2024,Madhusanka Malwattage,Gampaha,Minuwangoda,Western,7900,9605,17505,316000,384200,700200
6/10/2024,Madhusanka Malwattage,Gampaha,Minuwangoda,Western,5528,1978,7506,221120,79120,300240
6/11/2024,Madhusanka Malwattage,Gampaha,Minuwangoda,Western,3651,5277,8928,146040,211080,357120
6/12/2024,Madhusanka Malwattage,Gampaha,Minuwangoda,Western,1702,2913,4615,68080,116520,184600
6/13/2024,Madhusanka Malwattage,Gampaha,Minuwangoda,Western,2653,752,3405,106120,30080,136200
6/14/2024,Madhusanka Malwattage,Gampaha,Minuwangoda,Western,3768,4557,8325,150720,182280,333000
6/15/2024,Madhusanka Malwattage,Gampaha,Minuwangoda,Western,7940,3771,11711,317600,150840,468440
6/16/2024,Madhusanka Malwattage,Gampaha,Minuwangoda,Western,489,1479,1968,19560,59160,78720
6/17/2024,Madhusanka Malwattage,Gampaha,Minuwangoda,Western,3434,2112,5546,137360,84480,221840
6/18/2024,Madhusanka Malwattage,Gampaha,Minuwangoda,Western,7273,4108,11381,290920,164320,455240
6/19/2024,Madhusanka Malwattage,Gampaha,Minuwangoda,Western,3007,4085,7092,120280,163400,283680
6/20/2024,Madhusanka Malwattage,Gampaha,Minuwangoda,Western,7828,7385,15213,313120,295400,608520
6/21/2024,Madhusanka Malwattage,Gampaha,Minuwangoda,Western,5095,5442,10537,203800,217680,421480
6/22/2024,Madhusanka Malwattage,Gampaha,Minuwangoda,Western,4583,772,5355,183320,30880,214200
6/23/2024,Madhusanka Malwattage,Gampaha,Minuwangoda,Western,5544,2313,7857,221760,92520,314280
6/24/2024,Madhusanka Malwattage,Gampaha,Minuwangoda,Western,7222,716,7938,288880,28640,317520
6/25/2024,Madhusanka Malwattage,Gampaha,Minuwangoda,Western,4249,8095,12344,169960,323800,493760
6/26/2024,Madhusanka Malwattage,Gampaha,Minuwangoda,Western,7522,4924,12446,300880,196960,497840
6/27/2024,Madhusanka Malwattage,Gampaha,Minuwangoda,Western,5654,2611,8265,226160,104440,330600
6/28/2024,Madhusanka Malwattage,Gampaha,Minuwangoda,Western,199,9415,9614,7960,376600,384560
6/29/2024,Madhusanka Malwattage,Gampaha,Minuwangoda,Western,9793,6469,16262,391720,258760,650480
6/30/2024,Madhusanka Malwattage,Gampaha,Minuwangoda,Western,2144,3419,5563,85760,136760,222520
7/1/2024,Madhusanka Malwattage,Gampaha,Minuwangoda,Western,3324,5057,8381,132960,202280,335240
7/2/2024,Madhusanka Malwattage,Gampaha,Minuwangoda,Western,4835,854,5689,193400,34160,227560
7/3/2024,Madhusanka Malwattage,Gampaha,Minuwangoda,Western,5239,9154,14393,209560,366160,575720
7/4/2024,Madhusanka Malwattage,Gampaha,Minuwangoda,Western,1237,3979,5216,49480,159160,208640
7/5/2024,Madhusanka Malwattage,Gampaha,Minuwangoda,Western,9607,280,9887,384280,11200,395480
7/6/2024,Madhusanka Malwattage,Gampaha,Minuwangoda,Western,4227,7770,11997,169080,310800,479880
7/7/2024,Madhusanka Malwattage,Gampaha,Minuwangoda,Western,7519,4158,11677,300760,166320,467080
7/8/2024,Madhusanka Malwattage,Gampaha,Minuwangoda,Western,5286,373,5659,211440,14920,226360
7/9/2024,Madhusanka Malwattage,Gampaha,Minuwangoda,Western,5842,779,6621,233680,31160,264840
7/10/2024,Madhusanka Malwattage,Gampaha,Minuwangoda,Western,3685,9208,12893,147400,368320,515720
7/11/2024,Madhusanka Malwattage,Gampaha,Minuwangoda,Western,7006,3980,10986,280240,159200,439440
7/12/2024,Madhusanka Malwattage,Gampaha,Minuwangoda,Western,9111,5180,14291,364440,207200,571640
7/13/2024,Madhusanka Malwattage,Gampaha,Minuwangoda,Western,7728,407,8135,309120,16280,325400
7/14/2024,Madhusanka Malwattage,Gampaha,Minuwangoda,Western,944,5141,6085,37760,205640,243400
7/15/2024,Madhusanka Malwattage,Gampaha,Minuwangoda,Western,572,9683,10255,22880,387320,410200
7/16/2024,Madhusanka Malwattage,Gampaha,Minuwangoda,Western,1973,6245,8218,78920,249800,328720
7/17/2024,Madhusanka Malwattage,Gampaha,Minuwangoda,Western,8168,3840,12008,326720,153600,480320
7/18/2024,Madhusanka Malwattage,Gampaha,Minuwangoda,Western,6726,5080,11806,269040,203200,472240
7/19/2024,Madhusanka Malwattage,Gampaha,Minuwangoda,Western,6652,2298,8950,266080,91920,358000
7/20/2024,Madhusanka Malwattage,Gampaha,Minuwangoda,Western,5239,3035,8274,209560,121400,330960
7/21/2024,Madhusanka Malwattage,Gampaha,Minuwangoda,Western,3077,2706,5783,123080,108240,231320
7/22/2024,Madhusanka Malwattage,Gampaha,Minuwangoda,Western,8499,5296,13795,339960,211840,551800
7/23/2024,Madhusanka Malwattage,Gampaha,Minuwangoda,Western,2318,4545,6863,92720,181800,274520
7/24/2024,Madhusanka Malwattage,Gampaha,Minuwangoda,Western,7214,7117,14331,288560,284680,573240
7/25/2024,Madhusanka Malwattage,Gampaha,Minuwangoda,Western,3762,3261,7023,150480,130440,280920
7/26/2024,Madhusanka Malwattage,Gampaha,Minuwangoda,Western,7767,2457,10224,310680,98280,408960
7/27/2024,Madhusanka Malwattage,Gampaha,Minuwangoda,Western,5671,8748,14419,226840,349920,576760
7/28/2024,Madhusanka Malwattage,Gampaha,Minuwangoda,Western,3633,9569,13202,145320,382760,528080
7/29/2024,Madhusanka Malwattage,Gampaha,Minuwangoda,Western,6951,5539,12490,278040,221560,499600
7/30/2024,Madhusanka Malwattage,Gampaha,Minuwangoda,Western,7494,3012,10506,299760,120480,420240
7/31/2024,Madhusanka Malwattage,Gampaha,Minuwangoda,Western,8152,6753,14905,326080,270120,596200
8/1/2024,Madhusanka Malwattage,Gampaha,Minuwangoda,Western,3495,1734,5229,139800,69360,209160
8/2/2024,Madhusanka Malwattage,Gampaha,Minuwangoda,Western,636,3039,3675,25440,121560,147000
8/3/2024,Madhusanka Malwattage,Gampaha,Minuwangoda,Western,5686,4277,9963,227440,171080,398520
8/4/2024,Madhusanka Malwattage,Gampaha,Minuwangoda,Western,9023,8185,17208,360920,327400,688320
8/5/2024,Madhusanka Malwattage,Gampaha,Minuwangoda,Western,1047,198,1245,41880,7920,49800
8/6/2024,Madhusanka Malwattage,Gampaha,Minuwangoda,Western,5647,6235,11882,225880,249400,475280
8/7/2024,Madhusanka Malwattage,Gampaha,Minuwangoda,Western,6514,4385,10899,260560,175400,435960
8/8/2024,Madhusanka Malwattage,Gampaha,Minuwangoda,Western,4766,8571,13337,190640,342840,533480
8/9/2024,Madhusanka Malwattage,Gampaha,Minuwangoda,Western,4908,664,5572,196320,26560,222880
8/10/2024,Madhusanka Malwattage,Gampaha,Minuwangoda,Western,3534,4367,7901,141360,174680,316040
8/11/2024,Madhusanka Malwattage,Gampaha,Minuwangoda,Western,680,1229,1909,27200,49160,76360
8/12/2024,Madhusanka Malwattage,Gampaha,Minuwangoda,Western,2521,1574,4095,100840,62960,163800
8/13/2024,Madhusanka Malwattage,Gampaha,Minuwangoda,Western,7325,4462,11787,293000,178480,471480
8/14/2024,Madhusanka Malwattage,Gampaha,Minuwangoda,Western,7357,9312,16669,294280,372480,666760
8/15/2024,Madhusanka Malwattage,Gampaha,Minuwangoda,Western,4626,2025,6651,185040,81000,266040
8/16/2024,Madhusanka Malwattage,Gampaha,Minuwangoda,Western,8868,5178,14046,354720,207120,561840
8/17/2024,Madhusanka Malwattage,Gampaha,Minuwangoda,Western,8768,8055,16823,350720,322200,672920
8/18/2024,Madhusanka Malwattage,Gampaha,Minuwangoda,Western,6526,5481,12007,261040,219240,480280
8/19/2024,Madhusanka Malwattage,Gampaha,Minuwangoda,Western,8019,5773,13792,320760,230920,551680
8/20/2024,Madhusanka Malwattage,Gampaha,Minuwangoda,Western,7067,9696,16763,282680,387840,670520
8/21/2024,Madhusanka Malwattage,Gampaha,Minuwangoda,Western,6182,7191,13373,247280,287640,534920
8/22/2024,Madhusanka Malwattage,Gampaha,Minuwangoda,Western,8654,9704,18358,346160,388160,734320
8/23/2024,Madhusanka Malwattage,Gampaha,Minuwangoda,Western,7805,2181,9986,312200,87240,399440
8/24/2024,Madhusanka Malwattage,Gampaha,Minuwangoda,Western,74,1672,1746,2960,66880,69840
8/25/2024,Madhusanka Malwattage,Gampaha,Minuwangoda,Western,3164,3686,6850,126560,147440,274000
8/26/2024,Madhusanka Malwattage,Gampaha,Minuwangoda,Western,6639,7628,14267,265560,305120,570680
8/27/2024,Madhusanka Malwattage,Gampaha,Minuwangoda,Western,3569,9580,13149,142760,383200,525960
8/28/2024,Madhusanka Malwattage,Gampaha,Minuwangoda,Western,4814,4409,9223,192560,176360,368920
8/29/2024,Madhusanka Malwattage,Gampaha,Minuwangoda,Western,1797,4137,5934,71880,165480,237360
8/30/2024,Madhusanka Malwattage,Gampaha,Minuwangoda,Western,7215,3727,10942,288600,149080,437680
8/31/2024,Madhusanka Malwattage,Gampaha,Minuwangoda,Western,3094,3724,6818,123760,148960,272720
9/1/2024,Madhusanka Malwattage,Gampaha,Minuwangoda,Western,2831,1455,4286,113240,58200,171440
9/2/2024,Madhusanka Malwattage,Gampaha,Minuwangoda,Western,5628,8763,14391,225120,350520,575640
9/3/2024,Madhusanka Malwattage,Gampaha,Minuwangoda,Western,4291,864,5155,171640,34560,206200
9/4/2024,Madhusanka Malwattage,Gampaha,Minuwangoda,Western,8639,2018,10657,345560,80720,426280
9/5/2024,Madhusanka Malwattage,Gampaha,Minuwangoda,Western,7161,4816,11977,286440,192640,479080
9/6/2024,Madhusanka Malwattage,Gampaha,Minuwangoda,Western,7163,2963,10126,286520,118520,405040
9/7/2024,Madhusanka Malwattage,Gampaha,Minuwangoda,Western,1626,6982,8608,65040,279280,344320
9/8/2024,Madhusanka Malwattage,Gampaha,Minuwangoda,Western,7661,4971,12632,306440,198840,505280
9/9/2024,Madhusanka Malwattage,Gampaha,Minuwangoda,Western,8347,3049,11396,333880,121960,455840
9/10/2024,Madhusanka Malwattage,Gampaha,Minuwangoda,Western,4848,6571,11419,193920,262840,456760
9/11/2024,Madhusanka Malwattage,Gampaha,Minuwangoda,Western,6658,90,6748,266320,3600,269920
9/12/2024,Madhusanka Malwattage,Gampaha,Minuwangoda,Western,121,4442,4563,4840,177680,182520
9/13/2024,Madhusanka Malwattage,Gampaha,Minuwangoda,Western,6963,5622,12585,278520,224880,503400
9/14/2024,Madhusanka Malwattage,Gampaha,Minuwangoda,Western,1075,1020,2095,43000,40800,83800
9/15/2024,Madhusanka Malwattage,Gampaha,Minuwangoda,Western,5623,7623,13246,224920,304920,529840
9/16/2024,Madhusanka Malwattage,Gampaha,Minuwangoda,Western,2405,744,3149,96200,29760,125960
9/17/2024,Madhusanka Malwattage,Gampaha,Minuwangoda,Western,5220,1206,6426,208800,48240,257040
9/18/2024,Madhusanka Malwattage,Gampaha,Minuwangoda,Western,1908,3323,5231,76320,132920,209240
9/19/2024,Madhusanka Malwattage,Gampaha,Minuwangoda,Western,320,2039,2359,12800,81560,94360
9/20/2024,Madhusanka Malwattage,Gampaha,Minuwangoda,Western,6968,930,7898,278720,37200,315920
9/21/2024,Madhusanka Malwattage,Gampaha,Minuwangoda,Western,5025,6000,11025,201000,240000,441000
9/22/2024,Madhusanka Malwattage,Gampaha,Minuwangoda,Western,3936,8761,12697,157440,350440,507880
9/23/2024,Madhusanka Malwattage,Gampaha,Minuwangoda,Western,9682,895,10577,387280,35800,423080
9/24/2024,Madhusanka Malwattage,Gampaha,Minuwangoda,Western,5576,138,5714,223040,5520,228560
9/25/2024,Madhusanka Malwattage,Gampaha,Minuwangoda,Western,9854,6067,15921,394160,242680,636840
9/26/2024,Madhusanka Malwattage,Gampaha,Minuwangoda,Western,6752,9277,16029,270080,371080,641160
9/27/2024,Madhusanka Malwattage,Gampaha,Minuwangoda,Western,4462,8205,12667,178480,328200,506680
9/28/2024,Madhusanka Malwattage,Gampaha,Minuwangoda,Western,100,3709,3809,4000,148360,152360
9/29/2024,Madhusanka Malwattage,Gampaha,Minuwangoda,Western,4061,5683,9744,162440,227320,389760
9/30/2024,Madhusanka Malwattage,Gampaha,Minuwangoda,Western,4384,84,4468,175360,3360,178720
10/1/2024,Madhusanka Malwattage,Gampaha,Minuwangoda,Western,3198,1960,5158,127920,78400,206320
10/2/2024,Madhusanka Malwattage,Gampaha,Minuwangoda,Western,87,6974,7061,3480,278960,282440
10/3/2024,Madhusanka Malwattage,Gampaha,Minuwangoda,Western,8888,9973,18861,355520,398920,754440
10/4/2024,Madhusanka Malwattage,Gampaha,Minuwangoda,Western,2638,6111,8749,105520,244440,349960
10/5/2024,Madhusanka Malwattage,Gampaha,Minuwangoda,Western,2130,4334,6464,85200,173360,258560
10/6/2024,Madhusanka Malwattage,Gampaha,Minuwangoda,Western,1864,9370,11234,74560,374800,449360
10/7/2024,Madhusanka Malwattage,Gampaha,Minuwangoda,Western,9414,571,9985,376560,22840,399400
10/8/2024,Madhusanka Malwattage,Gampaha,Minuwangoda,Western,1574,8428,10002,62960,337120,400080
10/9/2024,Madhusanka Malwattage,Gampaha,Minuwangoda,Western,3568,1679,5247,142720,67160,209880
10/10/2024,Madhusanka Malwattage,Gampaha,Minuwangoda,Western,1705,1541,3246,68200,61640,129840
10/11/2024,Madhusanka Malwattage,Gampaha,Minuwangoda,Western,6052,3315,9367,242080,132600,374680
10/12/2024,Madhusanka Malwattage,Gampaha,Minuwangoda,Western,1713,4574,6287,68520,182960,251480
10/13/2024,Madhusanka Malwattage,Gampaha,Minuwangoda,Western,3376,7434,10810,135040,297360,432400
10/14/2024,Madhusanka Malwattage,Gampaha,Minuwangoda,Western,6655,6581,13236,266200,263240,529440
10/15/2024,Madhusanka Malwattage,Gampaha,Minuwangoda,Western,8281,6276,14557,331240,251040,582280
10/16/2024,Madhusanka Malwattage,Gampaha,Minuwangoda,Western,2109,7186,9295,84360,287440,371800
10/17/2024,Madhusanka Malwattage,Gampaha,Minuwangoda,Western,4291,2127,6418,171640,85080,256720
10/18/2024,Madhusanka Malwattage,Gampaha,Minuwangoda,Western,8419,2285,10704,336760,91400,428160
10/19/2024,Madhusanka Malwattage,Gampaha,Minuwangoda,Western,5882,9187,15069,235280,367480,602760
10/20/2024,Madhusanka Malwattage,Gampaha,Minuwangoda,Western,3430,9132,12562,137200,365280,502480
10/21/2024,Madhusanka Malwattage,Gampaha,Minuwangoda,Western,7376,8431,15807,295040,337240,632280
10/22/2024,Madhusanka Malwattage,Gampaha,Minuwangoda,Western,1231,4211,5442,49240,168440,217680
10/23/2024,Madhusanka Malwattage,Gampaha,Minuwangoda,Western,4366,2918,7284,174640,116720,291360
10/24/2024,Madhusanka Malwattage,Gampaha,Minuwangoda,Western,9122,3518,12640,364880,140720,505600
10/25/2024,Madhusanka Malwattage,Gampaha,Minuwangoda,Western,5553,8210,13763,222120,328400,550520
10/26/2024,Madhusanka Malwattage,Gampaha,Minuwangoda,Western,7488,8946,16434,299520,357840,657360
10/27/2024,Madhusanka Malwattage,Gampaha,Minuwangoda,Western,2705,5905,8610,108200,236200,344400
10/28/2024,Madhusanka Malwattage,Gampaha,Minuwangoda,Western,3631,5834,9465,145240,233360,378600
10/29/2024,Madhusanka Malwattage,Gampaha,Minuwangoda,Western,240,8675,8915,9600,347000,356600
10/30/2024,Madhusanka Malwattage,Gampaha,Minuwangoda,Western,5183,7556,12739,207320,302240,509560
10/31/2024,Madhusanka Malwattage,Gampaha,Minuwangoda,Western,231,7853,8084,9240,314120,323360
11/1/2024,Madhusanka Malwattage,Gampaha,Minuwangoda,Western,5874,4561,10435,234960,182440,417400
11/2/2024,Madhusanka Malwattage,Gampaha,Minuwangoda,Western,1479,3562,5041,59160,142480,201640
11/3/2024,Madhusanka Malwattage,Gampaha,Minuwangoda,Western,9519,2405,11924,380760,96200,476960
11/4/2024,Madhusanka Malwattage,Gampaha,Minuwangoda,Western,8120,4342,12462,324800,173680,498480
11/5/2024,Madhusanka Malwattage,Gampaha,Minuwangoda,Western,8453,8458,16911,338120,338320,676440
11/6/2024,Madhusanka Malwattage,Gampaha,Minuwangoda,Western,2921,9125,12046,116840,365000,481840
11/7/2024,Madhusanka Malwattage,Gampaha,Minuwangoda,Western,8046,3977,12023,321840,159080,480920
11/8/2024,Madhusanka Malwattage,Gampaha,Minuwangoda,Western,6775,2005,8780,271000,80200,351200
11/9/2024,Madhusanka Malwattage,Gampaha,Minuwangoda,Western,9020,4962,13982,360800,198480,559280
11/10/2024,Madhusanka Malwattage,Gampaha,Minuwangoda,Western,9122,4802,13924,364880,192080,556960
11/11/2024,Madhusanka Malwattage,Gampaha,Minuwangoda,Western,308,9026,9334,12320,361040,373360
11/12/2024,Madhusanka Malwattage,Gampaha,Minuwangoda,Western,5120,9290,14410,204800,371600,576400
11/13/2024,Madhusanka Malwattage,Gampaha,Minuwangoda,Western,932,6518,7450,37280,260720,298000
11/14/2024,Madhusanka Malwattage,Gampaha,Minuwangoda,Western,8234,5925,14159,329360,237000,566360
11/15/2024,Madhusanka Malwattage,Gampaha,Minuwangoda,Western,7753,2310,10063,310120,92400,402520
11/16/2024,Madhusanka Malwattage,Gampaha,Minuwangoda,Western,9478,3073,12551,379120,122920,502040
11/17/2024,Madhusanka Malwattage,Gampaha,Minuwangoda,Western,4063,2947,7010,162520,117880,280400
11/18/2024,Madhusanka Malwattage,Gampaha,Minuwangoda,Western,2239,3237,5476,89560,129480,219040
11/19/2024,Madhusanka Malwattage,Gampaha,Minuwangoda,Western,1070,3224,4294,42800,128960,171760
11/20/2024,Madhusanka Malwattage,Gampaha,Minuwangoda,Western,7854,1257,9111,314160,50280,364440
11/21/2024,Madhusanka Malwattage,Gampaha,Minuwangoda,Western,1889,6198,8087,75560,247920,323480
11/22/2024,Madhusanka Malwattage,Gampaha,Minuwangoda,Western,9436,6060,15496,377440,242400,619840
11/23/2024,Madhusanka Malwattage,Gampaha,Minuwangoda,Western,9800,4496,14296,392000,179840,571840
11/24/2024,Madhusanka Malwattage,Gampaha,Minuwangoda,Western,860,1322,2182,34400,52880,87280
11/25/2024,Madhusanka Malwattage,Gampaha,Minuwangoda,Western,5481,1316,6797,219240,52640,271880
11/26/2024,Madhusanka Malwattage,Gampaha,Minuwangoda,Western,1887,2415,4302,75480,96600,172080
11/27/2024,Madhusanka Malwattage,Gampaha,Minuwangoda,Western,2100,9824,11924,84000,392960,476960
11/28/2024,Madhusanka Malwattage,Gampaha,Minuwangoda,Western,4721,137,4858,188840,5480,194320
11/29/2024,Madhusanka Malwattage,Gampaha,Minuwangoda,Western,248,5813,6061,9920,232520,242440
11/30/2024,Madhusanka Malwattage,Gampaha,Minuwangoda,Western,5216,6789,12005,208640,271560,480200
12/1/2024,Madhusanka Malwattage,Gampaha,Minuwangoda,Western,5751,6793,12544,230040,271720,501760
12/2/2024,Madhusanka Malwattage,Gampaha,Minuwangoda,Western,5746,1618,7364,229840,64720,294560
12/3/2024,Madhusanka Malwattage,Gampaha,Minuwangoda,Western,2633,7681,10314,105320,307240,412560
12/4/2024,Madhusanka Malwattage,Gampaha,Minuwangoda,Western,6178,8903,15081,247120,356120,603240
12/5/2024,Madhusanka Malwattage,Gampaha,Minuwangoda,Western,400,3289,3689,16000,131560,147560
12/6/2024,Madhusanka Malwattage,Gampaha,Minuwangoda,Western,54,2838,2892,2160,113520,115680
12/7/2024,Madhusanka Malwattage,Gampaha,Minuwangoda,Western,2070,5141,7211,82800,205640,288440
12/8/2024,Madhusanka Malwattage,Gampaha,Minuwangoda,Western,8501,7512,16013,340040,300480,640520
12/9/2024,Madhusanka Malwattage,Gampaha,Minuwangoda,Western,5964,6541,12505,238560,261640,500200
12/10/2024,Madhusanka Malwattage,Gampaha,Minuwangoda,Western,6963,4270,11233,278520,170800,449320
12/11/2024,Madhusanka Malwattage,Gampaha,Minuwangoda,Western,9165,2611,11776,366600,104440,471040
12/12/2024,Madhusanka Malwattage,Gampaha,Minuwangoda,Western,1279,3878,5157,51160,155120,206280
12/13/2024,Madhusanka Malwattage,Gampaha,Minuwangoda,Western,7128,4965,12093,285120,198600,483720
12/14/2024,Madhusanka Malwattage,Gampaha,Minuwangoda,Western,4099,9590,13689,163960,383600,547560
12/15/2024,Madhusanka Malwattage,Gampaha,Minuwangoda,Western,8244,2251,10495,329760,90040,419800
12/16/2024,Madhusanka Malwattage,Gampaha,Minuwangoda,Western,1113,7319,8432,44520,292760,337280
12/17/2024,Madhusanka Malwattage,Gampaha,Minuwangoda,Western,4135,8814,12949,165400,352560,517960
12/18/2024,Madhusanka Malwattage,Gampaha,Minuwangoda,Western,2035,8595,10630,81400,343800,425200
12/19/2024,Madhusanka Malwattage,Gampaha,Minuwangoda,Western,6501,7568,14069,260040,302720,562760
12/20/2024,Madhusanka Malwattage,Gampaha,Minuwangoda,Western,9306,8273,17579,372240,330920,703160
12/21/2024,Madhusanka Malwattage,Gampaha,Minuwangoda,Western,3536,2422,5958,141440,96880,238320
12/22/2024,Madhusanka Malwattage,Gampaha,Minuwangoda,Western,2696,9682,12378,107840,387280,495120
12/23/2024,Madhusanka Malwattage,Gampaha,Minuwangoda,Western,7878,9084,16962,315120,363360,678480
12/24/2024,Madhusanka Malwattage,Gampaha,Minuwangoda,Western,4514,3113,7627,180560,124520,305080
12/25/2024,Madhusanka Malwattage,Gampaha,Minuwangoda,Western,2220,1915,4135,88800,76600,165400
12/26/2024,Madhusanka Malwattage,Gampaha,Minuwangoda,Western,2363,5522,7885,94520,220880,315400
12/27/2024,Madhusanka Malwattage,Gampaha,Minuwangoda,Western,1001,6300,7301,40040,252000,292040
12/28/2024,Madhusanka Malwattage,Gampaha,Minuwangoda,Western,5853,3091,8944,234120,123640,357760
12/29/2024,Madhusanka Malwattage,Gampaha,Minuwangoda,Western,4713,6478,11191,188520,259120,447640
12/30/2024,Madhusanka Malwattage,Gampaha,Minuwangoda,Western,8573,2266,10839,342920,90640,433560
12/31/2024,Madhusanka Malwattage,Gampaha,Minuwangoda,Western,3569,6646,10215,142760,265840,408600
1/1/2025,Madhusanka Malwattage,Gampaha,Minuwangoda,Western,1988,1353,3341,79520,54120,133640
1/2/2025,Madhusanka Malwattage,Gampaha,Minuwangoda,Western,9898,3618,13516,395920,144720,540640
1/3/2025,Madhusanka Malwattage,Gampaha,Minuwangoda,Western,5871,4947,10818,234840,197880,432720
1/4/2025,Madhusanka Malwattage,Gampaha,Minuwangoda,Western,5670,432,6102,226800,17280,244080
1/5/2025,Madhusanka Malwattage,Gampaha,Minuwangoda,Western,4230,4442,8672,169200,177680,346880
1/6/2025,Madhusanka Malwattage,Gampaha,Minuwangoda,Western,1292,9729,11021,51680,389160,440840
1/7/2025,Madhusanka Malwattage,Gampaha,Minuwangoda,Western,9415,4705,14120,376600,188200,564800
1/8/2025,Madhusanka Malwattage,Gampaha,Minuwangoda,Western,7851,975,8826,314040,39000,353040
1/9/2025,Madhusanka Malwattage,Gampaha,Minuwangoda,Western,8524,1606,10130,340960,64240,405200
1/10/2025,Madhusanka Malwattage,Gampaha,Minuwangoda,Western,6629,5222,11851,265160,208880,474040
1/11/2025,Madhusanka Malwattage,Gampaha,Minuwangoda,Western,883,7209,8092,35320,288360,323680
1/12/2025,Madhusanka Malwattage,Gampaha,Minuwangoda,Western,6895,9266,16161,275800,370640,646440
1/13/2025,Madhusanka Malwattage,Gampaha,Minuwangoda,Western,9663,2321,11984,386520,92840,479360
1/14/2025,Madhusanka Malwattage,Gampaha,Minuwangoda,Western,8446,3514,11960,337840,140560,478400
1/15/2025,Madhusanka Malwattage,Gampaha,Minuwangoda,Western,6504,6230,12734,260160,249200,509360
1/16/2025,Madhusanka Malwattage,Gampaha,Minuwangoda,Western,2271,4920,7191,90840,196800,287640
1/17/2025,Madhusanka Malwattage,Gampaha,Minuwangoda,Western,7049,1966,9015,281960,78640,360600
1/18/2025,Madhusanka Malwattage,Gampaha,Minuwangoda,Western,5428,5020,10448,217120,200800,417920
1/19/2025,Madhusanka Malwattage,Gampaha,Minuwangoda,Western,1946,4605,6551,77840,184200,262040
1/20/2025,Madhusanka Malwattage,Gampaha,Minuwangoda,Western,906,4674,5580,36240,186960,223200
1/21/2025,Madhusanka Malwattage,Gampaha,Minuwangoda,Western,5833,1205,7038,233320,48200,281520
1/22/2025,Madhusanka Malwattage,Gampaha,Minuwangoda,Western,821,2476,3297,32840,99040,131880
1/23/2025,Madhusanka Malwattage,Gampaha,Minuwangoda,Western,3447,4347,7794,137880,173880,311760
1/24/2025,Madhusanka Malwattage,Gampaha,Minuwangoda,Western,8780,2239,11019,351200,89560,440760
1/25/2025,Madhusanka Malwattage,Gampaha,Minuwangoda,Western,5883,9554,15437,235320,382160,617480
1/26/2025,Madhusanka Malwattage,Gampaha,Minuwangoda,Western,9665,7742,17407,386600,309680,696280
1/27/2025,Madhusanka Malwattage,Gampaha,Minuwangoda,Western,6169,7252,13421,246760,290080,536840
1/28/2025,Madhusanka Malwattage,Gampaha,Minuwangoda,Western,2312,7447,9759,92480,297880,390360
1/29/2025,Madhusanka Malwattage,Gampaha,Minuwangoda,Western,1697,9167,10864,67880,366680,434560
1/30/2025,Madhusanka Malwattage,Gampaha,Minuwangoda,Western,1724,119,1843,68960,4760,73720
1/31/2025,Madhusanka Malwattage,Gampaha,Minuwangoda,Western,7717,9482,17199,308680,379280,687960
2/1/2025,Madhusanka Malwattage,Gampaha,Minuwangoda,Western,7163,373,7536,286520,14920,301440
2/2/2025,Madhusanka Malwattage,Gampaha,Minuwangoda,Western,6932,7280,14212,277280,291200,568480
2/3/2025,Madhusanka Malwattage,Gampaha,Minuwangoda,Western,6052,1153,7205,242080,46120,288200
2/4/2025,Madhusanka Malwattage,Gampaha,Minuwangoda,Western,3852,6028,9880,154080,241120,395200
2/5/2025,Madhusanka Malwattage,Gampaha,Minuwangoda,Western,9178,9662,18840,367120,386480,753600
2/6/2025,Madhusanka Malwattage,Gampaha,Minuwangoda,Western,4007,6460,10467,160280,258400,418680
2/7/2025,Madhusanka Malwattage,Gampaha,Minuwangoda,Western,1935,2527,4462,77400,101080,178480
2/8/2025,Madhusanka Malwattage,Gampaha,Minuwangoda,Western,979,3311,4290,39160,132440,171600
2/9/2025,Madhusanka Malwattage,Gampaha,Minuwangoda,Western,458,8526,8984,18320,341040,359360
2/10/2025,Madhusanka Malwattage,Gampaha,Minuwangoda,Western,8695,5250,13945,347800,210000,557800
2/11/2025,Madhusanka Malwattage,Gampaha,Minuwangoda,Western,4061,3676,7737,162440,147040,309480
2/12/2025,Madhusanka Malwattage,Gampaha,Minuwangoda,Western,8043,5513,13556,321720,220520,542240
2/13/2025,Madhusanka Malwattage,Gampaha,Minuwangoda,Western,7109,2698,9807,284360,107920,392280
2/14/2025,Madhusanka Malwattage,Gampaha,Minuwangoda,Western,2474,880,3354,98960,35200,134160
2/15/2025,Madhusanka Malwattage,Gampaha,Minuwangoda,Western,8596,497,9093,343840,19880,363720
2/16/2025,Madhusanka Malwattage,Gampaha,Minuwangoda,Western,7839,8220,16059,313560,328800,642360
2/17/2025,Madhusanka Malwattage,Gampaha,Minuwangoda,Western,4313,4333,8646,172520,173320,345840
2/18/2025,Madhusanka Malwattage,Gampaha,Minuwangoda,Western,931,8079,9010,37240,323160,360400
2/19/2025,Madhusanka Malwattage,Gampaha,Minuwangoda,Western,738,1673,2411,29520,66920,96440
2/20/2025,Madhusanka Malwattage,Gampaha,Minuwangoda,Western,211,9035,9246,8440,361400,369840
2/21/2025,Madhusanka Malwattage,Gampaha,Minuwangoda,Western,4367,4128,8495,174680,165120,339800
2/22/2025,Madhusanka Malwattage,Gampaha,Minuwangoda,Western,2142,1412,3554,85680,56480,142160
2/23/2025,Madhusanka Malwattage,Gampaha,Minuwangoda,Western,5111,9056,14167,204440,362240,566680
2/24/2025,Madhusanka Malwattage,Gampaha,Minuwangoda,Western,1283,6546,7829,51320,261840,313160
2/25/2025,Madhusanka Malwattage,Gampaha,Minuwangoda,Western,317,3022,3339,12680,120880,133560
2/26/2025,Madhusanka Malwattage,Gampaha,Minuwangoda,Western,491,938,1429,19640,37520,57160
2/27/2025,Madhusanka Malwattage,Gampaha,Minuwangoda,Western,3607,2907,6514,144280,116280,260560
2/28/2025,Madhusanka Malwattage,Gampaha,Minuwangoda,Western,8832,9478,18310,353280,379120,732400
3/1/2025,Madhusanka Malwattage,Gampaha,Minuwangoda,Western,1641,5147,6788,65640,205880,271520
3/2/2025,Madhusanka Malwattage,Gampaha,Minuwangoda,Western,1558,152,1710,62320,6080,68400
3/3/2025,Madhusanka Malwattage,Gampaha,Minuwangoda,Western,78,165,243,3120,6600,9720
3/4/2025,Madhusanka Malwattage,Gampaha,Minuwangoda,Western,2041,3853,5894,81640,154120,235760
3/5/2025,Madhusanka Malwattage,Gampaha,Minuwangoda,Western,4072,2997,7069,162880,119880,282760
3/6/2025,Madhusanka Malwattage,Gampaha,Minuwangoda,Western,1848,494,2342,73920,19760,93680
3/7/2025,Madhusanka Malwattage,Gampaha,Minuwangoda,Western,7254,6752,14006,290160,270080,560240
3/8/2025,Madhusanka Malwattage,Gampaha,Minuwangoda,Western,2778,2874,5652,111120,114960,226080
3/9/2025,Madhusanka Malwattage,Gampaha,Minuwangoda,Western,155,3063,3218,6200,122520,128720
3/10/2025,Madhusanka Malwattage,Gampaha,Minuwangoda,Western,8798,6706,15504,351920,268240,620160
3/11/2025,Madhusanka Malwattage,Gampaha,Minuwangoda,Western,6801,1219,8020,272040,48760,320800
3/12/2025,Madhusanka Malwattage,Gampaha,Minuwangoda,Western,5207,9389,14596,208280,375560,583840
3/13/2025,Madhusanka Malwattage,Gampaha,Minuwangoda,Western,1010,3380,4390,40400,135200,175600
3/14/2025,Madhusanka Malwattage,Gampaha,Minuwangoda,Western,6790,827,7617,271600,33080,304680
3/15/2025,Madhusanka Malwattage,Gampaha,Minuwangoda,Western,2932,6658,9590,117280,266320,383600
3/16/2025,Madhusanka Malwattage,Gampaha,Minuwangoda,Western,8291,9844,18135,331640,393760,725400
3/17/2025,Madhusanka Malwattage,Gampaha,Minuwangoda,Western,484,9920,10404,19360,396800,416160
3/18/2025,Madhusanka Malwattage,Gampaha,Minuwangoda,Western,5516,5332,10848,220640,213280,433920
3/19/2025,Madhusanka Malwattage,Gampaha,Minuwangoda,Western,792,4384,5176,31680,175360,207040
3/20/2025,Madhusanka Malwattage,Gampaha,Minuwangoda,Western,1101,978,2079,44040,39120,83160
3/21/2025,Madhusanka Malwattage,Gampaha,Minuwangoda,Western,7215,7447,14662,288600,297880,586480
3/22/2025,Madhusanka Malwattage,Gampaha,Minuwangoda,Western,427,5089,5516,17080,203560,220640
3/23/2025,Madhusanka Malwattage,Gampaha,Minuwangoda,Western,8827,5822,14649,353080,232880,585960
3/25/2024,Tissa Samarasinghe,Jaffna,Karainagar,Northern,1772,7537,9309,70880,301480,372360
3/26/2024,Tissa Samarasinghe,Jaffna,Karainagar,Northern,657,9623,10280,26280,384920,411200
3/27/2024,Tissa Samarasinghe,Jaffna,Karainagar,Northern,2150,6038,8188,86000,241520,327520
3/28/2024,Tissa Samarasinghe,Jaffna,Karainagar,Northern,3149,2814,5963,125960,112560,238520
3/29/2024,Tissa Samarasinghe,Jaffna,Karainagar,Northern,9690,5946,15636,387600,237840,625440
3/30/2024,Tissa Samarasinghe,Jaffna,Karainagar,Northern,3598,2965,6563,143920,118600,262520
3/31/2024,Tissa Samarasinghe,Jaffna,Karainagar,Northern,3268,7359,10627,130720,294360,425080
4/1/2024,Tissa Samarasinghe,Jaffna,Karainagar,Northern,374,6760,7134,14960,270400,285360
4/2/2024,Tissa Samarasinghe,Jaffna,Karainagar,Northern,30,32,62,1200,1280,2480
4/3/2024,Tissa Samarasinghe,Jaffna,Karainagar,Northern,2176,1312,3488,87040,52480,139520
4/4/2024,Tissa Samarasinghe,Jaffna,Karainagar,Northern,3514,2756,6270,140560,110240,250800
4/5/2024,Tissa Samarasinghe,Jaffna,Karainagar,Northern,3017,5039,8056,120680,201560,322240
4/6/2024,Tissa Samarasinghe,Jaffna,Karainagar,Northern,4639,3469,8108,185560,138760,324320
4/7/2024,Tissa Samarasinghe,Jaffna,Karainagar,Northern,5108,37,5145,204320,1480,205800
4/8/2024,Tissa Samarasinghe,Jaffna,Karainagar,Northern,1195,7794,8989,47800,311760,359560
4/9/2024,Tissa Samarasinghe,Jaffna,Karainagar,Northern,9358,1346,10704,374320,53840,428160
4/10/2024,Tissa Samarasinghe,Jaffna,Karainagar,Northern,4483,5680,10163,179320,227200,406520
4/11/2024,Tissa Samarasinghe,Jaffna,Karainagar,Northern,4189,3990,8179,167560,159600,327160
4/19/2024,Tissa Samarasinghe,Jaffna,Karainagar,Northern,6962,555,7517,278480,22200,300680
4/20/2024,Tissa Samarasinghe,Jaffna,Karainagar,Northern,5190,6176,11366,207600,247040,454640
4/21/2024,Tissa Samarasinghe,Jaffna,Karainagar,Northern,2737,1164,3901,109480,46560,156040
4/22/2024,Tissa Samarasinghe,Jaffna,Karainagar,Northern,4079,7342,11421,163160,293680,456840
4/23/2024,Tissa Samarasinghe,Jaffna,Karainagar,Northern,5509,1064,6573,220360,42560,262920
4/24/2024,Tissa Samarasinghe,Jaffna,Karainagar,Northern,2031,3782,5813,81240,151280,232520
4/25/2024,Tissa Samarasinghe,Jaffna,Karainagar,Northern,4285,9974,14259,171400,398960,570360
4/26/2024,Tissa Samarasinghe,Jaffna,Karainagar,Northern,5381,2509,7890,215240,100360,315600
4/27/2024,Tissa Samarasinghe,Jaffna,Karainagar,Northern,4173,5724,9897,166920,228960,395880
4/28/2024,Tissa Samarasinghe,Jaffna,Karainagar,Northern,9622,8930,18552,384880,357200,742080
4/29/2024,Tissa Samarasinghe,Jaffna,Karainagar,Northern,1663,3817,5480,66520,152680,219200
4/30/2024,Tissa Samarasinghe,Jaffna,Karainagar,Northern,8875,7907,16782,355000,316280,671280
5/1/2024,Tissa Samarasinghe,Jaffna,Karainagar,Northern,1282,892,2174,51280,35680,86960
5/2/2024,Tissa Samarasinghe,Jaffna,Karainagar,Northern,9722,6302,16024,388880,252080,640960
5/3/2024,Tissa Samarasinghe,Jaffna,Karainagar,Northern,5411,8127,13538,216440,325080,541520
5/4/2024,Tissa Samarasinghe,Jaffna,Karainagar,Northern,4909,5246,10155,196360,209840,406200
5/5/2024,Tissa Samarasinghe,Jaffna,Karainagar,Northern,6648,562,7210,265920,22480,288400
5/6/2024,Tissa Samarasinghe,Jaffna,Karainagar,Northern,5131,580,5711,205240,23200,228440
5/7/2024,Tissa Samarasinghe,Jaffna,Karainagar,Northern,4905,6968,11873,196200,278720,474920
5/8/2024,Tissa Samarasinghe,Jaffna,Karainagar,Northern,9202,5729,14931,368080,229160,597240
5/9/2024,Tissa Samarasinghe,Jaffna,Karainagar,Northern,2041,4908,6949,81640,196320,277960
5/10/2024,Tissa Samarasinghe,Jaffna,Karainagar,Northern,2787,288,3075,111480,11520,123000
5/11/2024,Tissa Samarasinghe,Jaffna,Karainagar,Northern,1269,7411,8680,50760,296440,347200
5/12/2024,Tissa Samarasinghe,Jaffna,Karainagar,Northern,579,4907,5486,23160,196280,219440
5/13/2024,Tissa Samarasinghe,Jaffna,Karainagar,Northern,2966,37,3003,118640,1480,120120
5/14/2024,Tissa Samarasinghe,Jaffna,Karainagar,Northern,7857,4347,12204,314280,173880,488160
5/15/2024,Tissa Samarasinghe,Jaffna,Karainagar,Northern,7488,5739,13227,299520,229560,529080
5/16/2024,Tissa Samarasinghe,Jaffna,Karainagar,Northern,1397,9773,11170,55880,390920,446800
5/17/2024,Tissa Samarasinghe,Jaffna,Karainagar,Northern,7003,3725,10728,280120,149000,429120
5/18/2024,Tissa Samarasinghe,Jaffna,Karainagar,Northern,6351,6127,12478,254040,245080,499120
5/19/2024,Tissa Samarasinghe,Jaffna,Karainagar,Northern,5884,8043,13927,235360,321720,557080
5/20/2024,Tissa Samarasinghe,Jaffna,Karainagar,Northern,1589,2437,4026,63560,97480,161040
5/21/2024,Tissa Samarasinghe,Jaffna,Karainagar,Northern,9594,1342,10936,383760,53680,437440
5/22/2024,Tissa Samarasinghe,Jaffna,Karainagar,Northern,6975,4908,11883,279000,196320,475320
5/24/2024,Tissa Samarasinghe,Jaffna,Karainagar,Northern,6991,1836,8827,279640,73440,353080
5/25/2024,Tissa Samarasinghe,Jaffna,Karainagar,Northern,7427,544,7971,297080,21760,318840
5/26/2024,Tissa Samarasinghe,Jaffna,Karainagar,Northern,650,7221,7871,26000,288840,314840
5/27/2024,Tissa Samarasinghe,Jaffna,Karainagar,Northern,8785,4422,13207,351400,176880,528280
5/28/2024,Tissa Samarasinghe,Jaffna,Karainagar,Northern,20,3833,3853,800,153320,154120
5/29/2024,Tissa Samarasinghe,Jaffna,Karainagar,Northern,6116,2033,8149,244640,81320,325960
5/30/2024,Tissa Samarasinghe,Jaffna,Karainagar,Northern,4371,9620,13991,174840,384800,559640
5/31/2024,Tissa Samarasinghe,Jaffna,Karainagar,Northern,5023,6750,11773,200920,270000,470920
6/1/2024,Tissa Samarasinghe,Jaffna,Karainagar,Northern,1027,1337,2364,41080,53480,94560
6/2/2024,Tissa Samarasinghe,Jaffna,Karainagar,Northern,4665,6805,11470,186600,272200,458800
6/3/2024,Tissa Samarasinghe,Jaffna,Karainagar,Northern,6160,5160,11320,246400,206400,452800
6/4/2024,Tissa Samarasinghe,Jaffna,Karainagar,Northern,5383,572,5955,215320,22880,238200
6/5/2024,Tissa Samarasinghe,Jaffna,Karainagar,Northern,7759,6420,14179,310360,256800,567160
6/6/2024,Tissa Samarasinghe,Jaffna,Karainagar,Northern,2531,6034,8565,101240,241360,342600
6/7/2024,Tissa Samarasinghe,Jaffna,Karainagar,Northern,6801,1781,8582,272040,71240,343280
6/8/2024,Tissa Samarasinghe,Jaffna,Karainagar,Northern,3780,6823,10603,151200,272920,424120
6/9/2024,Tissa Samarasinghe,Jaffna,Karainagar,Northern,154,7420,7574,6160,296800,302960
6/10/2024,Tissa Samarasinghe,Jaffna,Karainagar,Northern,8580,922,9502,343200,36880,380080
6/11/2024,Tissa Samarasinghe,Jaffna,Karainagar,Northern,9975,2695,12670,399000,107800,506800
6/12/2024,Tissa Samarasinghe,Jaffna,Karainagar,Northern,7130,8227,15357,285200,329080,614280
6/13/2024,Tissa Samarasinghe,Jaffna,Karainagar,Northern,9556,8124,17680,382240,324960,707200
6/14/2024,Tissa Samarasinghe,Jaffna,Karainagar,Northern,6678,2202,8880,267120,88080,355200
6/15/2024,Tissa Samarasinghe,Jaffna,Karainagar,Northern,1322,4881,6203,52880,195240,248120
6/16/2024,Tissa Samarasinghe,Jaffna,Karainagar,Northern,688,9994,10682,27520,399760,427280
6/17/2024,Tissa Samarasinghe,Jaffna,Karainagar,Northern,1673,267,1940,66920,10680,77600
6/18/2024,Tissa Samarasinghe,Jaffna,Karainagar,Northern,5108,5967,11075,204320,238680,443000
6/19/2024,Tissa Samarasinghe,Jaffna,Karainagar,Northern,5946,2768,8714,237840,110720,348560
6/20/2024,Tissa Samarasinghe,Jaffna,Karainagar,Northern,3870,2461,6331,154800,98440,253240
6/21/2024,Tissa Samarasinghe,Jaffna,Karainagar,Northern,9561,5681,15242,382440,227240,609680
6/22/2024,Tissa Samarasinghe,Jaffna,Karainagar,Northern,8630,3182,11812,345200,127280,472480
6/23/2024,Tissa Samarasinghe,Jaffna,Karainagar,Northern,9280,7825,17105,371200,313000,684200
6/24/2024,Tissa Samarasinghe,Jaffna,Karainagar,Northern,9090,1834,10924,363600,73360,436960
6/25/2024,Tissa Samarasinghe,Jaffna,Karainagar,Northern,7251,128,7379,290040,5120,295160
6/26/2024,Tissa Samarasinghe,Jaffna,Karainagar,Northern,5813,7953,13766,232520,318120,550640
6/27/2024,Tissa Samarasinghe,Jaffna,Karainagar,Northern,3864,4824,8688,154560,192960,347520
6/28/2024,Tissa Samarasinghe,Jaffna,Karainagar,Northern,3910,2454,6364,156400,98160,254560
6/29/2024,Tissa Samarasinghe,Jaffna,Karainagar,Northern,2758,3440,6198,110320,137600,247920
6/30/2024,Tissa Samarasinghe,Jaffna,Karainagar,Northern,8931,8993,17924,357240,359720,716960
7/1/2024,Tissa Samarasinghe,Jaffna,Karainagar,Northern,231,610,841,9240,24400,33640
7/2/2024,Tissa Samarasinghe,Jaffna,Karainagar,Northern,8527,2979,11506,341080,119160,460240
7/3/2024,Tissa Samarasinghe,Jaffna,Karainagar,Northern,2076,7721,9797,83040,308840,391880
7/4/2024,Tissa Samarasinghe,Jaffna,Karainagar,Northern,5065,3252,8317,202600,130080,332680
7/5/2024,Tissa Samarasinghe,Jaffna,Karainagar,Northern,9564,7822,17386,382560,312880,695440
7/6/2024,Tissa Samarasinghe,Jaffna,Karainagar,Northern,4828,4707,9535,193120,188280,381400
7/7/2024,Tissa Samarasinghe,Jaffna,Karainagar,Northern,9362,7095,16457,374480,283800,658280
7/8/2024,Tissa Samarasinghe,Jaffna,Karainagar,Northern,1194,8428,9622,47760,337120,384880
7/9/2024,Tissa Samarasinghe,Jaffna,Karainagar,Northern,2587,1570,4157,103480,62800,166280
7/10/2024,Tissa Samarasinghe,Jaffna,Karainagar,Northern,2552,5981,8533,102080,239240,341320
7/11/2024,Tissa Samarasinghe,Jaffna,Karainagar,Northern,9049,6182,15231,361960,247280,609240
7/12/2024,Tissa Samarasinghe,Jaffna,Karainagar,Northern,4183,8103,12286,167320,324120,491440
7/13/2024,Tissa Samarasinghe,Jaffna,Karainagar,Northern,2188,8057,10245,87520,322280,409800
7/14/2024,Tissa Samarasinghe,Jaffna,Karainagar,Northern,2015,7774,9789,80600,310960,391560
7/15/2024,Tissa Samarasinghe,Jaffna,Karainagar,Northern,8627,1929,10556,345080,77160,422240
7/16/2024,Tissa Samarasinghe,Jaffna,Karainagar,Northern,5568,5966,11534,222720,238640,461360
7/17/2024,Tissa Samarasinghe,Jaffna,Karainagar,Northern,8541,6461,15002,341640,258440,600080
7/18/2024,Tissa Samarasinghe,Jaffna,Karainagar,Northern,4809,8230,13039,192360,329200,521560
7/19/2024,Tissa Samarasinghe,Jaffna,Karainagar,Northern,474,4476,4950,18960,179040,198000
7/20/2024,Tissa Samarasinghe,Jaffna,Karainagar,Northern,6035,3339,9374,241400,133560,374960
7/21/2024,Tissa Samarasinghe,Jaffna,Karainagar,Northern,8564,6454,15018,342560,258160,600720
7/22/2024,Tissa Samarasinghe,Jaffna,Karainagar,Northern,9471,9649,19120,378840,385960,764800
7/23/2024,Tissa Samarasinghe,Jaffna,Karainagar,Northern,2516,2352,4868,100640,94080,194720
7/24/2024,Tissa Samarasinghe,Jaffna,Karainagar,Northern,873,4204,5077,34920,168160,203080
7/25/2024,Tissa Samarasinghe,Jaffna,Karainagar,Northern,6452,3231,9683,258080,129240,387320
7/26/2024,Tissa Samarasinghe,Jaffna,Karainagar,Northern,4115,5289,9404,164600,211560,376160
7/27/2024,Tissa Samarasinghe,Jaffna,Karainagar,Northern,161,1913,2074,6440,76520,82960
7/28/2024,Tissa Samarasinghe,Jaffna,Karainagar,Northern,8245,1565,9810,329800,62600,392400
7/29/2024,Tissa Samarasinghe,Jaffna,Karainagar,Northern,9761,8548,18309,390440,341920,732360
7/30/2024,Tissa Samarasinghe,Jaffna,Karainagar,Northern,3061,454,3515,122440,18160,140600
7/31/2024,Tissa Samarasinghe,Jaffna,Karainagar,Northern,8798,2996,11794,351920,119840,471760
8/1/2024,Tissa Samarasinghe,Jaffna,Karainagar,Northern,7499,8931,16430,299960,357240,657200
8/2/2024,Tissa Samarasinghe,Jaffna,Karainagar,Northern,2632,1415,4047,105280,56600,161880
8/3/2024,Tissa Samarasinghe,Jaffna,Karainagar,Northern,7829,4147,11976,313160,165880,479040
8/4/2024,Tissa Samarasinghe,Jaffna,Karainagar,Northern,8025,4227,12252,321000,169080,490080
8/5/2024,Tissa Samarasinghe,Jaffna,Karainagar,Northern,8926,5223,14149,357040,208920,565960
8/6/2024,Tissa Samarasinghe,Jaffna,Karainagar,Northern,7497,827,8324,299880,33080,332960
8/7/2024,Tissa Samarasinghe,Jaffna,Karainagar,Northern,1600,9883,11483,64000,395320,459320
8/8/2024,Tissa Samarasinghe,Jaffna,Karainagar,Northern,6523,6806,13329,260920,272240,533160
8/9/2024,Tissa Samarasinghe,Jaffna,Karainagar,Northern,7439,383,7822,297560,15320,312880
8/10/2024,Tissa Samarasinghe,Jaffna,Karainagar,Northern,3448,3628,7076,137920,145120,283040
8/11/2024,Tissa Samarasinghe,Jaffna,Karainagar,Northern,6214,2748,8962,248560,109920,358480
8/12/2024,Tissa Samarasinghe,Jaffna,Karainagar,Northern,7349,2552,9901,293960,102080,396040
8/13/2024,Tissa Samarasinghe,Jaffna,Karainagar,Northern,5269,2374,7643,210760,94960,305720
8/14/2024,Tissa Samarasinghe,Jaffna,Karainagar,Northern,9148,9127,18275,365920,365080,731000
8/15/2024,Tissa Samarasinghe,Jaffna,Karainagar,Northern,9424,8152,17576,376960,326080,703040
8/16/2024,Tissa Samarasinghe,Jaffna,Karainagar,Northern,8284,7740,16024,331360,309600,640960
8/17/2024,Tissa Samarasinghe,Jaffna,Karainagar,Northern,9645,9805,19450,385800,392200,778000
8/18/2024,Tissa Samarasinghe,Jaffna,Karainagar,Northern,641,8391,9032,25640,335640,361280
8/19/2024,Tissa Samarasinghe,Jaffna,Karainagar,Northern,4492,882,5374,179680,35280,214960
8/20/2024,Tissa Samarasinghe,Jaffna,Karainagar,Northern,5281,7354,12635,211240,294160,505400
8/21/2024,Tissa Samarasinghe,Jaffna,Karainagar,Northern,675,5457,6132,27000,218280,245280
8/22/2024,Tissa Samarasinghe,Jaffna,Karainagar,Northern,6687,2245,8932,267480,89800,357280
8/23/2024,Tissa Samarasinghe,Jaffna,Karainagar,Northern,7579,6150,13729,303160,246000,549160
8/24/2024,Tissa Samarasinghe,Jaffna,Karainagar,Northern,9206,2935,12141,368240,117400,485640
8/25/2024,Tissa Samarasinghe,Jaffna,Karainagar,Northern,9017,3023,12040,360680,120920,481600
8/26/2024,Tissa Samarasinghe,Jaffna,Karainagar,Northern,3518,1673,5191,140720,66920,207640
8/27/2024,Tissa Samarasinghe,Jaffna,Karainagar,Northern,5328,5951,11279,213120,238040,451160
8/28/2024,Tissa Samarasinghe,Jaffna,Karainagar,Northern,8953,9557,18510,358120,382280,740400
8/29/2024,Tissa Samarasinghe,Jaffna,Karainagar,Northern,9862,6927,16789,394480,277080,671560
8/30/2024,Tissa Samarasinghe,Jaffna,Karainagar,Northern,2742,5528,8270,109680,221120,330800
8/31/2024,Tissa Samarasinghe,Jaffna,Karainagar,Northern,4083,7163,11246,163320,286520,449840
9/1/2024,Tissa Samarasinghe,Jaffna,Karainagar,Northern,4995,6207,11202,199800,248280,448080
9/2/2024,Tissa Samarasinghe,Jaffna,Karainagar,Northern,6331,6287,12618,253240,251480,504720
9/3/2024,Tissa Samarasinghe,Jaffna,Karainagar,Northern,1611,2003,3614,64440,80120,144560
9/4/2024,Tissa Samarasinghe,Jaffna,Karainagar,Northern,3464,1983,5447,138560,79320,217880
9/5/2024,Tissa Samarasinghe,Jaffna,Karainagar,Northern,1436,6135,7571,57440,245400,302840
9/6/2024,Tissa Samarasinghe,Jaffna,Karainagar,Northern,2870,1062,3932,114800,42480,157280
9/7/2024,Tissa Samarasinghe,Jaffna,Karainagar,Northern,5283,3456,8739,211320,138240,349560
9/8/2024,Tissa Samarasinghe,Jaffna,Karainagar,Northern,1056,2225,3281,42240,89000,131240
9/9/2024,Tissa Samarasinghe,Jaffna,Karainagar,Northern,6707,9483,16190,268280,379320,647600
9/10/2024,Tissa Samarasinghe,Jaffna,Karainagar,Northern,3286,6816,10102,131440,272640,404080
9/11/2024,Tissa Samarasinghe,Jaffna,Karainagar,Northern,2355,523,2878,94200,20920,115120
9/12/2024,Tissa Samarasinghe,Jaffna,Karainagar,Northern,8180,888,9068,327200,35520,362720
9/13/2024,Tissa Samarasinghe,Jaffna,Karainagar,Northern,2533,4159,6692,101320,166360,267680
9/14/2024,Tissa Samarasinghe,Jaffna,Karainagar,Northern,4048,7964,12012,161920,318560,480480
9/15/2024,Tissa Samarasinghe,Jaffna,Karainagar,Northern,5345,6965,12310,213800,278600,492400
9/16/2024,Tissa Samarasinghe,Jaffna,Karainagar,Northern,1078,5562,6640,43120,222480,265600
9/17/2024,Tissa Samarasinghe,Jaffna,Karainagar,Northern,6586,2549,9135,263440,101960,365400
9/18/2024,Tissa Samarasinghe,Jaffna,Karainagar,Northern,7207,5332,12539,288280,213280,501560
9/19/2024,Tissa Samarasinghe,Jaffna,Karainagar,Northern,8869,6999,15868,354760,279960,634720
9/20/2024,Tissa Samarasinghe,Jaffna,Karainagar,Northern,543,938,1481,21720,37520,59240
9/21/2024,Tissa Samarasinghe,Jaffna,Karainagar,Northern,5513,8042,13555,220520,321680,542200
9/22/2024,Tissa Samarasinghe,Jaffna,Karainagar,Northern,8369,1847,10216,334760,73880,408640
9/23/2024,Tissa Samarasinghe,Jaffna,Karainagar,Northern,8354,254,8608,334160,10160,344320
9/24/2024,Tissa Samarasinghe,Jaffna,Karainagar,Northern,1887,3369,5256,75480,134760,210240
9/25/2024,Tissa Samarasinghe,Jaffna,Karainagar,Northern,5430,4718,10148,217200,188720,405920
9/26/2024,Tissa Samarasinghe,Jaffna,Karainagar,Northern,7027,8299,15326,281080,331960,613040
9/27/2024,Tissa Samarasinghe,Jaffna,Karainagar,Northern,1593,1342,2935,63720,53680,117400
9/28/2024,Tissa Samarasinghe,Jaffna,Karainagar,Northern,7864,33,7897,314560,1320,315880
9/29/2024,Tissa Samarasinghe,Jaffna,Karainagar,Northern,6327,6128,12455,253080,245120,498200
9/30/2024,Tissa Samarasinghe,Jaffna,Karainagar,Northern,7241,6293,13534,289640,251720,541360
10/1/2024,Tissa Samarasinghe,Jaffna,Karainagar,Northern,4584,8421,13005,183360,336840,520200
10/2/2024,Tissa Samarasinghe,Jaffna,Karainagar,Northern,8367,164,8531,334680,6560,341240
10/3/2024,Tissa Samarasinghe,Jaffna,Karainagar,Northern,6696,868,7564,267840,34720,302560
10/4/2024,Tissa Samarasinghe,Jaffna,Karainagar,Northern,636,4232,4868,25440,169280,194720
10/5/2024,Tissa Samarasinghe,Jaffna,Karainagar,Northern,1929,1416,3345,77160,56640,133800
10/6/2024,Tissa Samarasinghe,Jaffna,Karainagar,Northern,4043,9036,13079,161720,361440,523160
10/7/2024,Tissa Samarasinghe,Jaffna,Karainagar,Northern,6695,8783,15478,267800,351320,619120
10/8/2024,Tissa Samarasinghe,Jaffna,Karainagar,Northern,1482,7765,9247,59280,310600,369880
10/9/2024,Tissa Samarasinghe,Jaffna,Karainagar,Northern,1819,2739,4558,72760,109560,182320
10/10/2024,Tissa Samarasinghe,Jaffna,Karainagar,Northern,864,4988,5852,34560,199520,234080
10/11/2024,Tissa Samarasinghe,Jaffna,Karainagar,Northern,679,1849,2528,27160,73960,101120
10/12/2024,Tissa Samarasinghe,Jaffna,Karainagar,Northern,7990,1142,9132,319600,45680,365280
10/13/2024,Tissa Samarasinghe,Jaffna,Karainagar,Northern,6413,7326,13739,256520,293040,549560
10/14/2024,Tissa Samarasinghe,Jaffna,Karainagar,Northern,4534,78,4612,181360,3120,184480
10/15/2024,Tissa Samarasinghe,Jaffna,Karainagar,Northern,8804,5810,14614,352160,232400,584560
10/16/2024,Tissa Samarasinghe,Jaffna,Karainagar,Northern,4476,3096,7572,179040,123840,302880
10/17/2024,Tissa Samarasinghe,Jaffna,Karainagar,Northern,7277,70,7347,291080,2800,293880
10/18/2024,Tissa Samarasinghe,Jaffna,Karainagar,Northern,3969,2182,6151,158760,87280,246040
10/19/2024,Tissa Samarasinghe,Jaffna,Karainagar,Northern,6597,2665,9262,263880,106600,370480
10/20/2024,Tissa Samarasinghe,Jaffna,Karainagar,Northern,7475,8417,15892,299000,336680,635680
10/21/2024,Tissa Samarasinghe,Jaffna,Karainagar,Northern,4125,5044,9169,165000,201760,366760
10/22/2024,Tissa Samarasinghe,Jaffna,Karainagar,Northern,3525,2787,6312,141000,111480,252480
10/23/2024,Tissa Samarasinghe,Jaffna,Karainagar,Northern,9121,189,9310,364840,7560,372400
10/24/2024,Tissa Samarasinghe,Jaffna,Karainagar,Northern,6379,4318,10697,255160,172720,427880
10/25/2024,Tissa Samarasinghe,Jaffna,Karainagar,Northern,9987,7602,17589,399480,304080,703560
10/26/2024,Tissa Samarasinghe,Jaffna,Karainagar,Northern,23,9914,9937,920,396560,397480
10/27/2024,Tissa Samarasinghe,Jaffna,Karainagar,Northern,5049,4460,9509,201960,178400,380360
10/28/2024,Tissa Samarasinghe,Jaffna,Karainagar,Northern,1099,3646,4745,43960,145840,189800
10/29/2024,Tissa Samarasinghe,Jaffna,Karainagar,Northern,3452,3461,6913,138080,138440,276520
10/30/2024,Tissa Samarasinghe,Jaffna,Karainagar,Northern,5833,1767,7600,233320,70680,304000
10/31/2024,Tissa Samarasinghe,Jaffna,Karainagar,Northern,8315,2774,11089,332600,110960,443560
11/1/2024,Tissa Samarasinghe,Jaffna,Karainagar,Northern,7023,2381,9404,280920,95240,376160
11/2/2024,Tissa Samarasinghe,Jaffna,Karainagar,Northern,9735,9611,19346,389400,384440,773840
11/3/2024,Tissa Samarasinghe,Jaffna,Karainagar,Northern,6335,7059,13394,253400,282360,535760
11/4/2024,Tissa Samarasinghe,Jaffna,Karainagar,Northern,9719,8281,18000,388760,331240,720000
11/5/2024,Tissa Samarasinghe,Jaffna,Karainagar,Northern,5085,9007,14092,203400,360280,563680
11/6/2024,Tissa Samarasinghe,Jaffna,Karainagar,Northern,8806,4735,13541,352240,189400,541640
11/7/2024,Tissa Samarasinghe,Jaffna,Karainagar,Northern,9738,488,10226,389520,19520,409040
11/8/2024,Tissa Samarasinghe,Jaffna,Karainagar,Northern,788,2419,3207,31520,96760,128280
11/9/2024,Tissa Samarasinghe,Jaffna,Karainagar,Northern,7362,1824,9186,294480,72960,367440
11/10/2024,Tissa Samarasinghe,Jaffna,Karainagar,Northern,8674,563,9237,346960,22520,369480
11/11/2024,Tissa Samarasinghe,Jaffna,Karainagar,Northern,1197,5882,7079,47880,235280,283160
11/12/2024,Tissa Samarasinghe,Jaffna,Karainagar,Northern,327,7782,8109,13080,311280,324360
11/13/2024,Tissa Samarasinghe,Jaffna,Karainagar,Northern,1574,9715,11289,62960,388600,451560
11/14/2024,Tissa Samarasinghe,Jaffna,Karainagar,Northern,9515,5266,14781,380600,210640,591240
11/15/2024,Tissa Samarasinghe,Jaffna,Karainagar,Northern,3387,5392,8779,135480,215680,351160
11/16/2024,Tissa Samarasinghe,Jaffna,Karainagar,Northern,4910,1883,6793,196400,75320,271720
11/17/2024,Tissa Samarasinghe,Jaffna,Karainagar,Northern,5411,6998,12409,216440,279920,496360
11/18/2024,Tissa Samarasinghe,Jaffna,Karainagar,Northern,9429,2589,12018,377160,103560,480720
11/19/2024,Tissa Samarasinghe,Jaffna,Karainagar,Northern,4608,9180,13788,184320,367200,551520
11/20/2024,Tissa Samarasinghe,Jaffna,Karainagar,Northern,653,7308,7961,26120,292320,318440
11/21/2024,Tissa Samarasinghe,Jaffna,Karainagar,Northern,5267,8618,13885,210680,344720,555400
11/22/2024,Tissa Samarasinghe,Jaffna,Karainagar,Northern,1757,6891,8648,70280,275640,345920
11/23/2024,Tissa Samarasinghe,Jaffna,Karainagar,Northern,9649,4520,14169,385960,180800,566760
11/24/2024,Tissa Samarasinghe,Jaffna,Karainagar,Northern,3925,6829,10754,157000,273160,430160
11/25/2024,Tissa Samarasinghe,Jaffna,Karainagar,Northern,733,7252,7985,29320,290080,319400
11/26/2024,Tissa Samarasinghe,Jaffna,Karainagar,Northern,7602,5180,12782,304080,207200,511280
11/27/2024,Tissa Samarasinghe,Jaffna,Karainagar,Northern,8798,2129,10927,351920,85160,437080
11/28/2024,Tissa Samarasinghe,Jaffna,Karainagar,Northern,8625,6743,15368,345000,269720,614720
11/29/2024,Tissa Samarasinghe,Jaffna,Karainagar,Northern,4961,5152,10113,198440,206080,404520
11/30/2024,Tissa Samarasinghe,Jaffna,Karainagar,Northern,2744,2857,5601,109760,114280,224040
12/1/2024,Tissa Samarasinghe,Jaffna,Karainagar,Northern,7462,2750,10212,298480,110000,408480
12/2/2024,Tissa Samarasinghe,Jaffna,Karainagar,Northern,2931,2416,5347,117240,96640,213880
12/3/2024,Tissa Samarasinghe,Jaffna,Karainagar,Northern,5930,717,6647,237200,28680,265880
12/4/2024,Tissa Samarasinghe,Jaffna,Karainagar,Northern,2819,3254,6073,112760,130160,242920
12/5/2024,Tissa Samarasinghe,Jaffna,Karainagar,Northern,8371,2342,10713,334840,93680,428520
12/6/2024,Tissa Samarasinghe,Jaffna,Karainagar,Northern,3181,9109,12290,127240,364360,491600
12/7/2024,Tissa Samarasinghe,Jaffna,Karainagar,Northern,7087,8714,15801,283480,348560,632040
12/8/2024,Tissa Samarasinghe,Jaffna,Karainagar,Northern,3796,4763,8559,151840,190520,342360
12/9/2024,Tissa Samarasinghe,Jaffna,Karainagar,Northern,2412,2849,5261,96480,113960,210440
12/10/2024,Tissa Samarasinghe,Jaffna,Karainagar,Northern,8288,910,9198,331520,36400,367920
12/11/2024,Tissa Samarasinghe,Jaffna,Karainagar,Northern,1441,4058,5499,57640,162320,219960
12/12/2024,Tissa Samarasinghe,Jaffna,Karainagar,Northern,3319,4782,8101,132760,191280,324040
12/13/2024,Tissa Samarasinghe,Jaffna,Karainagar,Northern,3817,1940,5757,152680,77600,230280
12/14/2024,Tissa Samarasinghe,Jaffna,Karainagar,Northern,829,6678,7507,33160,267120,300280
12/15/2024,Tissa Samarasinghe,Jaffna,Karainagar,Northern,3553,7105,10658,142120,284200,426320
12/16/2024,Tissa Samarasinghe,Jaffna,Karainagar,Northern,5085,897,5982,203400,35880,239280
12/17/2024,Tissa Samarasinghe,Jaffna,Karainagar,Northern,5763,6496,12259,230520,259840,490360
12/18/2024,Tissa Samarasinghe,Jaffna,Karainagar,Northern,5827,5354,11181,233080,214160,447240
12/19/2024,Tissa Samarasinghe,Jaffna,Karainagar,Northern,6732,2775,9507,269280,111000,380280
12/20/2024,Tissa Samarasinghe,Jaffna,Karainagar,Northern,31,7880,7911,1240,315200,316440
12/21/2024,Tissa Samarasinghe,Jaffna,Karainagar,Northern,2677,2306,4983,107080,92240,199320
12/22/2024,Tissa Samarasinghe,Jaffna,Karainagar,Northern,6159,3028,9187,246360,121120,367480
12/23/2024,Tissa Samarasinghe,Jaffna,Karainagar,Northern,9497,3220,12717,379880,128800,508680
12/24/2024,Tissa Samarasinghe,Jaffna,Karainagar,Northern,6854,3779,10633,274160,151160,425320
12/25/2024,Tissa Samarasinghe,Jaffna,Karainagar,Northern,6205,3767,9972,248200,150680,398880
12/26/2024,Tissa Samarasinghe,Jaffna,Karainagar,Northern,2693,385,3078,107720,15400,123120
12/27/2024,Tissa Samarasinghe,Jaffna,Karainagar,Northern,3908,3421,7329,156320,136840,293160
12/28/2024,Tissa Samarasinghe,Jaffna,Karainagar,Northern,1478,1756,3234,59120,70240,129360
12/29/2024,Tissa Samarasinghe,Jaffna,Karainagar,Northern,4466,6212,10678,178640,248480,427120
12/30/2024,Tissa Samarasinghe,Jaffna,Karainagar,Northern,2615,2951,5566,104600,118040,222640
12/31/2024,Tissa Samarasinghe,Jaffna,Karainagar,Northern,5553,9847,15400,222120,393880,616000
1/1/2025,Tissa Samarasinghe,Jaffna,Karainagar,Northern,5665,1136,6801,226600,45440,272040
1/2/2025,Tissa Samarasinghe,Jaffna,Karainagar,Northern,3729,7459,11188,149160,298360,447520
1/3/2025,Tissa Samarasinghe,Jaffna,Karainagar,Northern,2515,2949,5464,100600,117960,218560
1/4/2025,Tissa Samarasinghe,Jaffna,Karainagar,Northern,586,1704,2290,23440,68160,91600
1/5/2025,Tissa Samarasinghe,Jaffna,Karainagar,Northern,6172,810,6982,246880,32400,279280
1/6/2025,Tissa Samarasinghe,Jaffna,Karainagar,Northern,9311,2599,11910,372440,103960,476400
1/7/2025,Tissa Samarasinghe,Jaffna,Karainagar,Northern,6208,1266,7474,248320,50640,298960
1/8/2025,Tissa Samarasinghe,Jaffna,Karainagar,Northern,7230,2747,9977,289200,109880,399080
1/9/2025,Tissa Samarasinghe,Jaffna,Karainagar,Northern,6176,4748,10924,247040,189920,436960
1/10/2025,Tissa Samarasinghe,Jaffna,Karainagar,Northern,9730,8479,18209,389200,339160,728360
1/11/2025,Tissa Samarasinghe,Jaffna,Karainagar,Northern,6381,4854,11235,255240,194160,449400
1/12/2025,Tissa Samarasinghe,Jaffna,Karainagar,Northern,5605,7610,13215,224200,304400,528600
1/13/2025,Tissa Samarasinghe,Jaffna,Karainagar,Northern,7594,7893,15487,303760,315720,619480
1/14/2025,Tissa Samarasinghe,Jaffna,Karainagar,Northern,3602,308,3910,144080,12320,156400
1/15/2025,Tissa Samarasinghe,Jaffna,Karainagar,Northern,5118,5634,10752,204720,225360,430080
1/16/2025,Tissa Samarasinghe,Jaffna,Karainagar,Northern,8826,6643,15469,353040,265720,618760
1/17/2025,Tissa Samarasinghe,Jaffna,Karainagar,Northern,8668,8204,16872,346720,328160,674880
1/18/2025,Tissa Samarasinghe,Jaffna,Karainagar,Northern,7853,5239,13092,314120,209560,523680
1/19/2025,Tissa Samarasinghe,Jaffna,Karainagar,Northern,9955,4247,14202,398200,169880,568080
1/20/2025,Tissa Samarasinghe,Jaffna,Karainagar,Northern,8984,833,9817,359360,33320,392680
1/21/2025,Tissa Samarasinghe,Jaffna,Karainagar,Northern,8134,651,8785,325360,26040,351400
1/22/2025,Tissa Samarasinghe,Jaffna,Karainagar,Northern,478,3666,4144,19120,146640,165760
1/23/2025,Tissa Samarasinghe,Jaffna,Karainagar,Northern,6869,6381,13250,274760,255240,530000
1/24/2025,Tissa Samarasinghe,Jaffna,Karainagar,Northern,8352,2047,10399,334080,81880,415960
1/25/2025,Tissa Samarasinghe,Jaffna,Karainagar,Northern,9749,2460,12209,389960,98400,488360
1/26/2025,Tissa Samarasinghe,Jaffna,Karainagar,Northern,4345,5979,10324,173800,239160,412960
1/27/2025,Tissa Samarasinghe,Jaffna,Karainagar,Northern,6396,9232,15628,255840,369280,625120
1/28/2025,Tissa Samarasinghe,Jaffna,Karainagar,Northern,4086,9415,13501,163440,376600,540040
1/29/2025,Tissa Samarasinghe,Jaffna,Karainagar,Northern,9754,7348,17102,390160,293920,684080
1/30/2025,Tissa Samarasinghe,Jaffna,Karainagar,Northern,8466,31,8497,338640,1240,339880
1/31/2025,Tissa Samarasinghe,Jaffna,Karainagar,Northern,8995,6977,15972,359800,279080,638880
2/1/2025,Tissa Samarasinghe,Jaffna,Karainagar,Northern,2847,7131,9978,113880,285240,399120
2/2/2025,Tissa Samarasinghe,Jaffna,Karainagar,Northern,9590,3933,13523,383600,157320,540920
2/3/2025,Tissa Samarasinghe,Jaffna,Karainagar,Northern,3421,1702,5123,136840,68080,204920
2/4/2025,Tissa Samarasinghe,Jaffna,Karainagar,Northern,5090,8373,13463,203600,334920,538520
2/5/2025,Tissa Samarasinghe,Jaffna,Karainagar,Northern,8626,3107,11733,345040,124280,469320
2/6/2025,Tissa Samarasinghe,Jaffna,Karainagar,Northern,9304,5627,14931,372160,225080,597240
2/7/2025,Tissa Samarasinghe,Jaffna,Karainagar,Northern,5870,4546,10416,234800,181840,416640
2/8/2025,Tissa Samarasinghe,Jaffna,Karainagar,Northern,5973,4054,10027,238920,162160,401080
2/9/2025,Tissa Samarasinghe,Jaffna,Karainagar,Northern,7392,2461,9853,295680,98440,394120
2/10/2025,Tissa Samarasinghe,Jaffna,Karainagar,Northern,1495,9832,11327,59800,393280,453080
2/11/2025,Tissa Samarasinghe,Jaffna,Karainagar,Northern,5280,2922,8202,211200,116880,328080
2/12/2025,Tissa Samarasinghe,Jaffna,Karainagar,Northern,1213,9442,10655,48520,377680,426200
2/13/2025,Tissa Samarasinghe,Jaffna,Karainagar,Northern,3810,183,3993,152400,7320,159720
2/14/2025,Tissa Samarasinghe,Jaffna,Karainagar,Northern,336,8575,8911,13440,343000,356440
2/15/2025,Tissa Samarasinghe,Jaffna,Karainagar,Northern,9167,3348,12515,366680,133920,500600
2/16/2025,Tissa Samarasinghe,Jaffna,Karainagar,Northern,264,8370,8634,10560,334800,345360
2/17/2025,Tissa Samarasinghe,Jaffna,Karainagar,Northern,2075,2145,4220,83000,85800,168800
2/18/2025,Tissa Samarasinghe,Jaffna,Karainagar,Northern,1333,2660,3993,53320,106400,159720
2/19/2025,Tissa Samarasinghe,Jaffna,Karainagar,Northern,4425,3581,8006,177000,143240,320240
2/20/2025,Tissa Samarasinghe,Jaffna,Karainagar,Northern,4025,1050,5075,161000,42000,203000
2/21/2025,Tissa Samarasinghe,Jaffna,Karainagar,Northern,1718,9387,11105,68720,375480,444200
2/22/2025,Tissa Samarasinghe,Jaffna,Karainagar,Northern,3639,1921,5560,145560,76840,222400
2/23/2025,Tissa Samarasinghe,Jaffna,Karainagar,Northern,5481,124,5605,219240,4960,224200
2/24/2025,Tissa Samarasinghe,Jaffna,Karainagar,Northern,6014,8467,14481,240560,338680,579240
2/25/2025,Tissa Samarasinghe,Jaffna,Karainagar,Northern,9920,5357,15277,396800,214280,611080
2/26/2025,Tissa Samarasinghe,Jaffna,Karainagar,Northern,9360,9086,18446,374400,363440,737840
2/27/2025,Tissa Samarasinghe,Jaffna,Karainagar,Northern,2548,6892,9440,101920,275680,377600
2/28/2025,Tissa Samarasinghe,Jaffna,Karainagar,Northern,2510,5083,7593,100400,203320,303720
3/1/2025,Tissa Samarasinghe,Jaffna,Karainagar,Northern,7340,1634,8974,293600,65360,358960
3/2/2025,Tissa Samarasinghe,Jaffna,Karainagar,Northern,3466,1504,4970,138640,60160,198800
3/3/2025,Tissa Samarasinghe,Jaffna,Karainagar,Northern,7849,2112,9961,313960,84480,398440
3/4/2025,Tissa Samarasinghe,Jaffna,Karainagar,Northern,6807,9630,16437,272280,385200,657480
3/5/2025,Tissa Samarasinghe,Jaffna,Karainagar,Northern,4427,7662,12089,177080,306480,483560
3/6/2025,Tissa Samarasinghe,Jaffna,Karainagar,Northern,8694,6662,15356,347760,266480,614240
3/7/2025,Tissa Samarasinghe,Jaffna,Karainagar,Northern,7183,4310,11493,287320,172400,459720
3/8/2025,Tissa Samarasinghe,Jaffna,Karainagar,Northern,7797,1809,9606,311880,72360,384240
3/9/2025,Tissa Samarasinghe,Jaffna,Karainagar,Northern,3982,3389,7371,159280,135560,294840
3/10/2025,Tissa Samarasinghe,Jaffna,Karainagar,Northern,7563,4828,12391,302520,193120,495640
3/11/2025,Tissa Samarasinghe,Jaffna,Karainagar,Northern,6626,5230,11856,265040,209200,474240
3/12/2025,Tissa Samarasinghe,Jaffna,Karainagar,Northern,3822,9663,13485,152880,386520,539400
3/13/2025,Tissa Samarasinghe,Jaffna,Karainagar,Northern,2169,8363,10532,86760,334520,421280
3/14/2025,Tissa Samarasinghe,Jaffna,Karainagar,Northern,5518,7127,12645,220720,285080,505800
3/15/2025,Tissa Samarasinghe,Jaffna,Karainagar,Northern,5207,5753,10960,208280,230120,438400
3/16/2025,Tissa Samarasinghe,Jaffna,Karainagar,Northern,7544,1687,9231,301760,67480,369240
3/17/2025,Tissa Samarasinghe,Jaffna,Karainagar,Northern,2794,7792,10586,111760,311680,423440
3/18/2025,Tissa Samarasinghe,Jaffna,Karainagar,Northern,2990,2044,5034,119600,81760,201360
3/19/2025,Tissa Samarasinghe,Jaffna,Karainagar,Northern,6694,7368,14062,267760,294720,562480
3/20/2025,Tissa Samarasinghe,Jaffna,Karainagar,Northern,2480,1078,3558,99200,43120,142320
3/21/2025,Tissa Samarasinghe,Jaffna,Karainagar,Northern,83,77,160,3320,3080,6400
3/22/2025,Tissa Samarasinghe,Jaffna,Karainagar,Northern,8059,5078,13137,322360,203120,525480
3/23/2025,Tissa Samarasinghe,Jaffna,Karainagar,Northern,1622,3785,5407,64880,151400,216280
3/25/2024,Niroshan Ranasinghe,Ampara,Pottuvil,Eastern,9802,9911,19713,392080,396440,788520
3/26/2024,Niroshan Ranasinghe,Ampara,Pottuvil,Eastern,5496,6854,12350,219840,274160,494000
3/27/2024,Niroshan Ranasinghe,Ampara,Pottuvil,Eastern,772,597,1369,30880,23880,54760
3/28/2024,Niroshan Ranasinghe,Ampara,Pottuvil,Eastern,9400,4580,13980,376000,183200,559200
3/29/2024,Niroshan Ranasinghe,Ampara,Pottuvil,Eastern,853,8816,9669,34120,352640,386760
3/30/2024,Niroshan Ranasinghe,Ampara,Pottuvil,Eastern,4682,4094,8776,187280,163760,351040
3/31/2024,Niroshan Ranasinghe,Ampara,Pottuvil,Eastern,3022,8542,11564,120880,341680,462560
4/1/2024,Niroshan Ranasinghe,Ampara,Pottuvil,Eastern,3582,6264,9846,143280,250560,393840
4/2/2024,Niroshan Ranasinghe,Ampara,Pottuvil,Eastern,4030,4608,8638,161200,184320,345520
4/3/2024,Niroshan Ranasinghe,Ampara,Pottuvil,Eastern,7479,5190,12669,299160,207600,506760
4/4/2024,Niroshan Ranasinghe,Ampara,Pottuvil,Eastern,7176,9382,16558,287040,375280,662320
4/5/2024,Niroshan Ranasinghe,Ampara,Pottuvil,Eastern,4816,614,5430,192640,24560,217200
4/6/2024,Niroshan Ranasinghe,Ampara,Pottuvil,Eastern,4485,7931,12416,179400,317240,496640
4/7/2024,Niroshan Ranasinghe,Ampara,Pottuvil,Eastern,7304,6221,13525,292160,248840,541000
4/8/2024,Niroshan Ranasinghe,Ampara,Pottuvil,Eastern,9158,8467,17625,366320,338680,705000
4/9/2024,Niroshan Ranasinghe,Ampara,Pottuvil,Eastern,5098,3465,8563,203920,138600,342520
4/10/2024,Niroshan Ranasinghe,Ampara,Pottuvil,Eastern,8439,2780,11219,337560,111200,448760
4/11/2024,Niroshan Ranasinghe,Ampara,Pottuvil,Eastern,887,6273,7160,35480,250920,286400
4/19/2024,Niroshan Ranasinghe,Ampara,Pottuvil,Eastern,5676,6579,12255,227040,263160,490200
4/20/2024,Niroshan Ranasinghe,Ampara,Pottuvil,Eastern,7414,5609,13023,296560,224360,520920
4/21/2024,Niroshan Ranasinghe,Ampara,Pottuvil,Eastern,5685,3836,9521,227400,153440,380840
4/22/2024,Niroshan Ranasinghe,Ampara,Pottuvil,Eastern,3604,8695,12299,144160,347800,491960
4/23/2024,Niroshan Ranasinghe,Ampara,Pottuvil,Eastern,1052,3708,4760,42080,148320,190400
4/24/2024,Niroshan Ranasinghe,Ampara,Pottuvil,Eastern,3204,984,4188,128160,39360,167520
4/25/2024,Niroshan Ranasinghe,Ampara,Pottuvil,Eastern,1529,8550,10079,61160,342000,403160
4/26/2024,Niroshan Ranasinghe,Ampara,Pottuvil,Eastern,4718,5313,10031,188720,212520,401240
4/27/2024,Niroshan Ranasinghe,Ampara,Pottuvil,Eastern,2568,3346,5914,102720,133840,236560
4/28/2024,Niroshan Ranasinghe,Ampara,Pottuvil,Eastern,3135,8748,11883,125400,349920,475320
4/29/2024,Niroshan Ranasinghe,Ampara,Pottuvil,Eastern,3699,317,4016,147960,12680,160640
4/30/2024,Niroshan Ranasinghe,Ampara,Pottuvil,Eastern,2179,3834,6013,87160,153360,240520
5/1/2024,Niroshan Ranasinghe,Ampara,Pottuvil,Eastern,1341,3837,5178,53640,153480,207120
5/2/2024,Niroshan Ranasinghe,Ampara,Pottuvil,Eastern,5228,9260,14488,209120,370400,579520
5/3/2024,Niroshan Ranasinghe,Ampara,Pottuvil,Eastern,2882,4710,7592,115280,188400,303680
5/4/2024,Niroshan Ranasinghe,Ampara,Pottuvil,Eastern,9765,3984,13749,390600,159360,549960
5/5/2024,Niroshan Ranasinghe,Ampara,Pottuvil,Eastern,7418,1525,8943,296720,61000,357720
5/6/2024,Niroshan Ranasinghe,Ampara,Pottuvil,Eastern,5286,6735,12021,211440,269400,480840
5/7/2024,Niroshan Ranasinghe,Ampara,Pottuvil,Eastern,5806,9823,15629,232240,392920,625160
5/8/2024,Niroshan Ranasinghe,Ampara,Pottuvil,Eastern,153,2040,2193,6120,81600,87720
5/9/2024,Niroshan Ranasinghe,Ampara,Pottuvil,Eastern,867,1412,2279,34680,56480,91160
5/10/2024,Niroshan Ranasinghe,Ampara,Pottuvil,Eastern,9867,9772,19639,394680,390880,785560
5/11/2024,Niroshan Ranasinghe,Ampara,Pottuvil,Eastern,6559,633,7192,262360,25320,287680
5/12/2024,Niroshan Ranasinghe,Ampara,Pottuvil,Eastern,5321,603,5924,212840,24120,236960
5/13/2024,Niroshan Ranasinghe,Ampara,Pottuvil,Eastern,3936,8197,12133,157440,327880,485320
5/14/2024,Niroshan Ranasinghe,Ampara,Pottuvil,Eastern,7787,7916,15703,311480,316640,628120
5/15/2024,Niroshan Ranasinghe,Ampara,Pottuvil,Eastern,2622,2159,4781,104880,86360,191240
5/16/2024,Niroshan Ranasinghe,Ampara,Pottuvil,Eastern,1450,6197,7647,58000,247880,305880
5/17/2024,Niroshan Ranasinghe,Ampara,Pottuvil,Eastern,2790,6424,9214,111600,256960,368560
5/18/2024,Niroshan Ranasinghe,Ampara,Pottuvil,Eastern,3804,3252,7056,152160,130080,282240
5/19/2024,Niroshan Ranasinghe,Ampara,Pottuvil,Eastern,7234,2518,9752,289360,100720,390080
5/20/2024,Niroshan Ranasinghe,Ampara,Pottuvil,Eastern,7384,2902,10286,295360,116080,411440
5/21/2024,Niroshan Ranasinghe,Ampara,Pottuvil,Eastern,58,4248,4306,2320,169920,172240
5/22/2024,Niroshan Ranasinghe,Ampara,Pottuvil,Eastern,1481,2655,4136,59240,106200,165440
5/24/2024,Niroshan Ranasinghe,Ampara,Pottuvil,Eastern,7493,4075,11568,299720,163000,462720
5/25/2024,Niroshan Ranasinghe,Ampara,Pottuvil,Eastern,6096,8404,14500,243840,336160,580000
5/26/2024,Niroshan Ranasinghe,Ampara,Pottuvil,Eastern,9130,6822,15952,365200,272880,638080
5/27/2024,Niroshan Ranasinghe,Ampara,Pottuvil,Eastern,2331,9511,11842,93240,380440,473680
5/28/2024,Niroshan Ranasinghe,Ampara,Pottuvil,Eastern,3302,8166,11468,132080,326640,458720
5/29/2024,Niroshan Ranasinghe,Ampara,Pottuvil,Eastern,3776,5568,9344,151040,222720,373760
5/30/2024,Niroshan Ranasinghe,Ampara,Pottuvil,Eastern,2386,9985,12371,95440,399400,494840
5/31/2024,Niroshan Ranasinghe,Ampara,Pottuvil,Eastern,1803,1455,3258,72120,58200,130320
6/1/2024,Niroshan Ranasinghe,Ampara,Pottuvil,Eastern,7904,6078,13982,316160,243120,559280
6/2/2024,Niroshan Ranasinghe,Ampara,Pottuvil,Eastern,4406,5573,9979,176240,222920,399160
6/3/2024,Niroshan Ranasinghe,Ampara,Pottuvil,Eastern,6409,1368,7777,256360,54720,311080
6/4/2024,Niroshan Ranasinghe,Ampara,Pottuvil,Eastern,8823,5235,14058,352920,209400,562320
6/5/2024,Niroshan Ranasinghe,Ampara,Pottuvil,Eastern,187,8614,8801,7480,344560,352040
6/6/2024,Niroshan Ranasinghe,Ampara,Pottuvil,Eastern,6183,8483,14666,247320,339320,586640
6/7/2024,Niroshan Ranasinghe,Ampara,Pottuvil,Eastern,7709,9222,16931,308360,368880,677240
6/8/2024,Niroshan Ranasinghe,Ampara,Pottuvil,Eastern,2126,6668,8794,85040,266720,351760
6/9/2024,Niroshan Ranasinghe,Ampara,Pottuvil,Eastern,4726,35,4761,189040,1400,190440
6/10/2024,Niroshan Ranasinghe,Ampara,Pottuvil,Eastern,7903,3658,11561,316120,146320,462440
6/11/2024,Niroshan Ranasinghe,Ampara,Pottuvil,Eastern,5919,700,6619,236760,28000,264760
6/12/2024,Niroshan Ranasinghe,Ampara,Pottuvil,Eastern,3374,6482,9856,134960,259280,394240
6/13/2024,Niroshan Ranasinghe,Ampara,Pottuvil,Eastern,6903,357,7260,276120,14280,290400
6/14/2024,Niroshan Ranasinghe,Ampara,Pottuvil,Eastern,1934,7266,9200,77360,290640,368000
6/15/2024,Niroshan Ranasinghe,Ampara,Pottuvil,Eastern,2707,5307,8014,108280,212280,320560
6/16/2024,Niroshan Ranasinghe,Ampara,Pottuvil,Eastern,3602,1613,5215,144080,64520,208600
6/17/2024,Niroshan Ranasinghe,Ampara,Pottuvil,Eastern,4680,245,4925,187200,9800,197000
6/18/2024,Niroshan Ranasinghe,Ampara,Pottuvil,Eastern,882,414,1296,35280,16560,51840
6/19/2024,Niroshan Ranasinghe,Ampara,Pottuvil,Eastern,7223,5092,12315,288920,203680,492600
6/20/2024,Niroshan Ranasinghe,Ampara,Pottuvil,Eastern,3613,7446,11059,144520,297840,442360
6/21/2024,Niroshan Ranasinghe,Ampara,Pottuvil,Eastern,2756,5160,7916,110240,206400,316640
6/22/2024,Niroshan Ranasinghe,Ampara,Pottuvil,Eastern,9625,9149,18774,385000,365960,750960
6/23/2024,Niroshan Ranasinghe,Ampara,Pottuvil,Eastern,3964,1452,5416,158560,58080,216640
6/24/2024,Niroshan Ranasinghe,Ampara,Pottuvil,Eastern,4216,2038,6254,168640,81520,250160
6/25/2024,Niroshan Ranasinghe,Ampara,Pottuvil,Eastern,9305,8492,17797,372200,339680,711880
6/26/2024,Niroshan Ranasinghe,Ampara,Pottuvil,Eastern,374,3889,4263,14960,155560,170520
6/27/2024,Niroshan Ranasinghe,Ampara,Pottuvil,Eastern,9503,3242,12745,380120,129680,509800
6/28/2024,Niroshan Ranasinghe,Ampara,Pottuvil,Eastern,9464,5167,14631,378560,206680,585240
6/29/2024,Niroshan Ranasinghe,Ampara,Pottuvil,Eastern,753,9757,10510,30120,390280,420400
6/30/2024,Niroshan Ranasinghe,Ampara,Pottuvil,Eastern,6637,8639,15276,265480,345560,611040
7/1/2024,Niroshan Ranasinghe,Ampara,Pottuvil,Eastern,7795,3536,11331,311800,141440,453240
7/2/2024,Niroshan Ranasinghe,Ampara,Pottuvil,Eastern,6361,5982,12343,254440,239280,493720
7/3/2024,Niroshan Ranasinghe,Ampara,Pottuvil,Eastern,8826,4769,13595,353040,190760,543800
7/4/2024,Niroshan Ranasinghe,Ampara,Pottuvil,Eastern,5275,6722,11997,211000,268880,479880
7/5/2024,Niroshan Ranasinghe,Ampara,Pottuvil,Eastern,5871,5708,11579,234840,228320,463160
7/6/2024,Niroshan Ranasinghe,Ampara,Pottuvil,Eastern,7512,4712,12224,300480,188480,488960
7/7/2024,Niroshan Ranasinghe,Ampara,Pottuvil,Eastern,2825,3882,6707,113000,155280,268280
7/8/2024,Niroshan Ranasinghe,Ampara,Pottuvil,Eastern,9751,2217,11968,390040,88680,478720
7/9/2024,Niroshan Ranasinghe,Ampara,Pottuvil,Eastern,1246,9735,10981,49840,389400,439240
7/10/2024,Niroshan Ranasinghe,Ampara,Pottuvil,Eastern,5328,3531,8859,213120,141240,354360
7/11/2024,Niroshan Ranasinghe,Ampara,Pottuvil,Eastern,8589,8983,17572,343560,359320,702880
7/12/2024,Niroshan Ranasinghe,Ampara,Pottuvil,Eastern,6548,306,6854,261920,12240,274160
7/13/2024,Niroshan Ranasinghe,Ampara,Pottuvil,Eastern,5701,3341,9042,228040,133640,361680
7/14/2024,Niroshan Ranasinghe,Ampara,Pottuvil,Eastern,7248,2746,9994,289920,109840,399760
7/15/2024,Niroshan Ranasinghe,Ampara,Pottuvil,Eastern,2285,3632,5917,91400,145280,236680
7/16/2024,Niroshan Ranasinghe,Ampara,Pottuvil,Eastern,7231,8971,16202,289240,358840,648080
7/17/2024,Niroshan Ranasinghe,Ampara,Pottuvil,Eastern,1569,9679,11248,62760,387160,449920
7/18/2024,Niroshan Ranasinghe,Ampara,Pottuvil,Eastern,9904,2655,12559,396160,106200,502360
7/19/2024,Niroshan Ranasinghe,Ampara,Pottuvil,Eastern,6132,255,6387,245280,10200,255480
7/20/2024,Niroshan Ranasinghe,Ampara,Pottuvil,Eastern,9007,7896,16903,360280,315840,676120
7/21/2024,Niroshan Ranasinghe,Ampara,Pottuvil,Eastern,6780,8843,15623,271200,353720,624920
7/22/2024,Niroshan Ranasinghe,Ampara,Pottuvil,Eastern,6571,423,6994,262840,16920,279760
7/23/2024,Niroshan Ranasinghe,Ampara,Pottuvil,Eastern,244,2324,2568,9760,92960,102720
7/24/2024,Niroshan Ranasinghe,Ampara,Pottuvil,Eastern,5130,4090,9220,205200,163600,368800
7/25/2024,Niroshan Ranasinghe,Ampara,Pottuvil,Eastern,777,1814,2591,31080,72560,103640
7/26/2024,Niroshan Ranasinghe,Ampara,Pottuvil,Eastern,8314,5125,13439,332560,205000,537560
7/27/2024,Niroshan Ranasinghe,Ampara,Pottuvil,Eastern,2116,9477,11593,84640,379080,463720
7/28/2024,Niroshan Ranasinghe,Ampara,Pottuvil,Eastern,4816,7228,12044,192640,289120,481760
7/29/2024,Niroshan Ranasinghe,Ampara,Pottuvil,Eastern,1316,6062,7378,52640,242480,295120
7/30/2024,Niroshan Ranasinghe,Ampara,Pottuvil,Eastern,5255,3823,9078,210200,152920,363120
7/31/2024,Niroshan Ranasinghe,Ampara,Pottuvil,Eastern,2426,5777,8203,97040,231080,328120
8/1/2024,Niroshan Ranasinghe,Ampara,Pottuvil,Eastern,490,4599,5089,19600,183960,203560
8/2/2024,Niroshan Ranasinghe,Ampara,Pottuvil,Eastern,2113,5365,7478,84520,214600,299120
8/3/2024,Niroshan Ranasinghe,Ampara,Pottuvil,Eastern,4600,2339,6939,184000,93560,277560
8/4/2024,Niroshan Ranasinghe,Ampara,Pottuvil,Eastern,9031,7159,16190,361240,286360,647600
8/5/2024,Niroshan Ranasinghe,Ampara,Pottuvil,Eastern,1159,3062,4221,46360,122480,168840
8/6/2024,Niroshan Ranasinghe,Ampara,Pottuvil,Eastern,1012,8414,9426,40480,336560,377040
8/7/2024,Niroshan Ranasinghe,Ampara,Pottuvil,Eastern,7946,1931,9877,317840,77240,395080
8/8/2024,Niroshan Ranasinghe,Ampara,Pottuvil,Eastern,9814,2100,11914,392560,84000,476560
8/9/2024,Niroshan Ranasinghe,Ampara,Pottuvil,Eastern,4249,137,4386,169960,5480,175440
8/10/2024,Niroshan Ranasinghe,Ampara,Pottuvil,Eastern,8084,5210,13294,323360,208400,531760
8/11/2024,Niroshan Ranasinghe,Ampara,Pottuvil,Eastern,7010,7502,14512,280400,300080,580480
8/12/2024,Niroshan Ranasinghe,Ampara,Pottuvil,Eastern,36,9788,9824,1440,391520,392960
8/13/2024,Niroshan Ranasinghe,Ampara,Pottuvil,Eastern,7639,6114,13753,305560,244560,550120
8/14/2024,Niroshan Ranasinghe,Ampara,Pottuvil,Eastern,9139,4566,13705,365560,182640,548200
8/15/2024,Niroshan Ranasinghe,Ampara,Pottuvil,Eastern,6597,4492,11089,263880,179680,443560
8/16/2024,Niroshan Ranasinghe,Ampara,Pottuvil,Eastern,4679,2457,7136,187160,98280,285440
8/17/2024,Niroshan Ranasinghe,Ampara,Pottuvil,Eastern,4001,1525,5526,160040,61000,221040
8/18/2024,Niroshan Ranasinghe,Ampara,Pottuvil,Eastern,3534,4625,8159,141360,185000,326360
8/19/2024,Niroshan Ranasinghe,Ampara,Pottuvil,Eastern,2407,2655,5062,96280,106200,202480
8/20/2024,Niroshan Ranasinghe,Ampara,Pottuvil,Eastern,8846,1235,10081,353840,49400,403240
8/21/2024,Niroshan Ranasinghe,Ampara,Pottuvil,Eastern,309,1143,1452,12360,45720,58080
8/22/2024,Niroshan Ranasinghe,Ampara,Pottuvil,Eastern,7912,1017,8929,316480,40680,357160
8/23/2024,Niroshan Ranasinghe,Ampara,Pottuvil,Eastern,333,8603,8936,13320,344120,357440
8/24/2024,Niroshan Ranasinghe,Ampara,Pottuvil,Eastern,1080,5066,6146,43200,202640,245840
8/25/2024,Niroshan Ranasinghe,Ampara,Pottuvil,Eastern,7656,447,8103,306240,17880,324120
8/26/2024,Niroshan Ranasinghe,Ampara,Pottuvil,Eastern,1959,9457,11416,78360,378280,456640
8/27/2024,Niroshan Ranasinghe,Ampara,Pottuvil,Eastern,8111,6925,15036,324440,277000,601440
8/28/2024,Niroshan Ranasinghe,Ampara,Pottuvil,Eastern,5680,3295,8975,227200,131800,359000
8/29/2024,Niroshan Ranasinghe,Ampara,Pottuvil,Eastern,4593,6277,10870,183720,251080,434800
8/30/2024,Niroshan Ranasinghe,Ampara,Pottuvil,Eastern,2670,8846,11516,106800,353840,460640
8/31/2024,Niroshan Ranasinghe,Ampara,Pottuvil,Eastern,9386,7616,17002,375440,304640,680080
9/1/2024,Niroshan Ranasinghe,Ampara,Pottuvil,Eastern,9411,8849,18260,376440,353960,730400
9/2/2024,Niroshan Ranasinghe,Ampara,Pottuvil,Eastern,2082,8323,10405,83280,332920,416200
9/3/2024,Niroshan Ranasinghe,Ampara,Pottuvil,Eastern,193,8173,8366,7720,326920,334640
9/4/2024,Niroshan Ranasinghe,Ampara,Pottuvil,Eastern,4075,3687,7762,163000,147480,310480
9/5/2024,Niroshan Ranasinghe,Ampara,Pottuvil,Eastern,7780,7931,15711,311200,317240,628440
9/6/2024,Niroshan Ranasinghe,Ampara,Pottuvil,Eastern,7395,1094,8489,295800,43760,339560
9/7/2024,Niroshan Ranasinghe,Ampara,Pottuvil,Eastern,4753,7250,12003,190120,290000,480120
9/8/2024,Niroshan Ranasinghe,Ampara,Pottuvil,Eastern,1317,2213,3530,52680,88520,141200
9/9/2024,Niroshan Ranasinghe,Ampara,Pottuvil,Eastern,8404,3193,11597,336160,127720,463880
9/10/2024,Niroshan Ranasinghe,Ampara,Pottuvil,Eastern,5619,4778,10397,224760,191120,415880
9/11/2024,Niroshan Ranasinghe,Ampara,Pottuvil,Eastern,7404,1017,8421,296160,40680,336840
9/12/2024,Niroshan Ranasinghe,Ampara,Pottuvil,Eastern,7641,1254,8895,305640,50160,355800
9/13/2024,Niroshan Ranasinghe,Ampara,Pottuvil,Eastern,4343,3162,7505,173720,126480,300200
9/14/2024,Niroshan Ranasinghe,Ampara,Pottuvil,Eastern,8944,2447,11391,357760,97880,455640
9/15/2024,Niroshan Ranasinghe,Ampara,Pottuvil,Eastern,1946,5765,7711,77840,230600,308440
9/16/2024,Niroshan Ranasinghe,Ampara,Pottuvil,Eastern,6849,993,7842,273960,39720,313680
9/17/2024,Niroshan Ranasinghe,Ampara,Pottuvil,Eastern,6042,2854,8896,241680,114160,355840
9/18/2024,Niroshan Ranasinghe,Ampara,Pottuvil,Eastern,1330,1438,2768,53200,57520,110720
9/19/2024,Niroshan Ranasinghe,Ampara,Pottuvil,Eastern,3501,8550,12051,140040,342000,482040
9/20/2024,Niroshan Ranasinghe,Ampara,Pottuvil,Eastern,8898,6353,15251,355920,254120,610040
9/21/2024,Niroshan Ranasinghe,Ampara,Pottuvil,Eastern,2457,8398,10855,98280,335920,434200
9/22/2024,Niroshan Ranasinghe,Ampara,Pottuvil,Eastern,1545,6288,7833,61800,251520,313320
9/23/2024,Niroshan Ranasinghe,Ampara,Pottuvil,Eastern,4204,423,4627,168160,16920,185080
9/24/2024,Niroshan Ranasinghe,Ampara,Pottuvil,Eastern,562,6845,7407,22480,273800,296280
9/25/2024,Niroshan Ranasinghe,Ampara,Pottuvil,Eastern,7702,7130,14832,308080,285200,593280
9/26/2024,Niroshan Ranasinghe,Ampara,Pottuvil,Eastern,3973,1461,5434,158920,58440,217360
9/27/2024,Niroshan Ranasinghe,Ampara,Pottuvil,Eastern,6609,2019,8628,264360,80760,345120
9/28/2024,Niroshan Ranasinghe,Ampara,Pottuvil,Eastern,8889,166,9055,355560,6640,362200
9/29/2024,Niroshan Ranasinghe,Ampara,Pottuvil,Eastern,6413,8420,14833,256520,336800,593320
9/30/2024,Niroshan Ranasinghe,Ampara,Pottuvil,Eastern,832,4285,5117,33280,171400,204680
10/1/2024,Niroshan Ranasinghe,Ampara,Pottuvil,Eastern,1500,508,2008,60000,20320,80320
10/2/2024,Niroshan Ranasinghe,Ampara,Pottuvil,Eastern,9468,3162,12630,378720,126480,505200
10/3/2024,Niroshan Ranasinghe,Ampara,Pottuvil,Eastern,9837,2446,12283,393480,97840,491320
10/4/2024,Niroshan Ranasinghe,Ampara,Pottuvil,Eastern,6094,6839,12933,243760,273560,517320
10/5/2024,Niroshan Ranasinghe,Ampara,Pottuvil,Eastern,8570,6920,15490,342800,276800,619600
10/6/2024,Niroshan Ranasinghe,Ampara,Pottuvil,Eastern,949,8805,9754,37960,352200,390160
10/7/2024,Niroshan Ranasinghe,Ampara,Pottuvil,Eastern,3449,7383,10832,137960,295320,433280
10/8/2024,Niroshan Ranasinghe,Ampara,Pottuvil,Eastern,5462,550,6012,218480,22000,240480
10/9/2024,Niroshan Ranasinghe,Ampara,Pottuvil,Eastern,172,31,203,6880,1240,8120
10/10/2024,Niroshan Ranasinghe,Ampara,Pottuvil,Eastern,4185,8867,13052,167400,354680,522080
10/11/2024,Niroshan Ranasinghe,Ampara,Pottuvil,Eastern,3663,7340,11003,146520,293600,440120
10/12/2024,Niroshan Ranasinghe,Ampara,Pottuvil,Eastern,188,8040,8228,7520,321600,329120
10/13/2024,Niroshan Ranasinghe,Ampara,Pottuvil,Eastern,3468,6495,9963,138720,259800,398520
10/14/2024,Niroshan Ranasinghe,Ampara,Pottuvil,Eastern,5149,884,6033,205960,35360,241320
10/15/2024,Niroshan Ranasinghe,Ampara,Pottuvil,Eastern,428,7037,7465,17120,281480,298600
10/16/2024,Niroshan Ranasinghe,Ampara,Pottuvil,Eastern,5421,3438,8859,216840,137520,354360
10/17/2024,Niroshan Ranasinghe,Ampara,Pottuvil,Eastern,6148,9667,15815,245920,386680,632600
10/18/2024,Niroshan Ranasinghe,Ampara,Pottuvil,Eastern,4764,4853,9617,190560,194120,384680
10/19/2024,Niroshan Ranasinghe,Ampara,Pottuvil,Eastern,6269,5862,12131,250760,234480,485240
10/20/2024,Niroshan Ranasinghe,Ampara,Pottuvil,Eastern,4274,9203,13477,170960,368120,539080
10/21/2024,Niroshan Ranasinghe,Ampara,Pottuvil,Eastern,3674,5954,9628,146960,238160,385120
10/22/2024,Niroshan Ranasinghe,Ampara,Pottuvil,Eastern,953,8523,9476,38120,340920,379040
10/23/2024,Niroshan Ranasinghe,Ampara,Pottuvil,Eastern,6601,1228,7829,264040,49120,313160
10/24/2024,Niroshan Ranasinghe,Ampara,Pottuvil,Eastern,3956,7913,11869,158240,316520,474760
10/25/2024,Niroshan Ranasinghe,Ampara,Pottuvil,Eastern,2162,7376,9538,86480,295040,381520
10/26/2024,Niroshan Ranasinghe,Ampara,Pottuvil,Eastern,2474,1832,4306,98960,73280,172240
10/27/2024,Niroshan Ranasinghe,Ampara,Pottuvil,Eastern,234,1449,1683,9360,57960,67320
10/28/2024,Niroshan Ranasinghe,Ampara,Pottuvil,Eastern,8983,1367,10350,359320,54680,414000
10/29/2024,Niroshan Ranasinghe,Ampara,Pottuvil,Eastern,1420,9473,10893,56800,378920,435720
10/30/2024,Niroshan Ranasinghe,Ampara,Pottuvil,Eastern,1068,4860,5928,42720,194400,237120
10/31/2024,Niroshan Ranasinghe,Ampara,Pottuvil,Eastern,1394,1294,2688,55760,51760,107520
11/1/2024,Niroshan Ranasinghe,Ampara,Pottuvil,Eastern,4771,5532,10303,190840,221280,412120
11/2/2024,Niroshan Ranasinghe,Ampara,Pottuvil,Eastern,5039,1530,6569,201560,61200,262760
11/3/2024,Niroshan Ranasinghe,Ampara,Pottuvil,Eastern,7756,740,8496,310240,29600,339840
11/4/2024,Niroshan Ranasinghe,Ampara,Pottuvil,Eastern,2353,122,2475,94120,4880,99000
11/5/2024,Niroshan Ranasinghe,Ampara,Pottuvil,Eastern,9979,1103,11082,399160,44120,443280
11/6/2024,Niroshan Ranasinghe,Ampara,Pottuvil,Eastern,7051,5261,12312,282040,210440,492480
11/7/2024,Niroshan Ranasinghe,Ampara,Pottuvil,Eastern,6344,7794,14138,253760,311760,565520
11/8/2024,Niroshan Ranasinghe,Ampara,Pottuvil,Eastern,7184,7780,14964,287360,311200,598560
11/9/2024,Niroshan Ranasinghe,Ampara,Pottuvil,Eastern,5737,6930,12667,229480,277200,506680
11/10/2024,Niroshan Ranasinghe,Ampara,Pottuvil,Eastern,2082,1447,3529,83280,57880,141160
11/11/2024,Niroshan Ranasinghe,Ampara,Pottuvil,Eastern,6815,641,7456,272600,25640,298240
11/12/2024,Niroshan Ranasinghe,Ampara,Pottuvil,Eastern,414,8594,9008,16560,343760,360320
11/13/2024,Niroshan Ranasinghe,Ampara,Pottuvil,Eastern,3637,9901,13538,145480,396040,541520
11/14/2024,Niroshan Ranasinghe,Ampara,Pottuvil,Eastern,6616,1539,8155,264640,61560,326200
11/15/2024,Niroshan Ranasinghe,Ampara,Pottuvil,Eastern,3628,330,3958,145120,13200,158320
11/16/2024,Niroshan Ranasinghe,Ampara,Pottuvil,Eastern,6148,728,6876,245920,29120,275040
11/17/2024,Niroshan Ranasinghe,Ampara,Pottuvil,Eastern,1700,5980,7680,68000,239200,307200
11/18/2024,Niroshan Ranasinghe,Ampara,Pottuvil,Eastern,7625,1143,8768,305000,45720,350720
11/19/2024,Niroshan Ranasinghe,Ampara,Pottuvil,Eastern,3381,3835,7216,135240,153400,288640
11/20/2024,Niroshan Ranasinghe,Ampara,Pottuvil,Eastern,7935,7309,15244,317400,292360,609760
11/21/2024,Niroshan Ranasinghe,Ampara,Pottuvil,Eastern,565,9596,10161,22600,383840,406440
11/22/2024,Niroshan Ranasinghe,Ampara,Pottuvil,Eastern,7875,6720,14595,315000,268800,583800
11/23/2024,Niroshan Ranasinghe,Ampara,Pottuvil,Eastern,1273,8407,9680,50920,336280,387200
11/24/2024,Niroshan Ranasinghe,Ampara,Pottuvil,Eastern,5527,4547,10074,221080,181880,402960
11/25/2024,Niroshan Ranasinghe,Ampara,Pottuvil,Eastern,8145,3699,11844,325800,147960,473760
11/26/2024,Niroshan Ranasinghe,Ampara,Pottuvil,Eastern,9732,9993,19725,389280,399720,789000
11/27/2024,Niroshan Ranasinghe,Ampara,Pottuvil,Eastern,2354,6888,9242,94160,275520,369680
11/28/2024,Niroshan Ranasinghe,Ampara,Pottuvil,Eastern,1898,4879,6777,75920,195160,271080
11/29/2024,Niroshan Ranasinghe,Ampara,Pottuvil,Eastern,1906,5918,7824,76240,236720,312960
11/30/2024,Niroshan Ranasinghe,Ampara,Pottuvil,Eastern,4787,4569,9356,191480,182760,374240
12/1/2024,Niroshan Ranasinghe,Ampara,Pottuvil,Eastern,2024,2869,4893,80960,114760,195720
12/2/2024,Niroshan Ranasinghe,Ampara,Pottuvil,Eastern,8801,4454,13255,352040,178160,530200
12/3/2024,Niroshan Ranasinghe,Ampara,Pottuvil,Eastern,1816,5922,7738,72640,236880,309520
12/4/2024,Niroshan Ranasinghe,Ampara,Pottuvil,Eastern,8603,2616,11219,344120,104640,448760
12/5/2024,Niroshan Ranasinghe,Ampara,Pottuvil,Eastern,6769,2412,9181,270760,96480,367240
12/6/2024,Niroshan Ranasinghe,Ampara,Pottuvil,Eastern,5053,2433,7486,202120,97320,299440
12/7/2024,Niroshan Ranasinghe,Ampara,Pottuvil,Eastern,6213,176,6389,248520,7040,255560
12/8/2024,Niroshan Ranasinghe,Ampara,Pottuvil,Eastern,5469,4832,10301,218760,193280,412040
12/9/2024,Niroshan Ranasinghe,Ampara,Pottuvil,Eastern,9278,3562,12840,371120,142480,513600
12/10/2024,Niroshan Ranasinghe,Ampara,Pottuvil,Eastern,3154,5418,8572,126160,216720,342880
12/11/2024,Niroshan Ranasinghe,Ampara,Pottuvil,Eastern,1503,9928,11431,60120,397120,457240
12/12/2024,Niroshan Ranasinghe,Ampara,Pottuvil,Eastern,239,1681,1920,9560,67240,76800
12/13/2024,Niroshan Ranasinghe,Ampara,Pottuvil,Eastern,3404,5489,8893,136160,219560,355720
12/14/2024,Niroshan Ranasinghe,Ampara,Pottuvil,Eastern,9973,7475,17448,398920,299000,697920
12/15/2024,Niroshan Ranasinghe,Ampara,Pottuvil,Eastern,7833,6635,14468,313320,265400,578720
12/16/2024,Niroshan Ranasinghe,Ampara,Pottuvil,Eastern,8880,5838,14718,355200,233520,588720
12/17/2024,Niroshan Ranasinghe,Ampara,Pottuvil,Eastern,9138,6750,15888,365520,270000,635520
12/18/2024,Niroshan Ranasinghe,Ampara,Pottuvil,Eastern,9669,5429,15098,386760,217160,603920
12/19/2024,Niroshan Ranasinghe,Ampara,Pottuvil,Eastern,7154,3920,11074,286160,156800,442960
12/20/2024,Niroshan Ranasinghe,Ampara,Pottuvil,Eastern,6252,3722,9974,250080,148880,398960
12/21/2024,Niroshan Ranasinghe,Ampara,Pottuvil,Eastern,847,9385,10232,33880,375400,409280
12/22/2024,Niroshan Ranasinghe,Ampara,Pottuvil,Eastern,9178,6350,15528,367120,254000,621120
12/23/2024,Niroshan Ranasinghe,Ampara,Pottuvil,Eastern,6840,4316,11156,273600,172640,446240
12/24/2024,Niroshan Ranasinghe,Ampara,Pottuvil,Eastern,9537,6542,16079,381480,261680,643160
12/25/2024,Niroshan Ranasinghe,Ampara,Pottuvil,Eastern,9789,3472,13261,391560,138880,530440
12/26/2024,Niroshan Ranasinghe,Ampara,Pottuvil,Eastern,2339,454,2793,93560,18160,111720
12/27/2024,Niroshan Ranasinghe,Ampara,Pottuvil,Eastern,812,3163,3975,32480,126520,159000
12/28/2024,Niroshan Ranasinghe,Ampara,Pottuvil,Eastern,6140,4335,10475,245600,173400,419000
12/29/2024,Niroshan Ranasinghe,Ampara,Pottuvil,Eastern,73,6310,6383,2920,252400,255320
12/30/2024,Niroshan Ranasinghe,Ampara,Pottuvil,Eastern,2911,1985,4896,116440,79400,195840
12/31/2024,Niroshan Ranasinghe,Ampara,Pottuvil,Eastern,8840,696,9536,353600,27840,381440
1/1/2025,Niroshan Ranasinghe,Ampara,Pottuvil,Eastern,2099,2750,4849,83960,110000,193960
1/2/2025,Niroshan Ranasinghe,Ampara,Pottuvil,Eastern,9111,9604,18715,364440,384160,748600
1/3/2025,Niroshan Ranasinghe,Ampara,Pottuvil,Eastern,4788,9485,14273,191520,379400,570920
1/4/2025,Niroshan Ranasinghe,Ampara,Pottuvil,Eastern,222,8656,8878,8880,346240,355120
1/5/2025,Niroshan Ranasinghe,Ampara,Pottuvil,Eastern,9894,63,9957,395760,2520,398280
1/6/2025,Niroshan Ranasinghe,Ampara,Pottuvil,Eastern,3303,6399,9702,132120,255960,388080
1/7/2025,Niroshan Ranasinghe,Ampara,Pottuvil,Eastern,3731,6294,10025,149240,251760,401000
1/8/2025,Niroshan Ranasinghe,Ampara,Pottuvil,Eastern,9089,1936,11025,363560,77440,441000
1/9/2025,Niroshan Ranasinghe,Ampara,Pottuvil,Eastern,2950,814,3764,118000,32560,150560
1/10/2025,Niroshan Ranasinghe,Ampara,Pottuvil,Eastern,5228,3747,8975,209120,149880,359000
1/11/2025,Niroshan Ranasinghe,Ampara,Pottuvil,Eastern,7752,2302,10054,310080,92080,402160
1/12/2025,Niroshan Ranasinghe,Ampara,Pottuvil,Eastern,7868,1577,9445,314720,63080,377800
1/13/2025,Niroshan Ranasinghe,Ampara,Pottuvil,Eastern,2125,1315,3440,85000,52600,137600
1/14/2025,Niroshan Ranasinghe,Ampara,Pottuvil,Eastern,5678,3398,9076,227120,135920,363040
1/15/2025,Niroshan Ranasinghe,Ampara,Pottuvil,Eastern,2991,1586,4577,119640,63440,183080
1/16/2025,Niroshan Ranasinghe,Ampara,Pottuvil,Eastern,1428,1182,2610,57120,47280,104400
1/17/2025,Niroshan Ranasinghe,Ampara,Pottuvil,Eastern,6073,5172,11245,242920,206880,449800
1/18/2025,Niroshan Ranasinghe,Ampara,Pottuvil,Eastern,1549,2414,3963,61960,96560,158520
1/19/2025,Niroshan Ranasinghe,Ampara,Pottuvil,Eastern,8801,31,8832,352040,1240,353280
1/20/2025,Niroshan Ranasinghe,Ampara,Pottuvil,Eastern,2781,4024,6805,111240,160960,272200
1/21/2025,Niroshan Ranasinghe,Ampara,Pottuvil,Eastern,9110,7396,16506,364400,295840,660240
1/22/2025,Niroshan Ranasinghe,Ampara,Pottuvil,Eastern,2868,5670,8538,114720,226800,341520
1/23/2025,Niroshan Ranasinghe,Ampara,Pottuvil,Eastern,3146,5558,8704,125840,222320,348160
1/24/2025,Niroshan Ranasinghe,Ampara,Pottuvil,Eastern,5927,7094,13021,237080,283760,520840
1/25/2025,Niroshan Ranasinghe,Ampara,Pottuvil,Eastern,4119,1002,5121,164760,40080,204840
1/26/2025,Niroshan Ranasinghe,Ampara,Pottuvil,Eastern,8741,3666,12407,349640,146640,496280
1/27/2025,Niroshan Ranasinghe,Ampara,Pottuvil,Eastern,6139,4027,10166,245560,161080,406640
1/28/2025,Niroshan Ranasinghe,Ampara,Pottuvil,Eastern,6627,2584,9211,265080,103360,368440
1/29/2025,Niroshan Ranasinghe,Ampara,Pottuvil,Eastern,8304,1712,10016,332160,68480,400640
1/30/2025,Niroshan Ranasinghe,Ampara,Pottuvil,Eastern,816,4081,4897,32640,163240,195880
1/31/2025,Niroshan Ranasinghe,Ampara,Pottuvil,Eastern,2471,4913,7384,98840,196520,295360
2/1/2025,Niroshan Ranasinghe,Ampara,Pottuvil,Eastern,4983,5670,10653,199320,226800,426120
2/2/2025,Niroshan Ranasinghe,Ampara,Pottuvil,Eastern,7430,4644,12074,297200,185760,482960
2/3/2025,Niroshan Ranasinghe,Ampara,Pottuvil,Eastern,191,9303,9494,7640,372120,379760
2/4/2025,Niroshan Ranasinghe,Ampara,Pottuvil,Eastern,330,8562,8892,13200,342480,355680
2/5/2025,Niroshan Ranasinghe,Ampara,Pottuvil,Eastern,6051,2732,8783,242040,109280,351320
2/6/2025,Niroshan Ranasinghe,Ampara,Pottuvil,Eastern,1631,1378,3009,65240,55120,120360
2/7/2025,Niroshan Ranasinghe,Ampara,Pottuvil,Eastern,807,4699,5506,32280,187960,220240
2/8/2025,Niroshan Ranasinghe,Ampara,Pottuvil,Eastern,6246,9285,15531,249840,371400,621240
2/9/2025,Niroshan Ranasinghe,Ampara,Pottuvil,Eastern,9033,3273,12306,361320,130920,492240
2/10/2025,Niroshan Ranasinghe,Ampara,Pottuvil,Eastern,675,8685,9360,27000,347400,374400
2/11/2025,Niroshan Ranasinghe,Ampara,Pottuvil,Eastern,2054,3921,5975,82160,156840,239000
2/12/2025,Niroshan Ranasinghe,Ampara,Pottuvil,Eastern,6251,4760,11011,250040,190400,440440
2/13/2025,Niroshan Ranasinghe,Ampara,Pottuvil,Eastern,8201,1613,9814,328040,64520,392560
2/14/2025,Niroshan Ranasinghe,Ampara,Pottuvil,Eastern,3498,8002,11500,139920,320080,460000
2/15/2025,Niroshan Ranasinghe,Ampara,Pottuvil,Eastern,8319,6957,15276,332760,278280,611040
2/16/2025,Niroshan Ranasinghe,Ampara,Pottuvil,Eastern,6523,5614,12137,260920,224560,485480
2/17/2025,Niroshan Ranasinghe,Ampara,Pottuvil,Eastern,2366,4856,7222,94640,194240,288880
2/18/2025,Niroshan Ranasinghe,Ampara,Pottuvil,Eastern,9456,4045,13501,378240,161800,540040
2/19/2025,Niroshan Ranasinghe,Ampara,Pottuvil,Eastern,1460,8802,10262,58400,352080,410480
2/20/2025,Niroshan Ranasinghe,Ampara,Pottuvil,Eastern,8878,8975,17853,355120,359000,714120
2/21/2025,Niroshan Ranasinghe,Ampara,Pottuvil,Eastern,4648,134,4782,185920,5360,191280
2/22/2025,Niroshan Ranasinghe,Ampara,Pottuvil,Eastern,4145,2956,7101,165800,118240,284040
2/23/2025,Niroshan Ranasinghe,Ampara,Pottuvil,Eastern,1158,3828,4986,46320,153120,199440
2/24/2025,Niroshan Ranasinghe,Ampara,Pottuvil,Eastern,923,9582,10505,36920,383280,420200
2/25/2025,Niroshan Ranasinghe,Ampara,Pottuvil,Eastern,3570,542,4112,142800,21680,164480
2/26/2025,Niroshan Ranasinghe,Ampara,Pottuvil,Eastern,9444,1795,11239,377760,71800,449560
2/27/2025,Niroshan Ranasinghe,Ampara,Pottuvil,Eastern,3351,7371,10722,134040,294840,428880
2/28/2025,Niroshan Ranasinghe,Ampara,Pottuvil,Eastern,8395,1003,9398,335800,40120,375920
3/1/2025,Niroshan Ranasinghe,Ampara,Pottuvil,Eastern,5151,7318,12469,206040,292720,498760
3/2/2025,Niroshan Ranasinghe,Ampara,Pottuvil,Eastern,9056,2378,11434,362240,95120,457360
3/3/2025,Niroshan Ranasinghe,Ampara,Pottuvil,Eastern,6623,1892,8515,264920,75680,340600
3/4/2025,Niroshan Ranasinghe,Ampara,Pottuvil,Eastern,8467,9976,18443,338680,399040,737720
3/5/2025,Niroshan Ranasinghe,Ampara,Pottuvil,Eastern,5415,8980,14395,216600,359200,575800
3/6/2025,Niroshan Ranasinghe,Ampara,Pottuvil,Eastern,8822,6917,15739,352880,276680,629560
3/7/2025,Niroshan Ranasinghe,Ampara,Pottuvil,Eastern,6884,6712,13596,275360,268480,543840
3/8/2025,Niroshan Ranasinghe,Ampara,Pottuvil,Eastern,9084,7567,16651,363360,302680,666040
3/9/2025,Niroshan Ranasinghe,Ampara,Pottuvil,Eastern,7406,6212,13618,296240,248480,544720
3/10/2025,Niroshan Ranasinghe,Ampara,Pottuvil,Eastern,7280,5342,12622,291200,213680,504880
3/11/2025,Niroshan Ranasinghe,Ampara,Pottuvil,Eastern,8387,2909,11296,335480,116360,451840
3/12/2025,Niroshan Ranasinghe,Ampara,Pottuvil,Eastern,6379,566,6945,255160,22640,277800
3/13/2025,Niroshan Ranasinghe,Ampara,Pottuvil,Eastern,9749,4035,13784,389960,161400,551360
3/14/2025,Niroshan Ranasinghe,Ampara,Pottuvil,Eastern,9059,1797,10856,362360,71880,434240
3/15/2025,Niroshan Ranasinghe,Ampara,Pottuvil,Eastern,8425,9486,17911,337000,379440,716440
3/16/2025,Niroshan Ranasinghe,Ampara,Pottuvil,Eastern,6657,418,7075,266280,16720,283000
3/17/2025,Niroshan Ranasinghe,Ampara,Pottuvil,Eastern,2540,2781,5321,101600,111240,212840
3/18/2025,Niroshan Ranasinghe,Ampara,Pottuvil,Eastern,7865,7222,15087,314600,288880,603480
3/19/2025,Niroshan Ranasinghe,Ampara,Pottuvil,Eastern,1276,3781,5057,51040,151240,202280
3/20/2025,Niroshan Ranasinghe,Ampara,Pottuvil,Eastern,5301,6947,12248,212040,277880,489920
3/21/2025,Niroshan Ranasinghe,Ampara,Pottuvil,Eastern,7767,9711,17478,310680,388440,699120
3/22/2025,Niroshan Ranasinghe,Ampara,Pottuvil,Eastern,6353,4975,11328,254120,199000,453120
3/23/2025,Niroshan Ranasinghe,Ampara,Pottuvil,Eastern,4221,1150,5371,168840,46000,214840
3/25/2024,Dulani Aravinda,Moneragala,Bibile,Uva,2334,2996,5330,93360,119840,213200
3/26/2024,Dulani Aravinda,Moneragala,Bibile,Uva,6053,5627,11680,242120,225080,467200
3/27/2024,Dulani Aravinda,Moneragala,Bibile,Uva,8055,5647,13702,322200,225880,548080
3/28/2024,Dulani Aravinda,Moneragala,Bibile,Uva,3126,1602,4728,125040,64080,189120
3/29/2024,Dulani Aravinda,Moneragala,Bibile,Uva,2148,9740,11888,85920,389600,475520
3/30/2024,Dulani Aravinda,Moneragala,Bibile,Uva,8964,1780,10744,358560,71200,429760
3/31/2024,Dulani Aravinda,Moneragala,Bibile,Uva,9657,1376,11033,386280,55040,441320
4/1/2024,Dulani Aravinda,Moneragala,Bibile,Uva,992,9030,10022,39680,361200,400880
4/2/2024,Dulani Aravinda,Moneragala,Bibile,Uva,4391,220,4611,175640,8800,184440
4/3/2024,Dulani Aravinda,Moneragala,Bibile,Uva,9220,7713,16933,368800,308520,677320
4/4/2024,Dulani Aravinda,Moneragala,Bibile,Uva,1397,4992,6389,55880,199680,255560
4/5/2024,Dulani Aravinda,Moneragala,Bibile,Uva,3508,2719,6227,140320,108760,249080
4/6/2024,Dulani Aravinda,Moneragala,Bibile,Uva,6046,4927,10973,241840,197080,438920
4/7/2024,Dulani Aravinda,Moneragala,Bibile,Uva,174,5485,5659,6960,219400,226360
4/8/2024,Dulani Aravinda,Moneragala,Bibile,Uva,5475,4734,10209,219000,189360,408360
4/9/2024,Dulani Aravinda,Moneragala,Bibile,Uva,1824,3486,5310,72960,139440,212400
4/10/2024,Dulani Aravinda,Moneragala,Bibile,Uva,6154,1752,7906,246160,70080,316240
4/11/2024,Dulani Aravinda,Moneragala,Bibile,Uva,980,4407,5387,39200,176280,215480
4/19/2024,Dulani Aravinda,Moneragala,Bibile,Uva,4101,8981,13082,164040,359240,523280
4/20/2024,Dulani Aravinda,Moneragala,Bibile,Uva,6616,7146,13762,264640,285840,550480
4/21/2024,Dulani Aravinda,Moneragala,Bibile,Uva,9288,3593,12881,371520,143720,515240
4/22/2024,Dulani Aravinda,Moneragala,Bibile,Uva,6731,9530,16261,269240,381200,650440
4/23/2024,Dulani Aravinda,Moneragala,Bibile,Uva,6368,8891,15259,254720,355640,610360
4/24/2024,Dulani Aravinda,Moneragala,Bibile,Uva,4329,4105,8434,173160,164200,337360
4/25/2024,Dulani Aravinda,Moneragala,Bibile,Uva,1319,2936,4255,52760,117440,170200
4/26/2024,Dulani Aravinda,Moneragala,Bibile,Uva,989,8908,9897,39560,356320,395880
4/27/2024,Dulani Aravinda,Moneragala,Bibile,Uva,4656,2149,6805,186240,85960,272200
4/28/2024,Dulani Aravinda,Moneragala,Bibile,Uva,8335,4728,13063,333400,189120,522520
4/29/2024,Dulani Aravinda,Moneragala,Bibile,Uva,1898,8589,10487,75920,343560,419480
4/30/2024,Dulani Aravinda,Moneragala,Bibile,Uva,6765,1272,8037,270600,50880,321480
5/1/2024,Dulani Aravinda,Moneragala,Bibile,Uva,9860,1702,11562,394400,68080,462480
5/2/2024,Dulani Aravinda,Moneragala,Bibile,Uva,1429,4190,5619,57160,167600,224760
5/3/2024,Dulani Aravinda,Moneragala,Bibile,Uva,9952,9832,19784,398080,393280,791360
5/4/2024,Dulani Aravinda,Moneragala,Bibile,Uva,2525,4304,6829,101000,172160,273160
5/5/2024,Dulani Aravinda,Moneragala,Bibile,Uva,9560,7437,16997,382400,297480,679880
5/6/2024,Dulani Aravinda,Moneragala,Bibile,Uva,2884,6405,9289,115360,256200,371560
5/7/2024,Dulani Aravinda,Moneragala,Bibile,Uva,1790,8423,10213,71600,336920,408520
5/8/2024,Dulani Aravinda,Moneragala,Bibile,Uva,575,742,1317,23000,29680,52680
5/9/2024,Dulani Aravinda,Moneragala,Bibile,Uva,1844,3556,5400,73760,142240,216000
5/10/2024,Dulani Aravinda,Moneragala,Bibile,Uva,1630,5027,6657,65200,201080,266280
5/11/2024,Dulani Aravinda,Moneragala,Bibile,Uva,5874,455,6329,234960,18200,253160
5/12/2024,Dulani Aravinda,Moneragala,Bibile,Uva,2562,4035,6597,102480,161400,263880
5/13/2024,Dulani Aravinda,Moneragala,Bibile,Uva,742,3646,4388,29680,145840,175520
5/14/2024,Dulani Aravinda,Moneragala,Bibile,Uva,6288,6656,12944,251520,266240,517760
5/15/2024,Dulani Aravinda,Moneragala,Bibile,Uva,8140,2729,10869,325600,109160,434760
5/16/2024,Dulani Aravinda,Moneragala,Bibile,Uva,6516,3766,10282,260640,150640,411280
5/17/2024,Dulani Aravinda,Moneragala,Bibile,Uva,332,3984,4316,13280,159360,172640
5/18/2024,Dulani Aravinda,Moneragala,Bibile,Uva,3458,5826,9284,138320,233040,371360
5/19/2024,Dulani Aravinda,Moneragala,Bibile,Uva,1011,5891,6902,40440,235640,276080
5/20/2024,Dulani Aravinda,Moneragala,Bibile,Uva,6422,2937,9359,256880,117480,374360
5/21/2024,Dulani Aravinda,Moneragala,Bibile,Uva,2002,895,2897,80080,35800,115880
5/22/2024,Dulani Aravinda,Moneragala,Bibile,Uva,9946,8088,18034,397840,323520,721360
5/24/2024,Dulani Aravinda,Moneragala,Bibile,Uva,2272,7815,10087,90880,312600,403480
5/25/2024,Dulani Aravinda,Moneragala,Bibile,Uva,1657,5492,7149,66280,219680,285960
5/26/2024,Dulani Aravinda,Moneragala,Bibile,Uva,7039,6419,13458,281560,256760,538320
5/27/2024,Dulani Aravinda,Moneragala,Bibile,Uva,3628,1410,5038,145120,56400,201520
5/28/2024,Dulani Aravinda,Moneragala,Bibile,Uva,9173,5205,14378,366920,208200,575120
5/29/2024,Dulani Aravinda,Moneragala,Bibile,Uva,3912,3955,7867,156480,158200,314680
5/30/2024,Dulani Aravinda,Moneragala,Bibile,Uva,2725,5549,8274,109000,221960,330960
5/31/2024,Dulani Aravinda,Moneragala,Bibile,Uva,2526,9837,12363,101040,393480,494520
6/1/2024,Dulani Aravinda,Moneragala,Bibile,Uva,5413,7080,12493,216520,283200,499720
6/2/2024,Dulani Aravinda,Moneragala,Bibile,Uva,4383,3206,7589,175320,128240,303560
6/3/2024,Dulani Aravinda,Moneragala,Bibile,Uva,3203,4372,7575,128120,174880,303000
6/4/2024,Dulani Aravinda,Moneragala,Bibile,Uva,4201,5880,10081,168040,235200,403240
6/5/2024,Dulani Aravinda,Moneragala,Bibile,Uva,9295,1176,10471,371800,47040,418840
6/6/2024,Dulani Aravinda,Moneragala,Bibile,Uva,7116,6998,14114,284640,279920,564560
6/7/2024,Dulani Aravinda,Moneragala,Bibile,Uva,6688,4093,10781,267520,163720,431240
6/8/2024,Dulani Aravinda,Moneragala,Bibile,Uva,3941,3268,7209,157640,130720,288360
6/9/2024,Dulani Aravinda,Moneragala,Bibile,Uva,8581,7931,16512,343240,317240,660480
6/10/2024,Dulani Aravinda,Moneragala,Bibile,Uva,7265,9439,16704,290600,377560,668160
6/11/2024,Dulani Aravinda,Moneragala,Bibile,Uva,8806,816,9622,352240,32640,384880
6/12/2024,Dulani Aravinda,Moneragala,Bibile,Uva,5782,615,6397,231280,24600,255880
6/13/2024,Dulani Aravinda,Moneragala,Bibile,Uva,3724,2315,6039,148960,92600,241560
6/14/2024,Dulani Aravinda,Moneragala,Bibile,Uva,1458,8764,10222,58320,350560,408880
6/15/2024,Dulani Aravinda,Moneragala,Bibile,Uva,6046,8135,14181,241840,325400,567240
6/16/2024,Dulani Aravinda,Moneragala,Bibile,Uva,6338,1974,8312,253520,78960,332480
6/17/2024,Dulani Aravinda,Moneragala,Bibile,Uva,3869,7806,11675,154760,312240,467000
6/18/2024,Dulani Aravinda,Moneragala,Bibile,Uva,4547,682,5229,181880,27280,209160
6/19/2024,Dulani Aravinda,Moneragala,Bibile,Uva,3628,7229,10857,145120,289160,434280
6/20/2024,Dulani Aravinda,Moneragala,Bibile,Uva,3775,1988,5763,151000,79520,230520
6/21/2024,Dulani Aravinda,Moneragala,Bibile,Uva,875,1652,2527,35000,66080,101080
6/22/2024,Dulani Aravinda,Moneragala,Bibile,Uva,3886,9487,13373,155440,379480,534920
6/23/2024,Dulani Aravinda,Moneragala,Bibile,Uva,7228,7424,14652,289120,296960,586080
6/24/2024,Dulani Aravinda,Moneragala,Bibile,Uva,3448,2250,5698,137920,90000,227920
6/25/2024,Dulani Aravinda,Moneragala,Bibile,Uva,1010,2554,3564,40400,102160,142560
6/26/2024,Dulani Aravinda,Moneragala,Bibile,Uva,9563,4050,13613,382520,162000,544520
6/27/2024,Dulani Aravinda,Moneragala,Bibile,Uva,9953,1572,11525,398120,62880,461000
6/28/2024,Dulani Aravinda,Moneragala,Bibile,Uva,867,6199,7066,34680,247960,282640
6/29/2024,Dulani Aravinda,Moneragala,Bibile,Uva,965,4662,5627,38600,186480,225080
6/30/2024,Dulani Aravinda,Moneragala,Bibile,Uva,1489,8241,9730,59560,329640,389200
7/1/2024,Dulani Aravinda,Moneragala,Bibile,Uva,6631,4721,11352,265240,188840,454080
7/2/2024,Dulani Aravinda,Moneragala,Bibile,Uva,176,480,656,7040,19200,26240
7/3/2024,Dulani Aravinda,Moneragala,Bibile,Uva,2659,2834,5493,106360,113360,219720
7/4/2024,Dulani Aravinda,Moneragala,Bibile,Uva,3171,4270,7441,126840,170800,297640
7/5/2024,Dulani Aravinda,Moneragala,Bibile,Uva,8022,8209,16231,320880,328360,649240
7/6/2024,Dulani Aravinda,Moneragala,Bibile,Uva,5987,2183,8170,239480,87320,326800
7/7/2024,Dulani Aravinda,Moneragala,Bibile,Uva,3530,4390,7920,141200,175600,316800
7/8/2024,Dulani Aravinda,Moneragala,Bibile,Uva,4207,9423,13630,168280,376920,545200
7/9/2024,Dulani Aravinda,Moneragala,Bibile,Uva,8018,5904,13922,320720,236160,556880
7/10/2024,Dulani Aravinda,Moneragala,Bibile,Uva,5337,1814,7151,213480,72560,286040
7/11/2024,Dulani Aravinda,Moneragala,Bibile,Uva,1678,6764,8442,67120,270560,337680
7/12/2024,Dulani Aravinda,Moneragala,Bibile,Uva,7654,5525,13179,306160,221000,527160
7/13/2024,Dulani Aravinda,Moneragala,Bibile,Uva,1020,2845,3865,40800,113800,154600
7/14/2024,Dulani Aravinda,Moneragala,Bibile,Uva,9172,1301,10473,366880,52040,418920
7/15/2024,Dulani Aravinda,Moneragala,Bibile,Uva,9366,8504,17870,374640,340160,714800
7/16/2024,Dulani Aravinda,Moneragala,Bibile,Uva,7273,5192,12465,290920,207680,498600
7/17/2024,Dulani Aravinda,Moneragala,Bibile,Uva,2707,7146,9853,108280,285840,394120
7/18/2024,Dulani Aravinda,Moneragala,Bibile,Uva,7386,9467,16853,295440,378680,674120
7/19/2024,Dulani Aravinda,Moneragala,Bibile,Uva,5003,4215,9218,200120,168600,368720
7/20/2024,Dulani Aravinda,Moneragala,Bibile,Uva,8717,7830,16547,348680,313200,661880
7/21/2024,Dulani Aravinda,Moneragala,Bibile,Uva,5472,3590,9062,218880,143600,362480
7/22/2024,Dulani Aravinda,Moneragala,Bibile,Uva,5040,7617,12657,201600,304680,506280
7/23/2024,Dulani Aravinda,Moneragala,Bibile,Uva,7777,7082,14859,311080,283280,594360
7/24/2024,Dulani Aravinda,Moneragala,Bibile,Uva,3297,8426,11723,131880,337040,468920
7/25/2024,Dulani Aravinda,Moneragala,Bibile,Uva,4331,2547,6878,173240,101880,275120
7/26/2024,Dulani Aravinda,Moneragala,Bibile,Uva,6703,8557,15260,268120,342280,610400
7/27/2024,Dulani Aravinda,Moneragala,Bibile,Uva,5182,4735,9917,207280,189400,396680
7/28/2024,Dulani Aravinda,Moneragala,Bibile,Uva,6364,6298,12662,254560,251920,506480
7/29/2024,Dulani Aravinda,Moneragala,Bibile,Uva,7809,2035,9844,312360,81400,393760
7/30/2024,Dulani Aravinda,Moneragala,Bibile,Uva,5824,8758,14582,232960,350320,583280
7/31/2024,Dulani Aravinda,Moneragala,Bibile,Uva,6207,4390,10597,248280,175600,423880
8/1/2024,Dulani Aravinda,Moneragala,Bibile,Uva,3491,2011,5502,139640,80440,220080
8/2/2024,Dulani Aravinda,Moneragala,Bibile,Uva,5993,7265,13258,239720,290600,530320
8/3/2024,Dulani Aravinda,Moneragala,Bibile,Uva,9946,436,10382,397840,17440,415280
8/4/2024,Dulani Aravinda,Moneragala,Bibile,Uva,754,860,1614,30160,34400,64560
8/5/2024,Dulani Aravinda,Moneragala,Bibile,Uva,9862,4532,14394,394480,181280,575760
8/6/2024,Dulani Aravinda,Moneragala,Bibile,Uva,3168,3086,6254,126720,123440,250160
8/7/2024,Dulani Aravinda,Moneragala,Bibile,Uva,5480,643,6123,219200,25720,244920
8/8/2024,Dulani Aravinda,Moneragala,Bibile,Uva,5066,7414,12480,202640,296560,499200
8/9/2024,Dulani Aravinda,Moneragala,Bibile,Uva,7454,9497,16951,298160,379880,678040
8/10/2024,Dulani Aravinda,Moneragala,Bibile,Uva,1198,5333,6531,47920,213320,261240
8/11/2024,Dulani Aravinda,Moneragala,Bibile,Uva,419,6183,6602,16760,247320,264080
8/12/2024,Dulani Aravinda,Moneragala,Bibile,Uva,1647,6529,8176,65880,261160,327040
8/13/2024,Dulani Aravinda,Moneragala,Bibile,Uva,1254,2366,3620,50160,94640,144800
8/14/2024,Dulani Aravinda,Moneragala,Bibile,Uva,2362,4240,6602,94480,169600,264080
8/15/2024,Dulani Aravinda,Moneragala,Bibile,Uva,3042,1055,4097,121680,42200,163880
8/16/2024,Dulani Aravinda,Moneragala,Bibile,Uva,5516,2180,7696,220640,87200,307840
8/17/2024,Dulani Aravinda,Moneragala,Bibile,Uva,6974,9180,16154,278960,367200,646160
8/18/2024,Dulani Aravinda,Moneragala,Bibile,Uva,8258,7777,16035,330320,311080,641400
8/19/2024,Dulani Aravinda,Moneragala,Bibile,Uva,5017,9709,14726,200680,388360,589040
8/20/2024,Dulani Aravinda,Moneragala,Bibile,Uva,8453,2253,10706,338120,90120,428240
8/21/2024,Dulani Aravinda,Moneragala,Bibile,Uva,4386,7066,11452,175440,282640,458080
8/22/2024,Dulani Aravinda,Moneragala,Bibile,Uva,7921,5415,13336,316840,216600,533440
8/23/2024,Dulani Aravinda,Moneragala,Bibile,Uva,2638,69,2707,105520,2760,108280
8/24/2024,Dulani Aravinda,Moneragala,Bibile,Uva,3073,7982,11055,122920,319280,442200
8/25/2024,Dulani Aravinda,Moneragala,Bibile,Uva,1551,630,2181,62040,25200,87240
8/26/2024,Dulani Aravinda,Moneragala,Bibile,Uva,8959,2710,11669,358360,108400,466760
8/27/2024,Dulani Aravinda,Moneragala,Bibile,Uva,756,4867,5623,30240,194680,224920
8/28/2024,Dulani Aravinda,Moneragala,Bibile,Uva,7732,9665,17397,309280,386600,695880
8/29/2024,Dulani Aravinda,Moneragala,Bibile,Uva,6082,4368,10450,243280,174720,418000
8/30/2024,Dulani Aravinda,Moneragala,Bibile,Uva,7603,868,8471,304120,34720,338840
8/31/2024,Dulani Aravinda,Moneragala,Bibile,Uva,7643,327,7970,305720,13080,318800
9/1/2024,Dulani Aravinda,Moneragala,Bibile,Uva,9380,9116,18496,375200,364640,739840
9/2/2024,Dulani Aravinda,Moneragala,Bibile,Uva,4595,8614,13209,183800,344560,528360
9/3/2024,Dulani Aravinda,Moneragala,Bibile,Uva,9807,5338,15145,392280,213520,605800
9/4/2024,Dulani Aravinda,Moneragala,Bibile,Uva,7089,7626,14715,283560,305040,588600
9/5/2024,Dulani Aravinda,Moneragala,Bibile,Uva,4868,4313,9181,194720,172520,367240
9/6/2024,Dulani Aravinda,Moneragala,Bibile,Uva,9538,2916,12454,381520,116640,498160
9/7/2024,Dulani Aravinda,Moneragala,Bibile,Uva,9088,5797,14885,363520,231880,595400
9/8/2024,Dulani Aravinda,Moneragala,Bibile,Uva,4937,2224,7161,197480,88960,286440
9/9/2024,Dulani Aravinda,Moneragala,Bibile,Uva,4555,4992,9547,182200,199680,381880
9/10/2024,Dulani Aravinda,Moneragala,Bibile,Uva,4767,5589,10356,190680,223560,414240
9/11/2024,Dulani Aravinda,Moneragala,Bibile,Uva,3839,5284,9123,153560,211360,364920
9/12/2024,Dulani Aravinda,Moneragala,Bibile,Uva,1088,5438,6526,43520,217520,261040
9/13/2024,Dulani Aravinda,Moneragala,Bibile,Uva,7368,9089,16457,294720,363560,658280
9/14/2024,Dulani Aravinda,Moneragala,Bibile,Uva,9057,9824,18881,362280,392960,755240
9/15/2024,Dulani Aravinda,Moneragala,Bibile,Uva,8730,50,8780,349200,2000,351200
9/16/2024,Dulani Aravinda,Moneragala,Bibile,Uva,8030,8588,16618,321200,343520,664720
9/17/2024,Dulani Aravinda,Moneragala,Bibile,Uva,1452,5265,6717,58080,210600,268680
9/18/2024,Dulani Aravinda,Moneragala,Bibile,Uva,1366,4226,5592,54640,169040,223680
9/19/2024,Dulani Aravinda,Moneragala,Bibile,Uva,5701,7386,13087,228040,295440,523480
9/20/2024,Dulani Aravinda,Moneragala,Bibile,Uva,9933,1341,11274,397320,53640,450960
9/21/2024,Dulani Aravinda,Moneragala,Bibile,Uva,9614,4341,13955,384560,173640,558200
9/22/2024,Dulani Aravinda,Moneragala,Bibile,Uva,9313,7482,16795,372520,299280,671800
9/23/2024,Dulani Aravinda,Moneragala,Bibile,Uva,3109,8521,11630,124360,340840,465200
9/24/2024,Dulani Aravinda,Moneragala,Bibile,Uva,2491,6733,9224,99640,269320,368960
9/25/2024,Dulani Aravinda,Moneragala,Bibile,Uva,7067,9053,16120,282680,362120,644800
9/26/2024,Dulani Aravinda,Moneragala,Bibile,Uva,1065,9952,11017,42600,398080,440680
9/27/2024,Dulani Aravinda,Moneragala,Bibile,Uva,6642,2242,8884,265680,89680,355360
9/28/2024,Dulani Aravinda,Moneragala,Bibile,Uva,2981,4101,7082,119240,164040,283280
9/29/2024,Dulani Aravinda,Moneragala,Bibile,Uva,2138,6792,8930,85520,271680,357200
9/30/2024,Dulani Aravinda,Moneragala,Bibile,Uva,1477,2746,4223,59080,109840,168920
10/1/2024,Dulani Aravinda,Moneragala,Bibile,Uva,1499,7378,8877,59960,295120,355080
10/2/2024,Dulani Aravinda,Moneragala,Bibile,Uva,5057,7523,12580,202280,300920,503200
10/3/2024,Dulani Aravinda,Moneragala,Bibile,Uva,3912,4439,8351,156480,177560,334040
10/4/2024,Dulani Aravinda,Moneragala,Bibile,Uva,1664,8473,10137,66560,338920,405480
10/5/2024,Dulani Aravinda,Moneragala,Bibile,Uva,2417,8637,11054,96680,345480,442160
10/6/2024,Dulani Aravinda,Moneragala,Bibile,Uva,6865,2002,8867,274600,80080,354680
10/7/2024,Dulani Aravinda,Moneragala,Bibile,Uva,3112,13,3125,124480,520,125000
10/8/2024,Dulani Aravinda,Moneragala,Bibile,Uva,9969,2531,12500,398760,101240,500000
10/9/2024,Dulani Aravinda,Moneragala,Bibile,Uva,1989,7095,9084,79560,283800,363360
10/10/2024,Dulani Aravinda,Moneragala,Bibile,Uva,4586,1832,6418,183440,73280,256720
10/11/2024,Dulani Aravinda,Moneragala,Bibile,Uva,4867,1408,6275,194680,56320,251000
10/12/2024,Dulani Aravinda,Moneragala,Bibile,Uva,5658,6540,12198,226320,261600,487920
10/13/2024,Dulani Aravinda,Moneragala,Bibile,Uva,5165,9545,14710,206600,381800,588400
10/14/2024,Dulani Aravinda,Moneragala,Bibile,Uva,9051,239,9290,362040,9560,371600
10/15/2024,Dulani Aravinda,Moneragala,Bibile,Uva,1882,537,2419,75280,21480,96760
10/16/2024,Dulani Aravinda,Moneragala,Bibile,Uva,2042,421,2463,81680,16840,98520
10/17/2024,Dulani Aravinda,Moneragala,Bibile,Uva,1211,4445,5656,48440,177800,226240
10/18/2024,Dulani Aravinda,Moneragala,Bibile,Uva,2676,1015,3691,107040,40600,147640
10/19/2024,Dulani Aravinda,Moneragala,Bibile,Uva,2190,1150,3340,87600,46000,133600
10/20/2024,Dulani Aravinda,Moneragala,Bibile,Uva,9621,230,9851,384840,9200,394040
10/21/2024,Dulani Aravinda,Moneragala,Bibile,Uva,2787,2068,4855,111480,82720,194200
10/22/2024,Dulani Aravinda,Moneragala,Bibile,Uva,6953,7956,14909,278120,318240,596360
10/23/2024,Dulani Aravinda,Moneragala,Bibile,Uva,7409,3001,10410,296360,120040,416400
10/24/2024,Dulani Aravinda,Moneragala,Bibile,Uva,5139,7483,12622,205560,299320,504880
10/25/2024,Dulani Aravinda,Moneragala,Bibile,Uva,3354,2670,6024,134160,106800,240960
10/26/2024,Dulani Aravinda,Moneragala,Bibile,Uva,4832,2009,6841,193280,80360,273640
10/27/2024,Dulani Aravinda,Moneragala,Bibile,Uva,9876,9257,19133,395040,370280,765320
10/28/2024,Dulani Aravinda,Moneragala,Bibile,Uva,8408,3174,11582,336320,126960,463280
10/29/2024,Dulani Aravinda,Moneragala,Bibile,Uva,1765,5228,6993,70600,209120,279720
10/30/2024,Dulani Aravinda,Moneragala,Bibile,Uva,186,1317,1503,7440,52680,60120
10/31/2024,Dulani Aravinda,Moneragala,Bibile,Uva,3226,2482,5708,129040,99280,228320
11/1/2024,Dulani Aravinda,Moneragala,Bibile,Uva,5302,3414,8716,212080,136560,348640
11/2/2024,Dulani Aravinda,Moneragala,Bibile,Uva,3295,1963,5258,131800,78520,210320
11/3/2024,Dulani Aravinda,Moneragala,Bibile,Uva,8787,6959,15746,351480,278360,629840
11/4/2024,Dulani Aravinda,Moneragala,Bibile,Uva,939,5573,6512,37560,222920,260480
11/5/2024,Dulani Aravinda,Moneragala,Bibile,Uva,8974,8450,17424,358960,338000,696960
11/6/2024,Dulani Aravinda,Moneragala,Bibile,Uva,4778,402,5180,191120,16080,207200
11/7/2024,Dulani Aravinda,Moneragala,Bibile,Uva,664,9186,9850,26560,367440,394000
11/8/2024,Dulani Aravinda,Moneragala,Bibile,Uva,1804,3669,5473,72160,146760,218920
11/9/2024,Dulani Aravinda,Moneragala,Bibile,Uva,3061,7304,10365,122440,292160,414600
11/10/2024,Dulani Aravinda,Moneragala,Bibile,Uva,3566,4612,8178,142640,184480,327120
11/11/2024,Dulani Aravinda,Moneragala,Bibile,Uva,623,5023,5646,24920,200920,225840
11/12/2024,Dulani Aravinda,Moneragala,Bibile,Uva,2011,4371,6382,80440,174840,255280
11/13/2024,Dulani Aravinda,Moneragala,Bibile,Uva,3042,271,3313,121680,10840,132520
11/14/2024,Dulani Aravinda,Moneragala,Bibile,Uva,4426,4739,9165,177040,189560,366600
11/15/2024,Dulani Aravinda,Moneragala,Bibile,Uva,9123,7845,16968,364920,313800,678720
11/16/2024,Dulani Aravinda,Moneragala,Bibile,Uva,6651,2896,9547,266040,115840,381880
11/17/2024,Dulani Aravinda,Moneragala,Bibile,Uva,1252,1120,2372,50080,44800,94880
11/18/2024,Dulani Aravinda,Moneragala,Bibile,Uva,7593,295,7888,303720,11800,315520
11/19/2024,Dulani Aravinda,Moneragala,Bibile,Uva,5496,9408,14904,219840,376320,596160
11/20/2024,Dulani Aravinda,Moneragala,Bibile,Uva,7866,2405,10271,314640,96200,410840
11/21/2024,Dulani Aravinda,Moneragala,Bibile,Uva,9458,8445,17903,378320,337800,716120
11/22/2024,Dulani Aravinda,Moneragala,Bibile,Uva,7057,3779,10836,282280,151160,433440
11/23/2024,Dulani Aravinda,Moneragala,Bibile,Uva,5558,1809,7367,222320,72360,294680
11/24/2024,Dulani Aravinda,Moneragala,Bibile,Uva,5475,3911,9386,219000,156440,375440
11/25/2024,Dulani Aravinda,Moneragala,Bibile,Uva,2646,780,3426,105840,31200,137040
11/26/2024,Dulani Aravinda,Moneragala,Bibile,Uva,7157,4492,11649,286280,179680,465960
11/27/2024,Dulani Aravinda,Moneragala,Bibile,Uva,84,4485,4569,3360,179400,182760
11/28/2024,Dulani Aravinda,Moneragala,Bibile,Uva,5799,769,6568,231960,30760,262720
11/29/2024,Dulani Aravinda,Moneragala,Bibile,Uva,3531,8098,11629,141240,323920,465160
11/30/2024,Dulani Aravinda,Moneragala,Bibile,Uva,7635,1061,8696,305400,42440,347840
12/1/2024,Dulani Aravinda,Moneragala,Bibile,Uva,7507,759,8266,300280,30360,330640
12/2/2024,Dulani Aravinda,Moneragala,Bibile,Uva,3570,1398,4968,142800,55920,198720
12/3/2024,Dulani Aravinda,Moneragala,Bibile,Uva,6013,4237,10250,240520,169480,410000
12/4/2024,Dulani Aravinda,Moneragala,Bibile,Uva,4036,9280,13316,161440,371200,532640
12/5/2024,Dulani Aravinda,Moneragala,Bibile,Uva,3420,2451,5871,136800,98040,234840
12/6/2024,Dulani Aravinda,Moneragala,Bibile,Uva,9223,5523,14746,368920,220920,589840
12/7/2024,Dulani Aravinda,Moneragala,Bibile,Uva,6883,1849,8732,275320,73960,349280
12/8/2024,Dulani Aravinda,Moneragala,Bibile,Uva,2714,9769,12483,108560,390760,499320
12/9/2024,Dulani Aravinda,Moneragala,Bibile,Uva,6732,6483,13215,269280,259320,528600
12/10/2024,Dulani Aravinda,Moneragala,Bibile,Uva,2540,3934,6474,101600,157360,258960
12/11/2024,Dulani Aravinda,Moneragala,Bibile,Uva,3370,178,3548,134800,7120,141920
12/12/2024,Dulani Aravinda,Moneragala,Bibile,Uva,1219,8760,9979,48760,350400,399160
12/13/2024,Dulani Aravinda,Moneragala,Bibile,Uva,4191,6045,10236,167640,241800,409440
12/14/2024,Dulani Aravinda,Moneragala,Bibile,Uva,2375,4858,7233,95000,194320,289320
12/15/2024,Dulani Aravinda,Moneragala,Bibile,Uva,5961,5118,11079,238440,204720,443160
12/16/2024,Dulani Aravinda,Moneragala,Bibile,Uva,791,8521,9312,31640,340840,372480
12/17/2024,Dulani Aravinda,Moneragala,Bibile,Uva,5732,789,6521,229280,31560,260840
12/18/2024,Dulani Aravinda,Moneragala,Bibile,Uva,5453,9512,14965,218120,380480,598600
12/19/2024,Dulani Aravinda,Moneragala,Bibile,Uva,3208,1763,4971,128320,70520,198840
12/20/2024,Dulani Aravinda,Moneragala,Bibile,Uva,2854,6121,8975,114160,244840,359000
12/21/2024,Dulani Aravinda,Moneragala,Bibile,Uva,5505,6778,12283,220200,271120,491320
12/22/2024,Dulani Aravinda,Moneragala,Bibile,Uva,5942,6831,12773,237680,273240,510920
12/23/2024,Dulani Aravinda,Moneragala,Bibile,Uva,3990,9837,13827,159600,393480,553080
12/24/2024,Dulani Aravinda,Moneragala,Bibile,Uva,5102,3436,8538,204080,137440,341520
12/25/2024,Dulani Aravinda,Moneragala,Bibile,Uva,9223,2633,11856,368920,105320,474240
12/26/2024,Dulani Aravinda,Moneragala,Bibile,Uva,5658,639,6297,226320,25560,251880
12/27/2024,Dulani Aravinda,Moneragala,Bibile,Uva,3984,2658,6642,159360,106320,265680
12/28/2024,Dulani Aravinda,Moneragala,Bibile,Uva,5926,3847,9773,237040,153880,390920
12/29/2024,Dulani Aravinda,Moneragala,Bibile,Uva,9645,6028,15673,385800,241120,626920
12/30/2024,Dulani Aravinda,Moneragala,Bibile,Uva,572,331,903,22880,13240,36120
12/31/2024,Dulani Aravinda,Moneragala,Bibile,Uva,4784,8365,13149,191360,334600,525960
1/1/2025,Dulani Aravinda,Moneragala,Bibile,Uva,3757,3817,7574,150280,152680,302960
1/2/2025,Dulani Aravinda,Moneragala,Bibile,Uva,300,8232,8532,12000,329280,341280
1/3/2025,Dulani Aravinda,Moneragala,Bibile,Uva,4373,3391,7764,174920,135640,310560
1/4/2025,Dulani Aravinda,Moneragala,Bibile,Uva,1791,704,2495,71640,28160,99800
1/5/2025,Dulani Aravinda,Moneragala,Bibile,Uva,5375,6716,12091,215000,268640,483640
1/6/2025,Dulani Aravinda,Moneragala,Bibile,Uva,1086,168,1254,43440,6720,50160
1/7/2025,Dulani Aravinda,Moneragala,Bibile,Uva,6240,4250,10490,249600,170000,419600
1/8/2025,Dulani Aravinda,Moneragala,Bibile,Uva,4096,1883,5979,163840,75320,239160
1/9/2025,Dulani Aravinda,Moneragala,Bibile,Uva,5775,5562,11337,231000,222480,453480
1/10/2025,Dulani Aravinda,Moneragala,Bibile,Uva,8564,217,8781,342560,8680,351240
1/11/2025,Dulani Aravinda,Moneragala,Bibile,Uva,5243,338,5581,209720,13520,223240
1/12/2025,Dulani Aravinda,Moneragala,Bibile,Uva,868,3683,4551,34720,147320,182040
1/13/2025,Dulani Aravinda,Moneragala,Bibile,Uva,895,8940,9835,35800,357600,393400
1/14/2025,Dulani Aravinda,Moneragala,Bibile,Uva,582,7516,8098,23280,300640,323920
1/15/2025,Dulani Aravinda,Moneragala,Bibile,Uva,9157,7352,16509,366280,294080,660360
1/16/2025,Dulani Aravinda,Moneragala,Bibile,Uva,3542,4757,8299,141680,190280,331960
1/17/2025,Dulani Aravinda,Moneragala,Bibile,Uva,7409,6299,13708,296360,251960,548320
1/18/2025,Dulani Aravinda,Moneragala,Bibile,Uva,2951,6735,9686,118040,269400,387440
1/19/2025,Dulani Aravinda,Moneragala,Bibile,Uva,2208,9382,11590,88320,375280,463600
1/20/2025,Dulani Aravinda,Moneragala,Bibile,Uva,9417,4942,14359,376680,197680,574360
1/21/2025,Dulani Aravinda,Moneragala,Bibile,Uva,1532,9963,11495,61280,398520,459800
1/22/2025,Dulani Aravinda,Moneragala,Bibile,Uva,6028,804,6832,241120,32160,273280
1/23/2025,Dulani Aravinda,Moneragala,Bibile,Uva,3943,9642,13585,157720,385680,543400
1/24/2025,Dulani Aravinda,Moneragala,Bibile,Uva,1887,4667,6554,75480,186680,262160
1/25/2025,Dulani Aravinda,Moneragala,Bibile,Uva,9455,7726,17181,378200,309040,687240
1/26/2025,Dulani Aravinda,Moneragala,Bibile,Uva,904,616,1520,36160,24640,60800
1/27/2025,Dulani Aravinda,Moneragala,Bibile,Uva,8539,2755,11294,341560,110200,451760
1/28/2025,Dulani Aravinda,Moneragala,Bibile,Uva,345,2427,2772,13800,97080,110880
1/29/2025,Dulani Aravinda,Moneragala,Bibile,Uva,9066,6278,15344,362640,251120,613760
1/30/2025,Dulani Aravinda,Moneragala,Bibile,Uva,9473,9817,19290,378920,392680,771600
1/31/2025,Dulani Aravinda,Moneragala,Bibile,Uva,7246,3715,10961,289840,148600,438440
2/1/2025,Dulani Aravinda,Moneragala,Bibile,Uva,7693,2157,9850,307720,86280,394000
2/2/2025,Dulani Aravinda,Moneragala,Bibile,Uva,1366,5179,6545,54640,207160,261800
2/3/2025,Dulani Aravinda,Moneragala,Bibile,Uva,2217,6232,8449,88680,249280,337960
2/4/2025,Dulani Aravinda,Moneragala,Bibile,Uva,8039,9396,17435,321560,375840,697400
2/5/2025,Dulani Aravinda,Moneragala,Bibile,Uva,827,1976,2803,33080,79040,112120
2/6/2025,Dulani Aravinda,Moneragala,Bibile,Uva,163,3727,3890,6520,149080,155600
2/7/2025,Dulani Aravinda,Moneragala,Bibile,Uva,9316,9442,18758,372640,377680,750320
2/8/2025,Dulani Aravinda,Moneragala,Bibile,Uva,578,445,1023,23120,17800,40920
2/9/2025,Dulani Aravinda,Moneragala,Bibile,Uva,9143,9982,19125,365720,399280,765000
2/10/2025,Dulani Aravinda,Moneragala,Bibile,Uva,9964,7319,17283,398560,292760,691320
2/11/2025,Dulani Aravinda,Moneragala,Bibile,Uva,4630,6752,11382,185200,270080,455280
2/12/2025,Dulani Aravinda,Moneragala,Bibile,Uva,3093,2643,5736,123720,105720,229440
2/13/2025,Dulani Aravinda,Moneragala,Bibile,Uva,6537,1036,7573,261480,41440,302920
2/14/2025,Dulani Aravinda,Moneragala,Bibile,Uva,9629,2181,11810,385160,87240,472400
2/15/2025,Dulani Aravinda,Moneragala,Bibile,Uva,2331,3289,5620,93240,131560,224800
2/16/2025,Dulani Aravinda,Moneragala,Bibile,Uva,7490,4079,11569,299600,163160,462760
2/17/2025,Dulani Aravinda,Moneragala,Bibile,Uva,7650,2047,9697,306000,81880,387880
2/18/2025,Dulani Aravinda,Moneragala,Bibile,Uva,9685,580,10265,387400,23200,410600
2/19/2025,Dulani Aravinda,Moneragala,Bibile,Uva,8126,1585,9711,325040,63400,388440
2/20/2025,Dulani Aravinda,Moneragala,Bibile,Uva,9864,8301,18165,394560,332040,726600
2/21/2025,Dulani Aravinda,Moneragala,Bibile,Uva,685,3785,4470,27400,151400,178800
2/22/2025,Dulani Aravinda,Moneragala,Bibile,Uva,3116,8788,11904,124640,351520,476160
2/23/2025,Dulani Aravinda,Moneragala,Bibile,Uva,9675,6235,15910,387000,249400,636400
2/24/2025,Dulani Aravinda,Moneragala,Bibile,Uva,5770,7174,12944,230800,286960,517760
2/25/2025,Dulani Aravinda,Moneragala,Bibile,Uva,6112,9732,15844,244480,389280,633760
2/26/2025,Dulani Aravinda,Moneragala,Bibile,Uva,5425,4145,9570,217000,165800,382800
2/27/2025,Dulani Aravinda,Moneragala,Bibile,Uva,856,5414,6270,34240,216560,250800
2/28/2025,Dulani Aravinda,Moneragala,Bibile,Uva,9964,8892,18856,398560,355680,754240
3/1/2025,Dulani Aravinda,Moneragala,Bibile,Uva,1348,5589,6937,53920,223560,277480
3/2/2025,Dulani Aravinda,Moneragala,Bibile,Uva,9772,3958,13730,390880,158320,549200
3/3/2025,Dulani Aravinda,Moneragala,Bibile,Uva,183,9526,9709,7320,381040,388360
3/4/2025,Dulani Aravinda,Moneragala,Bibile,Uva,783,2088,2871,31320,83520,114840
3/5/2025,Dulani Aravinda,Moneragala,Bibile,Uva,8086,426,8512,323440,17040,340480
3/6/2025,Dulani Aravinda,Moneragala,Bibile,Uva,7425,1602,9027,297000,64080,361080
3/7/2025,Dulani Aravinda,Moneragala,Bibile,Uva,8227,4011,12238,329080,160440,489520
3/8/2025,Dulani Aravinda,Moneragala,Bibile,Uva,4660,573,5233,186400,22920,209320
3/9/2025,Dulani Aravinda,Moneragala,Bibile,Uva,381,320,701,15240,12800,28040
3/10/2025,Dulani Aravinda,Moneragala,Bibile,Uva,1125,5127,6252,45000,205080,250080
3/11/2025,Dulani Aravinda,Moneragala,Bibile,Uva,4737,7351,12088,189480,294040,483520
3/12/2025,Dulani Aravinda,Moneragala,Bibile,Uva,7139,5496,12635,285560,219840,505400
3/13/2025,Dulani Aravinda,Moneragala,Bibile,Uva,6837,9251,16088,273480,370040,643520
3/14/2025,Dulani Aravinda,Moneragala,Bibile,Uva,7664,9558,17222,306560,382320,688880
3/15/2025,Dulani Aravinda,Moneragala,Bibile,Uva,4171,5866,10037,166840,234640,401480
3/16/2025,Dulani Aravinda,Moneragala,Bibile,Uva,7761,6504,14265,310440,260160,570600
3/17/2025,Dulani Aravinda,Moneragala,Bibile,Uva,2627,1843,4470,105080,73720,178800
3/18/2025,Dulani Aravinda,Moneragala,Bibile,Uva,4590,1490,6080,183600,59600,243200
3/19/2025,Dulani Aravinda,Moneragala,Bibile,Uva,6019,5841,11860,240760,233640,474400
3/20/2025,Dulani Aravinda,Moneragala,Bibile,Uva,8709,2572,11281,348360,102880,451240
3/21/2025,Dulani Aravinda,Moneragala,Bibile,Uva,6499,7960,14459,259960,318400,578360
3/22/2025,Dulani Aravinda,Moneragala,Bibile,Uva,8991,7026,16017,359640,281040,640680
3/23/2025,Dulani Aravinda,Moneragala,Bibile,Uva,6284,1726,8010,251360,69040,320400
3/25/2024,Mahinda Mendis,Jaffna,Point Pedro,Northern,2065,1624,3689,82600,64960,147560
3/26/2024,Mahinda Mendis,Jaffna,Point Pedro,Northern,8495,233,8728,339800,9320,349120
3/27/2024,Mahinda Mendis,Jaffna,Point Pedro,Northern,8072,8133,16205,322880,325320,648200
3/28/2024,Mahinda Mendis,Jaffna,Point Pedro,Northern,624,9685,10309,24960,387400,412360
3/29/2024,Mahinda Mendis,Jaffna,Point Pedro,Northern,1696,2553,4249,67840,102120,169960
3/30/2024,Mahinda Mendis,Jaffna,Point Pedro,Northern,2346,1777,4123,93840,71080,164920
3/31/2024,Mahinda Mendis,Jaffna,Point Pedro,Northern,7753,4358,12111,310120,174320,484440
4/1/2024,Mahinda Mendis,Jaffna,Point Pedro,Northern,2903,224,3127,116120,8960,125080
4/2/2024,Mahinda Mendis,Jaffna,Point Pedro,Northern,868,3953,4821,34720,158120,192840
4/3/2024,Mahinda Mendis,Jaffna,Point Pedro,Northern,3142,1134,4276,125680,45360,171040
4/4/2024,Mahinda Mendis,Jaffna,Point Pedro,Northern,6682,9697,16379,267280,387880,655160
4/5/2024,Mahinda Mendis,Jaffna,Point Pedro,Northern,522,3434,3956,20880,137360,158240
4/6/2024,Mahinda Mendis,Jaffna,Point Pedro,Northern,7846,2784,10630,313840,111360,425200
4/7/2024,Mahinda Mendis,Jaffna,Point Pedro,Northern,6402,4620,11022,256080,184800,440880
4/8/2024,Mahinda Mendis,Jaffna,Point Pedro,Northern,9695,4750,14445,387800,190000,577800
4/9/2024,Mahinda Mendis,Jaffna,Point Pedro,Northern,9827,3005,12832,393080,120200,513280
4/10/2024,Mahinda Mendis,Jaffna,Point Pedro,Northern,4334,8394,12728,173360,335760,509120
4/11/2024,Mahinda Mendis,Jaffna,Point Pedro,Northern,8541,7050,15591,341640,282000,623640
4/19/2024,Mahinda Mendis,Jaffna,Point Pedro,Northern,856,9552,10408,34240,382080,416320
4/20/2024,Mahinda Mendis,Jaffna,Point Pedro,Northern,1080,4671,5751,43200,186840,230040
4/21/2024,Mahinda Mendis,Jaffna,Point Pedro,Northern,6618,2725,9343,264720,109000,373720
4/22/2024,Mahinda Mendis,Jaffna,Point Pedro,Northern,3777,8143,11920,151080,325720,476800
4/23/2024,Mahinda Mendis,Jaffna,Point Pedro,Northern,9071,3744,12815,362840,149760,512600
4/24/2024,Mahinda Mendis,Jaffna,Point Pedro,Northern,7965,6851,14816,318600,274040,592640
4/25/2024,Mahinda Mendis,Jaffna,Point Pedro,Northern,2716,7298,10014,108640,291920,400560
4/26/2024,Mahinda Mendis,Jaffna,Point Pedro,Northern,4172,7404,11576,166880,296160,463040
4/27/2024,Mahinda Mendis,Jaffna,Point Pedro,Northern,2060,9219,11279,82400,368760,451160
4/28/2024,Mahinda Mendis,Jaffna,Point Pedro,Northern,75,5707,5782,3000,228280,231280
4/29/2024,Mahinda Mendis,Jaffna,Point Pedro,Northern,6899,6508,13407,275960,260320,536280
4/30/2024,Mahinda Mendis,Jaffna,Point Pedro,Northern,6628,8765,15393,265120,350600,615720
5/1/2024,Mahinda Mendis,Jaffna,Point Pedro,Northern,5401,7267,12668,216040,290680,506720
5/2/2024,Mahinda Mendis,Jaffna,Point Pedro,Northern,3285,6253,9538,131400,250120,381520
5/3/2024,Mahinda Mendis,Jaffna,Point Pedro,Northern,415,2216,2631,16600,88640,105240
5/4/2024,Mahinda Mendis,Jaffna,Point Pedro,Northern,8817,5666,14483,352680,226640,579320
5/5/2024,Mahinda Mendis,Jaffna,Point Pedro,Northern,4400,1898,6298,176000,75920,251920
5/6/2024,Mahinda Mendis,Jaffna,Point Pedro,Northern,6218,4756,10974,248720,190240,438960
5/7/2024,Mahinda Mendis,Jaffna,Point Pedro,Northern,2022,160,2182,80880,6400,87280
5/8/2024,Mahinda Mendis,Jaffna,Point Pedro,Northern,4813,3626,8439,192520,145040,337560
5/9/2024,Mahinda Mendis,Jaffna,Point Pedro,Northern,2565,7621,10186,102600,304840,407440
5/10/2024,Mahinda Mendis,Jaffna,Point Pedro,Northern,7092,9888,16980,283680,395520,679200
5/11/2024,Mahinda Mendis,Jaffna,Point Pedro,Northern,1456,7411,8867,58240,296440,354680
5/12/2024,Mahinda Mendis,Jaffna,Point Pedro,Northern,6644,5584,12228,265760,223360,489120
5/13/2024,Mahinda Mendis,Jaffna,Point Pedro,Northern,6305,3128,9433,252200,125120,377320
5/14/2024,Mahinda Mendis,Jaffna,Point Pedro,Northern,7186,1370,8556,287440,54800,342240
5/15/2024,Mahinda Mendis,Jaffna,Point Pedro,Northern,5771,8734,14505,230840,349360,580200
5/16/2024,Mahinda Mendis,Jaffna,Point Pedro,Northern,1818,7626,9444,72720,305040,377760
5/17/2024,Mahinda Mendis,Jaffna,Point Pedro,Northern,7220,4494,11714,288800,179760,468560
5/18/2024,Mahinda Mendis,Jaffna,Point Pedro,Northern,4626,5680,10306,185040,227200,412240
5/19/2024,Mahinda Mendis,Jaffna,Point Pedro,Northern,3963,592,4555,158520,23680,182200
5/20/2024,Mahinda Mendis,Jaffna,Point Pedro,Northern,1318,8664,9982,52720,346560,399280
5/21/2024,Mahinda Mendis,Jaffna,Point Pedro,Northern,3258,7996,11254,130320,319840,450160
5/22/2024,Mahinda Mendis,Jaffna,Point Pedro,Northern,3659,470,4129,146360,18800,165160
5/24/2024,Mahinda Mendis,Jaffna,Point Pedro,Northern,8642,8264,16906,345680,330560,676240
5/25/2024,Mahinda Mendis,Jaffna,Point Pedro,Northern,6043,8603,14646,241720,344120,585840
5/26/2024,Mahinda Mendis,Jaffna,Point Pedro,Northern,1107,8321,9428,44280,332840,377120
5/27/2024,Mahinda Mendis,Jaffna,Point Pedro,Northern,1106,656,1762,44240,26240,70480
5/28/2024,Mahinda Mendis,Jaffna,Point Pedro,Northern,1124,7906,9030,44960,316240,361200
5/29/2024,Mahinda Mendis,Jaffna,Point Pedro,Northern,7521,841,8362,300840,33640,334480
5/30/2024,Mahinda Mendis,Jaffna,Point Pedro,Northern,7496,2808,10304,299840,112320,412160
5/31/2024,Mahinda Mendis,Jaffna,Point Pedro,Northern,9103,8924,18027,364120,356960,721080
6/1/2024,Mahinda Mendis,Jaffna,Point Pedro,Northern,6835,5039,11874,273400,201560,474960
6/2/2024,Mahinda Mendis,Jaffna,Point Pedro,Northern,8086,1089,9175,323440,43560,367000
6/3/2024,Mahinda Mendis,Jaffna,Point Pedro,Northern,242,6944,7186,9680,277760,287440
6/4/2024,Mahinda Mendis,Jaffna,Point Pedro,Northern,7896,4370,12266,315840,174800,490640
6/5/2024,Mahinda Mendis,Jaffna,Point Pedro,Northern,8371,1450,9821,334840,58000,392840
6/6/2024,Mahinda Mendis,Jaffna,Point Pedro,Northern,7133,2662,9795,285320,106480,391800
6/7/2024,Mahinda Mendis,Jaffna,Point Pedro,Northern,587,5506,6093,23480,220240,243720
6/8/2024,Mahinda Mendis,Jaffna,Point Pedro,Northern,6854,4660,11514,274160,186400,460560
6/9/2024,Mahinda Mendis,Jaffna,Point Pedro,Northern,240,1817,2057,9600,72680,82280
6/10/2024,Mahinda Mendis,Jaffna,Point Pedro,Northern,3666,2040,5706,146640,81600,228240
6/11/2024,Mahinda Mendis,Jaffna,Point Pedro,Northern,2852,9967,12819,114080,398680,512760
6/12/2024,Mahinda Mendis,Jaffna,Point Pedro,Northern,1774,9959,11733,70960,398360,469320
6/13/2024,Mahinda Mendis,Jaffna,Point Pedro,Northern,2771,799,3570,110840,31960,142800
6/14/2024,Mahinda Mendis,Jaffna,Point Pedro,Northern,173,2537,2710,6920,101480,108400
6/15/2024,Mahinda Mendis,Jaffna,Point Pedro,Northern,2000,2899,4899,80000,115960,195960
6/16/2024,Mahinda Mendis,Jaffna,Point Pedro,Northern,6043,3189,9232,241720,127560,369280
6/17/2024,Mahinda Mendis,Jaffna,Point Pedro,Northern,2827,2670,5497,113080,106800,219880
6/18/2024,Mahinda Mendis,Jaffna,Point Pedro,Northern,3938,2953,6891,157520,118120,275640
6/19/2024,Mahinda Mendis,Jaffna,Point Pedro,Northern,6919,2347,9266,276760,93880,370640
6/20/2024,Mahinda Mendis,Jaffna,Point Pedro,Northern,5381,1215,6596,215240,48600,263840
6/21/2024,Mahinda Mendis,Jaffna,Point Pedro,Northern,8402,9293,17695,336080,371720,707800
6/22/2024,Mahinda Mendis,Jaffna,Point Pedro,Northern,6949,9872,16821,277960,394880,672840
6/23/2024,Mahinda Mendis,Jaffna,Point Pedro,Northern,8389,376,8765,335560,15040,350600
6/24/2024,Mahinda Mendis,Jaffna,Point Pedro,Northern,2112,6788,8900,84480,271520,356000
6/25/2024,Mahinda Mendis,Jaffna,Point Pedro,Northern,5670,2762,8432,226800,110480,337280
6/26/2024,Mahinda Mendis,Jaffna,Point Pedro,Northern,5736,6398,12134,229440,255920,485360
6/27/2024,Mahinda Mendis,Jaffna,Point Pedro,Northern,7557,6814,14371,302280,272560,574840
6/28/2024,Mahinda Mendis,Jaffna,Point Pedro,Northern,3142,6660,9802,125680,266400,392080
6/29/2024,Mahinda Mendis,Jaffna,Point Pedro,Northern,7719,981,8700,308760,39240,348000
6/30/2024,Mahinda Mendis,Jaffna,Point Pedro,Northern,7784,5331,13115,311360,213240,524600
7/1/2024,Mahinda Mendis,Jaffna,Point Pedro,Northern,9568,67,9635,382720,2680,385400
7/2/2024,Mahinda Mendis,Jaffna,Point Pedro,Northern,8696,7582,16278,347840,303280,651120
7/3/2024,Mahinda Mendis,Jaffna,Point Pedro,Northern,8516,857,9373,340640,34280,374920
7/4/2024,Mahinda Mendis,Jaffna,Point Pedro,Northern,4376,2324,6700,175040,92960,268000
7/5/2024,Mahinda Mendis,Jaffna,Point Pedro,Northern,7709,4205,11914,308360,168200,476560
7/6/2024,Mahinda Mendis,Jaffna,Point Pedro,Northern,2793,5527,8320,111720,221080,332800
7/7/2024,Mahinda Mendis,Jaffna,Point Pedro,Northern,6984,3154,10138,279360,126160,405520
7/8/2024,Mahinda Mendis,Jaffna,Point Pedro,Northern,3122,2459,5581,124880,98360,223240
7/9/2024,Mahinda Mendis,Jaffna,Point Pedro,Northern,653,2030,2683,26120,81200,107320
7/10/2024,Mahinda Mendis,Jaffna,Point Pedro,Northern,9707,8685,18392,388280,347400,735680
7/11/2024,Mahinda Mendis,Jaffna,Point Pedro,Northern,9499,2802,12301,379960,112080,492040
7/12/2024,Mahinda Mendis,Jaffna,Point Pedro,Northern,8638,4605,13243,345520,184200,529720
7/13/2024,Mahinda Mendis,Jaffna,Point Pedro,Northern,1578,6320,7898,63120,252800,315920
7/14/2024,Mahinda Mendis,Jaffna,Point Pedro,Northern,5030,608,5638,201200,24320,225520
7/15/2024,Mahinda Mendis,Jaffna,Point Pedro,Northern,3072,3420,6492,122880,136800,259680
7/16/2024,Mahinda Mendis,Jaffna,Point Pedro,Northern,6383,8070,14453,255320,322800,578120
7/17/2024,Mahinda Mendis,Jaffna,Point Pedro,Northern,5239,1363,6602,209560,54520,264080
7/18/2024,Mahinda Mendis,Jaffna,Point Pedro,Northern,6610,4317,10927,264400,172680,437080
7/19/2024,Mahinda Mendis,Jaffna,Point Pedro,Northern,174,6232,6406,6960,249280,256240
7/20/2024,Mahinda Mendis,Jaffna,Point Pedro,Northern,3036,2094,5130,121440,83760,205200
7/21/2024,Mahinda Mendis,Jaffna,Point Pedro,Northern,8245,4333,12578,329800,173320,503120
7/22/2024,Mahinda Mendis,Jaffna,Point Pedro,Northern,899,5203,6102,35960,208120,244080
7/23/2024,Mahinda Mendis,Jaffna,Point Pedro,Northern,1230,6614,7844,49200,264560,313760
7/24/2024,Mahinda Mendis,Jaffna,Point Pedro,Northern,702,3486,4188,28080,139440,167520
7/25/2024,Mahinda Mendis,Jaffna,Point Pedro,Northern,8907,5520,14427,356280,220800,577080
7/26/2024,Mahinda Mendis,Jaffna,Point Pedro,Northern,6103,6976,13079,244120,279040,523160
7/27/2024,Mahinda Mendis,Jaffna,Point Pedro,Northern,1333,8822,10155,53320,352880,406200
7/28/2024,Mahinda Mendis,Jaffna,Point Pedro,Northern,7508,2802,10310,300320,112080,412400
7/29/2024,Mahinda Mendis,Jaffna,Point Pedro,Northern,3808,2141,5949,152320,85640,237960
7/30/2024,Mahinda Mendis,Jaffna,Point Pedro,Northern,5491,9803,15294,219640,392120,611760
7/31/2024,Mahinda Mendis,Jaffna,Point Pedro,Northern,4437,4472,8909,177480,178880,356360
8/1/2024,Mahinda Mendis,Jaffna,Point Pedro,Northern,3338,6567,9905,133520,262680,396200
8/2/2024,Mahinda Mendis,Jaffna,Point Pedro,Northern,4949,3610,8559,197960,144400,342360
8/3/2024,Mahinda Mendis,Jaffna,Point Pedro,Northern,6960,5853,12813,278400,234120,512520
8/4/2024,Mahinda Mendis,Jaffna,Point Pedro,Northern,9405,9665,19070,376200,386600,762800
8/5/2024,Mahinda Mendis,Jaffna,Point Pedro,Northern,9400,4113,13513,376000,164520,540520
8/6/2024,Mahinda Mendis,Jaffna,Point Pedro,Northern,115,867,982,4600,34680,39280
8/7/2024,Mahinda Mendis,Jaffna,Point Pedro,Northern,4074,9849,13923,162960,393960,556920
8/8/2024,Mahinda Mendis,Jaffna,Point Pedro,Northern,282,8754,9036,11280,350160,361440
8/9/2024,Mahinda Mendis,Jaffna,Point Pedro,Northern,8076,3469,11545,323040,138760,461800
8/10/2024,Mahinda Mendis,Jaffna,Point Pedro,Northern,8970,8587,17557,358800,343480,702280
8/11/2024,Mahinda Mendis,Jaffna,Point Pedro,Northern,710,309,1019,28400,12360,40760
8/12/2024,Mahinda Mendis,Jaffna,Point Pedro,Northern,7633,6247,13880,305320,249880,555200
8/13/2024,Mahinda Mendis,Jaffna,Point Pedro,Northern,4543,8863,13406,181720,354520,536240
8/14/2024,Mahinda Mendis,Jaffna,Point Pedro,Northern,6792,8429,15221,271680,337160,608840
8/15/2024,Mahinda Mendis,Jaffna,Point Pedro,Northern,4097,510,4607,163880,20400,184280
8/16/2024,Mahinda Mendis,Jaffna,Point Pedro,Northern,1887,9108,10995,75480,364320,439800
8/17/2024,Mahinda Mendis,Jaffna,Point Pedro,Northern,5538,9134,14672,221520,365360,586880
8/18/2024,Mahinda Mendis,Jaffna,Point Pedro,Northern,5659,9472,15131,226360,378880,605240
8/19/2024,Mahinda Mendis,Jaffna,Point Pedro,Northern,6335,7568,13903,253400,302720,556120
8/20/2024,Mahinda Mendis,Jaffna,Point Pedro,Northern,2623,3982,6605,104920,159280,264200
8/21/2024,Mahinda Mendis,Jaffna,Point Pedro,Northern,4683,4066,8749,187320,162640,349960
8/22/2024,Mahinda Mendis,Jaffna,Point Pedro,Northern,8370,7412,15782,334800,296480,631280
8/23/2024,Mahinda Mendis,Jaffna,Point Pedro,Northern,9396,1511,10907,375840,60440,436280
8/24/2024,Mahinda Mendis,Jaffna,Point Pedro,Northern,1370,412,1782,54800,16480,71280
8/25/2024,Mahinda Mendis,Jaffna,Point Pedro,Northern,4963,9150,14113,198520,366000,564520
8/26/2024,Mahinda Mendis,Jaffna,Point Pedro,Northern,1794,4543,6337,71760,181720,253480
8/27/2024,Mahinda Mendis,Jaffna,Point Pedro,Northern,2159,4249,6408,86360,169960,256320
8/28/2024,Mahinda Mendis,Jaffna,Point Pedro,Northern,6068,7891,13959,242720,315640,558360
8/29/2024,Mahinda Mendis,Jaffna,Point Pedro,Northern,2634,6486,9120,105360,259440,364800
8/30/2024,Mahinda Mendis,Jaffna,Point Pedro,Northern,1666,9540,11206,66640,381600,448240
8/31/2024,Mahinda Mendis,Jaffna,Point Pedro,Northern,104,1820,1924,4160,72800,76960
9/1/2024,Mahinda Mendis,Jaffna,Point Pedro,Northern,9597,4743,14340,383880,189720,573600
9/2/2024,Mahinda Mendis,Jaffna,Point Pedro,Northern,9523,2263,11786,380920,90520,471440
9/3/2024,Mahinda Mendis,Jaffna,Point Pedro,Northern,6352,9625,15977,254080,385000,639080
9/4/2024,Mahinda Mendis,Jaffna,Point Pedro,Northern,9423,3002,12425,376920,120080,497000
9/5/2024,Mahinda Mendis,Jaffna,Point Pedro,Northern,4707,7463,12170,188280,298520,486800
9/6/2024,Mahinda Mendis,Jaffna,Point Pedro,Northern,6597,3252,9849,263880,130080,393960
9/7/2024,Mahinda Mendis,Jaffna,Point Pedro,Northern,4999,9399,14398,199960,375960,575920
9/8/2024,Mahinda Mendis,Jaffna,Point Pedro,Northern,4533,2846,7379,181320,113840,295160
9/9/2024,Mahinda Mendis,Jaffna,Point Pedro,Northern,1976,1891,3867,79040,75640,154680
9/10/2024,Mahinda Mendis,Jaffna,Point Pedro,Northern,2581,6307,8888,103240,252280,355520
9/11/2024,Mahinda Mendis,Jaffna,Point Pedro,Northern,6955,6841,13796,278200,273640,551840
9/12/2024,Mahinda Mendis,Jaffna,Point Pedro,Northern,3885,1195,5080,155400,47800,203200
9/13/2024,Mahinda Mendis,Jaffna,Point Pedro,Northern,5643,5199,10842,225720,207960,433680
9/14/2024,Mahinda Mendis,Jaffna,Point Pedro,Northern,1682,820,2502,67280,32800,100080
9/15/2024,Mahinda Mendis,Jaffna,Point Pedro,Northern,7139,5035,12174,285560,201400,486960
9/16/2024,Mahinda Mendis,Jaffna,Point Pedro,Northern,9659,6837,16496,386360,273480,659840
9/17/2024,Mahinda Mendis,Jaffna,Point Pedro,Northern,9329,8781,18110,373160,351240,724400
9/18/2024,Mahinda Mendis,Jaffna,Point Pedro,Northern,9142,8061,17203,365680,322440,688120
9/19/2024,Mahinda Mendis,Jaffna,Point Pedro,Northern,1047,2013,3060,41880,80520,122400
9/20/2024,Mahinda Mendis,Jaffna,Point Pedro,Northern,5917,2912,8829,236680,116480,353160
9/21/2024,Mahinda Mendis,Jaffna,Point Pedro,Northern,2581,3899,6480,103240,155960,259200
9/22/2024,Mahinda Mendis,Jaffna,Point Pedro,Northern,3312,6426,9738,132480,257040,389520
9/23/2024,Mahinda Mendis,Jaffna,Point Pedro,Northern,7947,411,8358,317880,16440,334320
9/24/2024,Mahinda Mendis,Jaffna,Point Pedro,Northern,1429,3947,5376,57160,157880,215040
9/25/2024,Mahinda Mendis,Jaffna,Point Pedro,Northern,4337,3287,7624,173480,131480,304960
9/26/2024,Mahinda Mendis,Jaffna,Point Pedro,Northern,430,7705,8135,17200,308200,325400
9/27/2024,Mahinda Mendis,Jaffna,Point Pedro,Northern,7192,8354,15546,287680,334160,621840
9/28/2024,Mahinda Mendis,Jaffna,Point Pedro,Northern,9150,5703,14853,366000,228120,594120
9/29/2024,Mahinda Mendis,Jaffna,Point Pedro,Northern,1390,5858,7248,55600,234320,289920
9/30/2024,Mahinda Mendis,Jaffna,Point Pedro,Northern,663,5631,6294,26520,225240,251760
10/1/2024,Mahinda Mendis,Jaffna,Point Pedro,Northern,4091,3435,7526,163640,137400,301040
10/2/2024,Mahinda Mendis,Jaffna,Point Pedro,Northern,5258,4586,9844,210320,183440,393760
10/3/2024,Mahinda Mendis,Jaffna,Point Pedro,Northern,6223,2930,9153,248920,117200,366120
10/4/2024,Mahinda Mendis,Jaffna,Point Pedro,Northern,7337,460,7797,293480,18400,311880
10/5/2024,Mahinda Mendis,Jaffna,Point Pedro,Northern,6371,1188,7559,254840,47520,302360
10/6/2024,Mahinda Mendis,Jaffna,Point Pedro,Northern,6198,6047,12245,247920,241880,489800
10/7/2024,Mahinda Mendis,Jaffna,Point Pedro,Northern,7052,9953,17005,282080,398120,680200
10/8/2024,Mahinda Mendis,Jaffna,Point Pedro,Northern,4660,1645,6305,186400,65800,252200
10/9/2024,Mahinda Mendis,Jaffna,Point Pedro,Northern,6446,5774,12220,257840,230960,488800
10/10/2024,Mahinda Mendis,Jaffna,Point Pedro,Northern,6184,3074,9258,247360,122960,370320
10/11/2024,Mahinda Mendis,Jaffna,Point Pedro,Northern,7395,1592,8987,295800,63680,359480
10/12/2024,Mahinda Mendis,Jaffna,Point Pedro,Northern,4680,6835,11515,187200,273400,460600
10/13/2024,Mahinda Mendis,Jaffna,Point Pedro,Northern,1585,5905,7490,63400,236200,299600
10/14/2024,Mahinda Mendis,Jaffna,Point Pedro,Northern,21,4706,4727,840,188240,189080
10/15/2024,Mahinda Mendis,Jaffna,Point Pedro,Northern,8515,2324,10839,340600,92960,433560
10/16/2024,Mahinda Mendis,Jaffna,Point Pedro,Northern,8992,12,9004,359680,480,360160
10/17/2024,Mahinda Mendis,Jaffna,Point Pedro,Northern,403,9567,9970,16120,382680,398800
10/18/2024,Mahinda Mendis,Jaffna,Point Pedro,Northern,4602,2125,6727,184080,85000,269080
10/19/2024,Mahinda Mendis,Jaffna,Point Pedro,Northern,8172,6912,15084,326880,276480,603360
10/20/2024,Mahinda Mendis,Jaffna,Point Pedro,Northern,6525,971,7496,261000,38840,299840
10/21/2024,Mahinda Mendis,Jaffna,Point Pedro,Northern,4813,9925,14738,192520,397000,589520
10/22/2024,Mahinda Mendis,Jaffna,Point Pedro,Northern,4944,136,5080,197760,5440,203200
10/23/2024,Mahinda Mendis,Jaffna,Point Pedro,Northern,1860,8294,10154,74400,331760,406160
10/24/2024,Mahinda Mendis,Jaffna,Point Pedro,Northern,8357,2225,10582,334280,89000,423280
10/25/2024,Mahinda Mendis,Jaffna,Point Pedro,Northern,502,9893,10395,20080,395720,415800
10/26/2024,Mahinda Mendis,Jaffna,Point Pedro,Northern,2923,8587,11510,116920,343480,460400
10/27/2024,Mahinda Mendis,Jaffna,Point Pedro,Northern,8426,4133,12559,337040,165320,502360
10/28/2024,Mahinda Mendis,Jaffna,Point Pedro,Northern,1894,4746,6640,75760,189840,265600
10/29/2024,Mahinda Mendis,Jaffna,Point Pedro,Northern,109,2231,2340,4360,89240,93600
10/30/2024,Mahinda Mendis,Jaffna,Point Pedro,Northern,3688,4230,7918,147520,169200,316720
10/31/2024,Mahinda Mendis,Jaffna,Point Pedro,Northern,287,2647,2934,11480,105880,117360
11/1/2024,Mahinda Mendis,Jaffna,Point Pedro,Northern,5213,2636,7849,208520,105440,313960
11/2/2024,Mahinda Mendis,Jaffna,Point Pedro,Northern,9234,4896,14130,369360,195840,565200
11/3/2024,Mahinda Mendis,Jaffna,Point Pedro,Northern,3925,3640,7565,157000,145600,302600
11/4/2024,Mahinda Mendis,Jaffna,Point Pedro,Northern,4086,5100,9186,163440,204000,367440
11/5/2024,Mahinda Mendis,Jaffna,Point Pedro,Northern,7347,4485,11832,293880,179400,473280
11/6/2024,Mahinda Mendis,Jaffna,Point Pedro,Northern,21,7744,7765,840,309760,310600
11/7/2024,Mahinda Mendis,Jaffna,Point Pedro,Northern,7745,6968,14713,309800,278720,588520
11/8/2024,Mahinda Mendis,Jaffna,Point Pedro,Northern,7879,1968,9847,315160,78720,393880
11/9/2024,Mahinda Mendis,Jaffna,Point Pedro,Northern,5626,5915,11541,225040,236600,461640
11/10/2024,Mahinda Mendis,Jaffna,Point Pedro,Northern,6168,5474,11642,246720,218960,465680
11/11/2024,Mahinda Mendis,Jaffna,Point Pedro,Northern,5985,7457,13442,239400,298280,537680
11/12/2024,Mahinda Mendis,Jaffna,Point Pedro,Northern,9822,9080,18902,392880,363200,756080
11/13/2024,Mahinda Mendis,Jaffna,Point Pedro,Northern,6952,6526,13478,278080,261040,539120
11/14/2024,Mahinda Mendis,Jaffna,Point Pedro,Northern,6267,1382,7649,250680,55280,305960
11/15/2024,Mahinda Mendis,Jaffna,Point Pedro,Northern,2891,1161,4052,115640,46440,162080
11/16/2024,Mahinda Mendis,Jaffna,Point Pedro,Northern,4326,5503,9829,173040,220120,393160
11/17/2024,Mahinda Mendis,Jaffna,Point Pedro,Northern,5083,1529,6612,203320,61160,264480
11/18/2024,Mahinda Mendis,Jaffna,Point Pedro,Northern,2816,8004,10820,112640,320160,432800
11/19/2024,Mahinda Mendis,Jaffna,Point Pedro,Northern,2423,1030,3453,96920,41200,138120
11/20/2024,Mahinda Mendis,Jaffna,Point Pedro,Northern,8090,78,8168,323600,3120,326720
11/21/2024,Mahinda Mendis,Jaffna,Point Pedro,Northern,9773,2163,11936,390920,86520,477440
11/22/2024,Mahinda Mendis,Jaffna,Point Pedro,Northern,4495,1073,5568,179800,42920,222720
11/23/2024,Mahinda Mendis,Jaffna,Point Pedro,Northern,7560,6307,13867,302400,252280,554680
11/24/2024,Mahinda Mendis,Jaffna,Point Pedro,Northern,1224,9483,10707,48960,379320,428280
11/25/2024,Mahinda Mendis,Jaffna,Point Pedro,Northern,8921,967,9888,356840,38680,395520
11/26/2024,Mahinda Mendis,Jaffna,Point Pedro,Northern,3653,2053,5706,146120,82120,228240
11/27/2024,Mahinda Mendis,Jaffna,Point Pedro,Northern,8201,2673,10874,328040,106920,434960
11/28/2024,Mahinda Mendis,Jaffna,Point Pedro,Northern,4018,8515,12533,160720,340600,501320
11/29/2024,Mahinda Mendis,Jaffna,Point Pedro,Northern,7527,6094,13621,301080,243760,544840
11/30/2024,Mahinda Mendis,Jaffna,Point Pedro,Northern,5667,5139,10806,226680,205560,432240
12/1/2024,Mahinda Mendis,Jaffna,Point Pedro,Northern,8314,1051,9365,332560,42040,374600
12/2/2024,Mahinda Mendis,Jaffna,Point Pedro,Northern,7236,3407,10643,289440,136280,425720
12/3/2024,Mahinda Mendis,Jaffna,Point Pedro,Northern,2475,3392,5867,99000,135680,234680
12/4/2024,Mahinda Mendis,Jaffna,Point Pedro,Northern,4613,5479,10092,184520,219160,403680
12/5/2024,Mahinda Mendis,Jaffna,Point Pedro,Northern,2427,2377,4804,97080,95080,192160
12/6/2024,Mahinda Mendis,Jaffna,Point Pedro,Northern,5752,4159,9911,230080,166360,396440
12/7/2024,Mahinda Mendis,Jaffna,Point Pedro,Northern,7730,2868,10598,309200,114720,423920
12/8/2024,Mahinda Mendis,Jaffna,Point Pedro,Northern,1108,9746,10854,44320,389840,434160
12/9/2024,Mahinda Mendis,Jaffna,Point Pedro,Northern,403,6203,6606,16120,248120,264240
12/10/2024,Mahinda Mendis,Jaffna,Point Pedro,Northern,1615,3917,5532,64600,156680,221280
12/11/2024,Mahinda Mendis,Jaffna,Point Pedro,Northern,3981,6801,10782,159240,272040,431280
12/12/2024,Mahinda Mendis,Jaffna,Point Pedro,Northern,2656,2295,4951,106240,91800,198040
12/13/2024,Mahinda Mendis,Jaffna,Point Pedro,Northern,9149,185,9334,365960,7400,373360
12/14/2024,Mahinda Mendis,Jaffna,Point Pedro,Northern,6297,1277,7574,251880,51080,302960
12/15/2024,Mahinda Mendis,Jaffna,Point Pedro,Northern,172,7553,7725,6880,302120,309000
12/16/2024,Mahinda Mendis,Jaffna,Point Pedro,Northern,403,9006,9409,16120,360240,376360
12/17/2024,Mahinda Mendis,Jaffna,Point Pedro,Northern,9230,483,9713,369200,19320,388520
12/18/2024,Mahinda Mendis,Jaffna,Point Pedro,Northern,3078,8032,11110,123120,321280,444400
12/19/2024,Mahinda Mendis,Jaffna,Point Pedro,Northern,6535,7476,14011,261400,299040,560440
12/20/2024,Mahinda Mendis,Jaffna,Point Pedro,Northern,7255,5056,12311,290200,202240,492440
12/21/2024,Mahinda Mendis,Jaffna,Point Pedro,Northern,6601,4206,10807,264040,168240,432280
12/22/2024,Mahinda Mendis,Jaffna,Point Pedro,Northern,6905,8472,15377,276200,338880,615080
12/23/2024,Mahinda Mendis,Jaffna,Point Pedro,Northern,801,1500,2301,32040,60000,92040
12/24/2024,Mahinda Mendis,Jaffna,Point Pedro,Northern,1464,3985,5449,58560,159400,217960
12/25/2024,Mahinda Mendis,Jaffna,Point Pedro,Northern,5798,8886,14684,231920,355440,587360
12/26/2024,Mahinda Mendis,Jaffna,Point Pedro,Northern,5152,8670,13822,206080,346800,552880
12/27/2024,Mahinda Mendis,Jaffna,Point Pedro,Northern,4183,6203,10386,167320,248120,415440
12/28/2024,Mahinda Mendis,Jaffna,Point Pedro,Northern,2854,9645,12499,114160,385800,499960
12/29/2024,Mahinda Mendis,Jaffna,Point Pedro,Northern,944,6103,7047,37760,244120,281880
12/30/2024,Mahinda Mendis,Jaffna,Point Pedro,Northern,895,3923,4818,35800,156920,192720
12/31/2024,Mahinda Mendis,Jaffna,Point Pedro,Northern,5659,9698,15357,226360,387920,614280
1/1/2025,Mahinda Mendis,Jaffna,Point Pedro,Northern,8818,4718,13536,352720,188720,541440
1/2/2025,Mahinda Mendis,Jaffna,Point Pedro,Northern,9013,9605,18618,360520,384200,744720
1/3/2025,Mahinda Mendis,Jaffna,Point Pedro,Northern,638,4326,4964,25520,173040,198560
1/4/2025,Mahinda Mendis,Jaffna,Point Pedro,Northern,9431,88,9519,377240,3520,380760
1/5/2025,Mahinda Mendis,Jaffna,Point Pedro,Northern,642,5957,6599,25680,238280,263960
1/6/2025,Mahinda Mendis,Jaffna,Point Pedro,Northern,997,559,1556,39880,22360,62240
1/7/2025,Mahinda Mendis,Jaffna,Point Pedro,Northern,7275,1078,8353,291000,43120,334120
1/8/2025,Mahinda Mendis,Jaffna,Point Pedro,Northern,132,3349,3481,5280,133960,139240
1/9/2025,Mahinda Mendis,Jaffna,Point Pedro,Northern,7914,1315,9229,316560,52600,369160
1/10/2025,Mahinda Mendis,Jaffna,Point Pedro,Northern,2341,7723,10064,93640,308920,402560
1/11/2025,Mahinda Mendis,Jaffna,Point Pedro,Northern,1498,980,2478,59920,39200,99120
1/12/2025,Mahinda Mendis,Jaffna,Point Pedro,Northern,6782,1560,8342,271280,62400,333680
1/13/2025,Mahinda Mendis,Jaffna,Point Pedro,Northern,7987,4233,12220,319480,169320,488800
1/14/2025,Mahinda Mendis,Jaffna,Point Pedro,Northern,8857,1818,10675,354280,72720,427000
1/15/2025,Mahinda Mendis,Jaffna,Point Pedro,Northern,1228,4104,5332,49120,164160,213280
1/16/2025,Mahinda Mendis,Jaffna,Point Pedro,Northern,8917,5021,13938,356680,200840,557520
1/17/2025,Mahinda Mendis,Jaffna,Point Pedro,Northern,6496,6984,13480,259840,279360,539200
1/18/2025,Mahinda Mendis,Jaffna,Point Pedro,Northern,2347,4211,6558,93880,168440,262320
1/19/2025,Mahinda Mendis,Jaffna,Point Pedro,Northern,4485,3538,8023,179400,141520,320920
1/20/2025,Mahinda Mendis,Jaffna,Point Pedro,Northern,46,5880,5926,1840,235200,237040
1/21/2025,Mahinda Mendis,Jaffna,Point Pedro,Northern,1638,1051,2689,65520,42040,107560
1/22/2025,Mahinda Mendis,Jaffna,Point Pedro,Northern,3226,2204,5430,129040,88160,217200
1/23/2025,Mahinda Mendis,Jaffna,Point Pedro,Northern,8626,127,8753,345040,5080,350120
1/24/2025,Mahinda Mendis,Jaffna,Point Pedro,Northern,6424,6010,12434,256960,240400,497360
1/25/2025,Mahinda Mendis,Jaffna,Point Pedro,Northern,1005,3323,4328,40200,132920,173120
1/26/2025,Mahinda Mendis,Jaffna,Point Pedro,Northern,6708,4863,11571,268320,194520,462840
1/27/2025,Mahinda Mendis,Jaffna,Point Pedro,Northern,6994,7692,14686,279760,307680,587440
1/28/2025,Mahinda Mendis,Jaffna,Point Pedro,Northern,396,2519,2915,15840,100760,116600
1/29/2025,Mahinda Mendis,Jaffna,Point Pedro,Northern,5165,3126,8291,206600,125040,331640
1/30/2025,Mahinda Mendis,Jaffna,Point Pedro,Northern,2911,4795,7706,116440,191800,308240
1/31/2025,Mahinda Mendis,Jaffna,Point Pedro,Northern,4058,9151,13209,162320,366040,528360
2/1/2025,Mahinda Mendis,Jaffna,Point Pedro,Northern,2329,3831,6160,93160,153240,246400
2/2/2025,Mahinda Mendis,Jaffna,Point Pedro,Northern,2016,6146,8162,80640,245840,326480
2/3/2025,Mahinda Mendis,Jaffna,Point Pedro,Northern,2166,7771,9937,86640,310840,397480
2/4/2025,Mahinda Mendis,Jaffna,Point Pedro,Northern,6469,9100,15569,258760,364000,622760
2/5/2025,Mahinda Mendis,Jaffna,Point Pedro,Northern,3780,1194,4974,151200,47760,198960
2/6/2025,Mahinda Mendis,Jaffna,Point Pedro,Northern,6568,9437,16005,262720,377480,640200
2/7/2025,Mahinda Mendis,Jaffna,Point Pedro,Northern,4655,1577,6232,186200,63080,249280
2/8/2025,Mahinda Mendis,Jaffna,Point Pedro,Northern,6255,4051,10306,250200,162040,412240
2/9/2025,Mahinda Mendis,Jaffna,Point Pedro,Northern,9486,9181,18667,379440,367240,746680
2/10/2025,Mahinda Mendis,Jaffna,Point Pedro,Northern,9014,921,9935,360560,36840,397400
2/11/2025,Mahinda Mendis,Jaffna,Point Pedro,Northern,3885,5799,9684,155400,231960,387360
2/12/2025,Mahinda Mendis,Jaffna,Point Pedro,Northern,7252,1032,8284,290080,41280,331360
2/13/2025,Mahinda Mendis,Jaffna,Point Pedro,Northern,1097,3970,5067,43880,158800,202680
2/14/2025,Mahinda Mendis,Jaffna,Point Pedro,Northern,8671,4778,13449,346840,191120,537960
2/15/2025,Mahinda Mendis,Jaffna,Point Pedro,Northern,827,7094,7921,33080,283760,316840
2/16/2025,Mahinda Mendis,Jaffna,Point Pedro,Northern,1618,2148,3766,64720,85920,150640
2/17/2025,Mahinda Mendis,Jaffna,Point Pedro,Northern,5961,1784,7745,238440,71360,309800
2/18/2025,Mahinda Mendis,Jaffna,Point Pedro,Northern,4138,3042,7180,165520,121680,287200
2/19/2025,Mahinda Mendis,Jaffna,Point Pedro,Northern,9257,3431,12688,370280,137240,507520
2/20/2025,Mahinda Mendis,Jaffna,Point Pedro,Northern,9203,8052,17255,368120,322080,690200
2/21/2025,Mahinda Mendis,Jaffna,Point Pedro,Northern,9127,1390,10517,365080,55600,420680
2/22/2025,Mahinda Mendis,Jaffna,Point Pedro,Northern,3660,1518,5178,146400,60720,207120
2/23/2025,Mahinda Mendis,Jaffna,Point Pedro,Northern,904,4770,5674,36160,190800,226960
2/24/2025,Mahinda Mendis,Jaffna,Point Pedro,Northern,5867,6266,12133,234680,250640,485320
2/25/2025,Mahinda Mendis,Jaffna,Point Pedro,Northern,1009,9789,10798,40360,391560,431920
2/26/2025,Mahinda Mendis,Jaffna,Point Pedro,Northern,6118,901,7019,244720,36040,280760
2/27/2025,Mahinda Mendis,Jaffna,Point Pedro,Northern,2785,4957,7742,111400,198280,309680
2/28/2025,Mahinda Mendis,Jaffna,Point Pedro,Northern,2919,3771,6690,116760,150840,267600
3/1/2025,Mahinda Mendis,Jaffna,Point Pedro,Northern,6941,2177,9118,277640,87080,364720
3/2/2025,Mahinda Mendis,Jaffna,Point Pedro,Northern,2424,1380,3804,96960,55200,152160
3/3/2025,Mahinda Mendis,Jaffna,Point Pedro,Northern,7121,6549,13670,284840,261960,546800
3/4/2025,Mahinda Mendis,Jaffna,Point Pedro,Northern,4406,1241,5647,176240,49640,225880
3/5/2025,Mahinda Mendis,Jaffna,Point Pedro,Northern,7717,4959,12676,308680,198360,507040
3/6/2025,Mahinda Mendis,Jaffna,Point Pedro,Northern,9390,4424,13814,375600,176960,552560
3/7/2025,Mahinda Mendis,Jaffna,Point Pedro,Northern,7303,2754,10057,292120,110160,402280
3/8/2025,Mahinda Mendis,Jaffna,Point Pedro,Northern,7027,2696,9723,281080,107840,388920
3/9/2025,Mahinda Mendis,Jaffna,Point Pedro,Northern,7714,256,7970,308560,10240,318800
3/10/2025,Mahinda Mendis,Jaffna,Point Pedro,Northern,7178,1978,9156,287120,79120,366240
3/11/2025,Mahinda Mendis,Jaffna,Point Pedro,Northern,8260,8156,16416,330400,326240,656640
3/12/2025,Mahinda Mendis,Jaffna,Point Pedro,Northern,3799,3503,7302,151960,140120,292080
3/13/2025,Mahinda Mendis,Jaffna,Point Pedro,Northern,1632,7907,9539,65280,316280,381560
3/14/2025,Mahinda Mendis,Jaffna,Point Pedro,Northern,7676,1358,9034,307040,54320,361360
3/15/2025,Mahinda Mendis,Jaffna,Point Pedro,Northern,6103,8979,15082,244120,359160,603280
3/16/2025,Mahinda Mendis,Jaffna,Point Pedro,Northern,1656,1225,2881,66240,49000,115240
3/17/2025,Mahinda Mendis,Jaffna,Point Pedro,Northern,9642,1604,11246,385680,64160,449840
3/18/2025,Mahinda Mendis,Jaffna,Point Pedro,Northern,7707,4140,11847,308280,165600,473880
3/19/2025,Mahinda Mendis,Jaffna,Point Pedro,Northern,6168,8567,14735,246720,342680,589400
3/20/2025,Mahinda Mendis,Jaffna,Point Pedro,Northern,6350,1310,7660,254000,52400,306400
3/21/2025,Mahinda Mendis,Jaffna,Point Pedro,Northern,2131,9252,11383,85240,370080,455320
3/22/2025,Mahinda Mendis,Jaffna,Point Pedro,Northern,4659,4786,9445,186360,191440,377800
3/23/2025,Mahinda Mendis,Jaffna,Point Pedro,Northern,1070,5610,6680,42800,224400,267200
3/25/2024,Kumari Jayakody,Jaffna,Jaffna,Northern,6492,1924,8416,259680,76960,336640
3/26/2024,Kumari Jayakody,Jaffna,Jaffna,Northern,6144,9577,15721,245760,383080,628840
3/27/2024,Kumari Jayakody,Jaffna,Jaffna,Northern,9201,7803,17004,368040,312120,680160
3/28/2024,Kumari Jayakody,Jaffna,Jaffna,Northern,7416,9962,17378,296640,398480,695120
3/29/2024,Kumari Jayakody,Jaffna,Jaffna,Northern,6515,8206,14721,260600,328240,588840
3/30/2024,Kumari Jayakody,Jaffna,Jaffna,Northern,9833,725,10558,393320,29000,422320
3/31/2024,Kumari Jayakody,Jaffna,Jaffna,Northern,3703,3569,7272,148120,142760,290880
4/1/2024,Kumari Jayakody,Jaffna,Jaffna,Northern,7819,694,8513,312760,27760,340520
4/2/2024,Kumari Jayakody,Jaffna,Jaffna,Northern,9081,8364,17445,363240,334560,697800
4/3/2024,Kumari Jayakody,Jaffna,Jaffna,Northern,9766,525,10291,390640,21000,411640
4/4/2024,Kumari Jayakody,Jaffna,Jaffna,Northern,410,5080,5490,16400,203200,219600
4/5/2024,Kumari Jayakody,Jaffna,Jaffna,Northern,784,1112,1896,31360,44480,75840
4/6/2024,Kumari Jayakody,Jaffna,Jaffna,Northern,9038,783,9821,361520,31320,392840
4/7/2024,Kumari Jayakody,Jaffna,Jaffna,Northern,6082,2827,8909,243280,113080,356360
4/8/2024,Kumari Jayakody,Jaffna,Jaffna,Northern,928,3621,4549,37120,144840,181960
4/9/2024,Kumari Jayakody,Jaffna,Jaffna,Northern,9693,2123,11816,387720,84920,472640
4/10/2024,Kumari Jayakody,Jaffna,Jaffna,Northern,4964,9282,14246,198560,371280,569840
4/11/2024,Kumari Jayakody,Jaffna,Jaffna,Northern,1721,823,2544,68840,32920,101760
4/19/2024,Kumari Jayakody,Jaffna,Jaffna,Northern,9935,4399,14334,397400,175960,573360
4/20/2024,Kumari Jayakody,Jaffna,Jaffna,Northern,6691,7299,13990,267640,291960,559600
4/21/2024,Kumari Jayakody,Jaffna,Jaffna,Northern,2091,9513,11604,83640,380520,464160
4/22/2024,Kumari Jayakody,Jaffna,Jaffna,Northern,1236,3401,4637,49440,136040,185480
4/23/2024,Kumari Jayakody,Jaffna,Jaffna,Northern,553,280,833,22120,11200,33320
4/24/2024,Kumari Jayakody,Jaffna,Jaffna,Northern,8030,2187,10217,321200,87480,408680
4/25/2024,Kumari Jayakody,Jaffna,Jaffna,Northern,1012,2504,3516,40480,100160,140640
4/26/2024,Kumari Jayakody,Jaffna,Jaffna,Northern,7772,5544,13316,310880,221760,532640
4/27/2024,Kumari Jayakody,Jaffna,Jaffna,Northern,3342,1275,4617,133680,51000,184680
4/28/2024,Kumari Jayakody,Jaffna,Jaffna,Northern,2549,5759,8308,101960,230360,332320
4/29/2024,Kumari Jayakody,Jaffna,Jaffna,Northern,5532,5243,10775,221280,209720,431000
4/30/2024,Kumari Jayakody,Jaffna,Jaffna,Northern,3642,9648,13290,145680,385920,531600
5/1/2024,Kumari Jayakody,Jaffna,Jaffna,Northern,4309,395,4704,172360,15800,188160
5/2/2024,Kumari Jayakody,Jaffna,Jaffna,Northern,2598,3423,6021,103920,136920,240840
5/3/2024,Kumari Jayakody,Jaffna,Jaffna,Northern,8394,1246,9640,335760,49840,385600
5/4/2024,Kumari Jayakody,Jaffna,Jaffna,Northern,8198,8453,16651,327920,338120,666040
5/5/2024,Kumari Jayakody,Jaffna,Jaffna,Northern,1426,3002,4428,57040,120080,177120
5/6/2024,Kumari Jayakody,Jaffna,Jaffna,Northern,2213,3149,5362,88520,125960,214480
5/7/2024,Kumari Jayakody,Jaffna,Jaffna,Northern,2665,3454,6119,106600,138160,244760
5/8/2024,Kumari Jayakody,Jaffna,Jaffna,Northern,2742,9421,12163,109680,376840,486520
5/9/2024,Kumari Jayakody,Jaffna,Jaffna,Northern,8119,6982,15101,324760,279280,604040
5/10/2024,Kumari Jayakody,Jaffna,Jaffna,Northern,2321,8024,10345,92840,320960,413800
5/11/2024,Kumari Jayakody,Jaffna,Jaffna,Northern,9745,1737,11482,389800,69480,459280
5/12/2024,Kumari Jayakody,Jaffna,Jaffna,Northern,2360,7738,10098,94400,309520,403920
5/13/2024,Kumari Jayakody,Jaffna,Jaffna,Northern,2077,8317,10394,83080,332680,415760
5/14/2024,Kumari Jayakody,Jaffna,Jaffna,Northern,1585,1385,2970,63400,55400,118800
5/15/2024,Kumari Jayakody,Jaffna,Jaffna,Northern,963,6609,7572,38520,264360,302880
5/16/2024,Kumari Jayakody,Jaffna,Jaffna,Northern,3814,6824,10638,152560,272960,425520
5/17/2024,Kumari Jayakody,Jaffna,Jaffna,Northern,8407,7994,16401,336280,319760,656040
5/18/2024,Kumari Jayakody,Jaffna,Jaffna,Northern,2521,636,3157,100840,25440,126280
5/19/2024,Kumari Jayakody,Jaffna,Jaffna,Northern,1574,9502,11076,62960,380080,443040
5/20/2024,Kumari Jayakody,Jaffna,Jaffna,Northern,1955,6684,8639,78200,267360,345560
5/21/2024,Kumari Jayakody,Jaffna,Jaffna,Northern,5505,204,5709,220200,8160,228360
5/22/2024,Kumari Jayakody,Jaffna,Jaffna,Northern,2468,4172,6640,98720,166880,265600
5/24/2024,Kumari Jayakody,Jaffna,Jaffna,Northern,6685,9849,16534,267400,393960,661360
5/25/2024,Kumari Jayakody,Jaffna,Jaffna,Northern,6314,3376,9690,252560,135040,387600
5/26/2024,Kumari Jayakody,Jaffna,Jaffna,Northern,8681,7211,15892,347240,288440,635680
5/27/2024,Kumari Jayakody,Jaffna,Jaffna,Northern,9273,7196,16469,370920,287840,658760
5/28/2024,Kumari Jayakody,Jaffna,Jaffna,Northern,3050,9493,12543,122000,379720,501720
5/29/2024,Kumari Jayakody,Jaffna,Jaffna,Northern,3826,974,4800,153040,38960,192000
5/30/2024,Kumari Jayakody,Jaffna,Jaffna,Northern,2764,4796,7560,110560,191840,302400
5/31/2024,Kumari Jayakody,Jaffna,Jaffna,Northern,5555,9683,15238,222200,387320,609520
6/1/2024,Kumari Jayakody,Jaffna,Jaffna,Northern,6469,2252,8721,258760,90080,348840
6/2/2024,Kumari Jayakody,Jaffna,Jaffna,Northern,1901,8455,10356,76040,338200,414240
6/3/2024,Kumari Jayakody,Jaffna,Jaffna,Northern,9081,4785,13866,363240,191400,554640
6/4/2024,Kumari Jayakody,Jaffna,Jaffna,Northern,8609,2321,10930,344360,92840,437200
6/5/2024,Kumari Jayakody,Jaffna,Jaffna,Northern,2051,337,2388,82040,13480,95520
6/6/2024,Kumari Jayakody,Jaffna,Jaffna,Northern,4963,3547,8510,198520,141880,340400
6/7/2024,Kumari Jayakody,Jaffna,Jaffna,Northern,5282,8670,13952,211280,346800,558080
6/8/2024,Kumari Jayakody,Jaffna,Jaffna,Northern,6870,5211,12081,274800,208440,483240
6/9/2024,Kumari Jayakody,Jaffna,Jaffna,Northern,2283,6894,9177,91320,275760,367080
6/10/2024,Kumari Jayakody,Jaffna,Jaffna,Northern,8968,2643,11611,358720,105720,464440
6/11/2024,Kumari Jayakody,Jaffna,Jaffna,Northern,8354,8340,16694,334160,333600,667760
6/12/2024,Kumari Jayakody,Jaffna,Jaffna,Northern,9558,6719,16277,382320,268760,651080
6/13/2024,Kumari Jayakody,Jaffna,Jaffna,Northern,4055,821,4876,162200,32840,195040
6/14/2024,Kumari Jayakody,Jaffna,Jaffna,Northern,2832,3438,6270,113280,137520,250800
6/15/2024,Kumari Jayakody,Jaffna,Jaffna,Northern,9431,6960,16391,377240,278400,655640
6/16/2024,Kumari Jayakody,Jaffna,Jaffna,Northern,8116,4499,12615,324640,179960,504600
6/17/2024,Kumari Jayakody,Jaffna,Jaffna,Northern,6690,6658,13348,267600,266320,533920
6/18/2024,Kumari Jayakody,Jaffna,Jaffna,Northern,2915,2701,5616,116600,108040,224640
6/19/2024,Kumari Jayakody,Jaffna,Jaffna,Northern,6914,2648,9562,276560,105920,382480
6/20/2024,Kumari Jayakody,Jaffna,Jaffna,Northern,8741,9148,17889,349640,365920,715560
6/21/2024,Kumari Jayakody,Jaffna,Jaffna,Northern,8698,4770,13468,347920,190800,538720
6/22/2024,Kumari Jayakody,Jaffna,Jaffna,Northern,3476,531,4007,139040,21240,160280
6/23/2024,Kumari Jayakody,Jaffna,Jaffna,Northern,7474,5861,13335,298960,234440,533400
6/24/2024,Kumari Jayakody,Jaffna,Jaffna,Northern,3003,4611,7614,120120,184440,304560
6/25/2024,Kumari Jayakody,Jaffna,Jaffna,Northern,7650,6970,14620,306000,278800,584800
6/26/2024,Kumari Jayakody,Jaffna,Jaffna,Northern,9217,5132,14349,368680,205280,573960
6/27/2024,Kumari Jayakody,Jaffna,Jaffna,Northern,5290,4297,9587,211600,171880,383480
6/28/2024,Kumari Jayakody,Jaffna,Jaffna,Northern,6587,2656,9243,263480,106240,369720
6/29/2024,Kumari Jayakody,Jaffna,Jaffna,Northern,1186,158,1344,47440,6320,53760
6/30/2024,Kumari Jayakody,Jaffna,Jaffna,Northern,675,8973,9648,27000,358920,385920
7/1/2024,Kumari Jayakody,Jaffna,Jaffna,Northern,8683,9140,17823,347320,365600,712920
7/2/2024,Kumari Jayakody,Jaffna,Jaffna,Northern,6855,6600,13455,274200,264000,538200
7/3/2024,Kumari Jayakody,Jaffna,Jaffna,Northern,9547,6793,16340,381880,271720,653600
7/4/2024,Kumari Jayakody,Jaffna,Jaffna,Northern,9916,9371,19287,396640,374840,771480
7/5/2024,Kumari Jayakody,Jaffna,Jaffna,Northern,3625,9035,12660,145000,361400,506400
7/6/2024,Kumari Jayakody,Jaffna,Jaffna,Northern,2873,3644,6517,114920,145760,260680
7/7/2024,Kumari Jayakody,Jaffna,Jaffna,Northern,5393,489,5882,215720,19560,235280
7/8/2024,Kumari Jayakody,Jaffna,Jaffna,Northern,3145,6540,9685,125800,261600,387400
7/9/2024,Kumari Jayakody,Jaffna,Jaffna,Northern,8862,2984,11846,354480,119360,473840
7/10/2024,Kumari Jayakody,Jaffna,Jaffna,Northern,3181,6038,9219,127240,241520,368760
7/11/2024,Kumari Jayakody,Jaffna,Jaffna,Northern,6320,7941,14261,252800,317640,570440
7/12/2024,Kumari Jayakody,Jaffna,Jaffna,Northern,8573,3469,12042,342920,138760,481680
7/13/2024,Kumari Jayakody,Jaffna,Jaffna,Northern,4290,5291,9581,171600,211640,383240
7/14/2024,Kumari Jayakody,Jaffna,Jaffna,Northern,5928,3308,9236,237120,132320,369440
7/15/2024,Kumari Jayakody,Jaffna,Jaffna,Northern,8972,5969,14941,358880,238760,597640
7/16/2024,Kumari Jayakody,Jaffna,Jaffna,Northern,7063,2673,9736,282520,106920,389440
7/17/2024,Kumari Jayakody,Jaffna,Jaffna,Northern,7549,2099,9648,301960,83960,385920
7/18/2024,Kumari Jayakody,Jaffna,Jaffna,Northern,2149,9253,11402,85960,370120,456080
7/19/2024,Kumari Jayakody,Jaffna,Jaffna,Northern,8933,9021,17954,357320,360840,718160
7/20/2024,Kumari Jayakody,Jaffna,Jaffna,Northern,2266,9356,11622,90640,374240,464880
7/21/2024,Kumari Jayakody,Jaffna,Jaffna,Northern,4083,4066,8149,163320,162640,325960
7/22/2024,Kumari Jayakody,Jaffna,Jaffna,Northern,8161,4776,12937,326440,191040,517480
7/23/2024,Kumari Jayakody,Jaffna,Jaffna,Northern,9029,5192,14221,361160,207680,568840
7/24/2024,Kumari Jayakody,Jaffna,Jaffna,Northern,160,8428,8588,6400,337120,343520
7/25/2024,Kumari Jayakody,Jaffna,Jaffna,Northern,2367,4655,7022,94680,186200,280880
7/26/2024,Kumari Jayakody,Jaffna,Jaffna,Northern,192,3018,3210,7680,120720,128400
7/27/2024,Kumari Jayakody,Jaffna,Jaffna,Northern,7943,1749,9692,317720,69960,387680
7/28/2024,Kumari Jayakody,Jaffna,Jaffna,Northern,7828,9814,17642,313120,392560,705680
7/29/2024,Kumari Jayakody,Jaffna,Jaffna,Northern,3618,5629,9247,144720,225160,369880
7/30/2024,Kumari Jayakody,Jaffna,Jaffna,Northern,7358,7077,14435,294320,283080,577400
7/31/2024,Kumari Jayakody,Jaffna,Jaffna,Northern,1488,9944,11432,59520,397760,457280
8/1/2024,Kumari Jayakody,Jaffna,Jaffna,Northern,4219,1003,5222,168760,40120,208880
8/2/2024,Kumari Jayakody,Jaffna,Jaffna,Northern,2595,8138,10733,103800,325520,429320
8/3/2024,Kumari Jayakody,Jaffna,Jaffna,Northern,4742,9595,14337,189680,383800,573480
8/4/2024,Kumari Jayakody,Jaffna,Jaffna,Northern,2885,9918,12803,115400,396720,512120
8/5/2024,Kumari Jayakody,Jaffna,Jaffna,Northern,1898,7621,9519,75920,304840,380760
8/6/2024,Kumari Jayakody,Jaffna,Jaffna,Northern,3638,6764,10402,145520,270560,416080
8/7/2024,Kumari Jayakody,Jaffna,Jaffna,Northern,2985,833,3818,119400,33320,152720
8/8/2024,Kumari Jayakody,Jaffna,Jaffna,Northern,8883,3393,12276,355320,135720,491040
8/9/2024,Kumari Jayakody,Jaffna,Jaffna,Northern,7951,9709,17660,318040,388360,706400
8/10/2024,Kumari Jayakody,Jaffna,Jaffna,Northern,901,994,1895,36040,39760,75800
8/11/2024,Kumari Jayakody,Jaffna,Jaffna,Northern,650,7356,8006,26000,294240,320240
8/12/2024,Kumari Jayakody,Jaffna,Jaffna,Northern,1839,8159,9998,73560,326360,399920
8/13/2024,Kumari Jayakody,Jaffna,Jaffna,Northern,3802,9788,13590,152080,391520,543600
8/14/2024,Kumari Jayakody,Jaffna,Jaffna,Northern,832,3388,4220,33280,135520,168800
8/15/2024,Kumari Jayakody,Jaffna,Jaffna,Northern,73,6987,7060,2920,279480,282400
8/16/2024,Kumari Jayakody,Jaffna,Jaffna,Northern,3610,6973,10583,144400,278920,423320
8/17/2024,Kumari Jayakody,Jaffna,Jaffna,Northern,5436,46,5482,217440,1840,219280
8/18/2024,Kumari Jayakody,Jaffna,Jaffna,Northern,612,8134,8746,24480,325360,349840
8/19/2024,Kumari Jayakody,Jaffna,Jaffna,Northern,5715,4478,10193,228600,179120,407720
8/20/2024,Kumari Jayakody,Jaffna,Jaffna,Northern,1038,5839,6877,41520,233560,275080
8/21/2024,Kumari Jayakody,Jaffna,Jaffna,Northern,3408,6446,9854,136320,257840,394160
8/22/2024,Kumari Jayakody,Jaffna,Jaffna,Northern,5197,80,5277,207880,3200,211080
8/23/2024,Kumari Jayakody,Jaffna,Jaffna,Northern,6138,3834,9972,245520,153360,398880
8/24/2024,Kumari Jayakody,Jaffna,Jaffna,Northern,2456,7099,9555,98240,283960,382200
8/25/2024,Kumari Jayakody,Jaffna,Jaffna,Northern,8048,5315,13363,321920,212600,534520
8/26/2024,Kumari Jayakody,Jaffna,Jaffna,Northern,7639,2395,10034,305560,95800,401360
8/27/2024,Kumari Jayakody,Jaffna,Jaffna,Northern,5720,6337,12057,228800,253480,482280
8/28/2024,Kumari Jayakody,Jaffna,Jaffna,Northern,4555,5236,9791,182200,209440,391640
8/29/2024,Kumari Jayakody,Jaffna,Jaffna,Northern,6547,2143,8690,261880,85720,347600
8/30/2024,Kumari Jayakody,Jaffna,Jaffna,Northern,8173,6212,14385,326920,248480,575400
8/31/2024,Kumari Jayakody,Jaffna,Jaffna,Northern,7507,6288,13795,300280,251520,551800
9/1/2024,Kumari Jayakody,Jaffna,Jaffna,Northern,1536,5438,6974,61440,217520,278960
9/2/2024,Kumari Jayakody,Jaffna,Jaffna,Northern,7867,6105,13972,314680,244200,558880
9/3/2024,Kumari Jayakody,Jaffna,Jaffna,Northern,1255,9661,10916,50200,386440,436640
9/4/2024,Kumari Jayakody,Jaffna,Jaffna,Northern,9451,8952,18403,378040,358080,736120
9/5/2024,Kumari Jayakody,Jaffna,Jaffna,Northern,669,7700,8369,26760,308000,334760
9/6/2024,Kumari Jayakody,Jaffna,Jaffna,Northern,418,4266,4684,16720,170640,187360
9/7/2024,Kumari Jayakody,Jaffna,Jaffna,Northern,8758,9172,17930,350320,366880,717200
9/8/2024,Kumari Jayakody,Jaffna,Jaffna,Northern,5931,4769,10700,237240,190760,428000
9/9/2024,Kumari Jayakody,Jaffna,Jaffna,Northern,2839,3035,5874,113560,121400,234960
9/10/2024,Kumari Jayakody,Jaffna,Jaffna,Northern,7460,7092,14552,298400,283680,582080
9/11/2024,Kumari Jayakody,Jaffna,Jaffna,Northern,7308,7302,14610,292320,292080,584400
9/12/2024,Kumari Jayakody,Jaffna,Jaffna,Northern,3090,5370,8460,123600,214800,338400
9/13/2024,Kumari Jayakody,Jaffna,Jaffna,Northern,7295,7541,14836,291800,301640,593440
9/14/2024,Kumari Jayakody,Jaffna,Jaffna,Northern,5357,5572,10929,214280,222880,437160
9/15/2024,Kumari Jayakody,Jaffna,Jaffna,Northern,8947,4132,13079,357880,165280,523160
9/16/2024,Kumari Jayakody,Jaffna,Jaffna,Northern,8373,2147,10520,334920,85880,420800
9/17/2024,Kumari Jayakody,Jaffna,Jaffna,Northern,4729,2785,7514,189160,111400,300560
9/18/2024,Kumari Jayakody,Jaffna,Jaffna,Northern,7831,7426,15257,313240,297040,610280
9/19/2024,Kumari Jayakody,Jaffna,Jaffna,Northern,9654,5239,14893,386160,209560,595720
9/20/2024,Kumari Jayakody,Jaffna,Jaffna,Northern,1864,228,2092,74560,9120,83680
9/21/2024,Kumari Jayakody,Jaffna,Jaffna,Northern,4619,6586,11205,184760,263440,448200
9/22/2024,Kumari Jayakody,Jaffna,Jaffna,Northern,2540,5161,7701,101600,206440,308040
9/23/2024,Kumari Jayakody,Jaffna,Jaffna,Northern,6813,638,7451,272520,25520,298040
9/24/2024,Kumari Jayakody,Jaffna,Jaffna,Northern,1707,9713,11420,68280,388520,456800
9/25/2024,Kumari Jayakody,Jaffna,Jaffna,Northern,7674,8310,15984,306960,332400,639360
9/26/2024,Kumari Jayakody,Jaffna,Jaffna,Northern,7669,800,8469,306760,32000,338760
9/27/2024,Kumari Jayakody,Jaffna,Jaffna,Northern,5885,2031,7916,235400,81240,316640
9/28/2024,Kumari Jayakody,Jaffna,Jaffna,Northern,6579,2920,9499,263160,116800,379960
9/29/2024,Kumari Jayakody,Jaffna,Jaffna,Northern,5948,4607,10555,237920,184280,422200
9/30/2024,Kumari Jayakody,Jaffna,Jaffna,Northern,9429,7760,17189,377160,310400,687560
10/1/2024,Kumari Jayakody,Jaffna,Jaffna,Northern,8818,3617,12435,352720,144680,497400
10/2/2024,Kumari Jayakody,Jaffna,Jaffna,Northern,6658,8564,15222,266320,342560,608880
10/3/2024,Kumari Jayakody,Jaffna,Jaffna,Northern,8145,3820,11965,325800,152800,478600
10/4/2024,Kumari Jayakody,Jaffna,Jaffna,Northern,4524,7583,12107,180960,303320,484280
10/5/2024,Kumari Jayakody,Jaffna,Jaffna,Northern,8717,8871,17588,348680,354840,703520
10/6/2024,Kumari Jayakody,Jaffna,Jaffna,Northern,9404,3821,13225,376160,152840,529000
10/7/2024,Kumari Jayakody,Jaffna,Jaffna,Northern,8931,7652,16583,357240,306080,663320
10/8/2024,Kumari Jayakody,Jaffna,Jaffna,Northern,7580,3579,11159,303200,143160,446360
10/9/2024,Kumari Jayakody,Jaffna,Jaffna,Northern,2108,6969,9077,84320,278760,363080
10/10/2024,Kumari Jayakody,Jaffna,Jaffna,Northern,1033,3202,4235,41320,128080,169400
10/11/2024,Kumari Jayakody,Jaffna,Jaffna,Northern,3499,7449,10948,139960,297960,437920
10/12/2024,Kumari Jayakody,Jaffna,Jaffna,Northern,131,7501,7632,5240,300040,305280
10/13/2024,Kumari Jayakody,Jaffna,Jaffna,Northern,5706,6929,12635,228240,277160,505400
10/14/2024,Kumari Jayakody,Jaffna,Jaffna,Northern,2753,9543,12296,110120,381720,491840
10/15/2024,Kumari Jayakody,Jaffna,Jaffna,Northern,7679,8865,16544,307160,354600,661760
10/16/2024,Kumari Jayakody,Jaffna,Jaffna,Northern,9582,1490,11072,383280,59600,442880
10/17/2024,Kumari Jayakody,Jaffna,Jaffna,Northern,7856,3918,11774,314240,156720,470960
10/18/2024,Kumari Jayakody,Jaffna,Jaffna,Northern,2812,6739,9551,112480,269560,382040
10/19/2024,Kumari Jayakody,Jaffna,Jaffna,Northern,5599,9155,14754,223960,366200,590160
10/20/2024,Kumari Jayakody,Jaffna,Jaffna,Northern,6945,6370,13315,277800,254800,532600
10/21/2024,Kumari Jayakody,Jaffna,Jaffna,Northern,9026,4749,13775,361040,189960,551000
10/22/2024,Kumari Jayakody,Jaffna,Jaffna,Northern,2820,6686,9506,112800,267440,380240
10/23/2024,Kumari Jayakody,Jaffna,Jaffna,Northern,463,3626,4089,18520,145040,163560
10/24/2024,Kumari Jayakody,Jaffna,Jaffna,Northern,4407,7157,11564,176280,286280,462560
10/25/2024,Kumari Jayakody,Jaffna,Jaffna,Northern,577,4411,4988,23080,176440,199520
10/26/2024,Kumari Jayakody,Jaffna,Jaffna,Northern,4397,9892,14289,175880,395680,571560
10/27/2024,Kumari Jayakody,Jaffna,Jaffna,Northern,6045,4566,10611,241800,182640,424440
10/28/2024,Kumari Jayakody,Jaffna,Jaffna,Northern,997,1309,2306,39880,52360,92240
10/29/2024,Kumari Jayakody,Jaffna,Jaffna,Northern,9205,6611,15816,368200,264440,632640
10/30/2024,Kumari Jayakody,Jaffna,Jaffna,Northern,5264,8264,13528,210560,330560,541120
10/31/2024,Kumari Jayakody,Jaffna,Jaffna,Northern,8537,3191,11728,341480,127640,469120
11/1/2024,Kumari Jayakody,Jaffna,Jaffna,Northern,9847,4319,14166,393880,172760,566640
11/2/2024,Kumari Jayakody,Jaffna,Jaffna,Northern,3919,4671,8590,156760,186840,343600
11/3/2024,Kumari Jayakody,Jaffna,Jaffna,Northern,3224,3004,6228,128960,120160,249120
11/4/2024,Kumari Jayakody,Jaffna,Jaffna,Northern,1899,2241,4140,75960,89640,165600
11/5/2024,Kumari Jayakody,Jaffna,Jaffna,Northern,5399,3801,9200,215960,152040,368000
11/6/2024,Kumari Jayakody,Jaffna,Jaffna,Northern,3978,186,4164,159120,7440,166560
11/7/2024,Kumari Jayakody,Jaffna,Jaffna,Northern,2977,8864,11841,119080,354560,473640
11/8/2024,Kumari Jayakody,Jaffna,Jaffna,Northern,5995,4292,10287,239800,171680,411480
11/9/2024,Kumari Jayakody,Jaffna,Jaffna,Northern,4742,7219,11961,189680,288760,478440
11/10/2024,Kumari Jayakody,Jaffna,Jaffna,Northern,5587,2163,7750,223480,86520,310000
11/11/2024,Kumari Jayakody,Jaffna,Jaffna,Northern,348,7355,7703,13920,294200,308120
11/12/2024,Kumari Jayakody,Jaffna,Jaffna,Northern,8370,414,8784,334800,16560,351360
11/13/2024,Kumari Jayakody,Jaffna,Jaffna,Northern,9885,47,9932,395400,1880,397280
11/14/2024,Kumari Jayakody,Jaffna,Jaffna,Northern,8624,9772,18396,344960,390880,735840
11/15/2024,Kumari Jayakody,Jaffna,Jaffna,Northern,8388,6302,14690,335520,252080,587600
11/16/2024,Kumari Jayakody,Jaffna,Jaffna,Northern,7539,9023,16562,301560,360920,662480
11/17/2024,Kumari Jayakody,Jaffna,Jaffna,Northern,8877,9454,18331,355080,378160,733240
11/18/2024,Kumari Jayakody,Jaffna,Jaffna,Northern,6574,8676,15250,262960,347040,610000
11/19/2024,Kumari Jayakody,Jaffna,Jaffna,Northern,1762,7225,8987,70480,289000,359480
11/20/2024,Kumari Jayakody,Jaffna,Jaffna,Northern,6168,4981,11149,246720,199240,445960
11/21/2024,Kumari Jayakody,Jaffna,Jaffna,Northern,3425,9724,13149,137000,388960,525960
11/22/2024,Kumari Jayakody,Jaffna,Jaffna,Northern,8979,286,9265,359160,11440,370600
11/23/2024,Kumari Jayakody,Jaffna,Jaffna,Northern,4257,8859,13116,170280,354360,524640
11/24/2024,Kumari Jayakody,Jaffna,Jaffna,Northern,2687,7943,10630,107480,317720,425200
11/25/2024,Kumari Jayakody,Jaffna,Jaffna,Northern,8394,1385,9779,335760,55400,391160
11/26/2024,Kumari Jayakody,Jaffna,Jaffna,Northern,4789,5331,10120,191560,213240,404800
11/27/2024,Kumari Jayakody,Jaffna,Jaffna,Northern,8267,8115,16382,330680,324600,655280
11/28/2024,Kumari Jayakody,Jaffna,Jaffna,Northern,4539,4724,9263,181560,188960,370520
11/29/2024,Kumari Jayakody,Jaffna,Jaffna,Northern,1367,4276,5643,54680,171040,225720
11/30/2024,Kumari Jayakody,Jaffna,Jaffna,Northern,1493,6890,8383,59720,275600,335320
12/1/2024,Kumari Jayakody,Jaffna,Jaffna,Northern,844,5644,6488,33760,225760,259520
12/2/2024,Kumari Jayakody,Jaffna,Jaffna,Northern,9113,9790,18903,364520,391600,756120
12/3/2024,Kumari Jayakody,Jaffna,Jaffna,Northern,3401,1608,5009,136040,64320,200360
12/4/2024,Kumari Jayakody,Jaffna,Jaffna,Northern,4549,729,5278,181960,29160,211120
12/5/2024,Kumari Jayakody,Jaffna,Jaffna,Northern,8832,7496,16328,353280,299840,653120
12/6/2024,Kumari Jayakody,Jaffna,Jaffna,Northern,8224,96,8320,328960,3840,332800
12/7/2024,Kumari Jayakody,Jaffna,Jaffna,Northern,7715,4141,11856,308600,165640,474240
12/8/2024,Kumari Jayakody,Jaffna,Jaffna,Northern,6633,2745,9378,265320,109800,375120
12/9/2024,Kumari Jayakody,Jaffna,Jaffna,Northern,2898,9102,12000,115920,364080,480000
12/10/2024,Kumari Jayakody,Jaffna,Jaffna,Northern,9430,6270,15700,377200,250800,628000
12/11/2024,Kumari Jayakody,Jaffna,Jaffna,Northern,1818,4119,5937,72720,164760,237480
12/12/2024,Kumari Jayakody,Jaffna,Jaffna,Northern,1940,1254,3194,77600,50160,127760
12/13/2024,Kumari Jayakody,Jaffna,Jaffna,Northern,9577,3308,12885,383080,132320,515400
12/14/2024,Kumari Jayakody,Jaffna,Jaffna,Northern,256,3574,3830,10240,142960,153200
12/15/2024,Kumari Jayakody,Jaffna,Jaffna,Northern,7,3010,3017,280,120400,120680
12/16/2024,Kumari Jayakody,Jaffna,Jaffna,Northern,7289,9096,16385,291560,363840,655400
12/17/2024,Kumari Jayakody,Jaffna,Jaffna,Northern,4561,165,4726,182440,6600,189040
12/18/2024,Kumari Jayakody,Jaffna,Jaffna,Northern,7518,5151,12669,300720,206040,506760
12/19/2024,Kumari Jayakody,Jaffna,Jaffna,Northern,8822,9685,18507,352880,387400,740280
12/20/2024,Kumari Jayakody,Jaffna,Jaffna,Northern,2582,9181,11763,103280,367240,470520
12/21/2024,Kumari Jayakody,Jaffna,Jaffna,Northern,8133,581,8714,325320,23240,348560
12/22/2024,Kumari Jayakody,Jaffna,Jaffna,Northern,6343,7517,13860,253720,300680,554400
12/23/2024,Kumari Jayakody,Jaffna,Jaffna,Northern,3548,8538,12086,141920,341520,483440
12/24/2024,Kumari Jayakody,Jaffna,Jaffna,Northern,3736,3911,7647,149440,156440,305880
12/25/2024,Kumari Jayakody,Jaffna,Jaffna,Northern,3631,2920,6551,145240,116800,262040
12/26/2024,Kumari Jayakody,Jaffna,Jaffna,Northern,6619,2696,9315,264760,107840,372600
12/27/2024,Kumari Jayakody,Jaffna,Jaffna,Northern,491,2640,3131,19640,105600,125240
12/28/2024,Kumari Jayakody,Jaffna,Jaffna,Northern,7665,3461,11126,306600,138440,445040
12/29/2024,Kumari Jayakody,Jaffna,Jaffna,Northern,3300,7162,10462,132000,286480,418480
12/30/2024,Kumari Jayakody,Jaffna,Jaffna,Northern,4995,2139,7134,199800,85560,285360
12/31/2024,Kumari Jayakody,Jaffna,Jaffna,Northern,674,1129,1803,26960,45160,72120
1/1/2025,Kumari Jayakody,Jaffna,Jaffna,Northern,1867,4467,6334,74680,178680,253360
1/2/2025,Kumari Jayakody,Jaffna,Jaffna,Northern,8284,9617,17901,331360,384680,716040
1/3/2025,Kumari Jayakody,Jaffna,Jaffna,Northern,4288,5104,9392,171520,204160,375680
1/4/2025,Kumari Jayakody,Jaffna,Jaffna,Northern,8139,1228,9367,325560,49120,374680
1/5/2025,Kumari Jayakody,Jaffna,Jaffna,Northern,8022,5665,13687,320880,226600,547480
1/6/2025,Kumari Jayakody,Jaffna,Jaffna,Northern,8179,6890,15069,327160,275600,602760
1/7/2025,Kumari Jayakody,Jaffna,Jaffna,Northern,507,5737,6244,20280,229480,249760
1/8/2025,Kumari Jayakody,Jaffna,Jaffna,Northern,6304,740,7044,252160,29600,281760
1/9/2025,Kumari Jayakody,Jaffna,Jaffna,Northern,4396,2544,6940,175840,101760,277600
1/10/2025,Kumari Jayakody,Jaffna,Jaffna,Northern,1695,5810,7505,67800,232400,300200
1/11/2025,Kumari Jayakody,Jaffna,Jaffna,Northern,3156,5786,8942,126240,231440,357680
1/12/2025,Kumari Jayakody,Jaffna,Jaffna,Northern,6252,4193,10445,250080,167720,417800
1/13/2025,Kumari Jayakody,Jaffna,Jaffna,Northern,9392,1236,10628,375680,49440,425120
1/14/2025,Kumari Jayakody,Jaffna,Jaffna,Northern,5436,6922,12358,217440,276880,494320
1/15/2025,Kumari Jayakody,Jaffna,Jaffna,Northern,8901,9136,18037,356040,365440,721480
1/16/2025,Kumari Jayakody,Jaffna,Jaffna,Northern,7288,9713,17001,291520,388520,680040
1/17/2025,Kumari Jayakody,Jaffna,Jaffna,Northern,2904,106,3010,116160,4240,120400
1/18/2025,Kumari Jayakody,Jaffna,Jaffna,Northern,7514,9790,17304,300560,391600,692160
1/19/2025,Kumari Jayakody,Jaffna,Jaffna,Northern,8016,7845,15861,320640,313800,634440
1/20/2025,Kumari Jayakody,Jaffna,Jaffna,Northern,8552,5224,13776,342080,208960,551040
1/21/2025,Kumari Jayakody,Jaffna,Jaffna,Northern,2091,562,2653,83640,22480,106120
1/22/2025,Kumari Jayakody,Jaffna,Jaffna,Northern,409,3784,4193,16360,151360,167720
1/23/2025,Kumari Jayakody,Jaffna,Jaffna,Northern,3816,8708,12524,152640,348320,500960
1/24/2025,Kumari Jayakody,Jaffna,Jaffna,Northern,9765,8369,18134,390600,334760,725360
1/25/2025,Kumari Jayakody,Jaffna,Jaffna,Northern,388,328,716,15520,13120,28640
1/26/2025,Kumari Jayakody,Jaffna,Jaffna,Northern,3754,4095,7849,150160,163800,313960
1/27/2025,Kumari Jayakody,Jaffna,Jaffna,Northern,7968,8246,16214,318720,329840,648560
1/28/2025,Kumari Jayakody,Jaffna,Jaffna,Northern,5833,6373,12206,233320,254920,488240
1/29/2025,Kumari Jayakody,Jaffna,Jaffna,Northern,5816,8385,14201,232640,335400,568040
1/30/2025,Kumari Jayakody,Jaffna,Jaffna,Northern,4287,6338,10625,171480,253520,425000
1/31/2025,Kumari Jayakody,Jaffna,Jaffna,Northern,2858,2093,4951,114320,83720,198040
2/1/2025,Kumari Jayakody,Jaffna,Jaffna,Northern,869,119,988,34760,4760,39520
2/2/2025,Kumari Jayakody,Jaffna,Jaffna,Northern,1755,2034,3789,70200,81360,151560
2/3/2025,Kumari Jayakody,Jaffna,Jaffna,Northern,7853,5935,13788,314120,237400,551520
2/4/2025,Kumari Jayakody,Jaffna,Jaffna,Northern,3808,9524,13332,152320,380960,533280
2/5/2025,Kumari Jayakody,Jaffna,Jaffna,Northern,4284,3714,7998,171360,148560,319920
2/6/2025,Kumari Jayakody,Jaffna,Jaffna,Northern,1480,5550,7030,59200,222000,281200
2/7/2025,Kumari Jayakody,Jaffna,Jaffna,Northern,4099,7858,11957,163960,314320,478280
2/8/2025,Kumari Jayakody,Jaffna,Jaffna,Northern,991,940,1931,39640,37600,77240
2/9/2025,Kumari Jayakody,Jaffna,Jaffna,Northern,6437,1093,7530,257480,43720,301200
2/10/2025,Kumari Jayakody,Jaffna,Jaffna,Northern,2013,6594,8607,80520,263760,344280
2/11/2025,Kumari Jayakody,Jaffna,Jaffna,Northern,9233,9348,18581,369320,373920,743240
2/12/2025,Kumari Jayakody,Jaffna,Jaffna,Northern,4836,7193,12029,193440,287720,481160
2/13/2025,Kumari Jayakody,Jaffna,Jaffna,Northern,9820,1953,11773,392800,78120,470920
2/14/2025,Kumari Jayakody,Jaffna,Jaffna,Northern,1060,9619,10679,42400,384760,427160
2/15/2025,Kumari Jayakody,Jaffna,Jaffna,Northern,8104,8693,16797,324160,347720,671880
2/16/2025,Kumari Jayakody,Jaffna,Jaffna,Northern,3869,454,4323,154760,18160,172920
2/17/2025,Kumari Jayakody,Jaffna,Jaffna,Northern,7795,2807,10602,311800,112280,424080
2/18/2025,Kumari Jayakody,Jaffna,Jaffna,Northern,1729,1857,3586,69160,74280,143440
2/19/2025,Kumari Jayakody,Jaffna,Jaffna,Northern,2613,2887,5500,104520,115480,220000
2/20/2025,Kumari Jayakody,Jaffna,Jaffna,Northern,3668,3892,7560,146720,155680,302400
2/21/2025,Kumari Jayakody,Jaffna,Jaffna,Northern,6360,866,7226,254400,34640,289040
2/22/2025,Kumari Jayakody,Jaffna,Jaffna,Northern,7072,4856,11928,282880,194240,477120
2/23/2025,Kumari Jayakody,Jaffna,Jaffna,Northern,1290,6471,7761,51600,258840,310440
2/24/2025,Kumari Jayakody,Jaffna,Jaffna,Northern,3036,2770,5806,121440,110800,232240
2/25/2025,Kumari Jayakody,Jaffna,Jaffna,Northern,2223,7471,9694,88920,298840,387760
2/26/2025,Kumari Jayakody,Jaffna,Jaffna,Northern,210,8938,9148,8400,357520,365920
2/27/2025,Kumari Jayakody,Jaffna,Jaffna,Northern,6105,4121,10226,244200,164840,409040
2/28/2025,Kumari Jayakody,Jaffna,Jaffna,Northern,2148,9798,11946,85920,391920,477840
3/1/2025,Kumari Jayakody,Jaffna,Jaffna,Northern,9586,6768,16354,383440,270720,654160
3/2/2025,Kumari Jayakody,Jaffna,Jaffna,Northern,2318,6357,8675,92720,254280,347000
3/3/2025,Kumari Jayakody,Jaffna,Jaffna,Northern,4510,9551,14061,180400,382040,562440
3/4/2025,Kumari Jayakody,Jaffna,Jaffna,Northern,5691,1126,6817,227640,45040,272680
3/5/2025,Kumari Jayakody,Jaffna,Jaffna,Northern,6992,7278,14270,279680,291120,570800
3/6/2025,Kumari Jayakody,Jaffna,Jaffna,Northern,5371,2858,8229,214840,114320,329160
3/7/2025,Kumari Jayakody,Jaffna,Jaffna,Northern,3068,7080,10148,122720,283200,405920
3/8/2025,Kumari Jayakody,Jaffna,Jaffna,Northern,6595,3839,10434,263800,153560,417360
3/9/2025,Kumari Jayakody,Jaffna,Jaffna,Northern,1149,5651,6800,45960,226040,272000
3/10/2025,Kumari Jayakody,Jaffna,Jaffna,Northern,2270,455,2725,90800,18200,109000
3/11/2025,Kumari Jayakody,Jaffna,Jaffna,Northern,7714,7791,15505,308560,311640,620200
3/12/2025,Kumari Jayakody,Jaffna,Jaffna,Northern,8931,4292,13223,357240,171680,528920
3/13/2025,Kumari Jayakody,Jaffna,Jaffna,Northern,7297,3642,10939,291880,145680,437560
3/14/2025,Kumari Jayakody,Jaffna,Jaffna,Northern,9684,7437,17121,387360,297480,684840
3/15/2025,Kumari Jayakody,Jaffna,Jaffna,Northern,2154,7919,10073,86160,316760,402920
3/16/2025,Kumari Jayakody,Jaffna,Jaffna,Northern,273,2327,2600,10920,93080,104000
3/17/2025,Kumari Jayakody,Jaffna,Jaffna,Northern,459,1661,2120,18360,66440,84800
3/18/2025,Kumari Jayakody,Jaffna,Jaffna,Northern,7573,7160,14733,302920,286400,589320
3/19/2025,Kumari Jayakody,Jaffna,Jaffna,Northern,7729,8483,16212,309160,339320,648480
3/20/2025,Kumari Jayakody,Jaffna,Jaffna,Northern,561,6481,7042,22440,259240,281680
3/21/2025,Kumari Jayakody,Jaffna,Jaffna,Northern,2817,1420,4237,112680,56800,169480
3/22/2025,Kumari Jayakody,Jaffna,Jaffna,Northern,7134,5872,13006,285360,234880,520240
3/23/2025,Kumari Jayakody,Jaffna,Jaffna,Northern,6964,4415,11379,278560,176600,455160
3/25/2024,Ravi Amarasinghe,Kandy,Teldeniya,Central,5217,3535,8752,208680,141400,350080
3/26/2024,Ravi Amarasinghe,Kandy,Teldeniya,Central,3115,9141,12256,124600,365640,490240
3/27/2024,Ravi Amarasinghe,Kandy,Teldeniya,Central,5621,852,6473,224840,34080,258920
3/28/2024,Ravi Amarasinghe,Kandy,Teldeniya,Central,9216,5594,14810,368640,223760,592400
3/29/2024,Ravi Amarasinghe,Kandy,Teldeniya,Central,3334,7267,10601,133360,290680,424040
3/30/2024,Ravi Amarasinghe,Kandy,Teldeniya,Central,3312,9928,13240,132480,397120,529600
3/31/2024,Ravi Amarasinghe,Kandy,Teldeniya,Central,2862,3837,6699,114480,153480,267960
4/1/2024,Ravi Amarasinghe,Kandy,Teldeniya,Central,7408,9799,17207,296320,391960,688280
4/2/2024,Ravi Amarasinghe,Kandy,Teldeniya,Central,716,3343,4059,28640,133720,162360
4/3/2024,Ravi Amarasinghe,Kandy,Teldeniya,Central,5483,627,6110,219320,25080,244400
4/4/2024,Ravi Amarasinghe,Kandy,Teldeniya,Central,4390,6748,11138,175600,269920,445520
4/5/2024,Ravi Amarasinghe,Kandy,Teldeniya,Central,4014,6652,10666,160560,266080,426640
4/6/2024,Ravi Amarasinghe,Kandy,Teldeniya,Central,7882,3781,11663,315280,151240,466520
4/7/2024,Ravi Amarasinghe,Kandy,Teldeniya,Central,588,9444,10032,23520,377760,401280
4/8/2024,Ravi Amarasinghe,Kandy,Teldeniya,Central,6236,2641,8877,249440,105640,355080
4/9/2024,Ravi Amarasinghe,Kandy,Teldeniya,Central,6957,4143,11100,278280,165720,444000
4/10/2024,Ravi Amarasinghe,Kandy,Teldeniya,Central,7351,8008,15359,294040,320320,614360
4/11/2024,Ravi Amarasinghe,Kandy,Teldeniya,Central,6271,4792,11063,250840,191680,442520
4/19/2024,Ravi Amarasinghe,Kandy,Teldeniya,Central,7938,8280,16218,317520,331200,648720
4/20/2024,Ravi Amarasinghe,Kandy,Teldeniya,Central,6724,7009,13733,268960,280360,549320
4/21/2024,Ravi Amarasinghe,Kandy,Teldeniya,Central,8828,8127,16955,353120,325080,678200
4/22/2024,Ravi Amarasinghe,Kandy,Teldeniya,Central,7625,9549,17174,305000,381960,686960
4/23/2024,Ravi Amarasinghe,Kandy,Teldeniya,Central,1384,6439,7823,55360,257560,312920
4/24/2024,Ravi Amarasinghe,Kandy,Teldeniya,Central,1306,6308,7614,52240,252320,304560
4/25/2024,Ravi Amarasinghe,Kandy,Teldeniya,Central,9825,1055,10880,393000,42200,435200
4/26/2024,Ravi Amarasinghe,Kandy,Teldeniya,Central,4073,4930,9003,162920,197200,360120
4/27/2024,Ravi Amarasinghe,Kandy,Teldeniya,Central,903,767,1670,36120,30680,66800
4/28/2024,Ravi Amarasinghe,Kandy,Teldeniya,Central,3628,2175,5803,145120,87000,232120
4/29/2024,Ravi Amarasinghe,Kandy,Teldeniya,Central,2522,6333,8855,100880,253320,354200
4/30/2024,Ravi Amarasinghe,Kandy,Teldeniya,Central,4886,7270,12156,195440,290800,486240
5/1/2024,Ravi Amarasinghe,Kandy,Teldeniya,Central,1327,2805,4132,53080,112200,165280
5/2/2024,Ravi Amarasinghe,Kandy,Teldeniya,Central,953,9219,10172,38120,368760,406880
5/3/2024,Ravi Amarasinghe,Kandy,Teldeniya,Central,6237,2298,8535,249480,91920,341400
5/4/2024,Ravi Amarasinghe,Kandy,Teldeniya,Central,5050,3089,8139,202000,123560,325560
5/5/2024,Ravi Amarasinghe,Kandy,Teldeniya,Central,3864,2930,6794,154560,117200,271760
5/6/2024,Ravi Amarasinghe,Kandy,Teldeniya,Central,3570,609,4179,142800,24360,167160
5/7/2024,Ravi Amarasinghe,Kandy,Teldeniya,Central,9038,2692,11730,361520,107680,469200
5/8/2024,Ravi Amarasinghe,Kandy,Teldeniya,Central,3267,7006,10273,130680,280240,410920
5/9/2024,Ravi Amarasinghe,Kandy,Teldeniya,Central,818,2658,3476,32720,106320,139040
5/10/2024,Ravi Amarasinghe,Kandy,Teldeniya,Central,5060,2440,7500,202400,97600,300000
5/11/2024,Ravi Amarasinghe,Kandy,Teldeniya,Central,4,7601,7605,160,304040,304200
5/12/2024,Ravi Amarasinghe,Kandy,Teldeniya,Central,5183,6549,11732,207320,261960,469280
5/13/2024,Ravi Amarasinghe,Kandy,Teldeniya,Central,8764,2185,10949,350560,87400,437960
5/14/2024,Ravi Amarasinghe,Kandy,Teldeniya,Central,721,6444,7165,28840,257760,286600
5/15/2024,Ravi Amarasinghe,Kandy,Teldeniya,Central,1731,2526,4257,69240,101040,170280
5/16/2024,Ravi Amarasinghe,Kandy,Teldeniya,Central,1466,5416,6882,58640,216640,275280
5/17/2024,Ravi Amarasinghe,Kandy,Teldeniya,Central,8209,8570,16779,328360,342800,671160
5/18/2024,Ravi Amarasinghe,Kandy,Teldeniya,Central,7933,929,8862,317320,37160,354480
5/19/2024,Ravi Amarasinghe,Kandy,Teldeniya,Central,4436,6002,10438,177440,240080,417520
5/20/2024,Ravi Amarasinghe,Kandy,Teldeniya,Central,1655,2891,4546,66200,115640,181840
5/21/2024,Ravi Amarasinghe,Kandy,Teldeniya,Central,6899,4396,11295,275960,175840,451800
5/22/2024,Ravi Amarasinghe,Kandy,Teldeniya,Central,9390,7384,16774,375600,295360,670960
5/24/2024,Ravi Amarasinghe,Kandy,Teldeniya,Central,3512,8891,12403,140480,355640,496120
5/25/2024,Ravi Amarasinghe,Kandy,Teldeniya,Central,5346,5750,11096,213840,230000,443840
5/26/2024,Ravi Amarasinghe,Kandy,Teldeniya,Central,4808,2599,7407,192320,103960,296280
5/27/2024,Ravi Amarasinghe,Kandy,Teldeniya,Central,7596,4937,12533,303840,197480,501320
5/28/2024,Ravi Amarasinghe,Kandy,Teldeniya,Central,9233,560,9793,369320,22400,391720
5/29/2024,Ravi Amarasinghe,Kandy,Teldeniya,Central,7410,910,8320,296400,36400,332800
5/30/2024,Ravi Amarasinghe,Kandy,Teldeniya,Central,9042,7768,16810,361680,310720,672400
5/31/2024,Ravi Amarasinghe,Kandy,Teldeniya,Central,3234,2713,5947,129360,108520,237880
6/1/2024,Ravi Amarasinghe,Kandy,Teldeniya,Central,3695,6007,9702,147800,240280,388080
6/2/2024,Ravi Amarasinghe,Kandy,Teldeniya,Central,8418,9371,17789,336720,374840,711560
6/3/2024,Ravi Amarasinghe,Kandy,Teldeniya,Central,6104,7804,13908,244160,312160,556320
6/4/2024,Ravi Amarasinghe,Kandy,Teldeniya,Central,7765,6568,14333,310600,262720,573320
6/5/2024,Ravi Amarasinghe,Kandy,Teldeniya,Central,8843,4291,13134,353720,171640,525360
6/6/2024,Ravi Amarasinghe,Kandy,Teldeniya,Central,4875,8270,13145,195000,330800,525800
6/7/2024,Ravi Amarasinghe,Kandy,Teldeniya,Central,4110,2131,6241,164400,85240,249640
6/8/2024,Ravi Amarasinghe,Kandy,Teldeniya,Central,7666,9938,17604,306640,397520,704160
6/9/2024,Ravi Amarasinghe,Kandy,Teldeniya,Central,7015,8055,15070,280600,322200,602800
6/10/2024,Ravi Amarasinghe,Kandy,Teldeniya,Central,5253,8718,13971,210120,348720,558840
6/11/2024,Ravi Amarasinghe,Kandy,Teldeniya,Central,7403,6421,13824,296120,256840,552960
6/12/2024,Ravi Amarasinghe,Kandy,Teldeniya,Central,1185,6216,7401,47400,248640,296040
6/13/2024,Ravi Amarasinghe,Kandy,Teldeniya,Central,4308,8507,12815,172320,340280,512600
6/14/2024,Ravi Amarasinghe,Kandy,Teldeniya,Central,6854,1593,8447,274160,63720,337880
6/15/2024,Ravi Amarasinghe,Kandy,Teldeniya,Central,4452,6694,11146,178080,267760,445840
6/16/2024,Ravi Amarasinghe,Kandy,Teldeniya,Central,9413,2345,11758,376520,93800,470320
6/17/2024,Ravi Amarasinghe,Kandy,Teldeniya,Central,1473,9595,11068,58920,383800,442720
6/18/2024,Ravi Amarasinghe,Kandy,Teldeniya,Central,4581,8493,13074,183240,339720,522960
6/19/2024,Ravi Amarasinghe,Kandy,Teldeniya,Central,8426,7219,15645,337040,288760,625800
6/20/2024,Ravi Amarasinghe,Kandy,Teldeniya,Central,1522,1195,2717,60880,47800,108680
6/21/2024,Ravi Amarasinghe,Kandy,Teldeniya,Central,4608,1408,6016,184320,56320,240640
6/22/2024,Ravi Amarasinghe,Kandy,Teldeniya,Central,402,240,642,16080,9600,25680
6/23/2024,Ravi Amarasinghe,Kandy,Teldeniya,Central,2561,6777,9338,102440,271080,373520
6/24/2024,Ravi Amarasinghe,Kandy,Teldeniya,Central,3580,294,3874,143200,11760,154960
6/25/2024,Ravi Amarasinghe,Kandy,Teldeniya,Central,5667,1189,6856,226680,47560,274240
6/26/2024,Ravi Amarasinghe,Kandy,Teldeniya,Central,4692,4301,8993,187680,172040,359720
6/27/2024,Ravi Amarasinghe,Kandy,Teldeniya,Central,4698,5959,10657,187920,238360,426280
6/28/2024,Ravi Amarasinghe,Kandy,Teldeniya,Central,6339,8898,15237,253560,355920,609480
6/29/2024,Ravi Amarasinghe,Kandy,Teldeniya,Central,3625,7674,11299,145000,306960,451960
6/30/2024,Ravi Amarasinghe,Kandy,Teldeniya,Central,1157,3600,4757,46280,144000,190280
7/1/2024,Ravi Amarasinghe,Kandy,Teldeniya,Central,1826,1038,2864,73040,41520,114560
7/2/2024,Ravi Amarasinghe,Kandy,Teldeniya,Central,6701,6130,12831,268040,245200,513240
7/3/2024,Ravi Amarasinghe,Kandy,Teldeniya,Central,3159,5214,8373,126360,208560,334920
7/4/2024,Ravi Amarasinghe,Kandy,Teldeniya,Central,1058,4479,5537,42320,179160,221480
7/5/2024,Ravi Amarasinghe,Kandy,Teldeniya,Central,1914,2424,4338,76560,96960,173520
7/6/2024,Ravi Amarasinghe,Kandy,Teldeniya,Central,2944,4163,7107,117760,166520,284280
7/7/2024,Ravi Amarasinghe,Kandy,Teldeniya,Central,4508,8395,12903,180320,335800,516120
7/8/2024,Ravi Amarasinghe,Kandy,Teldeniya,Central,8087,5236,13323,323480,209440,532920
7/9/2024,Ravi Amarasinghe,Kandy,Teldeniya,Central,4235,6803,11038,169400,272120,441520
7/10/2024,Ravi Amarasinghe,Kandy,Teldeniya,Central,1056,9806,10862,42240,392240,434480
7/11/2024,Ravi Amarasinghe,Kandy,Teldeniya,Central,7255,1061,8316,290200,42440,332640
7/12/2024,Ravi Amarasinghe,Kandy,Teldeniya,Central,4140,8484,12624,165600,339360,504960
7/13/2024,Ravi Amarasinghe,Kandy,Teldeniya,Central,2560,6150,8710,102400,246000,348400
7/14/2024,Ravi Amarasinghe,Kandy,Teldeniya,Central,3693,9780,13473,147720,391200,538920
7/15/2024,Ravi Amarasinghe,Kandy,Teldeniya,Central,9625,4002,13627,385000,160080,545080
7/16/2024,Ravi Amarasinghe,Kandy,Teldeniya,Central,6251,1828,8079,250040,73120,323160
7/17/2024,Ravi Amarasinghe,Kandy,Teldeniya,Central,9079,1630,10709,363160,65200,428360
7/18/2024,Ravi Amarasinghe,Kandy,Teldeniya,Central,4076,3373,7449,163040,134920,297960
7/19/2024,Ravi Amarasinghe,Kandy,Teldeniya,Central,4251,7879,12130,170040,315160,485200
7/20/2024,Ravi Amarasinghe,Kandy,Teldeniya,Central,2212,8616,10828,88480,344640,433120
7/21/2024,Ravi Amarasinghe,Kandy,Teldeniya,Central,7816,9607,17423,312640,384280,696920
7/22/2024,Ravi Amarasinghe,Kandy,Teldeniya,Central,9126,8803,17929,365040,352120,717160
7/23/2024,Ravi Amarasinghe,Kandy,Teldeniya,Central,648,1733,2381,25920,69320,95240
7/24/2024,Ravi Amarasinghe,Kandy,Teldeniya,Central,9884,2281,12165,395360,91240,486600
7/25/2024,Ravi Amarasinghe,Kandy,Teldeniya,Central,217,8534,8751,8680,341360,350040
7/26/2024,Ravi Amarasinghe,Kandy,Teldeniya,Central,8203,3345,11548,328120,133800,461920
7/27/2024,Ravi Amarasinghe,Kandy,Teldeniya,Central,2987,7854,10841,119480,314160,433640
7/28/2024,Ravi Amarasinghe,Kandy,Teldeniya,Central,4844,265,5109,193760,10600,204360
7/29/2024,Ravi Amarasinghe,Kandy,Teldeniya,Central,9335,7248,16583,373400,289920,663320
7/30/2024,Ravi Amarasinghe,Kandy,Teldeniya,Central,8759,2699,11458,350360,107960,458320
7/31/2024,Ravi Amarasinghe,Kandy,Teldeniya,Central,1258,3282,4540,50320,131280,181600
8/1/2024,Ravi Amarasinghe,Kandy,Teldeniya,Central,9599,5994,15593,383960,239760,623720
8/2/2024,Ravi Amarasinghe,Kandy,Teldeniya,Central,9610,5714,15324,384400,228560,612960
8/3/2024,Ravi Amarasinghe,Kandy,Teldeniya,Central,120,5668,5788,4800,226720,231520
8/4/2024,Ravi Amarasinghe,Kandy,Teldeniya,Central,1257,151,1408,50280,6040,56320
8/5/2024,Ravi Amarasinghe,Kandy,Teldeniya,Central,1878,4384,6262,75120,175360,250480
8/6/2024,Ravi Amarasinghe,Kandy,Teldeniya,Central,7374,3697,11071,294960,147880,442840
8/7/2024,Ravi Amarasinghe,Kandy,Teldeniya,Central,9542,2721,12263,381680,108840,490520
8/8/2024,Ravi Amarasinghe,Kandy,Teldeniya,Central,9181,3201,12382,367240,128040,495280
8/9/2024,Ravi Amarasinghe,Kandy,Teldeniya,Central,3812,6653,10465,152480,266120,418600
8/10/2024,Ravi Amarasinghe,Kandy,Teldeniya,Central,4455,5765,10220,178200,230600,408800
8/11/2024,Ravi Amarasinghe,Kandy,Teldeniya,Central,9039,9434,18473,361560,377360,738920
8/12/2024,Ravi Amarasinghe,Kandy,Teldeniya,Central,6924,3644,10568,276960,145760,422720
8/13/2024,Ravi Amarasinghe,Kandy,Teldeniya,Central,5523,375,5898,220920,15000,235920
8/14/2024,Ravi Amarasinghe,Kandy,Teldeniya,Central,6344,5319,11663,253760,212760,466520
8/15/2024,Ravi Amarasinghe,Kandy,Teldeniya,Central,2861,6782,9643,114440,271280,385720
8/16/2024,Ravi Amarasinghe,Kandy,Teldeniya,Central,4610,2401,7011,184400,96040,280440
8/17/2024,Ravi Amarasinghe,Kandy,Teldeniya,Central,9403,3517,12920,376120,140680,516800
8/18/2024,Ravi Amarasinghe,Kandy,Teldeniya,Central,8360,8711,17071,334400,348440,682840
8/19/2024,Ravi Amarasinghe,Kandy,Teldeniya,Central,5278,3360,8638,211120,134400,345520
8/20/2024,Ravi Amarasinghe,Kandy,Teldeniya,Central,8358,7748,16106,334320,309920,644240
8/21/2024,Ravi Amarasinghe,Kandy,Teldeniya,Central,156,3524,3680,6240,140960,147200
8/22/2024,Ravi Amarasinghe,Kandy,Teldeniya,Central,9751,2474,12225,390040,98960,489000
8/23/2024,Ravi Amarasinghe,Kandy,Teldeniya,Central,940,4843,5783,37600,193720,231320
8/24/2024,Ravi Amarasinghe,Kandy,Teldeniya,Central,6142,9706,15848,245680,388240,633920
8/25/2024,Ravi Amarasinghe,Kandy,Teldeniya,Central,7818,4922,12740,312720,196880,509600
8/26/2024,Ravi Amarasinghe,Kandy,Teldeniya,Central,2651,4431,7082,106040,177240,283280
8/27/2024,Ravi Amarasinghe,Kandy,Teldeniya,Central,9061,9579,18640,362440,383160,745600
8/28/2024,Ravi Amarasinghe,Kandy,Teldeniya,Central,6280,9473,15753,251200,378920,630120
8/29/2024,Ravi Amarasinghe,Kandy,Teldeniya,Central,547,8118,8665,21880,324720,346600
8/30/2024,Ravi Amarasinghe,Kandy,Teldeniya,Central,1312,1354,2666,52480,54160,106640
8/31/2024,Ravi Amarasinghe,Kandy,Teldeniya,Central,1263,3560,4823,50520,142400,192920
9/1/2024,Ravi Amarasinghe,Kandy,Teldeniya,Central,4810,1493,6303,192400,59720,252120
9/2/2024,Ravi Amarasinghe,Kandy,Teldeniya,Central,785,7554,8339,31400,302160,333560
9/3/2024,Ravi Amarasinghe,Kandy,Teldeniya,Central,3574,8824,12398,142960,352960,495920
9/4/2024,Ravi Amarasinghe,Kandy,Teldeniya,Central,4286,4824,9110,171440,192960,364400
9/5/2024,Ravi Amarasinghe,Kandy,Teldeniya,Central,7969,7774,15743,318760,310960,629720
9/6/2024,Ravi Amarasinghe,Kandy,Teldeniya,Central,7495,8151,15646,299800,326040,625840
9/7/2024,Ravi Amarasinghe,Kandy,Teldeniya,Central,7759,9302,17061,310360,372080,682440
9/8/2024,Ravi Amarasinghe,Kandy,Teldeniya,Central,5748,1574,7322,229920,62960,292880
9/9/2024,Ravi Amarasinghe,Kandy,Teldeniya,Central,3284,8741,12025,131360,349640,481000
9/10/2024,Ravi Amarasinghe,Kandy,Teldeniya,Central,9151,5140,14291,366040,205600,571640
9/11/2024,Ravi Amarasinghe,Kandy,Teldeniya,Central,2654,1563,4217,106160,62520,168680
9/12/2024,Ravi Amarasinghe,Kandy,Teldeniya,Central,3384,5720,9104,135360,228800,364160
9/13/2024,Ravi Amarasinghe,Kandy,Teldeniya,Central,4516,1927,6443,180640,77080,257720
9/14/2024,Ravi Amarasinghe,Kandy,Teldeniya,Central,9335,9719,19054,373400,388760,762160
9/15/2024,Ravi Amarasinghe,Kandy,Teldeniya,Central,2617,7100,9717,104680,284000,388680
9/16/2024,Ravi Amarasinghe,Kandy,Teldeniya,Central,3320,4706,8026,132800,188240,321040
9/17/2024,Ravi Amarasinghe,Kandy,Teldeniya,Central,9169,9246,18415,366760,369840,736600
9/18/2024,Ravi Amarasinghe,Kandy,Teldeniya,Central,5243,9916,15159,209720,396640,606360
9/19/2024,Ravi Amarasinghe,Kandy,Teldeniya,Central,1902,3477,5379,76080,139080,215160
9/20/2024,Ravi Amarasinghe,Kandy,Teldeniya,Central,2125,3025,5150,85000,121000,206000
9/21/2024,Ravi Amarasinghe,Kandy,Teldeniya,Central,2967,3294,6261,118680,131760,250440
9/22/2024,Ravi Amarasinghe,Kandy,Teldeniya,Central,9148,6236,15384,365920,249440,615360
9/23/2024,Ravi Amarasinghe,Kandy,Teldeniya,Central,5887,1153,7040,235480,46120,281600
9/24/2024,Ravi Amarasinghe,Kandy,Teldeniya,Central,1350,124,1474,54000,4960,58960
9/25/2024,Ravi Amarasinghe,Kandy,Teldeniya,Central,1089,5907,6996,43560,236280,279840
9/26/2024,Ravi Amarasinghe,Kandy,Teldeniya,Central,2010,3999,6009,80400,159960,240360
9/27/2024,Ravi Amarasinghe,Kandy,Teldeniya,Central,31,9756,9787,1240,390240,391480
9/28/2024,Ravi Amarasinghe,Kandy,Teldeniya,Central,719,925,1644,28760,37000,65760
9/29/2024,Ravi Amarasinghe,Kandy,Teldeniya,Central,6296,4235,10531,251840,169400,421240
9/30/2024,Ravi Amarasinghe,Kandy,Teldeniya,Central,6944,5745,12689,277760,229800,507560
10/1/2024,Ravi Amarasinghe,Kandy,Teldeniya,Central,4634,8120,12754,185360,324800,510160
10/2/2024,Ravi Amarasinghe,Kandy,Teldeniya,Central,4031,4564,8595,161240,182560,343800
10/3/2024,Ravi Amarasinghe,Kandy,Teldeniya,Central,3329,3256,6585,133160,130240,263400
10/4/2024,Ravi Amarasinghe,Kandy,Teldeniya,Central,6790,1359,8149,271600,54360,325960
10/5/2024,Ravi Amarasinghe,Kandy,Teldeniya,Central,4498,7286,11784,179920,291440,471360
10/6/2024,Ravi Amarasinghe,Kandy,Teldeniya,Central,9123,2606,11729,364920,104240,469160
10/7/2024,Ravi Amarasinghe,Kandy,Teldeniya,Central,6606,8777,15383,264240,351080,615320
10/8/2024,Ravi Amarasinghe,Kandy,Teldeniya,Central,1373,5005,6378,54920,200200,255120
10/9/2024,Ravi Amarasinghe,Kandy,Teldeniya,Central,3215,9426,12641,128600,377040,505640
10/10/2024,Ravi Amarasinghe,Kandy,Teldeniya,Central,9470,7918,17388,378800,316720,695520
10/11/2024,Ravi Amarasinghe,Kandy,Teldeniya,Central,8624,8726,17350,344960,349040,694000
10/12/2024,Ravi Amarasinghe,Kandy,Teldeniya,Central,8819,3220,12039,352760,128800,481560
10/13/2024,Ravi Amarasinghe,Kandy,Teldeniya,Central,5486,9440,14926,219440,377600,597040
10/14/2024,Ravi Amarasinghe,Kandy,Teldeniya,Central,1907,3786,5693,76280,151440,227720
10/15/2024,Ravi Amarasinghe,Kandy,Teldeniya,Central,586,3857,4443,23440,154280,177720
10/16/2024,Ravi Amarasinghe,Kandy,Teldeniya,Central,6111,3346,9457,244440,133840,378280
10/17/2024,Ravi Amarasinghe,Kandy,Teldeniya,Central,3259,1533,4792,130360,61320,191680
10/18/2024,Ravi Amarasinghe,Kandy,Teldeniya,Central,3331,2392,5723,133240,95680,228920
10/19/2024,Ravi Amarasinghe,Kandy,Teldeniya,Central,3678,1980,5658,147120,79200,226320
10/20/2024,Ravi Amarasinghe,Kandy,Teldeniya,Central,3385,5444,8829,135400,217760,353160
10/21/2024,Ravi Amarasinghe,Kandy,Teldeniya,Central,8115,6814,14929,324600,272560,597160
10/22/2024,Ravi Amarasinghe,Kandy,Teldeniya,Central,2285,939,3224,91400,37560,128960
10/23/2024,Ravi Amarasinghe,Kandy,Teldeniya,Central,69,9233,9302,2760,369320,372080
10/24/2024,Ravi Amarasinghe,Kandy,Teldeniya,Central,8636,1785,10421,345440,71400,416840
10/25/2024,Ravi Amarasinghe,Kandy,Teldeniya,Central,511,8524,9035,20440,340960,361400
10/26/2024,Ravi Amarasinghe,Kandy,Teldeniya,Central,716,1352,2068,28640,54080,82720
10/27/2024,Ravi Amarasinghe,Kandy,Teldeniya,Central,7627,8688,16315,305080,347520,652600
10/28/2024,Ravi Amarasinghe,Kandy,Teldeniya,Central,2303,9237,11540,92120,369480,461600
10/29/2024,Ravi Amarasinghe,Kandy,Teldeniya,Central,1771,4834,6605,70840,193360,264200
10/30/2024,Ravi Amarasinghe,Kandy,Teldeniya,Central,3502,853,4355,140080,34120,174200
10/31/2024,Ravi Amarasinghe,Kandy,Teldeniya,Central,3198,6737,9935,127920,269480,397400
11/1/2024,Ravi Amarasinghe,Kandy,Teldeniya,Central,22,8807,8829,880,352280,353160
11/2/2024,Ravi Amarasinghe,Kandy,Teldeniya,Central,2296,3859,6155,91840,154360,246200
11/3/2024,Ravi Amarasinghe,Kandy,Teldeniya,Central,7786,5513,13299,311440,220520,531960
11/4/2024,Ravi Amarasinghe,Kandy,Teldeniya,Central,5665,6932,12597,226600,277280,503880
11/5/2024,Ravi Amarasinghe,Kandy,Teldeniya,Central,9268,9618,18886,370720,384720,755440
11/6/2024,Ravi Amarasinghe,Kandy,Teldeniya,Central,3306,3592,6898,132240,143680,275920
11/7/2024,Ravi Amarasinghe,Kandy,Teldeniya,Central,9420,3688,13108,376800,147520,524320
11/8/2024,Ravi Amarasinghe,Kandy,Teldeniya,Central,7361,2049,9410,294440,81960,376400
11/9/2024,Ravi Amarasinghe,Kandy,Teldeniya,Central,3246,5216,8462,129840,208640,338480
11/10/2024,Ravi Amarasinghe,Kandy,Teldeniya,Central,8203,1243,9446,328120,49720,377840
11/11/2024,Ravi Amarasinghe,Kandy,Teldeniya,Central,5562,1165,6727,222480,46600,269080
11/12/2024,Ravi Amarasinghe,Kandy,Teldeniya,Central,6063,4481,10544,242520,179240,421760
11/13/2024,Ravi Amarasinghe,Kandy,Teldeniya,Central,8403,1570,9973,336120,62800,398920
11/14/2024,Ravi Amarasinghe,Kandy,Teldeniya,Central,5869,5288,11157,234760,211520,446280
11/15/2024,Ravi Amarasinghe,Kandy,Teldeniya,Central,2794,2101,4895,111760,84040,195800
11/16/2024,Ravi Amarasinghe,Kandy,Teldeniya,Central,4771,1405,6176,190840,56200,247040
11/17/2024,Ravi Amarasinghe,Kandy,Teldeniya,Central,5150,8801,13951,206000,352040,558040
11/18/2024,Ravi Amarasinghe,Kandy,Teldeniya,Central,9624,2436,12060,384960,97440,482400
11/19/2024,Ravi Amarasinghe,Kandy,Teldeniya,Central,2648,2376,5024,105920,95040,200960
11/20/2024,Ravi Amarasinghe,Kandy,Teldeniya,Central,1418,7511,8929,56720,300440,357160
11/21/2024,Ravi Amarasinghe,Kandy,Teldeniya,Central,2812,9825,12637,112480,393000,505480
11/22/2024,Ravi Amarasinghe,Kandy,Teldeniya,Central,2493,3410,5903,99720,136400,236120
11/23/2024,Ravi Amarasinghe,Kandy,Teldeniya,Central,2484,7770,10254,99360,310800,410160
11/24/2024,Ravi Amarasinghe,Kandy,Teldeniya,Central,8958,7661,16619,358320,306440,664760
11/25/2024,Ravi Amarasinghe,Kandy,Teldeniya,Central,1848,6946,8794,73920,277840,351760
11/26/2024,Ravi Amarasinghe,Kandy,Teldeniya,Central,5561,2202,7763,222440,88080,310520
11/27/2024,Ravi Amarasinghe,Kandy,Teldeniya,Central,1187,7975,9162,47480,319000,366480
11/28/2024,Ravi Amarasinghe,Kandy,Teldeniya,Central,610,7020,7630,24400,280800,305200
11/29/2024,Ravi Amarasinghe,Kandy,Teldeniya,Central,9480,2878,12358,379200,115120,494320
11/30/2024,Ravi Amarasinghe,Kandy,Teldeniya,Central,2527,1445,3972,101080,57800,158880
12/1/2024,Ravi Amarasinghe,Kandy,Teldeniya,Central,8432,2121,10553,337280,84840,422120
12/2/2024,Ravi Amarasinghe,Kandy,Teldeniya,Central,2138,4343,6481,85520,173720,259240
12/3/2024,Ravi Amarasinghe,Kandy,Teldeniya,Central,8077,8396,16473,323080,335840,658920
12/4/2024,Ravi Amarasinghe,Kandy,Teldeniya,Central,4808,3204,8012,192320,128160,320480
12/5/2024,Ravi Amarasinghe,Kandy,Teldeniya,Central,3277,1071,4348,131080,42840,173920
12/6/2024,Ravi Amarasinghe,Kandy,Teldeniya,Central,4092,8181,12273,163680,327240,490920
12/7/2024,Ravi Amarasinghe,Kandy,Teldeniya,Central,326,7659,7985,13040,306360,319400
12/8/2024,Ravi Amarasinghe,Kandy,Teldeniya,Central,4877,55,4932,195080,2200,197280
12/9/2024,Ravi Amarasinghe,Kandy,Teldeniya,Central,6323,5393,11716,252920,215720,468640
12/10/2024,Ravi Amarasinghe,Kandy,Teldeniya,Central,7538,5921,13459,301520,236840,538360
12/11/2024,Ravi Amarasinghe,Kandy,Teldeniya,Central,8425,1153,9578,337000,46120,383120
12/12/2024,Ravi Amarasinghe,Kandy,Teldeniya,Central,1160,3901,5061,46400,156040,202440
12/13/2024,Ravi Amarasinghe,Kandy,Teldeniya,Central,3702,3124,6826,148080,124960,273040
12/14/2024,Ravi Amarasinghe,Kandy,Teldeniya,Central,7831,9609,17440,313240,384360,697600
12/15/2024,Ravi Amarasinghe,Kandy,Teldeniya,Central,8737,5010,13747,349480,200400,549880
12/16/2024,Ravi Amarasinghe,Kandy,Teldeniya,Central,9293,2244,11537,371720,89760,461480
12/17/2024,Ravi Amarasinghe,Kandy,Teldeniya,Central,3305,1292,4597,132200,51680,183880
12/18/2024,Ravi Amarasinghe,Kandy,Teldeniya,Central,3535,499,4034,141400,19960,161360
12/19/2024,Ravi Amarasinghe,Kandy,Teldeniya,Central,8424,9951,18375,336960,398040,735000
12/20/2024,Ravi Amarasinghe,Kandy,Teldeniya,Central,8181,8418,16599,327240,336720,663960
12/21/2024,Ravi Amarasinghe,Kandy,Teldeniya,Central,3212,4623,7835,128480,184920,313400
12/22/2024,Ravi Amarasinghe,Kandy,Teldeniya,Central,5996,4453,10449,239840,178120,417960
12/23/2024,Ravi Amarasinghe,Kandy,Teldeniya,Central,517,2379,2896,20680,95160,115840
12/24/2024,Ravi Amarasinghe,Kandy,Teldeniya,Central,7364,6127,13491,294560,245080,539640
12/25/2024,Ravi Amarasinghe,Kandy,Teldeniya,Central,7373,3094,10467,294920,123760,418680
12/26/2024,Ravi Amarasinghe,Kandy,Teldeniya,Central,9171,8024,17195,366840,320960,687800
12/27/2024,Ravi Amarasinghe,Kandy,Teldeniya,Central,4526,1077,5603,181040,43080,224120
12/28/2024,Ravi Amarasinghe,Kandy,Teldeniya,Central,8162,2352,10514,326480,94080,420560
12/29/2024,Ravi Amarasinghe,Kandy,Teldeniya,Central,2570,8265,10835,102800,330600,433400
12/30/2024,Ravi Amarasinghe,Kandy,Teldeniya,Central,4345,3350,7695,173800,134000,307800
12/31/2024,Ravi Amarasinghe,Kandy,Teldeniya,Central,3959,8077,12036,158360,323080,481440
1/1/2025,Ravi Amarasinghe,Kandy,Teldeniya,Central,9490,2288,11778,379600,91520,471120
1/2/2025,Ravi Amarasinghe,Kandy,Teldeniya,Central,1981,4935,6916,79240,197400,276640
1/3/2025,Ravi Amarasinghe,Kandy,Teldeniya,Central,7655,9668,17323,306200,386720,692920
1/4/2025,Ravi Amarasinghe,Kandy,Teldeniya,Central,7415,5687,13102,296600,227480,524080
1/5/2025,Ravi Amarasinghe,Kandy,Teldeniya,Central,2366,2226,4592,94640,89040,183680
1/6/2025,Ravi Amarasinghe,Kandy,Teldeniya,Central,348,6476,6824,13920,259040,272960
1/7/2025,Ravi Amarasinghe,Kandy,Teldeniya,Central,9496,736,10232,379840,29440,409280
1/8/2025,Ravi Amarasinghe,Kandy,Teldeniya,Central,4069,2699,6768,162760,107960,270720
1/9/2025,Ravi Amarasinghe,Kandy,Teldeniya,Central,8834,1444,10278,353360,57760,411120
1/10/2025,Ravi Amarasinghe,Kandy,Teldeniya,Central,7239,3161,10400,289560,126440,416000
1/11/2025,Ravi Amarasinghe,Kandy,Teldeniya,Central,2125,5817,7942,85000,232680,317680
1/12/2025,Ravi Amarasinghe,Kandy,Teldeniya,Central,1447,996,2443,57880,39840,97720
1/13/2025,Ravi Amarasinghe,Kandy,Teldeniya,Central,4202,5135,9337,168080,205400,373480
1/14/2025,Ravi Amarasinghe,Kandy,Teldeniya,Central,9939,8228,18167,397560,329120,726680
1/15/2025,Ravi Amarasinghe,Kandy,Teldeniya,Central,6277,7094,13371,251080,283760,534840
1/16/2025,Ravi Amarasinghe,Kandy,Teldeniya,Central,5412,9234,14646,216480,369360,585840
1/17/2025,Ravi Amarasinghe,Kandy,Teldeniya,Central,2162,9103,11265,86480,364120,450600
1/18/2025,Ravi Amarasinghe,Kandy,Teldeniya,Central,7948,2044,9992,317920,81760,399680
1/19/2025,Ravi Amarasinghe,Kandy,Teldeniya,Central,4241,262,4503,169640,10480,180120
1/20/2025,Ravi Amarasinghe,Kandy,Teldeniya,Central,7080,9355,16435,283200,374200,657400
1/21/2025,Ravi Amarasinghe,Kandy,Teldeniya,Central,4673,7972,12645,186920,318880,505800
1/22/2025,Ravi Amarasinghe,Kandy,Teldeniya,Central,1078,7742,8820,43120,309680,352800
1/23/2025,Ravi Amarasinghe,Kandy,Teldeniya,Central,1125,4103,5228,45000,164120,209120
1/24/2025,Ravi Amarasinghe,Kandy,Teldeniya,Central,721,8874,9595,28840,354960,383800
1/25/2025,Ravi Amarasinghe,Kandy,Teldeniya,Central,9363,3774,13137,374520,150960,525480
1/26/2025,Ravi Amarasinghe,Kandy,Teldeniya,Central,7322,8134,15456,292880,325360,618240
1/27/2025,Ravi Amarasinghe,Kandy,Teldeniya,Central,7696,4011,11707,307840,160440,468280
1/28/2025,Ravi Amarasinghe,Kandy,Teldeniya,Central,2814,3024,5838,112560,120960,233520
1/29/2025,Ravi Amarasinghe,Kandy,Teldeniya,Central,4831,5445,10276,193240,217800,411040
1/30/2025,Ravi Amarasinghe,Kandy,Teldeniya,Central,4924,8587,13511,196960,343480,540440
1/31/2025,Ravi Amarasinghe,Kandy,Teldeniya,Central,2833,3787,6620,113320,151480,264800
2/1/2025,Ravi Amarasinghe,Kandy,Teldeniya,Central,2951,7204,10155,118040,288160,406200
2/2/2025,Ravi Amarasinghe,Kandy,Teldeniya,Central,5884,7511,13395,235360,300440,535800
2/3/2025,Ravi Amarasinghe,Kandy,Teldeniya,Central,4442,9937,14379,177680,397480,575160
2/4/2025,Ravi Amarasinghe,Kandy,Teldeniya,Central,190,1928,2118,7600,77120,84720
2/5/2025,Ravi Amarasinghe,Kandy,Teldeniya,Central,2459,6736,9195,98360,269440,367800
2/6/2025,Ravi Amarasinghe,Kandy,Teldeniya,Central,6554,5550,12104,262160,222000,484160
2/7/2025,Ravi Amarasinghe,Kandy,Teldeniya,Central,7647,1337,8984,305880,53480,359360
2/8/2025,Ravi Amarasinghe,Kandy,Teldeniya,Central,2274,4585,6859,90960,183400,274360
2/9/2025,Ravi Amarasinghe,Kandy,Teldeniya,Central,317,6414,6731,12680,256560,269240
2/10/2025,Ravi Amarasinghe,Kandy,Teldeniya,Central,8559,5795,14354,342360,231800,574160
2/11/2025,Ravi Amarasinghe,Kandy,Teldeniya,Central,7570,8110,15680,302800,324400,627200
2/12/2025,Ravi Amarasinghe,Kandy,Teldeniya,Central,7458,9958,17416,298320,398320,696640
2/13/2025,Ravi Amarasinghe,Kandy,Teldeniya,Central,6745,5890,12635,269800,235600,505400
2/14/2025,Ravi Amarasinghe,Kandy,Teldeniya,Central,6903,8831,15734,276120,353240,629360
2/15/2025,Ravi Amarasinghe,Kandy,Teldeniya,Central,5833,2033,7866,233320,81320,314640
2/16/2025,Ravi Amarasinghe,Kandy,Teldeniya,Central,8354,5570,13924,334160,222800,556960
2/17/2025,Ravi Amarasinghe,Kandy,Teldeniya,Central,8734,6977,15711,349360,279080,628440
2/18/2025,Ravi Amarasinghe,Kandy,Teldeniya,Central,3369,9683,13052,134760,387320,522080
2/19/2025,Ravi Amarasinghe,Kandy,Teldeniya,Central,4676,7128,11804,187040,285120,472160
2/20/2025,Ravi Amarasinghe,Kandy,Teldeniya,Central,3144,5033,8177,125760,201320,327080
2/21/2025,Ravi Amarasinghe,Kandy,Teldeniya,Central,6515,4082,10597,260600,163280,423880
2/22/2025,Ravi Amarasinghe,Kandy,Teldeniya,Central,7084,7111,14195,283360,284440,567800
2/23/2025,Ravi Amarasinghe,Kandy,Teldeniya,Central,3847,3284,7131,153880,131360,285240
2/24/2025,Ravi Amarasinghe,Kandy,Teldeniya,Central,119,3228,3347,4760,129120,133880
2/25/2025,Ravi Amarasinghe,Kandy,Teldeniya,Central,4917,451,5368,196680,18040,214720
2/26/2025,Ravi Amarasinghe,Kandy,Teldeniya,Central,8777,1953,10730,351080,78120,429200
2/27/2025,Ravi Amarasinghe,Kandy,Teldeniya,Central,5667,7589,13256,226680,303560,530240
2/28/2025,Ravi Amarasinghe,Kandy,Teldeniya,Central,1372,6325,7697,54880,253000,307880
3/1/2025,Ravi Amarasinghe,Kandy,Teldeniya,Central,733,4731,5464,29320,189240,218560
3/2/2025,Ravi Amarasinghe,Kandy,Teldeniya,Central,1343,3760,5103,53720,150400,204120
3/3/2025,Ravi Amarasinghe,Kandy,Teldeniya,Central,5811,5958,11769,232440,238320,470760
3/4/2025,Ravi Amarasinghe,Kandy,Teldeniya,Central,4267,4769,9036,170680,190760,361440
3/5/2025,Ravi Amarasinghe,Kandy,Teldeniya,Central,8689,1076,9765,347560,43040,390600
3/6/2025,Ravi Amarasinghe,Kandy,Teldeniya,Central,3497,6219,9716,139880,248760,388640
3/7/2025,Ravi Amarasinghe,Kandy,Teldeniya,Central,7826,8664,16490,313040,346560,659600
3/8/2025,Ravi Amarasinghe,Kandy,Teldeniya,Central,6422,486,6908,256880,19440,276320
3/9/2025,Ravi Amarasinghe,Kandy,Teldeniya,Central,296,8774,9070,11840,350960,362800
3/10/2025,Ravi Amarasinghe,Kandy,Teldeniya,Central,6615,4221,10836,264600,168840,433440
3/11/2025,Ravi Amarasinghe,Kandy,Teldeniya,Central,5581,774,6355,223240,30960,254200
3/12/2025,Ravi Amarasinghe,Kandy,Teldeniya,Central,4770,7262,12032,190800,290480,481280
3/13/2025,Ravi Amarasinghe,Kandy,Teldeniya,Central,9634,7413,17047,385360,296520,681880
3/14/2025,Ravi Amarasinghe,Kandy,Teldeniya,Central,9156,1757,10913,366240,70280,436520
3/15/2025,Ravi Amarasinghe,Kandy,Teldeniya,Central,5428,7968,13396,217120,318720,535840
3/16/2025,Ravi Amarasinghe,Kandy,Teldeniya,Central,3853,2218,6071,154120,88720,242840
3/17/2025,Ravi Amarasinghe,Kandy,Teldeniya,Central,2213,9692,11905,88520,387680,476200
3/18/2025,Ravi Amarasinghe,Kandy,Teldeniya,Central,5076,9347,14423,203040,373880,576920
3/19/2025,Ravi Amarasinghe,Kandy,Teldeniya,Central,2261,5159,7420,90440,206360,296800
3/20/2025,Ravi Amarasinghe,Kandy,Teldeniya,Central,6771,4459,11230,270840,178360,449200
3/21/2025,Ravi Amarasinghe,Kandy,Teldeniya,Central,1729,2443,4172,69160,97720,166880
3/22/2025,Ravi Amarasinghe,Kandy,Teldeniya,Central,4199,8329,12528,167960,333160,501120
3/23/2025,Ravi Amarasinghe,Kandy,Teldeniya,Central,2895,9580,12475,115800,383200,499000
3/25/2024,Vimukthi Wickramasinghe,Puttalam,Marawila,North Western,1683,5387,7070,67320,215480,282800
3/26/2024,Vimukthi Wickramasinghe,Puttalam,Marawila,North Western,6413,5122,11535,256520,204880,461400
3/27/2024,Vimukthi Wickramasinghe,Puttalam,Marawila,North Western,5352,6725,12077,214080,269000,483080
3/28/2024,Vimukthi Wickramasinghe,Puttalam,Marawila,North Western,2368,4185,6553,94720,167400,262120
3/29/2024,Vimukthi Wickramasinghe,Puttalam,Marawila,North Western,5981,6264,12245,239240,250560,489800
3/30/2024,Vimukthi Wickramasinghe,Puttalam,Marawila,North Western,7232,2476,9708,289280,99040,388320
3/31/2024,Vimukthi Wickramasinghe,Puttalam,Marawila,North Western,9485,816,10301,379400,32640,412040
4/1/2024,Vimukthi Wickramasinghe,Puttalam,Marawila,North Western,3258,5034,8292,130320,201360,331680
4/2/2024,Vimukthi Wickramasinghe,Puttalam,Marawila,North Western,8160,7153,15313,326400,286120,612520
4/3/2024,Vimukthi Wickramasinghe,Puttalam,Marawila,North Western,7236,6587,13823,289440,263480,552920
4/4/2024,Vimukthi Wickramasinghe,Puttalam,Marawila,North Western,3673,4821,8494,146920,192840,339760
4/5/2024,Vimukthi Wickramasinghe,Puttalam,Marawila,North Western,7145,2125,9270,285800,85000,370800
4/6/2024,Vimukthi Wickramasinghe,Puttalam,Marawila,North Western,338,6862,7200,13520,274480,288000
4/7/2024,Vimukthi Wickramasinghe,Puttalam,Marawila,North Western,1809,6255,8064,72360,250200,322560
4/8/2024,Vimukthi Wickramasinghe,Puttalam,Marawila,North Western,2250,1402,3652,90000,56080,146080
4/9/2024,Vimukthi Wickramasinghe,Puttalam,Marawila,North Western,8421,8267,16688,336840,330680,667520
4/10/2024,Vimukthi Wickramasinghe,Puttalam,Marawila,North Western,830,5345,6175,33200,213800,247000
4/11/2024,Vimukthi Wickramasinghe,Puttalam,Marawila,North Western,350,5557,5907,14000,222280,236280
4/19/2024,Vimukthi Wickramasinghe,Puttalam,Marawila,North Western,8844,7942,16786,353760,317680,671440
4/20/2024,Vimukthi Wickramasinghe,Puttalam,Marawila,North Western,2215,4619,6834,88600,184760,273360
4/21/2024,Vimukthi Wickramasinghe,Puttalam,Marawila,North Western,2533,4981,7514,101320,199240,300560
4/22/2024,Vimukthi Wickramasinghe,Puttalam,Marawila,North Western,472,8851,9323,18880,354040,372920
4/23/2024,Vimukthi Wickramasinghe,Puttalam,Marawila,North Western,4008,6120,10128,160320,244800,405120
4/24/2024,Vimukthi Wickramasinghe,Puttalam,Marawila,North Western,2366,3533,5899,94640,141320,235960
4/25/2024,Vimukthi Wickramasinghe,Puttalam,Marawila,North Western,26,1768,1794,1040,70720,71760
4/26/2024,Vimukthi Wickramasinghe,Puttalam,Marawila,North Western,8696,7688,16384,347840,307520,655360
4/27/2024,Vimukthi Wickramasinghe,Puttalam,Marawila,North Western,4728,2861,7589,189120,114440,303560
4/28/2024,Vimukthi Wickramasinghe,Puttalam,Marawila,North Western,8415,4028,12443,336600,161120,497720
4/29/2024,Vimukthi Wickramasinghe,Puttalam,Marawila,North Western,7615,1153,8768,304600,46120,350720
4/30/2024,Vimukthi Wickramasinghe,Puttalam,Marawila,North Western,1924,3587,5511,76960,143480,220440
5/1/2024,Vimukthi Wickramasinghe,Puttalam,Marawila,North Western,7182,4606,11788,287280,184240,471520
5/2/2024,Vimukthi Wickramasinghe,Puttalam,Marawila,North Western,9144,1631,10775,365760,65240,431000
5/3/2024,Vimukthi Wickramasinghe,Puttalam,Marawila,North Western,2793,2482,5275,111720,99280,211000
5/4/2024,Vimukthi Wickramasinghe,Puttalam,Marawila,North Western,9439,2882,12321,377560,115280,492840
5/5/2024,Vimukthi Wickramasinghe,Puttalam,Marawila,North Western,6794,8603,15397,271760,344120,615880
5/6/2024,Vimukthi Wickramasinghe,Puttalam,Marawila,North Western,9789,7666,17455,391560,306640,698200
5/7/2024,Vimukthi Wickramasinghe,Puttalam,Marawila,North Western,2009,3451,5460,80360,138040,218400
5/8/2024,Vimukthi Wickramasinghe,Puttalam,Marawila,North Western,2335,3522,5857,93400,140880,234280
5/9/2024,Vimukthi Wickramasinghe,Puttalam,Marawila,North Western,9698,7499,17197,387920,299960,687880
5/10/2024,Vimukthi Wickramasinghe,Puttalam,Marawila,North Western,8803,3564,12367,352120,142560,494680
5/11/2024,Vimukthi Wickramasinghe,Puttalam,Marawila,North Western,6699,3672,10371,267960,146880,414840
5/12/2024,Vimukthi Wickramasinghe,Puttalam,Marawila,North Western,5970,3257,9227,238800,130280,369080
5/13/2024,Vimukthi Wickramasinghe,Puttalam,Marawila,North Western,3315,1013,4328,132600,40520,173120
5/14/2024,Vimukthi Wickramasinghe,Puttalam,Marawila,North Western,2305,3525,5830,92200,141000,233200
5/15/2024,Vimukthi Wickramasinghe,Puttalam,Marawila,North Western,4444,1422,5866,177760,56880,234640
5/16/2024,Vimukthi Wickramasinghe,Puttalam,Marawila,North Western,199,3829,4028,7960,153160,161120
5/17/2024,Vimukthi Wickramasinghe,Puttalam,Marawila,North Western,557,3951,4508,22280,158040,180320
5/18/2024,Vimukthi Wickramasinghe,Puttalam,Marawila,North Western,4161,5226,9387,166440,209040,375480
5/19/2024,Vimukthi Wickramasinghe,Puttalam,Marawila,North Western,8991,2814,11805,359640,112560,472200
5/20/2024,Vimukthi Wickramasinghe,Puttalam,Marawila,North Western,6583,4360,10943,263320,174400,437720
5/21/2024,Vimukthi Wickramasinghe,Puttalam,Marawila,North Western,5128,8521,13649,205120,340840,545960
5/22/2024,Vimukthi Wickramasinghe,Puttalam,Marawila,North Western,7298,1124,8422,291920,44960,336880
5/24/2024,Vimukthi Wickramasinghe,Puttalam,Marawila,North Western,1576,8237,9813,63040,329480,392520
5/25/2024,Vimukthi Wickramasinghe,Puttalam,Marawila,North Western,4044,184,4228,161760,7360,169120
5/26/2024,Vimukthi Wickramasinghe,Puttalam,Marawila,North Western,243,2535,2778,9720,101400,111120
5/27/2024,Vimukthi Wickramasinghe,Puttalam,Marawila,North Western,5094,1329,6423,203760,53160,256920
5/28/2024,Vimukthi Wickramasinghe,Puttalam,Marawila,North Western,9376,3193,12569,375040,127720,502760
5/29/2024,Vimukthi Wickramasinghe,Puttalam,Marawila,North Western,970,2102,3072,38800,84080,122880
5/30/2024,Vimukthi Wickramasinghe,Puttalam,Marawila,North Western,1729,4977,6706,69160,199080,268240
5/31/2024,Vimukthi Wickramasinghe,Puttalam,Marawila,North Western,6724,522,7246,268960,20880,289840
6/1/2024,Vimukthi Wickramasinghe,Puttalam,Marawila,North Western,481,8421,8902,19240,336840,356080
6/2/2024,Vimukthi Wickramasinghe,Puttalam,Marawila,North Western,9474,3748,13222,378960,149920,528880
6/3/2024,Vimukthi Wickramasinghe,Puttalam,Marawila,North Western,7757,7843,15600,310280,313720,624000
6/4/2024,Vimukthi Wickramasinghe,Puttalam,Marawila,North Western,4145,5835,9980,165800,233400,399200
6/5/2024,Vimukthi Wickramasinghe,Puttalam,Marawila,North Western,1664,4322,5986,66560,172880,239440
6/6/2024,Vimukthi Wickramasinghe,Puttalam,Marawila,North Western,3901,7777,11678,156040,311080,467120
6/7/2024,Vimukthi Wickramasinghe,Puttalam,Marawila,North Western,4835,9885,14720,193400,395400,588800
6/8/2024,Vimukthi Wickramasinghe,Puttalam,Marawila,North Western,7546,1014,8560,301840,40560,342400
6/9/2024,Vimukthi Wickramasinghe,Puttalam,Marawila,North Western,332,3956,4288,13280,158240,171520
6/10/2024,Vimukthi Wickramasinghe,Puttalam,Marawila,North Western,9076,1098,10174,363040,43920,406960
6/11/2024,Vimukthi Wickramasinghe,Puttalam,Marawila,North Western,3317,2155,5472,132680,86200,218880
6/12/2024,Vimukthi Wickramasinghe,Puttalam,Marawila,North Western,4486,4972,9458,179440,198880,378320
6/13/2024,Vimukthi Wickramasinghe,Puttalam,Marawila,North Western,827,5774,6601,33080,230960,264040
6/14/2024,Vimukthi Wickramasinghe,Puttalam,Marawila,North Western,5211,6384,11595,208440,255360,463800
6/15/2024,Vimukthi Wickramasinghe,Puttalam,Marawila,North Western,2750,7346,10096,110000,293840,403840
6/16/2024,Vimukthi Wickramasinghe,Puttalam,Marawila,North Western,5998,297,6295,239920,11880,251800
6/17/2024,Vimukthi Wickramasinghe,Puttalam,Marawila,North Western,8699,1733,10432,347960,69320,417280
6/18/2024,Vimukthi Wickramasinghe,Puttalam,Marawila,North Western,6018,5941,11959,240720,237640,478360
6/19/2024,Vimukthi Wickramasinghe,Puttalam,Marawila,North Western,9675,2548,12223,387000,101920,488920
6/20/2024,Vimukthi Wickramasinghe,Puttalam,Marawila,North Western,86,2976,3062,3440,119040,122480
6/21/2024,Vimukthi Wickramasinghe,Puttalam,Marawila,North Western,864,1870,2734,34560,74800,109360
6/22/2024,Vimukthi Wickramasinghe,Puttalam,Marawila,North Western,4512,3255,7767,180480,130200,310680
6/23/2024,Vimukthi Wickramasinghe,Puttalam,Marawila,North Western,3450,723,4173,138000,28920,166920
6/24/2024,Vimukthi Wickramasinghe,Puttalam,Marawila,North Western,897,6340,7237,35880,253600,289480
6/25/2024,Vimukthi Wickramasinghe,Puttalam,Marawila,North Western,1881,4229,6110,75240,169160,244400
6/26/2024,Vimukthi Wickramasinghe,Puttalam,Marawila,North Western,7519,9626,17145,300760,385040,685800
6/27/2024,Vimukthi Wickramasinghe,Puttalam,Marawila,North Western,8790,1433,10223,351600,57320,408920
6/28/2024,Vimukthi Wickramasinghe,Puttalam,Marawila,North Western,3465,8703,12168,138600,348120,486720
6/29/2024,Vimukthi Wickramasinghe,Puttalam,Marawila,North Western,828,2832,3660,33120,113280,146400
6/30/2024,Vimukthi Wickramasinghe,Puttalam,Marawila,North Western,4666,2423,7089,186640,96920,283560
7/1/2024,Vimukthi Wickramasinghe,Puttalam,Marawila,North Western,9823,7055,16878,392920,282200,675120
7/2/2024,Vimukthi Wickramasinghe,Puttalam,Marawila,North Western,7095,5573,12668,283800,222920,506720
7/3/2024,Vimukthi Wickramasinghe,Puttalam,Marawila,North Western,6936,7657,14593,277440,306280,583720
7/4/2024,Vimukthi Wickramasinghe,Puttalam,Marawila,North Western,7333,9332,16665,293320,373280,666600
7/5/2024,Vimukthi Wickramasinghe,Puttalam,Marawila,North Western,6066,3385,9451,242640,135400,378040
7/6/2024,Vimukthi Wickramasinghe,Puttalam,Marawila,North Western,3557,7075,10632,142280,283000,425280
7/7/2024,Vimukthi Wickramasinghe,Puttalam,Marawila,North Western,3968,3732,7700,158720,149280,308000
7/8/2024,Vimukthi Wickramasinghe,Puttalam,Marawila,North Western,8358,4108,12466,334320,164320,498640
7/9/2024,Vimukthi Wickramasinghe,Puttalam,Marawila,North Western,7378,6799,14177,295120,271960,567080
7/10/2024,Vimukthi Wickramasinghe,Puttalam,Marawila,North Western,760,5340,6100,30400,213600,244000
7/11/2024,Vimukthi Wickramasinghe,Puttalam,Marawila,North Western,30,8242,8272,1200,329680,330880
7/12/2024,Vimukthi Wickramasinghe,Puttalam,Marawila,North Western,1512,5590,7102,60480,223600,284080
7/13/2024,Vimukthi Wickramasinghe,Puttalam,Marawila,North Western,317,4477,4794,12680,179080,191760
7/14/2024,Vimukthi Wickramasinghe,Puttalam,Marawila,North Western,6379,6027,12406,255160,241080,496240
7/15/2024,Vimukthi Wickramasinghe,Puttalam,Marawila,North Western,1515,6236,7751,60600,249440,310040
7/16/2024,Vimukthi Wickramasinghe,Puttalam,Marawila,North Western,1418,2275,3693,56720,91000,147720
7/17/2024,Vimukthi Wickramasinghe,Puttalam,Marawila,North Western,6170,2356,8526,246800,94240,341040
7/18/2024,Vimukthi Wickramasinghe,Puttalam,Marawila,North Western,8604,4619,13223,344160,184760,528920
7/19/2024,Vimukthi Wickramasinghe,Puttalam,Marawila,North Western,7357,4007,11364,294280,160280,454560
7/20/2024,Vimukthi Wickramasinghe,Puttalam,Marawila,North Western,1835,540,2375,73400,21600,95000
7/21/2024,Vimukthi Wickramasinghe,Puttalam,Marawila,North Western,5735,835,6570,229400,33400,262800
7/22/2024,Vimukthi Wickramasinghe,Puttalam,Marawila,North Western,7954,5715,13669,318160,228600,546760
7/23/2024,Vimukthi Wickramasinghe,Puttalam,Marawila,North Western,4893,7654,12547,195720,306160,501880
7/24/2024,Vimukthi Wickramasinghe,Puttalam,Marawila,North Western,3753,3858,7611,150120,154320,304440
7/25/2024,Vimukthi Wickramasinghe,Puttalam,Marawila,North Western,8752,108,8860,350080,4320,354400
7/26/2024,Vimukthi Wickramasinghe,Puttalam,Marawila,North Western,2287,5290,7577,91480,211600,303080
7/27/2024,Vimukthi Wickramasinghe,Puttalam,Marawila,North Western,2035,2328,4363,81400,93120,174520
7/28/2024,Vimukthi Wickramasinghe,Puttalam,Marawila,North Western,5468,6747,12215,218720,269880,488600
7/29/2024,Vimukthi Wickramasinghe,Puttalam,Marawila,North Western,4086,6952,11038,163440,278080,441520
7/30/2024,Vimukthi Wickramasinghe,Puttalam,Marawila,North Western,3663,4097,7760,146520,163880,310400
7/31/2024,Vimukthi Wickramasinghe,Puttalam,Marawila,North Western,2295,362,2657,91800,14480,106280
8/1/2024,Vimukthi Wickramasinghe,Puttalam,Marawila,North Western,1104,7411,8515,44160,296440,340600
8/2/2024,Vimukthi Wickramasinghe,Puttalam,Marawila,North Western,1162,2572,3734,46480,102880,149360
8/3/2024,Vimukthi Wickramasinghe,Puttalam,Marawila,North Western,5243,801,6044,209720,32040,241760
8/4/2024,Vimukthi Wickramasinghe,Puttalam,Marawila,North Western,3245,2854,6099,129800,114160,243960
8/5/2024,Vimukthi Wickramasinghe,Puttalam,Marawila,North Western,3736,2955,6691,149440,118200,267640
8/6/2024,Vimukthi Wickramasinghe,Puttalam,Marawila,North Western,3588,6288,9876,143520,251520,395040
8/7/2024,Vimukthi Wickramasinghe,Puttalam,Marawila,North Western,8315,2965,11280,332600,118600,451200
8/8/2024,Vimukthi Wickramasinghe,Puttalam,Marawila,North Western,4197,1933,6130,167880,77320,245200
8/9/2024,Vimukthi Wickramasinghe,Puttalam,Marawila,North Western,2865,3902,6767,114600,156080,270680
8/10/2024,Vimukthi Wickramasinghe,Puttalam,Marawila,North Western,517,2099,2616,20680,83960,104640
8/11/2024,Vimukthi Wickramasinghe,Puttalam,Marawila,North Western,7363,3090,10453,294520,123600,418120
8/12/2024,Vimukthi Wickramasinghe,Puttalam,Marawila,North Western,494,507,1001,19760,20280,40040
8/13/2024,Vimukthi Wickramasinghe,Puttalam,Marawila,North Western,9451,956,10407,378040,38240,416280
8/14/2024,Vimukthi Wickramasinghe,Puttalam,Marawila,North Western,9887,4676,14563,395480,187040,582520
8/15/2024,Vimukthi Wickramasinghe,Puttalam,Marawila,North Western,4677,2293,6970,187080,91720,278800
8/16/2024,Vimukthi Wickramasinghe,Puttalam,Marawila,North Western,7219,9722,16941,288760,388880,677640
8/17/2024,Vimukthi Wickramasinghe,Puttalam,Marawila,North Western,6730,2803,9533,269200,112120,381320
8/18/2024,Vimukthi Wickramasinghe,Puttalam,Marawila,North Western,9985,2908,12893,399400,116320,515720
8/19/2024,Vimukthi Wickramasinghe,Puttalam,Marawila,North Western,4382,6780,11162,175280,271200,446480
8/20/2024,Vimukthi Wickramasinghe,Puttalam,Marawila,North Western,3315,1157,4472,132600,46280,178880
8/21/2024,Vimukthi Wickramasinghe,Puttalam,Marawila,North Western,2422,7453,9875,96880,298120,395000
8/22/2024,Vimukthi Wickramasinghe,Puttalam,Marawila,North Western,9547,3531,13078,381880,141240,523120
8/23/2024,Vimukthi Wickramasinghe,Puttalam,Marawila,North Western,2439,9707,12146,97560,388280,485840
8/24/2024,Vimukthi Wickramasinghe,Puttalam,Marawila,North Western,4353,8066,12419,174120,322640,496760
8/25/2024,Vimukthi Wickramasinghe,Puttalam,Marawila,North Western,9206,4786,13992,368240,191440,559680
8/26/2024,Vimukthi Wickramasinghe,Puttalam,Marawila,North Western,767,7872,8639,30680,314880,345560
8/27/2024,Vimukthi Wickramasinghe,Puttalam,Marawila,North Western,7998,5295,13293,319920,211800,531720
8/28/2024,Vimukthi Wickramasinghe,Puttalam,Marawila,North Western,4232,3723,7955,169280,148920,318200
8/29/2024,Vimukthi Wickramasinghe,Puttalam,Marawila,North Western,4833,9616,14449,193320,384640,577960
8/30/2024,Vimukthi Wickramasinghe,Puttalam,Marawila,North Western,9705,6667,16372,388200,266680,654880
8/31/2024,Vimukthi Wickramasinghe,Puttalam,Marawila,North Western,8069,8257,16326,322760,330280,653040
9/1/2024,Vimukthi Wickramasinghe,Puttalam,Marawila,North Western,9401,7085,16486,376040,283400,659440
9/2/2024,Vimukthi Wickramasinghe,Puttalam,Marawila,North Western,1675,5699,7374,67000,227960,294960
9/3/2024,Vimukthi Wickramasinghe,Puttalam,Marawila,North Western,8027,4172,12199,321080,166880,487960
9/4/2024,Vimukthi Wickramasinghe,Puttalam,Marawila,North Western,223,1266,1489,8920,50640,59560
9/5/2024,Vimukthi Wickramasinghe,Puttalam,Marawila,North Western,9505,324,9829,380200,12960,393160
9/6/2024,Vimukthi Wickramasinghe,Puttalam,Marawila,North Western,8083,1245,9328,323320,49800,373120
9/7/2024,Vimukthi Wickramasinghe,Puttalam,Marawila,North Western,2213,5129,7342,88520,205160,293680
9/8/2024,Vimukthi Wickramasinghe,Puttalam,Marawila,North Western,9048,8859,17907,361920,354360,716280
9/9/2024,Vimukthi Wickramasinghe,Puttalam,Marawila,North Western,3734,2680,6414,149360,107200,256560
9/10/2024,Vimukthi Wickramasinghe,Puttalam,Marawila,North Western,1123,1031,2154,44920,41240,86160
9/11/2024,Vimukthi Wickramasinghe,Puttalam,Marawila,North Western,9620,113,9733,384800,4520,389320
9/12/2024,Vimukthi Wickramasinghe,Puttalam,Marawila,North Western,5424,2180,7604,216960,87200,304160
9/13/2024,Vimukthi Wickramasinghe,Puttalam,Marawila,North Western,1271,9378,10649,50840,375120,425960
9/14/2024,Vimukthi Wickramasinghe,Puttalam,Marawila,North Western,9850,9560,19410,394000,382400,776400
9/15/2024,Vimukthi Wickramasinghe,Puttalam,Marawila,North Western,6774,718,7492,270960,28720,299680
9/16/2024,Vimukthi Wickramasinghe,Puttalam,Marawila,North Western,9996,7320,17316,399840,292800,692640
9/17/2024,Vimukthi Wickramasinghe,Puttalam,Marawila,North Western,4409,5925,10334,176360,237000,413360
9/18/2024,Vimukthi Wickramasinghe,Puttalam,Marawila,North Western,3363,8797,12160,134520,351880,486400
9/19/2024,Vimukthi Wickramasinghe,Puttalam,Marawila,North Western,8514,2021,10535,340560,80840,421400
9/20/2024,Vimukthi Wickramasinghe,Puttalam,Marawila,North Western,6850,1920,8770,274000,76800,350800
9/21/2024,Vimukthi Wickramasinghe,Puttalam,Marawila,North Western,3861,7772,11633,154440,310880,465320
9/22/2024,Vimukthi Wickramasinghe,Puttalam,Marawila,North Western,9193,7369,16562,367720,294760,662480
9/23/2024,Vimukthi Wickramasinghe,Puttalam,Marawila,North Western,2226,2647,4873,89040,105880,194920
9/24/2024,Vimukthi Wickramasinghe,Puttalam,Marawila,North Western,1788,6239,8027,71520,249560,321080
9/25/2024,Vimukthi Wickramasinghe,Puttalam,Marawila,North Western,6636,8675,15311,265440,347000,612440
9/26/2024,Vimukthi Wickramasinghe,Puttalam,Marawila,North Western,5432,2271,7703,217280,90840,308120
9/27/2024,Vimukthi Wickramasinghe,Puttalam,Marawila,North Western,6517,3205,9722,260680,128200,388880
9/28/2024,Vimukthi Wickramasinghe,Puttalam,Marawila,North Western,3546,9852,13398,141840,394080,535920
9/29/2024,Vimukthi Wickramasinghe,Puttalam,Marawila,North Western,5765,7183,12948,230600,287320,517920
9/30/2024,Vimukthi Wickramasinghe,Puttalam,Marawila,North Western,9014,464,9478,360560,18560,379120
10/1/2024,Vimukthi Wickramasinghe,Puttalam,Marawila,North Western,7433,6010,13443,297320,240400,537720
10/2/2024,Vimukthi Wickramasinghe,Puttalam,Marawila,North Western,6021,6826,12847,240840,273040,513880
10/3/2024,Vimukthi Wickramasinghe,Puttalam,Marawila,North Western,5955,777,6732,238200,31080,269280
10/4/2024,Vimukthi Wickramasinghe,Puttalam,Marawila,North Western,3314,6548,9862,132560,261920,394480
10/5/2024,Vimukthi Wickramasinghe,Puttalam,Marawila,North Western,2991,2713,5704,119640,108520,228160
10/6/2024,Vimukthi Wickramasinghe,Puttalam,Marawila,North Western,5009,2016,7025,200360,80640,281000
10/7/2024,Vimukthi Wickramasinghe,Puttalam,Marawila,North Western,8937,5226,14163,357480,209040,566520
10/8/2024,Vimukthi Wickramasinghe,Puttalam,Marawila,North Western,2362,1864,4226,94480,74560,169040
10/9/2024,Vimukthi Wickramasinghe,Puttalam,Marawila,North Western,1357,4115,5472,54280,164600,218880
10/10/2024,Vimukthi Wickramasinghe,Puttalam,Marawila,North Western,5353,3990,9343,214120,159600,373720
10/11/2024,Vimukthi Wickramasinghe,Puttalam,Marawila,North Western,2665,4934,7599,106600,197360,303960
10/12/2024,Vimukthi Wickramasinghe,Puttalam,Marawila,North Western,4953,4318,9271,198120,172720,370840
10/13/2024,Vimukthi Wickramasinghe,Puttalam,Marawila,North Western,7415,5390,12805,296600,215600,512200
10/14/2024,Vimukthi Wickramasinghe,Puttalam,Marawila,North Western,3490,6409,9899,139600,256360,395960
10/15/2024,Vimukthi Wickramasinghe,Puttalam,Marawila,North Western,3556,8899,12455,142240,355960,498200
10/16/2024,Vimukthi Wickramasinghe,Puttalam,Marawila,North Western,414,7585,7999,16560,303400,319960
10/17/2024,Vimukthi Wickramasinghe,Puttalam,Marawila,North Western,3468,6373,9841,138720,254920,393640
10/18/2024,Vimukthi Wickramasinghe,Puttalam,Marawila,North Western,2634,5724,8358,105360,228960,334320
10/19/2024,Vimukthi Wickramasinghe,Puttalam,Marawila,North Western,5006,5129,10135,200240,205160,405400
10/20/2024,Vimukthi Wickramasinghe,Puttalam,Marawila,North Western,3304,5233,8537,132160,209320,341480
10/21/2024,Vimukthi Wickramasinghe,Puttalam,Marawila,North Western,804,2854,3658,32160,114160,146320
10/22/2024,Vimukthi Wickramasinghe,Puttalam,Marawila,North Western,4851,4038,8889,194040,161520,355560
10/23/2024,Vimukthi Wickramasinghe,Puttalam,Marawila,North Western,9550,7641,17191,382000,305640,687640
10/24/2024,Vimukthi Wickramasinghe,Puttalam,Marawila,North Western,8259,9510,17769,330360,380400,710760
10/25/2024,Vimukthi Wickramasinghe,Puttalam,Marawila,North Western,9744,3503,13247,389760,140120,529880
10/26/2024,Vimukthi Wickramasinghe,Puttalam,Marawila,North Western,9936,9629,19565,397440,385160,782600
10/27/2024,Vimukthi Wickramasinghe,Puttalam,Marawila,North Western,4627,3819,8446,185080,152760,337840
10/28/2024,Vimukthi Wickramasinghe,Puttalam,Marawila,North Western,3706,9776,13482,148240,391040,539280
10/29/2024,Vimukthi Wickramasinghe,Puttalam,Marawila,North Western,4616,4332,8948,184640,173280,357920
10/30/2024,Vimukthi Wickramasinghe,Puttalam,Marawila,North Western,594,1910,2504,23760,76400,100160
10/31/2024,Vimukthi Wickramasinghe,Puttalam,Marawila,North Western,8311,4263,12574,332440,170520,502960
11/1/2024,Vimukthi Wickramasinghe,Puttalam,Marawila,North Western,4857,546,5403,194280,21840,216120
11/2/2024,Vimukthi Wickramasinghe,Puttalam,Marawila,North Western,5511,1698,7209,220440,67920,288360
11/3/2024,Vimukthi Wickramasinghe,Puttalam,Marawila,North Western,7189,5571,12760,287560,222840,510400
11/4/2024,Vimukthi Wickramasinghe,Puttalam,Marawila,North Western,1994,4463,6457,79760,178520,258280
11/5/2024,Vimukthi Wickramasinghe,Puttalam,Marawila,North Western,9205,9409,18614,368200,376360,744560
11/6/2024,Vimukthi Wickramasinghe,Puttalam,Marawila,North Western,6823,3577,10400,272920,143080,416000
11/7/2024,Vimukthi Wickramasinghe,Puttalam,Marawila,North Western,3951,6944,10895,158040,277760,435800
11/8/2024,Vimukthi Wickramasinghe,Puttalam,Marawila,North Western,3535,546,4081,141400,21840,163240
11/9/2024,Vimukthi Wickramasinghe,Puttalam,Marawila,North Western,5353,608,5961,214120,24320,238440
11/10/2024,Vimukthi Wickramasinghe,Puttalam,Marawila,North Western,6190,6897,13087,247600,275880,523480
11/11/2024,Vimukthi Wickramasinghe,Puttalam,Marawila,North Western,5674,3178,8852,226960,127120,354080
11/12/2024,Vimukthi Wickramasinghe,Puttalam,Marawila,North Western,4023,7834,11857,160920,313360,474280
11/13/2024,Vimukthi Wickramasinghe,Puttalam,Marawila,North Western,3464,4073,7537,138560,162920,301480
11/14/2024,Vimukthi Wickramasinghe,Puttalam,Marawila,North Western,3670,1588,5258,146800,63520,210320
11/15/2024,Vimukthi Wickramasinghe,Puttalam,Marawila,North Western,1237,7881,9118,49480,315240,364720
11/16/2024,Vimukthi Wickramasinghe,Puttalam,Marawila,North Western,5543,1556,7099,221720,62240,283960
11/17/2024,Vimukthi Wickramasinghe,Puttalam,Marawila,North Western,3061,4982,8043,122440,199280,321720
11/18/2024,Vimukthi Wickramasinghe,Puttalam,Marawila,North Western,1792,6020,7812,71680,240800,312480
11/19/2024,Vimukthi Wickramasinghe,Puttalam,Marawila,North Western,1215,607,1822,48600,24280,72880
11/20/2024,Vimukthi Wickramasinghe,Puttalam,Marawila,North Western,6421,6762,13183,256840,270480,527320
11/21/2024,Vimukthi Wickramasinghe,Puttalam,Marawila,North Western,8304,853,9157,332160,34120,366280
11/22/2024,Vimukthi Wickramasinghe,Puttalam,Marawila,North Western,2742,850,3592,109680,34000,143680
11/23/2024,Vimukthi Wickramasinghe,Puttalam,Marawila,North Western,5865,815,6680,234600,32600,267200
11/24/2024,Vimukthi Wickramasinghe,Puttalam,Marawila,North Western,553,8154,8707,22120,326160,348280
11/25/2024,Vimukthi Wickramasinghe,Puttalam,Marawila,North Western,6788,1834,8622,271520,73360,344880
11/26/2024,Vimukthi Wickramasinghe,Puttalam,Marawila,North Western,4217,5655,9872,168680,226200,394880
11/27/2024,Vimukthi Wickramasinghe,Puttalam,Marawila,North Western,7804,8654,16458,312160,346160,658320
11/28/2024,Vimukthi Wickramasinghe,Puttalam,Marawila,North Western,7920,1741,9661,316800,69640,386440
11/29/2024,Vimukthi Wickramasinghe,Puttalam,Marawila,North Western,1287,2299,3586,51480,91960,143440
11/30/2024,Vimukthi Wickramasinghe,Puttalam,Marawila,North Western,9376,6575,15951,375040,263000,638040
12/1/2024,Vimukthi Wickramasinghe,Puttalam,Marawila,North Western,7956,7171,15127,318240,286840,605080
12/2/2024,Vimukthi Wickramasinghe,Puttalam,Marawila,North Western,3687,3371,7058,147480,134840,282320
12/3/2024,Vimukthi Wickramasinghe,Puttalam,Marawila,North Western,6693,2014,8707,267720,80560,348280
12/4/2024,Vimukthi Wickramasinghe,Puttalam,Marawila,North Western,7373,8415,15788,294920,336600,631520
12/5/2024,Vimukthi Wickramasinghe,Puttalam,Marawila,North Western,5959,9864,15823,238360,394560,632920
12/6/2024,Vimukthi Wickramasinghe,Puttalam,Marawila,North Western,9146,7916,17062,365840,316640,682480
12/7/2024,Vimukthi Wickramasinghe,Puttalam,Marawila,North Western,1246,6684,7930,49840,267360,317200
12/8/2024,Vimukthi Wickramasinghe,Puttalam,Marawila,North Western,5845,4430,10275,233800,177200,411000
12/9/2024,Vimukthi Wickramasinghe,Puttalam,Marawila,North Western,6363,6088,12451,254520,243520,498040
12/10/2024,Vimukthi Wickramasinghe,Puttalam,Marawila,North Western,2948,5882,8830,117920,235280,353200
12/11/2024,Vimukthi Wickramasinghe,Puttalam,Marawila,North Western,9674,2946,12620,386960,117840,504800
12/12/2024,Vimukthi Wickramasinghe,Puttalam,Marawila,North Western,761,8912,9673,30440,356480,386920
12/13/2024,Vimukthi Wickramasinghe,Puttalam,Marawila,North Western,5568,3839,9407,222720,153560,376280
12/14/2024,Vimukthi Wickramasinghe,Puttalam,Marawila,North Western,7396,5934,13330,295840,237360,533200
12/15/2024,Vimukthi Wickramasinghe,Puttalam,Marawila,North Western,4198,2647,6845,167920,105880,273800
12/16/2024,Vimukthi Wickramasinghe,Puttalam,Marawila,North Western,9296,1613,10909,371840,64520,436360
12/17/2024,Vimukthi Wickramasinghe,Puttalam,Marawila,North Western,4760,2465,7225,190400,98600,289000
12/18/2024,Vimukthi Wickramasinghe,Puttalam,Marawila,North Western,9599,597,10196,383960,23880,407840
12/19/2024,Vimukthi Wickramasinghe,Puttalam,Marawila,North Western,5495,8857,14352,219800,354280,574080
12/20/2024,Vimukthi Wickramasinghe,Puttalam,Marawila,North Western,5327,3794,9121,213080,151760,364840
12/21/2024,Vimukthi Wickramasinghe,Puttalam,Marawila,North Western,4612,4826,9438,184480,193040,377520
12/22/2024,Vimukthi Wickramasinghe,Puttalam,Marawila,North Western,3141,8402,11543,125640,336080,461720
12/23/2024,Vimukthi Wickramasinghe,Puttalam,Marawila,North Western,7132,1010,8142,285280,40400,325680
12/24/2024,Vimukthi Wickramasinghe,Puttalam,Marawila,North Western,1415,8910,10325,56600,356400,413000
12/25/2024,Vimukthi Wickramasinghe,Puttalam,Marawila,North Western,5009,4469,9478,200360,178760,379120
12/26/2024,Vimukthi Wickramasinghe,Puttalam,Marawila,North Western,6248,6179,12427,249920,247160,497080
12/27/2024,Vimukthi Wickramasinghe,Puttalam,Marawila,North Western,3122,6863,9985,124880,274520,399400
12/28/2024,Vimukthi Wickramasinghe,Puttalam,Marawila,North Western,6207,9635,15842,248280,385400,633680
12/29/2024,Vimukthi Wickramasinghe,Puttalam,Marawila,North Western,6182,7651,13833,247280,306040,553320
12/30/2024,Vimukthi Wickramasinghe,Puttalam,Marawila,North Western,233,5102,5335,9320,204080,213400
12/31/2024,Vimukthi Wickramasinghe,Puttalam,Marawila,North Western,9574,4582,14156,382960,183280,566240
1/1/2025,Vimukthi Wickramasinghe,Puttalam,Marawila,North Western,7093,8183,15276,283720,327320,611040
1/2/2025,Vimukthi Wickramasinghe,Puttalam,Marawila,North Western,5166,3844,9010,206640,153760,360400
1/3/2025,Vimukthi Wickramasinghe,Puttalam,Marawila,North Western,780,4836,5616,31200,193440,224640
1/4/2025,Vimukthi Wickramasinghe,Puttalam,Marawila,North Western,8980,2829,11809,359200,113160,472360
1/5/2025,Vimukthi Wickramasinghe,Puttalam,Marawila,North Western,2300,3634,5934,92000,145360,237360
1/6/2025,Vimukthi Wickramasinghe,Puttalam,Marawila,North Western,5911,6109,12020,236440,244360,480800
1/7/2025,Vimukthi Wickramasinghe,Puttalam,Marawila,North Western,5424,79,5503,216960,3160,220120
1/8/2025,Vimukthi Wickramasinghe,Puttalam,Marawila,North Western,1016,7280,8296,40640,291200,331840
1/9/2025,Vimukthi Wickramasinghe,Puttalam,Marawila,North Western,4470,34,4504,178800,1360,180160
1/10/2025,Vimukthi Wickramasinghe,Puttalam,Marawila,North Western,9844,4676,14520,393760,187040,580800
1/11/2025,Vimukthi Wickramasinghe,Puttalam,Marawila,North Western,1679,7022,8701,67160,280880,348040
1/12/2025,Vimukthi Wickramasinghe,Puttalam,Marawila,North Western,1389,5346,6735,55560,213840,269400
1/13/2025,Vimukthi Wickramasinghe,Puttalam,Marawila,North Western,2516,9926,12442,100640,397040,497680
1/14/2025,Vimukthi Wickramasinghe,Puttalam,Marawila,North Western,56,1877,1933,2240,75080,77320
1/15/2025,Vimukthi Wickramasinghe,Puttalam,Marawila,North Western,1070,633,1703,42800,25320,68120
1/16/2025,Vimukthi Wickramasinghe,Puttalam,Marawila,North Western,5671,7409,13080,226840,296360,523200
1/17/2025,Vimukthi Wickramasinghe,Puttalam,Marawila,North Western,2509,1023,3532,100360,40920,141280
1/18/2025,Vimukthi Wickramasinghe,Puttalam,Marawila,North Western,7633,4939,12572,305320,197560,502880
1/19/2025,Vimukthi Wickramasinghe,Puttalam,Marawila,North Western,8524,6484,15008,340960,259360,600320
1/20/2025,Vimukthi Wickramasinghe,Puttalam,Marawila,North Western,1222,2803,4025,48880,112120,161000
1/21/2025,Vimukthi Wickramasinghe,Puttalam,Marawila,North Western,1575,7363,8938,63000,294520,357520
1/22/2025,Vimukthi Wickramasinghe,Puttalam,Marawila,North Western,3726,9827,13553,149040,393080,542120
1/23/2025,Vimukthi Wickramasinghe,Puttalam,Marawila,North Western,6692,111,6803,267680,4440,272120
1/24/2025,Vimukthi Wickramasinghe,Puttalam,Marawila,North Western,3898,4064,7962,155920,162560,318480
1/25/2025,Vimukthi Wickramasinghe,Puttalam,Marawila,North Western,7913,3919,11832,316520,156760,473280
1/26/2025,Vimukthi Wickramasinghe,Puttalam,Marawila,North Western,9836,3054,12890,393440,122160,515600
1/27/2025,Vimukthi Wickramasinghe,Puttalam,Marawila,North Western,1566,3193,4759,62640,127720,190360
1/28/2025,Vimukthi Wickramasinghe,Puttalam,Marawila,North Western,4516,2320,6836,180640,92800,273440
1/29/2025,Vimukthi Wickramasinghe,Puttalam,Marawila,North Western,3386,345,3731,135440,13800,149240
1/30/2025,Vimukthi Wickramasinghe,Puttalam,Marawila,North Western,8519,5435,13954,340760,217400,558160
1/31/2025,Vimukthi Wickramasinghe,Puttalam,Marawila,North Western,6608,1267,7875,264320,50680,315000
2/1/2025,Vimukthi Wickramasinghe,Puttalam,Marawila,North Western,7948,6525,14473,317920,261000,578920
2/2/2025,Vimukthi Wickramasinghe,Puttalam,Marawila,North Western,837,4155,4992,33480,166200,199680
2/3/2025,Vimukthi Wickramasinghe,Puttalam,Marawila,North Western,4310,8131,12441,172400,325240,497640
2/4/2025,Vimukthi Wickramasinghe,Puttalam,Marawila,North Western,4525,267,4792,181000,10680,191680
2/5/2025,Vimukthi Wickramasinghe,Puttalam,Marawila,North Western,646,8232,8878,25840,329280,355120
2/6/2025,Vimukthi Wickramasinghe,Puttalam,Marawila,North Western,7018,5352,12370,280720,214080,494800
2/7/2025,Vimukthi Wickramasinghe,Puttalam,Marawila,North Western,7223,19,7242,288920,760,289680
2/8/2025,Vimukthi Wickramasinghe,Puttalam,Marawila,North Western,3839,5429,9268,153560,217160,370720
2/9/2025,Vimukthi Wickramasinghe,Puttalam,Marawila,North Western,4103,2170,6273,164120,86800,250920
2/10/2025,Vimukthi Wickramasinghe,Puttalam,Marawila,North Western,4599,6020,10619,183960,240800,424760
2/11/2025,Vimukthi Wickramasinghe,Puttalam,Marawila,North Western,2389,8603,10992,95560,344120,439680
2/12/2025,Vimukthi Wickramasinghe,Puttalam,Marawila,North Western,5955,3211,9166,238200,128440,366640
2/13/2025,Vimukthi Wickramasinghe,Puttalam,Marawila,North Western,5790,4144,9934,231600,165760,397360
2/14/2025,Vimukthi Wickramasinghe,Puttalam,Marawila,North Western,919,9002,9921,36760,360080,396840
2/15/2025,Vimukthi Wickramasinghe,Puttalam,Marawila,North Western,8143,9082,17225,325720,363280,689000
2/16/2025,Vimukthi Wickramasinghe,Puttalam,Marawila,North Western,7819,749,8568,312760,29960,342720
2/17/2025,Vimukthi Wickramasinghe,Puttalam,Marawila,North Western,6912,3947,10859,276480,157880,434360
2/18/2025,Vimukthi Wickramasinghe,Puttalam,Marawila,North Western,4570,1054,5624,182800,42160,224960
2/19/2025,Vimukthi Wickramasinghe,Puttalam,Marawila,North Western,6350,8486,14836,254000,339440,593440
2/20/2025,Vimukthi Wickramasinghe,Puttalam,Marawila,North Western,5565,6969,12534,222600,278760,501360
2/21/2025,Vimukthi Wickramasinghe,Puttalam,Marawila,North Western,7637,761,8398,305480,30440,335920
2/22/2025,Vimukthi Wickramasinghe,Puttalam,Marawila,North Western,7414,8171,15585,296560,326840,623400
2/23/2025,Vimukthi Wickramasinghe,Puttalam,Marawila,North Western,7013,6813,13826,280520,272520,553040
2/24/2025,Vimukthi Wickramasinghe,Puttalam,Marawila,North Western,7905,1473,9378,316200,58920,375120
2/25/2025,Vimukthi Wickramasinghe,Puttalam,Marawila,North Western,4076,7597,11673,163040,303880,466920
2/26/2025,Vimukthi Wickramasinghe,Puttalam,Marawila,North Western,9472,2449,11921,378880,97960,476840
2/27/2025,Vimukthi Wickramasinghe,Puttalam,Marawila,North Western,2733,7382,10115,109320,295280,404600
2/28/2025,Vimukthi Wickramasinghe,Puttalam,Marawila,North Western,9722,7409,17131,388880,296360,685240
3/1/2025,Vimukthi Wickramasinghe,Puttalam,Marawila,North Western,1694,9006,10700,67760,360240,428000
3/2/2025,Vimukthi Wickramasinghe,Puttalam,Marawila,North Western,4790,3739,8529,191600,149560,341160
3/3/2025,Vimukthi Wickramasinghe,Puttalam,Marawila,North Western,5216,7237,12453,208640,289480,498120
3/4/2025,Vimukthi Wickramasinghe,Puttalam,Marawila,North Western,7453,782,8235,298120,31280,329400
3/5/2025,Vimukthi Wickramasinghe,Puttalam,Marawila,North Western,9157,4121,13278,366280,164840,531120
3/6/2025,Vimukthi Wickramasinghe,Puttalam,Marawila,North Western,4561,3932,8493,182440,157280,339720
3/7/2025,Vimukthi Wickramasinghe,Puttalam,Marawila,North Western,3292,1762,5054,131680,70480,202160
3/8/2025,Vimukthi Wickramasinghe,Puttalam,Marawila,North Western,5058,5616,10674,202320,224640,426960
3/9/2025,Vimukthi Wickramasinghe,Puttalam,Marawila,North Western,1840,2458,4298,73600,98320,171920
3/10/2025,Vimukthi Wickramasinghe,Puttalam,Marawila,North Western,2820,4754,7574,112800,190160,302960
3/11/2025,Vimukthi Wickramasinghe,Puttalam,Marawila,North Western,9327,7127,16454,373080,285080,658160
3/12/2025,Vimukthi Wickramasinghe,Puttalam,Marawila,North Western,9835,9326,19161,393400,373040,766440
3/13/2025,Vimukthi Wickramasinghe,Puttalam,Marawila,North Western,4174,7172,11346,166960,286880,453840
3/14/2025,Vimukthi Wickramasinghe,Puttalam,Marawila,North Western,6145,4140,10285,245800,165600,411400
3/15/2025,Vimukthi Wickramasinghe,Puttalam,Marawila,North Western,7940,2086,10026,317600,83440,401040
3/16/2025,Vimukthi Wickramasinghe,Puttalam,Marawila,North Western,5211,9949,15160,208440,397960,606400
3/17/2025,Vimukthi Wickramasinghe,Puttalam,Marawila,North Western,1760,6504,8264,70400,260160,330560
3/18/2025,Vimukthi Wickramasinghe,Puttalam,Marawila,North Western,6074,5139,11213,242960,205560,448520
3/19/2025,Vimukthi Wickramasinghe,Puttalam,Marawila,North Western,4414,3481,7895,176560,139240,315800
3/20/2025,Vimukthi Wickramasinghe,Puttalam,Marawila,North Western,5070,7945,13015,202800,317800,520600
3/21/2025,Vimukthi Wickramasinghe,Puttalam,Marawila,North Western,1802,7120,8922,72080,284800,356880
3/22/2025,Vimukthi Wickramasinghe,Puttalam,Marawila,North Western,8580,2318,10898,343200,92720,435920
3/23/2025,Vimukthi Wickramasinghe,Puttalam,Marawila,North Western,9560,2404,11964,382400,96160,478560
3/25/2024,Chaminda Gunaratne,Colombo,Sri Jayawardenepura Kotte,Western,5357,9824,15181,214280,392960,607240
3/26/2024,Chaminda Gunaratne,Colombo,Sri Jayawardenepura Kotte,Western,8050,1783,9833,322000,71320,393320
3/27/2024,Chaminda Gunaratne,Colombo,Sri Jayawardenepura Kotte,Western,6677,7643,14320,267080,305720,572800
3/28/2024,Chaminda Gunaratne,Colombo,Sri Jayawardenepura Kotte,Western,7557,670,8227,302280,26800,329080
3/29/2024,Chaminda Gunaratne,Colombo,Sri Jayawardenepura Kotte,Western,3943,2672,6615,157720,106880,264600
3/30/2024,Chaminda Gunaratne,Colombo,Sri Jayawardenepura Kotte,Western,3737,6356,10093,149480,254240,403720
3/31/2024,Chaminda Gunaratne,Colombo,Sri Jayawardenepura Kotte,Western,588,8214,8802,23520,328560,352080
4/1/2024,Chaminda Gunaratne,Colombo,Sri Jayawardenepura Kotte,Western,3,3198,3201,120,127920,128040
4/2/2024,Chaminda Gunaratne,Colombo,Sri Jayawardenepura Kotte,Western,4804,143,4947,192160,5720,197880
4/3/2024,Chaminda Gunaratne,Colombo,Sri Jayawardenepura Kotte,Western,8361,1016,9377,334440,40640,375080
4/4/2024,Chaminda Gunaratne,Colombo,Sri Jayawardenepura Kotte,Western,2026,2852,4878,81040,114080,195120
4/5/2024,Chaminda Gunaratne,Colombo,Sri Jayawardenepura Kotte,Western,8963,5358,14321,358520,214320,572840
4/6/2024,Chaminda Gunaratne,Colombo,Sri Jayawardenepura Kotte,Western,3351,3868,7219,134040,154720,288760
4/7/2024,Chaminda Gunaratne,Colombo,Sri Jayawardenepura Kotte,Western,2566,9930,12496,102640,397200,499840
4/8/2024,Chaminda Gunaratne,Colombo,Sri Jayawardenepura Kotte,Western,4885,3827,8712,195400,153080,348480
4/9/2024,Chaminda Gunaratne,Colombo,Sri Jayawardenepura Kotte,Western,6459,9432,15891,258360,377280,635640
4/10/2024,Chaminda Gunaratne,Colombo,Sri Jayawardenepura Kotte,Western,4787,4873,9660,191480,194920,386400
4/11/2024,Chaminda Gunaratne,Colombo,Sri Jayawardenepura Kotte,Western,6162,9831,15993,246480,393240,639720
4/19/2024,Chaminda Gunaratne,Colombo,Sri Jayawardenepura Kotte,Western,967,3462,4429,38680,138480,177160
4/20/2024,Chaminda Gunaratne,Colombo,Sri Jayawardenepura Kotte,Western,1861,888,2749,74440,35520,109960
4/21/2024,Chaminda Gunaratne,Colombo,Sri Jayawardenepura Kotte,Western,5897,554,6451,235880,22160,258040
4/22/2024,Chaminda Gunaratne,Colombo,Sri Jayawardenepura Kotte,Western,7923,8081,16004,316920,323240,640160
4/23/2024,Chaminda Gunaratne,Colombo,Sri Jayawardenepura Kotte,Western,1191,1482,2673,47640,59280,106920
4/24/2024,Chaminda Gunaratne,Colombo,Sri Jayawardenepura Kotte,Western,1767,8649,10416,70680,345960,416640
4/25/2024,Chaminda Gunaratne,Colombo,Sri Jayawardenepura Kotte,Western,6507,383,6890,260280,15320,275600
4/26/2024,Chaminda Gunaratne,Colombo,Sri Jayawardenepura Kotte,Western,8496,8798,17294,339840,351920,691760
4/27/2024,Chaminda Gunaratne,Colombo,Sri Jayawardenepura Kotte,Western,8229,9375,17604,329160,375000,704160
4/28/2024,Chaminda Gunaratne,Colombo,Sri Jayawardenepura Kotte,Western,8959,9964,18923,358360,398560,756920
4/29/2024,Chaminda Gunaratne,Colombo,Sri Jayawardenepura Kotte,Western,7861,8721,16582,314440,348840,663280
4/30/2024,Chaminda Gunaratne,Colombo,Sri Jayawardenepura Kotte,Western,7695,4570,12265,307800,182800,490600
5/1/2024,Chaminda Gunaratne,Colombo,Sri Jayawardenepura Kotte,Western,4929,9988,14917,197160,399520,596680
5/2/2024,Chaminda Gunaratne,Colombo,Sri Jayawardenepura Kotte,Western,5115,9173,14288,204600,366920,571520
5/3/2024,Chaminda Gunaratne,Colombo,Sri Jayawardenepura Kotte,Western,6461,3636,10097,258440,145440,403880
5/4/2024,Chaminda Gunaratne,Colombo,Sri Jayawardenepura Kotte,Western,2860,6301,9161,114400,252040,366440
5/5/2024,Chaminda Gunaratne,Colombo,Sri Jayawardenepura Kotte,Western,5995,8524,14519,239800,340960,580760
5/6/2024,Chaminda Gunaratne,Colombo,Sri Jayawardenepura Kotte,Western,5693,6479,12172,227720,259160,486880
5/7/2024,Chaminda Gunaratne,Colombo,Sri Jayawardenepura Kotte,Western,9018,5255,14273,360720,210200,570920
5/8/2024,Chaminda Gunaratne,Colombo,Sri Jayawardenepura Kotte,Western,8600,8852,17452,344000,354080,698080
5/9/2024,Chaminda Gunaratne,Colombo,Sri Jayawardenepura Kotte,Western,8346,9301,17647,333840,372040,705880
5/10/2024,Chaminda Gunaratne,Colombo,Sri Jayawardenepura Kotte,Western,2065,5247,7312,82600,209880,292480
5/11/2024,Chaminda Gunaratne,Colombo,Sri Jayawardenepura Kotte,Western,9645,5014,14659,385800,200560,586360
5/12/2024,Chaminda Gunaratne,Colombo,Sri Jayawardenepura Kotte,Western,2318,7537,9855,92720,301480,394200
5/13/2024,Chaminda Gunaratne,Colombo,Sri Jayawardenepura Kotte,Western,9007,8870,17877,360280,354800,715080
5/14/2024,Chaminda Gunaratne,Colombo,Sri Jayawardenepura Kotte,Western,3687,4571,8258,147480,182840,330320
5/15/2024,Chaminda Gunaratne,Colombo,Sri Jayawardenepura Kotte,Western,5412,2416,7828,216480,96640,313120
5/16/2024,Chaminda Gunaratne,Colombo,Sri Jayawardenepura Kotte,Western,8818,8629,17447,352720,345160,697880
5/17/2024,Chaminda Gunaratne,Colombo,Sri Jayawardenepura Kotte,Western,4438,3665,8103,177520,146600,324120
5/18/2024,Chaminda Gunaratne,Colombo,Sri Jayawardenepura Kotte,Western,9803,4051,13854,392120,162040,554160
5/19/2024,Chaminda Gunaratne,Colombo,Sri Jayawardenepura Kotte,Western,8451,432,8883,338040,17280,355320
5/20/2024,Chaminda Gunaratne,Colombo,Sri Jayawardenepura Kotte,Western,582,8329,8911,23280,333160,356440
5/21/2024,Chaminda Gunaratne,Colombo,Sri Jayawardenepura Kotte,Western,8012,6972,14984,320480,278880,599360
5/22/2024,Chaminda Gunaratne,Colombo,Sri Jayawardenepura Kotte,Western,8856,126,8982,354240,5040,359280
5/24/2024,Chaminda Gunaratne,Colombo,Sri Jayawardenepura Kotte,Western,8066,3350,11416,322640,134000,456640
5/25/2024,Chaminda Gunaratne,Colombo,Sri Jayawardenepura Kotte,Western,2167,1734,3901,86680,69360,156040
5/26/2024,Chaminda Gunaratne,Colombo,Sri Jayawardenepura Kotte,Western,5442,8243,13685,217680,329720,547400
5/27/2024,Chaminda Gunaratne,Colombo,Sri Jayawardenepura Kotte,Western,9932,2891,12823,397280,115640,512920
5/28/2024,Chaminda Gunaratne,Colombo,Sri Jayawardenepura Kotte,Western,1776,628,2404,71040,25120,96160
5/29/2024,Chaminda Gunaratne,Colombo,Sri Jayawardenepura Kotte,Western,2661,2762,5423,106440,110480,216920
5/30/2024,Chaminda Gunaratne,Colombo,Sri Jayawardenepura Kotte,Western,206,4101,4307,8240,164040,172280
5/31/2024,Chaminda Gunaratne,Colombo,Sri Jayawardenepura Kotte,Western,4468,8008,12476,178720,320320,499040
6/1/2024,Chaminda Gunaratne,Colombo,Sri Jayawardenepura Kotte,Western,4631,3680,8311,185240,147200,332440
6/2/2024,Chaminda Gunaratne,Colombo,Sri Jayawardenepura Kotte,Western,571,4594,5165,22840,183760,206600
6/3/2024,Chaminda Gunaratne,Colombo,Sri Jayawardenepura Kotte,Western,6211,5361,11572,248440,214440,462880
6/4/2024,Chaminda Gunaratne,Colombo,Sri Jayawardenepura Kotte,Western,4145,412,4557,165800,16480,182280
6/5/2024,Chaminda Gunaratne,Colombo,Sri Jayawardenepura Kotte,Western,225,821,1046,9000,32840,41840
6/6/2024,Chaminda Gunaratne,Colombo,Sri Jayawardenepura Kotte,Western,8790,8759,17549,351600,350360,701960
6/7/2024,Chaminda Gunaratne,Colombo,Sri Jayawardenepura Kotte,Western,5075,9238,14313,203000,369520,572520
6/8/2024,Chaminda Gunaratne,Colombo,Sri Jayawardenepura Kotte,Western,4381,7887,12268,175240,315480,490720
6/9/2024,Chaminda Gunaratne,Colombo,Sri Jayawardenepura Kotte,Western,6734,6210,12944,269360,248400,517760
6/10/2024,Chaminda Gunaratne,Colombo,Sri Jayawardenepura Kotte,Western,6335,5532,11867,253400,221280,474680
6/11/2024,Chaminda Gunaratne,Colombo,Sri Jayawardenepura Kotte,Western,3881,5498,9379,155240,219920,375160
6/12/2024,Chaminda Gunaratne,Colombo,Sri Jayawardenepura Kotte,Western,6047,1950,7997,241880,78000,319880
6/13/2024,Chaminda Gunaratne,Colombo,Sri Jayawardenepura Kotte,Western,9771,8513,18284,390840,340520,731360
6/14/2024,Chaminda Gunaratne,Colombo,Sri Jayawardenepura Kotte,Western,3136,8550,11686,125440,342000,467440
6/15/2024,Chaminda Gunaratne,Colombo,Sri Jayawardenepura Kotte,Western,8578,3882,12460,343120,155280,498400
6/16/2024,Chaminda Gunaratne,Colombo,Sri Jayawardenepura Kotte,Western,8258,4387,12645,330320,175480,505800
6/17/2024,Chaminda Gunaratne,Colombo,Sri Jayawardenepura Kotte,Western,106,134,240,4240,5360,9600
6/18/2024,Chaminda Gunaratne,Colombo,Sri Jayawardenepura Kotte,Western,1618,1111,2729,64720,44440,109160
6/19/2024,Chaminda Gunaratne,Colombo,Sri Jayawardenepura Kotte,Western,4793,8975,13768,191720,359000,550720
6/20/2024,Chaminda Gunaratne,Colombo,Sri Jayawardenepura Kotte,Western,3984,7662,11646,159360,306480,465840
6/21/2024,Chaminda Gunaratne,Colombo,Sri Jayawardenepura Kotte,Western,6391,5203,11594,255640,208120,463760
6/22/2024,Chaminda Gunaratne,Colombo,Sri Jayawardenepura Kotte,Western,7273,2889,10162,290920,115560,406480
6/23/2024,Chaminda Gunaratne,Colombo,Sri Jayawardenepura Kotte,Western,5474,9388,14862,218960,375520,594480
6/24/2024,Chaminda Gunaratne,Colombo,Sri Jayawardenepura Kotte,Western,4348,2324,6672,173920,92960,266880
6/25/2024,Chaminda Gunaratne,Colombo,Sri Jayawardenepura Kotte,Western,2950,4085,7035,118000,163400,281400
6/26/2024,Chaminda Gunaratne,Colombo,Sri Jayawardenepura Kotte,Western,5711,7103,12814,228440,284120,512560
6/27/2024,Chaminda Gunaratne,Colombo,Sri Jayawardenepura Kotte,Western,5866,3441,9307,234640,137640,372280
6/28/2024,Chaminda Gunaratne,Colombo,Sri Jayawardenepura Kotte,Western,1046,1092,2138,41840,43680,85520
6/29/2024,Chaminda Gunaratne,Colombo,Sri Jayawardenepura Kotte,Western,9589,132,9721,383560,5280,388840
6/30/2024,Chaminda Gunaratne,Colombo,Sri Jayawardenepura Kotte,Western,6761,8662,15423,270440,346480,616920
7/1/2024,Chaminda Gunaratne,Colombo,Sri Jayawardenepura Kotte,Western,6547,2677,9224,261880,107080,368960
7/2/2024,Chaminda Gunaratne,Colombo,Sri Jayawardenepura Kotte,Western,3319,7385,10704,132760,295400,428160
7/3/2024,Chaminda Gunaratne,Colombo,Sri Jayawardenepura Kotte,Western,3254,5325,8579,130160,213000,343160
7/4/2024,Chaminda Gunaratne,Colombo,Sri Jayawardenepura Kotte,Western,2440,5546,7986,97600,221840,319440
7/5/2024,Chaminda Gunaratne,Colombo,Sri Jayawardenepura Kotte,Western,5154,3375,8529,206160,135000,341160
7/6/2024,Chaminda Gunaratne,Colombo,Sri Jayawardenepura Kotte,Western,3474,9406,12880,138960,376240,515200
7/7/2024,Chaminda Gunaratne,Colombo,Sri Jayawardenepura Kotte,Western,4863,6374,11237,194520,254960,449480
7/8/2024,Chaminda Gunaratne,Colombo,Sri Jayawardenepura Kotte,Western,9338,507,9845,373520,20280,393800
7/9/2024,Chaminda Gunaratne,Colombo,Sri Jayawardenepura Kotte,Western,1922,8222,10144,76880,328880,405760
7/10/2024,Chaminda Gunaratne,Colombo,Sri Jayawardenepura Kotte,Western,7254,2353,9607,290160,94120,384280
7/11/2024,Chaminda Gunaratne,Colombo,Sri Jayawardenepura Kotte,Western,343,8853,9196,13720,354120,367840
7/12/2024,Chaminda Gunaratne,Colombo,Sri Jayawardenepura Kotte,Western,3472,8039,11511,138880,321560,460440
7/13/2024,Chaminda Gunaratne,Colombo,Sri Jayawardenepura Kotte,Western,1050,8884,9934,42000,355360,397360
7/14/2024,Chaminda Gunaratne,Colombo,Sri Jayawardenepura Kotte,Western,7432,5537,12969,297280,221480,518760
7/15/2024,Chaminda Gunaratne,Colombo,Sri Jayawardenepura Kotte,Western,7763,7783,15546,310520,311320,621840
7/16/2024,Chaminda Gunaratne,Colombo,Sri Jayawardenepura Kotte,Western,9536,6671,16207,381440,266840,648280
7/17/2024,Chaminda Gunaratne,Colombo,Sri Jayawardenepura Kotte,Western,3695,3281,6976,147800,131240,279040
7/18/2024,Chaminda Gunaratne,Colombo,Sri Jayawardenepura Kotte,Western,492,298,790,19680,11920,31600
7/19/2024,Chaminda Gunaratne,Colombo,Sri Jayawardenepura Kotte,Western,3655,1860,5515,146200,74400,220600
7/20/2024,Chaminda Gunaratne,Colombo,Sri Jayawardenepura Kotte,Western,7696,793,8489,307840,31720,339560
7/21/2024,Chaminda Gunaratne,Colombo,Sri Jayawardenepura Kotte,Western,8817,2862,11679,352680,114480,467160
7/22/2024,Chaminda Gunaratne,Colombo,Sri Jayawardenepura Kotte,Western,4950,8328,13278,198000,333120,531120
7/23/2024,Chaminda Gunaratne,Colombo,Sri Jayawardenepura Kotte,Western,462,5049,5511,18480,201960,220440
7/24/2024,Chaminda Gunaratne,Colombo,Sri Jayawardenepura Kotte,Western,3820,2544,6364,152800,101760,254560
7/25/2024,Chaminda Gunaratne,Colombo,Sri Jayawardenepura Kotte,Western,6528,7988,14516,261120,319520,580640
7/26/2024,Chaminda Gunaratne,Colombo,Sri Jayawardenepura Kotte,Western,1485,3844,5329,59400,153760,213160
7/27/2024,Chaminda Gunaratne,Colombo,Sri Jayawardenepura Kotte,Western,7844,82,7926,313760,3280,317040
7/28/2024,Chaminda Gunaratne,Colombo,Sri Jayawardenepura Kotte,Western,3215,5320,8535,128600,212800,341400
7/29/2024,Chaminda Gunaratne,Colombo,Sri Jayawardenepura Kotte,Western,6309,3350,9659,252360,134000,386360
7/30/2024,Chaminda Gunaratne,Colombo,Sri Jayawardenepura Kotte,Western,2972,3135,6107,118880,125400,244280
7/31/2024,Chaminda Gunaratne,Colombo,Sri Jayawardenepura Kotte,Western,2282,376,2658,91280,15040,106320
8/1/2024,Chaminda Gunaratne,Colombo,Sri Jayawardenepura Kotte,Western,756,5022,5778,30240,200880,231120
8/2/2024,Chaminda Gunaratne,Colombo,Sri Jayawardenepura Kotte,Western,861,507,1368,34440,20280,54720
8/3/2024,Chaminda Gunaratne,Colombo,Sri Jayawardenepura Kotte,Western,43,8939,8982,1720,357560,359280
8/4/2024,Chaminda Gunaratne,Colombo,Sri Jayawardenepura Kotte,Western,9716,1459,11175,388640,58360,447000
8/5/2024,Chaminda Gunaratne,Colombo,Sri Jayawardenepura Kotte,Western,7805,5735,13540,312200,229400,541600
8/6/2024,Chaminda Gunaratne,Colombo,Sri Jayawardenepura Kotte,Western,7829,16,7845,313160,640,313800
8/7/2024,Chaminda Gunaratne,Colombo,Sri Jayawardenepura Kotte,Western,1626,4481,6107,65040,179240,244280
8/8/2024,Chaminda Gunaratne,Colombo,Sri Jayawardenepura Kotte,Western,7930,5443,13373,317200,217720,534920
8/9/2024,Chaminda Gunaratne,Colombo,Sri Jayawardenepura Kotte,Western,4394,3834,8228,175760,153360,329120
8/10/2024,Chaminda Gunaratne,Colombo,Sri Jayawardenepura Kotte,Western,4194,4705,8899,167760,188200,355960
8/11/2024,Chaminda Gunaratne,Colombo,Sri Jayawardenepura Kotte,Western,309,7325,7634,12360,293000,305360
8/12/2024,Chaminda Gunaratne,Colombo,Sri Jayawardenepura Kotte,Western,1500,1440,2940,60000,57600,117600
8/13/2024,Chaminda Gunaratne,Colombo,Sri Jayawardenepura Kotte,Western,7770,5009,12779,310800,200360,511160
8/14/2024,Chaminda Gunaratne,Colombo,Sri Jayawardenepura Kotte,Western,6515,9584,16099,260600,383360,643960
8/15/2024,Chaminda Gunaratne,Colombo,Sri Jayawardenepura Kotte,Western,5293,5761,11054,211720,230440,442160
8/16/2024,Chaminda Gunaratne,Colombo,Sri Jayawardenepura Kotte,Western,565,3951,4516,22600,158040,180640
8/17/2024,Chaminda Gunaratne,Colombo,Sri Jayawardenepura Kotte,Western,2175,8779,10954,87000,351160,438160
8/18/2024,Chaminda Gunaratne,Colombo,Sri Jayawardenepura Kotte,Western,1666,2165,3831,66640,86600,153240
8/19/2024,Chaminda Gunaratne,Colombo,Sri Jayawardenepura Kotte,Western,8535,6554,15089,341400,262160,603560
8/20/2024,Chaminda Gunaratne,Colombo,Sri Jayawardenepura Kotte,Western,8180,7138,15318,327200,285520,612720
8/21/2024,Chaminda Gunaratne,Colombo,Sri Jayawardenepura Kotte,Western,35,3491,3526,1400,139640,141040
8/22/2024,Chaminda Gunaratne,Colombo,Sri Jayawardenepura Kotte,Western,7346,2367,9713,293840,94680,388520
8/23/2024,Chaminda Gunaratne,Colombo,Sri Jayawardenepura Kotte,Western,3585,6380,9965,143400,255200,398600
8/24/2024,Chaminda Gunaratne,Colombo,Sri Jayawardenepura Kotte,Western,2797,5980,8777,111880,239200,351080
8/25/2024,Chaminda Gunaratne,Colombo,Sri Jayawardenepura Kotte,Western,2659,3492,6151,106360,139680,246040
8/26/2024,Chaminda Gunaratne,Colombo,Sri Jayawardenepura Kotte,Western,3881,1157,5038,155240,46280,201520
8/27/2024,Chaminda Gunaratne,Colombo,Sri Jayawardenepura Kotte,Western,7466,3945,11411,298640,157800,456440
8/28/2024,Chaminda Gunaratne,Colombo,Sri Jayawardenepura Kotte,Western,8745,4132,12877,349800,165280,515080
8/29/2024,Chaminda Gunaratne,Colombo,Sri Jayawardenepura Kotte,Western,9883,1894,11777,395320,75760,471080
8/30/2024,Chaminda Gunaratne,Colombo,Sri Jayawardenepura Kotte,Western,102,5244,5346,4080,209760,213840
8/31/2024,Chaminda Gunaratne,Colombo,Sri Jayawardenepura Kotte,Western,5295,6678,11973,211800,267120,478920
9/1/2024,Chaminda Gunaratne,Colombo,Sri Jayawardenepura Kotte,Western,1588,9878,11466,63520,395120,458640
9/2/2024,Chaminda Gunaratne,Colombo,Sri Jayawardenepura Kotte,Western,7443,2748,10191,297720,109920,407640
9/3/2024,Chaminda Gunaratne,Colombo,Sri Jayawardenepura Kotte,Western,7511,9965,17476,300440,398600,699040
9/4/2024,Chaminda Gunaratne,Colombo,Sri Jayawardenepura Kotte,Western,8945,7355,16300,357800,294200,652000
9/5/2024,Chaminda Gunaratne,Colombo,Sri Jayawardenepura Kotte,Western,4870,4149,9019,194800,165960,360760
9/6/2024,Chaminda Gunaratne,Colombo,Sri Jayawardenepura Kotte,Western,3587,8290,11877,143480,331600,475080
9/7/2024,Chaminda Gunaratne,Colombo,Sri Jayawardenepura Kotte,Western,8641,1450,10091,345640,58000,403640
9/8/2024,Chaminda Gunaratne,Colombo,Sri Jayawardenepura Kotte,Western,6267,2703,8970,250680,108120,358800
9/9/2024,Chaminda Gunaratne,Colombo,Sri Jayawardenepura Kotte,Western,8763,522,9285,350520,20880,371400
9/10/2024,Chaminda Gunaratne,Colombo,Sri Jayawardenepura Kotte,Western,9106,9760,18866,364240,390400,754640
9/11/2024,Chaminda Gunaratne,Colombo,Sri Jayawardenepura Kotte,Western,1077,3734,4811,43080,149360,192440
9/12/2024,Chaminda Gunaratne,Colombo,Sri Jayawardenepura Kotte,Western,24,3717,3741,960,148680,149640
9/13/2024,Chaminda Gunaratne,Colombo,Sri Jayawardenepura Kotte,Western,8879,8610,17489,355160,344400,699560
9/14/2024,Chaminda Gunaratne,Colombo,Sri Jayawardenepura Kotte,Western,2334,1268,3602,93360,50720,144080
9/15/2024,Chaminda Gunaratne,Colombo,Sri Jayawardenepura Kotte,Western,2440,1357,3797,97600,54280,151880
9/16/2024,Chaminda Gunaratne,Colombo,Sri Jayawardenepura Kotte,Western,951,7735,8686,38040,309400,347440
9/17/2024,Chaminda Gunaratne,Colombo,Sri Jayawardenepura Kotte,Western,7528,2062,9590,301120,82480,383600
9/18/2024,Chaminda Gunaratne,Colombo,Sri Jayawardenepura Kotte,Western,2464,4253,6717,98560,170120,268680
9/19/2024,Chaminda Gunaratne,Colombo,Sri Jayawardenepura Kotte,Western,1116,6746,7862,44640,269840,314480
9/20/2024,Chaminda Gunaratne,Colombo,Sri Jayawardenepura Kotte,Western,4379,4343,8722,175160,173720,348880
9/21/2024,Chaminda Gunaratne,Colombo,Sri Jayawardenepura Kotte,Western,1938,3611,5549,77520,144440,221960
9/22/2024,Chaminda Gunaratne,Colombo,Sri Jayawardenepura Kotte,Western,6773,9873,16646,270920,394920,665840
9/23/2024,Chaminda Gunaratne,Colombo,Sri Jayawardenepura Kotte,Western,8985,7500,16485,359400,300000,659400
9/24/2024,Chaminda Gunaratne,Colombo,Sri Jayawardenepura Kotte,Western,3525,6771,10296,141000,270840,411840
9/25/2024,Chaminda Gunaratne,Colombo,Sri Jayawardenepura Kotte,Western,7700,5103,12803,308000,204120,512120
9/26/2024,Chaminda Gunaratne,Colombo,Sri Jayawardenepura Kotte,Western,7926,1572,9498,317040,62880,379920
9/27/2024,Chaminda Gunaratne,Colombo,Sri Jayawardenepura Kotte,Western,8020,3140,11160,320800,125600,446400
9/28/2024,Chaminda Gunaratne,Colombo,Sri Jayawardenepura Kotte,Western,1768,8352,10120,70720,334080,404800
9/29/2024,Chaminda Gunaratne,Colombo,Sri Jayawardenepura Kotte,Western,2063,7799,9862,82520,311960,394480
9/30/2024,Chaminda Gunaratne,Colombo,Sri Jayawardenepura Kotte,Western,1470,4033,5503,58800,161320,220120
10/1/2024,Chaminda Gunaratne,Colombo,Sri Jayawardenepura Kotte,Western,5539,4377,9916,221560,175080,396640
10/2/2024,Chaminda Gunaratne,Colombo,Sri Jayawardenepura Kotte,Western,3048,7139,10187,121920,285560,407480
10/3/2024,Chaminda Gunaratne,Colombo,Sri Jayawardenepura Kotte,Western,5356,8348,13704,214240,333920,548160
10/4/2024,Chaminda Gunaratne,Colombo,Sri Jayawardenepura Kotte,Western,492,5250,5742,19680,210000,229680
10/5/2024,Chaminda Gunaratne,Colombo,Sri Jayawardenepura Kotte,Western,6760,8859,15619,270400,354360,624760
10/6/2024,Chaminda Gunaratne,Colombo,Sri Jayawardenepura Kotte,Western,3721,8997,12718,148840,359880,508720
10/7/2024,Chaminda Gunaratne,Colombo,Sri Jayawardenepura Kotte,Western,9971,1329,11300,398840,53160,452000
10/8/2024,Chaminda Gunaratne,Colombo,Sri Jayawardenepura Kotte,Western,2271,600,2871,90840,24000,114840
10/9/2024,Chaminda Gunaratne,Colombo,Sri Jayawardenepura Kotte,Western,370,3244,3614,14800,129760,144560
10/10/2024,Chaminda Gunaratne,Colombo,Sri Jayawardenepura Kotte,Western,2984,9926,12910,119360,397040,516400
10/11/2024,Chaminda Gunaratne,Colombo,Sri Jayawardenepura Kotte,Western,1080,9209,10289,43200,368360,411560
10/12/2024,Chaminda Gunaratne,Colombo,Sri Jayawardenepura Kotte,Western,5632,3485,9117,225280,139400,364680
10/13/2024,Chaminda Gunaratne,Colombo,Sri Jayawardenepura Kotte,Western,5476,7307,12783,219040,292280,511320
10/14/2024,Chaminda Gunaratne,Colombo,Sri Jayawardenepura Kotte,Western,4723,5733,10456,188920,229320,418240
10/15/2024,Chaminda Gunaratne,Colombo,Sri Jayawardenepura Kotte,Western,1793,291,2084,71720,11640,83360
10/16/2024,Chaminda Gunaratne,Colombo,Sri Jayawardenepura Kotte,Western,4277,1345,5622,171080,53800,224880
10/17/2024,Chaminda Gunaratne,Colombo,Sri Jayawardenepura Kotte,Western,7151,7838,14989,286040,313520,599560
10/18/2024,Chaminda Gunaratne,Colombo,Sri Jayawardenepura Kotte,Western,5526,8609,14135,221040,344360,565400
10/19/2024,Chaminda Gunaratne,Colombo,Sri Jayawardenepura Kotte,Western,9022,5088,14110,360880,203520,564400
10/20/2024,Chaminda Gunaratne,Colombo,Sri Jayawardenepura Kotte,Western,5526,7615,13141,221040,304600,525640
10/21/2024,Chaminda Gunaratne,Colombo,Sri Jayawardenepura Kotte,Western,9331,6048,15379,373240,241920,615160
10/22/2024,Chaminda Gunaratne,Colombo,Sri Jayawardenepura Kotte,Western,5689,4414,10103,227560,176560,404120
10/23/2024,Chaminda Gunaratne,Colombo,Sri Jayawardenepura Kotte,Western,5932,3149,9081,237280,125960,363240
10/24/2024,Chaminda Gunaratne,Colombo,Sri Jayawardenepura Kotte,Western,7365,9507,16872,294600,380280,674880
10/25/2024,Chaminda Gunaratne,Colombo,Sri Jayawardenepura Kotte,Western,6335,9403,15738,253400,376120,629520
10/26/2024,Chaminda Gunaratne,Colombo,Sri Jayawardenepura Kotte,Western,7062,8496,15558,282480,339840,622320
10/27/2024,Chaminda Gunaratne,Colombo,Sri Jayawardenepura Kotte,Western,5320,153,5473,212800,6120,218920
10/28/2024,Chaminda Gunaratne,Colombo,Sri Jayawardenepura Kotte,Western,6098,3591,9689,243920,143640,387560
10/29/2024,Chaminda Gunaratne,Colombo,Sri Jayawardenepura Kotte,Western,2737,2684,5421,109480,107360,216840
10/30/2024,Chaminda Gunaratne,Colombo,Sri Jayawardenepura Kotte,Western,7996,4287,12283,319840,171480,491320
10/31/2024,Chaminda Gunaratne,Colombo,Sri Jayawardenepura Kotte,Western,1385,9459,10844,55400,378360,433760
11/1/2024,Chaminda Gunaratne,Colombo,Sri Jayawardenepura Kotte,Western,7753,4158,11911,310120,166320,476440
11/2/2024,Chaminda Gunaratne,Colombo,Sri Jayawardenepura Kotte,Western,6712,4030,10742,268480,161200,429680
11/3/2024,Chaminda Gunaratne,Colombo,Sri Jayawardenepura Kotte,Western,4585,3363,7948,183400,134520,317920
11/4/2024,Chaminda Gunaratne,Colombo,Sri Jayawardenepura Kotte,Western,3408,3040,6448,136320,121600,257920
11/5/2024,Chaminda Gunaratne,Colombo,Sri Jayawardenepura Kotte,Western,4556,5424,9980,182240,216960,399200
11/6/2024,Chaminda Gunaratne,Colombo,Sri Jayawardenepura Kotte,Western,203,5189,5392,8120,207560,215680
11/7/2024,Chaminda Gunaratne,Colombo,Sri Jayawardenepura Kotte,Western,9224,995,10219,368960,39800,408760
11/8/2024,Chaminda Gunaratne,Colombo,Sri Jayawardenepura Kotte,Western,957,2985,3942,38280,119400,157680
11/9/2024,Chaminda Gunaratne,Colombo,Sri Jayawardenepura Kotte,Western,2541,8062,10603,101640,322480,424120
11/10/2024,Chaminda Gunaratne,Colombo,Sri Jayawardenepura Kotte,Western,9218,9531,18749,368720,381240,749960
11/11/2024,Chaminda Gunaratne,Colombo,Sri Jayawardenepura Kotte,Western,7362,283,7645,294480,11320,305800
11/12/2024,Chaminda Gunaratne,Colombo,Sri Jayawardenepura Kotte,Western,7360,5514,12874,294400,220560,514960
11/13/2024,Chaminda Gunaratne,Colombo,Sri Jayawardenepura Kotte,Western,3587,8041,11628,143480,321640,465120
11/14/2024,Chaminda Gunaratne,Colombo,Sri Jayawardenepura Kotte,Western,4764,680,5444,190560,27200,217760
11/15/2024,Chaminda Gunaratne,Colombo,Sri Jayawardenepura Kotte,Western,5920,7659,13579,236800,306360,543160
11/16/2024,Chaminda Gunaratne,Colombo,Sri Jayawardenepura Kotte,Western,9754,7197,16951,390160,287880,678040
11/17/2024,Chaminda Gunaratne,Colombo,Sri Jayawardenepura Kotte,Western,5881,8891,14772,235240,355640,590880
11/18/2024,Chaminda Gunaratne,Colombo,Sri Jayawardenepura Kotte,Western,8783,6943,15726,351320,277720,629040
11/19/2024,Chaminda Gunaratne,Colombo,Sri Jayawardenepura Kotte,Western,3440,5732,9172,137600,229280,366880
11/20/2024,Chaminda Gunaratne,Colombo,Sri Jayawardenepura Kotte,Western,2461,9214,11675,98440,368560,467000
11/21/2024,Chaminda Gunaratne,Colombo,Sri Jayawardenepura Kotte,Western,3670,588,4258,146800,23520,170320
11/22/2024,Chaminda Gunaratne,Colombo,Sri Jayawardenepura Kotte,Western,222,4549,4771,8880,181960,190840
11/23/2024,Chaminda Gunaratne,Colombo,Sri Jayawardenepura Kotte,Western,2115,589,2704,84600,23560,108160
11/24/2024,Chaminda Gunaratne,Colombo,Sri Jayawardenepura Kotte,Western,1118,1403,2521,44720,56120,100840
11/25/2024,Chaminda Gunaratne,Colombo,Sri Jayawardenepura Kotte,Western,4322,1088,5410,172880,43520,216400
11/26/2024,Chaminda Gunaratne,Colombo,Sri Jayawardenepura Kotte,Western,7490,1350,8840,299600,54000,353600
11/27/2024,Chaminda Gunaratne,Colombo,Sri Jayawardenepura Kotte,Western,7182,5451,12633,287280,218040,505320
11/28/2024,Chaminda Gunaratne,Colombo,Sri Jayawardenepura Kotte,Western,8081,2836,10917,323240,113440,436680
11/29/2024,Chaminda Gunaratne,Colombo,Sri Jayawardenepura Kotte,Western,3556,4768,8324,142240,190720,332960
11/30/2024,Chaminda Gunaratne,Colombo,Sri Jayawardenepura Kotte,Western,2741,5995,8736,109640,239800,349440
12/1/2024,Chaminda Gunaratne,Colombo,Sri Jayawardenepura Kotte,Western,6893,1782,8675,275720,71280,347000
12/2/2024,Chaminda Gunaratne,Colombo,Sri Jayawardenepura Kotte,Western,1801,180,1981,72040,7200,79240
12/3/2024,Chaminda Gunaratne,Colombo,Sri Jayawardenepura Kotte,Western,6532,3238,9770,261280,129520,390800
12/4/2024,Chaminda Gunaratne,Colombo,Sri Jayawardenepura Kotte,Western,3359,3990,7349,134360,159600,293960
12/5/2024,Chaminda Gunaratne,Colombo,Sri Jayawardenepura Kotte,Western,8206,1534,9740,328240,61360,389600
12/6/2024,Chaminda Gunaratne,Colombo,Sri Jayawardenepura Kotte,Western,2353,9975,12328,94120,399000,493120
12/7/2024,Chaminda Gunaratne,Colombo,Sri Jayawardenepura Kotte,Western,5994,8948,14942,239760,357920,597680
12/8/2024,Chaminda Gunaratne,Colombo,Sri Jayawardenepura Kotte,Western,1622,5380,7002,64880,215200,280080
12/9/2024,Chaminda Gunaratne,Colombo,Sri Jayawardenepura Kotte,Western,2144,5373,7517,85760,214920,300680
12/10/2024,Chaminda Gunaratne,Colombo,Sri Jayawardenepura Kotte,Western,7551,3115,10666,302040,124600,426640
12/11/2024,Chaminda Gunaratne,Colombo,Sri Jayawardenepura Kotte,Western,5515,1557,7072,220600,62280,282880
12/12/2024,Chaminda Gunaratne,Colombo,Sri Jayawardenepura Kotte,Western,6698,7176,13874,267920,287040,554960
12/13/2024,Chaminda Gunaratne,Colombo,Sri Jayawardenepura Kotte,Western,9528,6352,15880,381120,254080,635200
12/14/2024,Chaminda Gunaratne,Colombo,Sri Jayawardenepura Kotte,Western,5247,7688,12935,209880,307520,517400
12/15/2024,Chaminda Gunaratne,Colombo,Sri Jayawardenepura Kotte,Western,6492,4822,11314,259680,192880,452560
12/16/2024,Chaminda Gunaratne,Colombo,Sri Jayawardenepura Kotte,Western,7812,4128,11940,312480,165120,477600
12/17/2024,Chaminda Gunaratne,Colombo,Sri Jayawardenepura Kotte,Western,2971,7325,10296,118840,293000,411840
12/18/2024,Chaminda Gunaratne,Colombo,Sri Jayawardenepura Kotte,Western,5606,5564,11170,224240,222560,446800
12/19/2024,Chaminda Gunaratne,Colombo,Sri Jayawardenepura Kotte,Western,8609,5288,13897,344360,211520,555880
12/20/2024,Chaminda Gunaratne,Colombo,Sri Jayawardenepura Kotte,Western,6278,3046,9324,251120,121840,372960
12/21/2024,Chaminda Gunaratne,Colombo,Sri Jayawardenepura Kotte,Western,1228,4004,5232,49120,160160,209280
12/22/2024,Chaminda Gunaratne,Colombo,Sri Jayawardenepura Kotte,Western,3595,3006,6601,143800,120240,264040
12/23/2024,Chaminda Gunaratne,Colombo,Sri Jayawardenepura Kotte,Western,6912,3085,9997,276480,123400,399880
12/24/2024,Chaminda Gunaratne,Colombo,Sri Jayawardenepura Kotte,Western,3875,7053,10928,155000,282120,437120
12/25/2024,Chaminda Gunaratne,Colombo,Sri Jayawardenepura Kotte,Western,843,9746,10589,33720,389840,423560
12/26/2024,Chaminda Gunaratne,Colombo,Sri Jayawardenepura Kotte,Western,7363,3332,10695,294520,133280,427800
12/27/2024,Chaminda Gunaratne,Colombo,Sri Jayawardenepura Kotte,Western,9663,1318,10981,386520,52720,439240
12/28/2024,Chaminda Gunaratne,Colombo,Sri Jayawardenepura Kotte,Western,6085,2572,8657,243400,102880,346280
12/29/2024,Chaminda Gunaratne,Colombo,Sri Jayawardenepura Kotte,Western,8638,5262,13900,345520,210480,556000
12/30/2024,Chaminda Gunaratne,Colombo,Sri Jayawardenepura Kotte,Western,4845,131,4976,193800,5240,199040
12/31/2024,Chaminda Gunaratne,Colombo,Sri Jayawardenepura Kotte,Western,8585,6902,15487,343400,276080,619480
1/1/2025,Chaminda Gunaratne,Colombo,Sri Jayawardenepura Kotte,Western,7953,4550,12503,318120,182000,500120
1/2/2025,Chaminda Gunaratne,Colombo,Sri Jayawardenepura Kotte,Western,2816,2570,5386,112640,102800,215440
1/3/2025,Chaminda Gunaratne,Colombo,Sri Jayawardenepura Kotte,Western,4156,7439,11595,166240,297560,463800
1/4/2025,Chaminda Gunaratne,Colombo,Sri Jayawardenepura Kotte,Western,490,2378,2868,19600,95120,114720
1/5/2025,Chaminda Gunaratne,Colombo,Sri Jayawardenepura Kotte,Western,5464,3431,8895,218560,137240,355800
1/6/2025,Chaminda Gunaratne,Colombo,Sri Jayawardenepura Kotte,Western,2259,3648,5907,90360,145920,236280
1/7/2025,Chaminda Gunaratne,Colombo,Sri Jayawardenepura Kotte,Western,2586,4292,6878,103440,171680,275120
1/8/2025,Chaminda Gunaratne,Colombo,Sri Jayawardenepura Kotte,Western,6593,7315,13908,263720,292600,556320
1/9/2025,Chaminda Gunaratne,Colombo,Sri Jayawardenepura Kotte,Western,5239,1018,6257,209560,40720,250280
1/10/2025,Chaminda Gunaratne,Colombo,Sri Jayawardenepura Kotte,Western,5180,8206,13386,207200,328240,535440
1/11/2025,Chaminda Gunaratne,Colombo,Sri Jayawardenepura Kotte,Western,2002,8147,10149,80080,325880,405960
1/12/2025,Chaminda Gunaratne,Colombo,Sri Jayawardenepura Kotte,Western,6210,3336,9546,248400,133440,381840
1/13/2025,Chaminda Gunaratne,Colombo,Sri Jayawardenepura Kotte,Western,7346,5895,13241,293840,235800,529640
1/14/2025,Chaminda Gunaratne,Colombo,Sri Jayawardenepura Kotte,Western,1891,3615,5506,75640,144600,220240
1/15/2025,Chaminda Gunaratne,Colombo,Sri Jayawardenepura Kotte,Western,408,662,1070,16320,26480,42800
1/16/2025,Chaminda Gunaratne,Colombo,Sri Jayawardenepura Kotte,Western,1471,4780,6251,58840,191200,250040
1/17/2025,Chaminda Gunaratne,Colombo,Sri Jayawardenepura Kotte,Western,5006,6680,11686,200240,267200,467440
1/18/2025,Chaminda Gunaratne,Colombo,Sri Jayawardenepura Kotte,Western,2703,6202,8905,108120,248080,356200
1/19/2025,Chaminda Gunaratne,Colombo,Sri Jayawardenepura Kotte,Western,9172,9089,18261,366880,363560,730440
1/20/2025,Chaminda Gunaratne,Colombo,Sri Jayawardenepura Kotte,Western,1413,238,1651,56520,9520,66040
1/21/2025,Chaminda Gunaratne,Colombo,Sri Jayawardenepura Kotte,Western,2014,4291,6305,80560,171640,252200
1/22/2025,Chaminda Gunaratne,Colombo,Sri Jayawardenepura Kotte,Western,7009,5182,12191,280360,207280,487640
1/23/2025,Chaminda Gunaratne,Colombo,Sri Jayawardenepura Kotte,Western,5619,9615,15234,224760,384600,609360
1/24/2025,Chaminda Gunaratne,Colombo,Sri Jayawardenepura Kotte,Western,3767,9067,12834,150680,362680,513360
1/25/2025,Chaminda Gunaratne,Colombo,Sri Jayawardenepura Kotte,Western,9128,1793,10921,365120,71720,436840
1/26/2025,Chaminda Gunaratne,Colombo,Sri Jayawardenepura Kotte,Western,7004,8389,15393,280160,335560,615720
1/27/2025,Chaminda Gunaratne,Colombo,Sri Jayawardenepura Kotte,Western,2754,2389,5143,110160,95560,205720
1/28/2025,Chaminda Gunaratne,Colombo,Sri Jayawardenepura Kotte,Western,3853,841,4694,154120,33640,187760
1/29/2025,Chaminda Gunaratne,Colombo,Sri Jayawardenepura Kotte,Western,7715,8934,16649,308600,357360,665960
1/30/2025,Chaminda Gunaratne,Colombo,Sri Jayawardenepura Kotte,Western,2603,5410,8013,104120,216400,320520
1/31/2025,Chaminda Gunaratne,Colombo,Sri Jayawardenepura Kotte,Western,1061,7959,9020,42440,318360,360800
2/1/2025,Chaminda Gunaratne,Colombo,Sri Jayawardenepura Kotte,Western,820,8226,9046,32800,329040,361840
2/2/2025,Chaminda Gunaratne,Colombo,Sri Jayawardenepura Kotte,Western,8558,3610,12168,342320,144400,486720
2/3/2025,Chaminda Gunaratne,Colombo,Sri Jayawardenepura Kotte,Western,73,6204,6277,2920,248160,251080
2/4/2025,Chaminda Gunaratne,Colombo,Sri Jayawardenepura Kotte,Western,1596,1980,3576,63840,79200,143040
2/5/2025,Chaminda Gunaratne,Colombo,Sri Jayawardenepura Kotte,Western,7356,8181,15537,294240,327240,621480
2/6/2025,Chaminda Gunaratne,Colombo,Sri Jayawardenepura Kotte,Western,123,5971,6094,4920,238840,243760
2/7/2025,Chaminda Gunaratne,Colombo,Sri Jayawardenepura Kotte,Western,8314,1389,9703,332560,55560,388120
2/8/2025,Chaminda Gunaratne,Colombo,Sri Jayawardenepura Kotte,Western,319,6229,6548,12760,249160,261920
2/9/2025,Chaminda Gunaratne,Colombo,Sri Jayawardenepura Kotte,Western,3327,2260,5587,133080,90400,223480
2/10/2025,Chaminda Gunaratne,Colombo,Sri Jayawardenepura Kotte,Western,53,5123,5176,2120,204920,207040
2/11/2025,Chaminda Gunaratne,Colombo,Sri Jayawardenepura Kotte,Western,8547,6347,14894,341880,253880,595760
2/12/2025,Chaminda Gunaratne,Colombo,Sri Jayawardenepura Kotte,Western,8425,9631,18056,337000,385240,722240
2/13/2025,Chaminda Gunaratne,Colombo,Sri Jayawardenepura Kotte,Western,9542,7801,17343,381680,312040,693720
2/14/2025,Chaminda Gunaratne,Colombo,Sri Jayawardenepura Kotte,Western,2638,9771,12409,105520,390840,496360
2/15/2025,Chaminda Gunaratne,Colombo,Sri Jayawardenepura Kotte,Western,8416,9587,18003,336640,383480,720120
2/16/2025,Chaminda Gunaratne,Colombo,Sri Jayawardenepura Kotte,Western,2574,3102,5676,102960,124080,227040
2/17/2025,Chaminda Gunaratne,Colombo,Sri Jayawardenepura Kotte,Western,2062,3359,5421,82480,134360,216840
2/18/2025,Chaminda Gunaratne,Colombo,Sri Jayawardenepura Kotte,Western,5633,150,5783,225320,6000,231320
2/19/2025,Chaminda Gunaratne,Colombo,Sri Jayawardenepura Kotte,Western,4335,9620,13955,173400,384800,558200
2/20/2025,Chaminda Gunaratne,Colombo,Sri Jayawardenepura Kotte,Western,685,5871,6556,27400,234840,262240
2/21/2025,Chaminda Gunaratne,Colombo,Sri Jayawardenepura Kotte,Western,5493,2294,7787,219720,91760,311480
2/22/2025,Chaminda Gunaratne,Colombo,Sri Jayawardenepura Kotte,Western,9039,741,9780,361560,29640,391200
2/23/2025,Chaminda Gunaratne,Colombo,Sri Jayawardenepura Kotte,Western,5131,7693,12824,205240,307720,512960
2/24/2025,Chaminda Gunaratne,Colombo,Sri Jayawardenepura Kotte,Western,4591,9944,14535,183640,397760,581400
2/25/2025,Chaminda Gunaratne,Colombo,Sri Jayawardenepura Kotte,Western,2049,4872,6921,81960,194880,276840
2/26/2025,Chaminda Gunaratne,Colombo,Sri Jayawardenepura Kotte,Western,2054,4254,6308,82160,170160,252320
2/27/2025,Chaminda Gunaratne,Colombo,Sri Jayawardenepura Kotte,Western,5238,6483,11721,209520,259320,468840
2/28/2025,Chaminda Gunaratne,Colombo,Sri Jayawardenepura Kotte,Western,273,8251,8524,10920,330040,340960
3/1/2025,Chaminda Gunaratne,Colombo,Sri Jayawardenepura Kotte,Western,7983,7927,15910,319320,317080,636400
3/2/2025,Chaminda Gunaratne,Colombo,Sri Jayawardenepura Kotte,Western,7541,7453,14994,301640,298120,599760
3/3/2025,Chaminda Gunaratne,Colombo,Sri Jayawardenepura Kotte,Western,15,6694,6709,600,267760,268360
3/4/2025,Chaminda Gunaratne,Colombo,Sri Jayawardenepura Kotte,Western,9939,97,10036,397560,3880,401440
3/5/2025,Chaminda Gunaratne,Colombo,Sri Jayawardenepura Kotte,Western,2633,6151,8784,105320,246040,351360
3/6/2025,Chaminda Gunaratne,Colombo,Sri Jayawardenepura Kotte,Western,9951,2189,12140,398040,87560,485600
3/7/2025,Chaminda Gunaratne,Colombo,Sri Jayawardenepura Kotte,Western,8793,3588,12381,351720,143520,495240
3/8/2025,Chaminda Gunaratne,Colombo,Sri Jayawardenepura Kotte,Western,181,7752,7933,7240,310080,317320
3/9/2025,Chaminda Gunaratne,Colombo,Sri Jayawardenepura Kotte,Western,2966,7195,10161,118640,287800,406440
3/10/2025,Chaminda Gunaratne,Colombo,Sri Jayawardenepura Kotte,Western,2804,7891,10695,112160,315640,427800
3/11/2025,Chaminda Gunaratne,Colombo,Sri Jayawardenepura Kotte,Western,6726,3574,10300,269040,142960,412000
3/12/2025,Chaminda Gunaratne,Colombo,Sri Jayawardenepura Kotte,Western,6872,5018,11890,274880,200720,475600
3/13/2025,Chaminda Gunaratne,Colombo,Sri Jayawardenepura Kotte,Western,9057,5232,14289,362280,209280,571560
3/14/2025,Chaminda Gunaratne,Colombo,Sri Jayawardenepura Kotte,Western,8578,8285,16863,343120,331400,674520
3/15/2025,Chaminda Gunaratne,Colombo,Sri Jayawardenepura Kotte,Western,6528,3683,10211,261120,147320,408440
3/16/2025,Chaminda Gunaratne,Colombo,Sri Jayawardenepura Kotte,Western,493,16,509,19720,640,20360
3/17/2025,Chaminda Gunaratne,Colombo,Sri Jayawardenepura Kotte,Western,4317,2370,6687,172680,94800,267480
3/18/2025,Chaminda Gunaratne,Colombo,Sri Jayawardenepura Kotte,Western,5950,5890,11840,238000,235600,473600
3/19/2025,Chaminda Gunaratne,Colombo,Sri Jayawardenepura Kotte,Western,2568,5697,8265,102720,227880,330600
3/20/2025,Chaminda Gunaratne,Colombo,Sri Jayawardenepura Kotte,Western,1421,6168,7589,56840,246720,303560
3/21/2025,Chaminda Gunaratne,Colombo,Sri Jayawardenepura Kotte,Western,5682,8472,14154,227280,338880,566160
3/22/2025,Chaminda Gunaratne,Colombo,Sri Jayawardenepura Kotte,Western,983,5580,6563,39320,223200,262520
3/23/2025,Chaminda Gunaratne,Colombo,Sri Jayawardenepura Kotte,Western,5595,2189,7784,223800,87560,311360
3/25/2024,Dilanthi Jayasinghe,Kandy,Gampola,Central,7075,2690,9765,283000,107600,390600
3/26/2024,Dilanthi Jayasinghe,Kandy,Gampola,Central,2263,6876,9139,90520,275040,365560
3/27/2024,Dilanthi Jayasinghe,Kandy,Gampola,Central,5071,7837,12908,202840,313480,516320
3/28/2024,Dilanthi Jayasinghe,Kandy,Gampola,Central,5575,2932,8507,223000,117280,340280
3/29/2024,Dilanthi Jayasinghe,Kandy,Gampola,Central,1337,3900,5237,53480,156000,209480
3/30/2024,Dilanthi Jayasinghe,Kandy,Gampola,Central,5375,2901,8276,215000,116040,331040
3/31/2024,Dilanthi Jayasinghe,Kandy,Gampola,Central,1225,9124,10349,49000,364960,413960
4/1/2024,Dilanthi Jayasinghe,Kandy,Gampola,Central,8643,476,9119,345720,19040,364760
4/2/2024,Dilanthi Jayasinghe,Kandy,Gampola,Central,8855,8634,17489,354200,345360,699560
4/3/2024,Dilanthi Jayasinghe,Kandy,Gampola,Central,3188,2052,5240,127520,82080,209600
4/4/2024,Dilanthi Jayasinghe,Kandy,Gampola,Central,8867,5499,14366,354680,219960,574640
4/5/2024,Dilanthi Jayasinghe,Kandy,Gampola,Central,6751,5057,11808,270040,202280,472320
4/6/2024,Dilanthi Jayasinghe,Kandy,Gampola,Central,242,6407,6649,9680,256280,265960
4/7/2024,Dilanthi Jayasinghe,Kandy,Gampola,Central,3719,2829,6548,148760,113160,261920
4/8/2024,Dilanthi Jayasinghe,Kandy,Gampola,Central,2062,4336,6398,82480,173440,255920
4/9/2024,Dilanthi Jayasinghe,Kandy,Gampola,Central,6425,8567,14992,257000,342680,599680
4/10/2024,Dilanthi Jayasinghe,Kandy,Gampola,Central,9837,6001,15838,393480,240040,633520
4/11/2024,Dilanthi Jayasinghe,Kandy,Gampola,Central,5956,6759,12715,238240,270360,508600
4/19/2024,Dilanthi Jayasinghe,Kandy,Gampola,Central,3973,3889,7862,158920,155560,314480
4/20/2024,Dilanthi Jayasinghe,Kandy,Gampola,Central,8147,8756,16903,325880,350240,676120
4/21/2024,Dilanthi Jayasinghe,Kandy,Gampola,Central,1738,556,2294,69520,22240,91760
4/22/2024,Dilanthi Jayasinghe,Kandy,Gampola,Central,6862,6141,13003,274480,245640,520120
4/23/2024,Dilanthi Jayasinghe,Kandy,Gampola,Central,422,4941,5363,16880,197640,214520
4/24/2024,Dilanthi Jayasinghe,Kandy,Gampola,Central,7306,4797,12103,292240,191880,484120
4/25/2024,Dilanthi Jayasinghe,Kandy,Gampola,Central,7940,6245,14185,317600,249800,567400
4/26/2024,Dilanthi Jayasinghe,Kandy,Gampola,Central,8600,5040,13640,344000,201600,545600
4/27/2024,Dilanthi Jayasinghe,Kandy,Gampola,Central,7337,1266,8603,293480,50640,344120
4/28/2024,Dilanthi Jayasinghe,Kandy,Gampola,Central,9432,1725,11157,377280,69000,446280
4/29/2024,Dilanthi Jayasinghe,Kandy,Gampola,Central,4531,9989,14520,181240,399560,580800
4/30/2024,Dilanthi Jayasinghe,Kandy,Gampola,Central,6516,7844,14360,260640,313760,574400
5/1/2024,Dilanthi Jayasinghe,Kandy,Gampola,Central,2817,4915,7732,112680,196600,309280
5/2/2024,Dilanthi Jayasinghe,Kandy,Gampola,Central,5492,7271,12763,219680,290840,510520
5/3/2024,Dilanthi Jayasinghe,Kandy,Gampola,Central,7969,129,8098,318760,5160,323920
5/4/2024,Dilanthi Jayasinghe,Kandy,Gampola,Central,1145,8821,9966,45800,352840,398640
5/5/2024,Dilanthi Jayasinghe,Kandy,Gampola,Central,2806,3654,6460,112240,146160,258400
5/6/2024,Dilanthi Jayasinghe,Kandy,Gampola,Central,729,6820,7549,29160,272800,301960
5/7/2024,Dilanthi Jayasinghe,Kandy,Gampola,Central,2766,2281,5047,110640,91240,201880
5/8/2024,Dilanthi Jayasinghe,Kandy,Gampola,Central,2748,1737,4485,109920,69480,179400
5/9/2024,Dilanthi Jayasinghe,Kandy,Gampola,Central,7061,6086,13147,282440,243440,525880
5/10/2024,Dilanthi Jayasinghe,Kandy,Gampola,Central,8143,5029,13172,325720,201160,526880
5/11/2024,Dilanthi Jayasinghe,Kandy,Gampola,Central,6512,1557,8069,260480,62280,322760
5/12/2024,Dilanthi Jayasinghe,Kandy,Gampola,Central,3308,1771,5079,132320,70840,203160
5/13/2024,Dilanthi Jayasinghe,Kandy,Gampola,Central,2248,1999,4247,89920,79960,169880
5/14/2024,Dilanthi Jayasinghe,Kandy,Gampola,Central,2071,6456,8527,82840,258240,341080
5/15/2024,Dilanthi Jayasinghe,Kandy,Gampola,Central,9519,6826,16345,380760,273040,653800
5/16/2024,Dilanthi Jayasinghe,Kandy,Gampola,Central,9976,8135,18111,399040,325400,724440
5/17/2024,Dilanthi Jayasinghe,Kandy,Gampola,Central,2743,5232,7975,109720,209280,319000
5/18/2024,Dilanthi Jayasinghe,Kandy,Gampola,Central,6171,6676,12847,246840,267040,513880
5/19/2024,Dilanthi Jayasinghe,Kandy,Gampola,Central,9402,7081,16483,376080,283240,659320
5/20/2024,Dilanthi Jayasinghe,Kandy,Gampola,Central,1900,7734,9634,76000,309360,385360
5/21/2024,Dilanthi Jayasinghe,Kandy,Gampola,Central,601,7691,8292,24040,307640,331680
5/22/2024,Dilanthi Jayasinghe,Kandy,Gampola,Central,160,6496,6656,6400,259840,266240
5/24/2024,Dilanthi Jayasinghe,Kandy,Gampola,Central,4913,5266,10179,196520,210640,407160
5/25/2024,Dilanthi Jayasinghe,Kandy,Gampola,Central,9647,4979,14626,385880,199160,585040
5/26/2024,Dilanthi Jayasinghe,Kandy,Gampola,Central,1204,3855,5059,48160,154200,202360
5/27/2024,Dilanthi Jayasinghe,Kandy,Gampola,Central,6982,6514,13496,279280,260560,539840
5/28/2024,Dilanthi Jayasinghe,Kandy,Gampola,Central,4592,4352,8944,183680,174080,357760
5/29/2024,Dilanthi Jayasinghe,Kandy,Gampola,Central,9663,1923,11586,386520,76920,463440
5/30/2024,Dilanthi Jayasinghe,Kandy,Gampola,Central,2642,8383,11025,105680,335320,441000
5/31/2024,Dilanthi Jayasinghe,Kandy,Gampola,Central,4792,8732,13524,191680,349280,540960
6/1/2024,Dilanthi Jayasinghe,Kandy,Gampola,Central,2888,6063,8951,115520,242520,358040
6/2/2024,Dilanthi Jayasinghe,Kandy,Gampola,Central,602,9904,10506,24080,396160,420240
6/3/2024,Dilanthi Jayasinghe,Kandy,Gampola,Central,6874,9258,16132,274960,370320,645280
6/4/2024,Dilanthi Jayasinghe,Kandy,Gampola,Central,5376,7449,12825,215040,297960,513000
6/5/2024,Dilanthi Jayasinghe,Kandy,Gampola,Central,6316,9700,16016,252640,388000,640640
6/6/2024,Dilanthi Jayasinghe,Kandy,Gampola,Central,4474,5507,9981,178960,220280,399240
6/7/2024,Dilanthi Jayasinghe,Kandy,Gampola,Central,8905,2441,11346,356200,97640,453840
6/8/2024,Dilanthi Jayasinghe,Kandy,Gampola,Central,3214,3513,6727,128560,140520,269080
6/9/2024,Dilanthi Jayasinghe,Kandy,Gampola,Central,9955,3268,13223,398200,130720,528920
6/10/2024,Dilanthi Jayasinghe,Kandy,Gampola,Central,6729,8488,15217,269160,339520,608680
6/11/2024,Dilanthi Jayasinghe,Kandy,Gampola,Central,5435,7860,13295,217400,314400,531800
6/12/2024,Dilanthi Jayasinghe,Kandy,Gampola,Central,7565,231,7796,302600,9240,311840
6/13/2024,Dilanthi Jayasinghe,Kandy,Gampola,Central,9663,839,10502,386520,33560,420080
6/14/2024,Dilanthi Jayasinghe,Kandy,Gampola,Central,8291,7033,15324,331640,281320,612960
6/15/2024,Dilanthi Jayasinghe,Kandy,Gampola,Central,7651,2137,9788,306040,85480,391520
6/16/2024,Dilanthi Jayasinghe,Kandy,Gampola,Central,5517,1043,6560,220680,41720,262400
6/17/2024,Dilanthi Jayasinghe,Kandy,Gampola,Central,7215,6405,13620,288600,256200,544800
6/18/2024,Dilanthi Jayasinghe,Kandy,Gampola,Central,386,3893,4279,15440,155720,171160
6/19/2024,Dilanthi Jayasinghe,Kandy,Gampola,Central,6574,551,7125,262960,22040,285000
6/20/2024,Dilanthi Jayasinghe,Kandy,Gampola,Central,1296,8545,9841,51840,341800,393640
6/21/2024,Dilanthi Jayasinghe,Kandy,Gampola,Central,8703,4958,13661,348120,198320,546440
6/22/2024,Dilanthi Jayasinghe,Kandy,Gampola,Central,7690,4465,12155,307600,178600,486200
6/23/2024,Dilanthi Jayasinghe,Kandy,Gampola,Central,5794,1557,7351,231760,62280,294040
6/24/2024,Dilanthi Jayasinghe,Kandy,Gampola,Central,6592,7258,13850,263680,290320,554000
6/25/2024,Dilanthi Jayasinghe,Kandy,Gampola,Central,1502,970,2472,60080,38800,98880
6/26/2024,Dilanthi Jayasinghe,Kandy,Gampola,Central,7451,1609,9060,298040,64360,362400
6/27/2024,Dilanthi Jayasinghe,Kandy,Gampola,Central,4181,3601,7782,167240,144040,311280
6/28/2024,Dilanthi Jayasinghe,Kandy,Gampola,Central,9765,2846,12611,390600,113840,504440
6/29/2024,Dilanthi Jayasinghe,Kandy,Gampola,Central,2423,6012,8435,96920,240480,337400
6/30/2024,Dilanthi Jayasinghe,Kandy,Gampola,Central,3541,540,4081,141640,21600,163240
7/1/2024,Dilanthi Jayasinghe,Kandy,Gampola,Central,5041,7688,12729,201640,307520,509160
7/2/2024,Dilanthi Jayasinghe,Kandy,Gampola,Central,9142,5051,14193,365680,202040,567720
7/3/2024,Dilanthi Jayasinghe,Kandy,Gampola,Central,3429,3928,7357,137160,157120,294280
7/4/2024,Dilanthi Jayasinghe,Kandy,Gampola,Central,376,4524,4900,15040,180960,196000
7/5/2024,Dilanthi Jayasinghe,Kandy,Gampola,Central,6595,6620,13215,263800,264800,528600
7/6/2024,Dilanthi Jayasinghe,Kandy,Gampola,Central,5135,6063,11198,205400,242520,447920
7/7/2024,Dilanthi Jayasinghe,Kandy,Gampola,Central,4840,4706,9546,193600,188240,381840
7/8/2024,Dilanthi Jayasinghe,Kandy,Gampola,Central,3001,2336,5337,120040,93440,213480
7/9/2024,Dilanthi Jayasinghe,Kandy,Gampola,Central,7322,479,7801,292880,19160,312040
7/10/2024,Dilanthi Jayasinghe,Kandy,Gampola,Central,1307,9703,11010,52280,388120,440400
7/11/2024,Dilanthi Jayasinghe,Kandy,Gampola,Central,1193,6381,7574,47720,255240,302960
7/12/2024,Dilanthi Jayasinghe,Kandy,Gampola,Central,4249,4711,8960,169960,188440,358400
7/13/2024,Dilanthi Jayasinghe,Kandy,Gampola,Central,438,6333,6771,17520,253320,270840
7/14/2024,Dilanthi Jayasinghe,Kandy,Gampola,Central,5581,5768,11349,223240,230720,453960
7/15/2024,Dilanthi Jayasinghe,Kandy,Gampola,Central,7501,4431,11932,300040,177240,477280
7/16/2024,Dilanthi Jayasinghe,Kandy,Gampola,Central,968,5275,6243,38720,211000,249720
7/17/2024,Dilanthi Jayasinghe,Kandy,Gampola,Central,4091,6580,10671,163640,263200,426840
7/18/2024,Dilanthi Jayasinghe,Kandy,Gampola,Central,9091,2769,11860,363640,110760,474400
7/19/2024,Dilanthi Jayasinghe,Kandy,Gampola,Central,7901,4815,12716,316040,192600,508640
7/20/2024,Dilanthi Jayasinghe,Kandy,Gampola,Central,4614,846,5460,184560,33840,218400
7/21/2024,Dilanthi Jayasinghe,Kandy,Gampola,Central,1056,2981,4037,42240,119240,161480
7/22/2024,Dilanthi Jayasinghe,Kandy,Gampola,Central,2575,9274,11849,103000,370960,473960
7/23/2024,Dilanthi Jayasinghe,Kandy,Gampola,Central,9888,6432,16320,395520,257280,652800
7/24/2024,Dilanthi Jayasinghe,Kandy,Gampola,Central,41,1861,1902,1640,74440,76080
7/25/2024,Dilanthi Jayasinghe,Kandy,Gampola,Central,7377,38,7415,295080,1520,296600
7/26/2024,Dilanthi Jayasinghe,Kandy,Gampola,Central,8365,8146,16511,334600,325840,660440
7/27/2024,Dilanthi Jayasinghe,Kandy,Gampola,Central,6011,8953,14964,240440,358120,598560
7/28/2024,Dilanthi Jayasinghe,Kandy,Gampola,Central,423,4378,4801,16920,175120,192040
7/29/2024,Dilanthi Jayasinghe,Kandy,Gampola,Central,3269,753,4022,130760,30120,160880
7/30/2024,Dilanthi Jayasinghe,Kandy,Gampola,Central,12,1616,1628,480,64640,65120
7/31/2024,Dilanthi Jayasinghe,Kandy,Gampola,Central,8356,5841,14197,334240,233640,567880
8/1/2024,Dilanthi Jayasinghe,Kandy,Gampola,Central,1010,9344,10354,40400,373760,414160
8/2/2024,Dilanthi Jayasinghe,Kandy,Gampola,Central,2080,3058,5138,83200,122320,205520
8/3/2024,Dilanthi Jayasinghe,Kandy,Gampola,Central,8805,4325,13130,352200,173000,525200
8/4/2024,Dilanthi Jayasinghe,Kandy,Gampola,Central,7200,3538,10738,288000,141520,429520
8/5/2024,Dilanthi Jayasinghe,Kandy,Gampola,Central,3708,8277,11985,148320,331080,479400
8/6/2024,Dilanthi Jayasinghe,Kandy,Gampola,Central,3110,1930,5040,124400,77200,201600
8/7/2024,Dilanthi Jayasinghe,Kandy,Gampola,Central,1344,5668,7012,53760,226720,280480
8/8/2024,Dilanthi Jayasinghe,Kandy,Gampola,Central,9987,7592,17579,399480,303680,703160
8/9/2024,Dilanthi Jayasinghe,Kandy,Gampola,Central,6988,2112,9100,279520,84480,364000
8/10/2024,Dilanthi Jayasinghe,Kandy,Gampola,Central,3408,6891,10299,136320,275640,411960
8/11/2024,Dilanthi Jayasinghe,Kandy,Gampola,Central,5048,4147,9195,201920,165880,367800
8/12/2024,Dilanthi Jayasinghe,Kandy,Gampola,Central,7165,7193,14358,286600,287720,574320
8/13/2024,Dilanthi Jayasinghe,Kandy,Gampola,Central,4469,8888,13357,178760,355520,534280
8/14/2024,Dilanthi Jayasinghe,Kandy,Gampola,Central,7206,9446,16652,288240,377840,666080
8/15/2024,Dilanthi Jayasinghe,Kandy,Gampola,Central,8427,9450,17877,337080,378000,715080
8/16/2024,Dilanthi Jayasinghe,Kandy,Gampola,Central,9654,8379,18033,386160,335160,721320
8/17/2024,Dilanthi Jayasinghe,Kandy,Gampola,Central,3411,1560,4971,136440,62400,198840
8/18/2024,Dilanthi Jayasinghe,Kandy,Gampola,Central,4703,6458,11161,188120,258320,446440
8/19/2024,Dilanthi Jayasinghe,Kandy,Gampola,Central,5921,9229,15150,236840,369160,606000
8/20/2024,Dilanthi Jayasinghe,Kandy,Gampola,Central,5194,1942,7136,207760,77680,285440
8/21/2024,Dilanthi Jayasinghe,Kandy,Gampola,Central,4446,1290,5736,177840,51600,229440
8/22/2024,Dilanthi Jayasinghe,Kandy,Gampola,Central,9768,1581,11349,390720,63240,453960
8/23/2024,Dilanthi Jayasinghe,Kandy,Gampola,Central,7738,5349,13087,309520,213960,523480
8/24/2024,Dilanthi Jayasinghe,Kandy,Gampola,Central,5080,6073,11153,203200,242920,446120
8/25/2024,Dilanthi Jayasinghe,Kandy,Gampola,Central,563,6321,6884,22520,252840,275360
8/26/2024,Dilanthi Jayasinghe,Kandy,Gampola,Central,5669,1803,7472,226760,72120,298880
8/27/2024,Dilanthi Jayasinghe,Kandy,Gampola,Central,6933,3165,10098,277320,126600,403920
8/28/2024,Dilanthi Jayasinghe,Kandy,Gampola,Central,9398,6779,16177,375920,271160,647080
8/29/2024,Dilanthi Jayasinghe,Kandy,Gampola,Central,652,2725,3377,26080,109000,135080
8/30/2024,Dilanthi Jayasinghe,Kandy,Gampola,Central,2874,3185,6059,114960,127400,242360
8/31/2024,Dilanthi Jayasinghe,Kandy,Gampola,Central,3944,925,4869,157760,37000,194760
9/1/2024,Dilanthi Jayasinghe,Kandy,Gampola,Central,2251,7588,9839,90040,303520,393560
9/2/2024,Dilanthi Jayasinghe,Kandy,Gampola,Central,3991,3630,7621,159640,145200,304840
9/3/2024,Dilanthi Jayasinghe,Kandy,Gampola,Central,8912,853,9765,356480,34120,390600
9/4/2024,Dilanthi Jayasinghe,Kandy,Gampola,Central,2472,3237,5709,98880,129480,228360
9/5/2024,Dilanthi Jayasinghe,Kandy,Gampola,Central,5273,9815,15088,210920,392600,603520
9/6/2024,Dilanthi Jayasinghe,Kandy,Gampola,Central,8857,5391,14248,354280,215640,569920
9/7/2024,Dilanthi Jayasinghe,Kandy,Gampola,Central,5764,9229,14993,230560,369160,599720
9/8/2024,Dilanthi Jayasinghe,Kandy,Gampola,Central,4803,7867,12670,192120,314680,506800
9/9/2024,Dilanthi Jayasinghe,Kandy,Gampola,Central,8607,3705,12312,344280,148200,492480
9/10/2024,Dilanthi Jayasinghe,Kandy,Gampola,Central,4722,7845,12567,188880,313800,502680
9/11/2024,Dilanthi Jayasinghe,Kandy,Gampola,Central,3586,6141,9727,143440,245640,389080
9/12/2024,Dilanthi Jayasinghe,Kandy,Gampola,Central,8298,1900,10198,331920,76000,407920
9/13/2024,Dilanthi Jayasinghe,Kandy,Gampola,Central,2231,5625,7856,89240,225000,314240
9/14/2024,Dilanthi Jayasinghe,Kandy,Gampola,Central,5246,1007,6253,209840,40280,250120
9/15/2024,Dilanthi Jayasinghe,Kandy,Gampola,Central,9131,1050,10181,365240,42000,407240
9/16/2024,Dilanthi Jayasinghe,Kandy,Gampola,Central,2856,4202,7058,114240,168080,282320
9/17/2024,Dilanthi Jayasinghe,Kandy,Gampola,Central,1805,3494,5299,72200,139760,211960
9/18/2024,Dilanthi Jayasinghe,Kandy,Gampola,Central,6984,995,7979,279360,39800,319160
9/19/2024,Dilanthi Jayasinghe,Kandy,Gampola,Central,3152,3021,6173,126080,120840,246920
9/20/2024,Dilanthi Jayasinghe,Kandy,Gampola,Central,584,107,691,23360,4280,27640
9/21/2024,Dilanthi Jayasinghe,Kandy,Gampola,Central,788,1580,2368,31520,63200,94720
9/22/2024,Dilanthi Jayasinghe,Kandy,Gampola,Central,5522,122,5644,220880,4880,225760
9/23/2024,Dilanthi Jayasinghe,Kandy,Gampola,Central,6685,6618,13303,267400,264720,532120
9/24/2024,Dilanthi Jayasinghe,Kandy,Gampola,Central,8577,3421,11998,343080,136840,479920
9/25/2024,Dilanthi Jayasinghe,Kandy,Gampola,Central,5156,6577,11733,206240,263080,469320
9/26/2024,Dilanthi Jayasinghe,Kandy,Gampola,Central,746,1547,2293,29840,61880,91720
9/27/2024,Dilanthi Jayasinghe,Kandy,Gampola,Central,7077,5749,12826,283080,229960,513040
9/28/2024,Dilanthi Jayasinghe,Kandy,Gampola,Central,5027,9956,14983,201080,398240,599320
9/29/2024,Dilanthi Jayasinghe,Kandy,Gampola,Central,4830,3881,8711,193200,155240,348440
9/30/2024,Dilanthi Jayasinghe,Kandy,Gampola,Central,8984,4208,13192,359360,168320,527680
10/1/2024,Dilanthi Jayasinghe,Kandy,Gampola,Central,6624,5915,12539,264960,236600,501560
10/2/2024,Dilanthi Jayasinghe,Kandy,Gampola,Central,6184,5549,11733,247360,221960,469320
10/3/2024,Dilanthi Jayasinghe,Kandy,Gampola,Central,4000,4067,8067,160000,162680,322680
10/4/2024,Dilanthi Jayasinghe,Kandy,Gampola,Central,1502,4958,6460,60080,198320,258400
10/5/2024,Dilanthi Jayasinghe,Kandy,Gampola,Central,4553,9300,13853,182120,372000,554120
10/6/2024,Dilanthi Jayasinghe,Kandy,Gampola,Central,3012,1127,4139,120480,45080,165560
10/7/2024,Dilanthi Jayasinghe,Kandy,Gampola,Central,7405,4004,11409,296200,160160,456360
10/8/2024,Dilanthi Jayasinghe,Kandy,Gampola,Central,4020,4622,8642,160800,184880,345680
10/9/2024,Dilanthi Jayasinghe,Kandy,Gampola,Central,8413,1850,10263,336520,74000,410520
10/10/2024,Dilanthi Jayasinghe,Kandy,Gampola,Central,6339,9197,15536,253560,367880,621440
10/11/2024,Dilanthi Jayasinghe,Kandy,Gampola,Central,2184,3334,5518,87360,133360,220720
10/12/2024,Dilanthi Jayasinghe,Kandy,Gampola,Central,9105,6836,15941,364200,273440,637640
10/13/2024,Dilanthi Jayasinghe,Kandy,Gampola,Central,3427,424,3851,137080,16960,154040
10/14/2024,Dilanthi Jayasinghe,Kandy,Gampola,Central,3185,3866,7051,127400,154640,282040
10/15/2024,Dilanthi Jayasinghe,Kandy,Gampola,Central,3184,5344,8528,127360,213760,341120
10/16/2024,Dilanthi Jayasinghe,Kandy,Gampola,Central,9759,3494,13253,390360,139760,530120
10/17/2024,Dilanthi Jayasinghe,Kandy,Gampola,Central,8411,8768,17179,336440,350720,687160
10/18/2024,Dilanthi Jayasinghe,Kandy,Gampola,Central,2581,4160,6741,103240,166400,269640
10/19/2024,Dilanthi Jayasinghe,Kandy,Gampola,Central,6728,9504,16232,269120,380160,649280
10/20/2024,Dilanthi Jayasinghe,Kandy,Gampola,Central,3133,9966,13099,125320,398640,523960
10/21/2024,Dilanthi Jayasinghe,Kandy,Gampola,Central,5669,1681,7350,226760,67240,294000
10/22/2024,Dilanthi Jayasinghe,Kandy,Gampola,Central,323,3498,3821,12920,139920,152840
10/23/2024,Dilanthi Jayasinghe,Kandy,Gampola,Central,2071,7646,9717,82840,305840,388680
10/24/2024,Dilanthi Jayasinghe,Kandy,Gampola,Central,3094,6619,9713,123760,264760,388520
10/25/2024,Dilanthi Jayasinghe,Kandy,Gampola,Central,1424,3766,5190,56960,150640,207600
10/26/2024,Dilanthi Jayasinghe,Kandy,Gampola,Central,3433,7010,10443,137320,280400,417720
10/27/2024,Dilanthi Jayasinghe,Kandy,Gampola,Central,8238,2837,11075,329520,113480,443000
10/28/2024,Dilanthi Jayasinghe,Kandy,Gampola,Central,6453,3850,10303,258120,154000,412120
10/29/2024,Dilanthi Jayasinghe,Kandy,Gampola,Central,3842,5289,9131,153680,211560,365240
10/30/2024,Dilanthi Jayasinghe,Kandy,Gampola,Central,1790,7442,9232,71600,297680,369280
10/31/2024,Dilanthi Jayasinghe,Kandy,Gampola,Central,3702,9766,13468,148080,390640,538720
11/1/2024,Dilanthi Jayasinghe,Kandy,Gampola,Central,5447,6481,11928,217880,259240,477120
11/2/2024,Dilanthi Jayasinghe,Kandy,Gampola,Central,1478,7943,9421,59120,317720,376840
11/3/2024,Dilanthi Jayasinghe,Kandy,Gampola,Central,4334,3515,7849,173360,140600,313960
11/4/2024,Dilanthi Jayasinghe,Kandy,Gampola,Central,4323,2148,6471,172920,85920,258840
11/5/2024,Dilanthi Jayasinghe,Kandy,Gampola,Central,3505,7311,10816,140200,292440,432640
11/6/2024,Dilanthi Jayasinghe,Kandy,Gampola,Central,3177,9009,12186,127080,360360,487440
11/7/2024,Dilanthi Jayasinghe,Kandy,Gampola,Central,9290,7962,17252,371600,318480,690080
11/8/2024,Dilanthi Jayasinghe,Kandy,Gampola,Central,7628,8579,16207,305120,343160,648280
11/9/2024,Dilanthi Jayasinghe,Kandy,Gampola,Central,2370,3819,6189,94800,152760,247560
11/10/2024,Dilanthi Jayasinghe,Kandy,Gampola,Central,2232,7166,9398,89280,286640,375920
11/11/2024,Dilanthi Jayasinghe,Kandy,Gampola,Central,5393,1542,6935,215720,61680,277400
11/12/2024,Dilanthi Jayasinghe,Kandy,Gampola,Central,1264,5478,6742,50560,219120,269680
11/13/2024,Dilanthi Jayasinghe,Kandy,Gampola,Central,6891,3099,9990,275640,123960,399600
11/14/2024,Dilanthi Jayasinghe,Kandy,Gampola,Central,4047,3784,7831,161880,151360,313240
11/15/2024,Dilanthi Jayasinghe,Kandy,Gampola,Central,1737,4466,6203,69480,178640,248120
11/16/2024,Dilanthi Jayasinghe,Kandy,Gampola,Central,6450,3027,9477,258000,121080,379080
11/17/2024,Dilanthi Jayasinghe,Kandy,Gampola,Central,1504,4398,5902,60160,175920,236080
11/18/2024,Dilanthi Jayasinghe,Kandy,Gampola,Central,5966,9238,15204,238640,369520,608160
11/19/2024,Dilanthi Jayasinghe,Kandy,Gampola,Central,1253,9879,11132,50120,395160,445280
11/20/2024,Dilanthi Jayasinghe,Kandy,Gampola,Central,8683,9005,17688,347320,360200,707520
11/21/2024,Dilanthi Jayasinghe,Kandy,Gampola,Central,7511,4674,12185,300440,186960,487400
11/22/2024,Dilanthi Jayasinghe,Kandy,Gampola,Central,7179,3869,11048,287160,154760,441920
11/23/2024,Dilanthi Jayasinghe,Kandy,Gampola,Central,1855,3974,5829,74200,158960,233160
11/24/2024,Dilanthi Jayasinghe,Kandy,Gampola,Central,612,3891,4503,24480,155640,180120
11/25/2024,Dilanthi Jayasinghe,Kandy,Gampola,Central,5154,2022,7176,206160,80880,287040
11/26/2024,Dilanthi Jayasinghe,Kandy,Gampola,Central,9676,9507,19183,387040,380280,767320
11/27/2024,Dilanthi Jayasinghe,Kandy,Gampola,Central,8067,4300,12367,322680,172000,494680
11/28/2024,Dilanthi Jayasinghe,Kandy,Gampola,Central,6903,6193,13096,276120,247720,523840
11/29/2024,Dilanthi Jayasinghe,Kandy,Gampola,Central,6188,7358,13546,247520,294320,541840
11/30/2024,Dilanthi Jayasinghe,Kandy,Gampola,Central,2349,9804,12153,93960,392160,486120
12/1/2024,Dilanthi Jayasinghe,Kandy,Gampola,Central,8918,6508,15426,356720,260320,617040
12/2/2024,Dilanthi Jayasinghe,Kandy,Gampola,Central,5464,5369,10833,218560,214760,433320
12/3/2024,Dilanthi Jayasinghe,Kandy,Gampola,Central,8238,2963,11201,329520,118520,448040
12/4/2024,Dilanthi Jayasinghe,Kandy,Gampola,Central,5697,5388,11085,227880,215520,443400
12/5/2024,Dilanthi Jayasinghe,Kandy,Gampola,Central,5107,8291,13398,204280,331640,535920
12/6/2024,Dilanthi Jayasinghe,Kandy,Gampola,Central,9360,8477,17837,374400,339080,713480
12/7/2024,Dilanthi Jayasinghe,Kandy,Gampola,Central,5427,294,5721,217080,11760,228840
12/8/2024,Dilanthi Jayasinghe,Kandy,Gampola,Central,3678,4658,8336,147120,186320,333440
12/9/2024,Dilanthi Jayasinghe,Kandy,Gampola,Central,3819,677,4496,152760,27080,179840
12/10/2024,Dilanthi Jayasinghe,Kandy,Gampola,Central,5919,8738,14657,236760,349520,586280
12/11/2024,Dilanthi Jayasinghe,Kandy,Gampola,Central,6767,2053,8820,270680,82120,352800
12/12/2024,Dilanthi Jayasinghe,Kandy,Gampola,Central,8287,148,8435,331480,5920,337400
12/13/2024,Dilanthi Jayasinghe,Kandy,Gampola,Central,1076,2506,3582,43040,100240,143280
12/14/2024,Dilanthi Jayasinghe,Kandy,Gampola,Central,3561,3599,7160,142440,143960,286400
12/15/2024,Dilanthi Jayasinghe,Kandy,Gampola,Central,9601,737,10338,384040,29480,413520
12/16/2024,Dilanthi Jayasinghe,Kandy,Gampola,Central,1183,4545,5728,47320,181800,229120
12/17/2024,Dilanthi Jayasinghe,Kandy,Gampola,Central,7081,2433,9514,283240,97320,380560
12/18/2024,Dilanthi Jayasinghe,Kandy,Gampola,Central,200,3188,3388,8000,127520,135520
12/19/2024,Dilanthi Jayasinghe,Kandy,Gampola,Central,3452,5607,9059,138080,224280,362360
12/20/2024,Dilanthi Jayasinghe,Kandy,Gampola,Central,8670,6176,14846,346800,247040,593840
12/21/2024,Dilanthi Jayasinghe,Kandy,Gampola,Central,1022,753,1775,40880,30120,71000
12/22/2024,Dilanthi Jayasinghe,Kandy,Gampola,Central,6682,779,7461,267280,31160,298440
12/23/2024,Dilanthi Jayasinghe,Kandy,Gampola,Central,3790,9425,13215,151600,377000,528600
12/24/2024,Dilanthi Jayasinghe,Kandy,Gampola,Central,3714,2400,6114,148560,96000,244560
12/25/2024,Dilanthi Jayasinghe,Kandy,Gampola,Central,2241,3655,5896,89640,146200,235840
12/26/2024,Dilanthi Jayasinghe,Kandy,Gampola,Central,9329,4012,13341,373160,160480,533640
12/27/2024,Dilanthi Jayasinghe,Kandy,Gampola,Central,900,767,1667,36000,30680,66680
12/28/2024,Dilanthi Jayasinghe,Kandy,Gampola,Central,4485,4850,9335,179400,194000,373400
12/29/2024,Dilanthi Jayasinghe,Kandy,Gampola,Central,8143,6116,14259,325720,244640,570360
12/30/2024,Dilanthi Jayasinghe,Kandy,Gampola,Central,8323,9031,17354,332920,361240,694160
12/31/2024,Dilanthi Jayasinghe,Kandy,Gampola,Central,5176,7097,12273,207040,283880,490920
1/1/2025,Dilanthi Jayasinghe,Kandy,Gampola,Central,6427,5783,12210,257080,231320,488400
1/2/2025,Dilanthi Jayasinghe,Kandy,Gampola,Central,9529,1605,11134,381160,64200,445360
1/3/2025,Dilanthi Jayasinghe,Kandy,Gampola,Central,4722,6939,11661,188880,277560,466440
1/4/2025,Dilanthi Jayasinghe,Kandy,Gampola,Central,6320,3311,9631,252800,132440,385240
1/5/2025,Dilanthi Jayasinghe,Kandy,Gampola,Central,9201,1459,10660,368040,58360,426400
1/6/2025,Dilanthi Jayasinghe,Kandy,Gampola,Central,4345,4282,8627,173800,171280,345080
1/7/2025,Dilanthi Jayasinghe,Kandy,Gampola,Central,4714,2200,6914,188560,88000,276560
1/8/2025,Dilanthi Jayasinghe,Kandy,Gampola,Central,2910,1400,4310,116400,56000,172400
1/9/2025,Dilanthi Jayasinghe,Kandy,Gampola,Central,842,5649,6491,33680,225960,259640
1/10/2025,Dilanthi Jayasinghe,Kandy,Gampola,Central,5218,2949,8167,208720,117960,326680
1/11/2025,Dilanthi Jayasinghe,Kandy,Gampola,Central,5890,9472,15362,235600,378880,614480
1/12/2025,Dilanthi Jayasinghe,Kandy,Gampola,Central,8548,4894,13442,341920,195760,537680
1/13/2025,Dilanthi Jayasinghe,Kandy,Gampola,Central,1688,2147,3835,67520,85880,153400
1/14/2025,Dilanthi Jayasinghe,Kandy,Gampola,Central,5976,9504,15480,239040,380160,619200
1/15/2025,Dilanthi Jayasinghe,Kandy,Gampola,Central,702,3830,4532,28080,153200,181280
1/16/2025,Dilanthi Jayasinghe,Kandy,Gampola,Central,7042,479,7521,281680,19160,300840
1/17/2025,Dilanthi Jayasinghe,Kandy,Gampola,Central,4047,3795,7842,161880,151800,313680
1/18/2025,Dilanthi Jayasinghe,Kandy,Gampola,Central,4221,8990,13211,168840,359600,528440
1/19/2025,Dilanthi Jayasinghe,Kandy,Gampola,Central,4927,7651,12578,197080,306040,503120
1/20/2025,Dilanthi Jayasinghe,Kandy,Gampola,Central,4835,7569,12404,193400,302760,496160
1/21/2025,Dilanthi Jayasinghe,Kandy,Gampola,Central,227,6664,6891,9080,266560,275640
1/22/2025,Dilanthi Jayasinghe,Kandy,Gampola,Central,1296,412,1708,51840,16480,68320
1/23/2025,Dilanthi Jayasinghe,Kandy,Gampola,Central,8748,6742,15490,349920,269680,619600
1/24/2025,Dilanthi Jayasinghe,Kandy,Gampola,Central,5600,9181,14781,224000,367240,591240
1/25/2025,Dilanthi Jayasinghe,Kandy,Gampola,Central,3756,8830,12586,150240,353200,503440
1/26/2025,Dilanthi Jayasinghe,Kandy,Gampola,Central,7078,2419,9497,283120,96760,379880
1/27/2025,Dilanthi Jayasinghe,Kandy,Gampola,Central,6974,1072,8046,278960,42880,321840
1/28/2025,Dilanthi Jayasinghe,Kandy,Gampola,Central,9613,4547,14160,384520,181880,566400
1/29/2025,Dilanthi Jayasinghe,Kandy,Gampola,Central,2523,1543,4066,100920,61720,162640
1/30/2025,Dilanthi Jayasinghe,Kandy,Gampola,Central,7482,9587,17069,299280,383480,682760
1/31/2025,Dilanthi Jayasinghe,Kandy,Gampola,Central,3632,3598,7230,145280,143920,289200
2/1/2025,Dilanthi Jayasinghe,Kandy,Gampola,Central,9324,2559,11883,372960,102360,475320
2/2/2025,Dilanthi Jayasinghe,Kandy,Gampola,Central,5316,623,5939,212640,24920,237560
2/3/2025,Dilanthi Jayasinghe,Kandy,Gampola,Central,2324,4596,6920,92960,183840,276800
2/4/2025,Dilanthi Jayasinghe,Kandy,Gampola,Central,9864,156,10020,394560,6240,400800
2/5/2025,Dilanthi Jayasinghe,Kandy,Gampola,Central,1505,8030,9535,60200,321200,381400
2/6/2025,Dilanthi Jayasinghe,Kandy,Gampola,Central,4859,1306,6165,194360,52240,246600
2/7/2025,Dilanthi Jayasinghe,Kandy,Gampola,Central,1382,990,2372,55280,39600,94880
2/8/2025,Dilanthi Jayasinghe,Kandy,Gampola,Central,22,2492,2514,880,99680,100560
2/9/2025,Dilanthi Jayasinghe,Kandy,Gampola,Central,6612,7767,14379,264480,310680,575160
2/10/2025,Dilanthi Jayasinghe,Kandy,Gampola,Central,3034,25,3059,121360,1000,122360
2/11/2025,Dilanthi Jayasinghe,Kandy,Gampola,Central,9703,9680,19383,388120,387200,775320
2/12/2025,Dilanthi Jayasinghe,Kandy,Gampola,Central,5808,8509,14317,232320,340360,572680
2/13/2025,Dilanthi Jayasinghe,Kandy,Gampola,Central,5709,5571,11280,228360,222840,451200
2/14/2025,Dilanthi Jayasinghe,Kandy,Gampola,Central,769,3145,3914,30760,125800,156560
2/15/2025,Dilanthi Jayasinghe,Kandy,Gampola,Central,6056,2036,8092,242240,81440,323680
2/16/2025,Dilanthi Jayasinghe,Kandy,Gampola,Central,9268,1732,11000,370720,69280,440000
2/17/2025,Dilanthi Jayasinghe,Kandy,Gampola,Central,6436,4525,10961,257440,181000,438440
2/18/2025,Dilanthi Jayasinghe,Kandy,Gampola,Central,3996,5625,9621,159840,225000,384840
2/19/2025,Dilanthi Jayasinghe,Kandy,Gampola,Central,9229,5140,14369,369160,205600,574760
2/20/2025,Dilanthi Jayasinghe,Kandy,Gampola,Central,6726,8866,15592,269040,354640,623680
2/21/2025,Dilanthi Jayasinghe,Kandy,Gampola,Central,7402,2660,10062,296080,106400,402480
2/22/2025,Dilanthi Jayasinghe,Kandy,Gampola,Central,479,1513,1992,19160,60520,79680
2/23/2025,Dilanthi Jayasinghe,Kandy,Gampola,Central,8215,4476,12691,328600,179040,507640
2/24/2025,Dilanthi Jayasinghe,Kandy,Gampola,Central,3301,32,3333,132040,1280,133320
2/25/2025,Dilanthi Jayasinghe,Kandy,Gampola,Central,113,9716,9829,4520,388640,393160
2/26/2025,Dilanthi Jayasinghe,Kandy,Gampola,Central,2292,3516,5808,91680,140640,232320
2/27/2025,Dilanthi Jayasinghe,Kandy,Gampola,Central,6168,5846,12014,246720,233840,480560
2/28/2025,Dilanthi Jayasinghe,Kandy,Gampola,Central,5306,3733,9039,212240,149320,361560
3/1/2025,Dilanthi Jayasinghe,Kandy,Gampola,Central,1047,8823,9870,41880,352920,394800
3/2/2025,Dilanthi Jayasinghe,Kandy,Gampola,Central,2781,3162,5943,111240,126480,237720
3/3/2025,Dilanthi Jayasinghe,Kandy,Gampola,Central,1074,5986,7060,42960,239440,282400
3/4/2025,Dilanthi Jayasinghe,Kandy,Gampola,Central,425,1779,2204,17000,71160,88160
3/5/2025,Dilanthi Jayasinghe,Kandy,Gampola,Central,4093,1848,5941,163720,73920,237640
3/6/2025,Dilanthi Jayasinghe,Kandy,Gampola,Central,1064,4095,5159,42560,163800,206360
3/7/2025,Dilanthi Jayasinghe,Kandy,Gampola,Central,6646,3271,9917,265840,130840,396680
3/8/2025,Dilanthi Jayasinghe,Kandy,Gampola,Central,8742,6907,15649,349680,276280,625960
3/9/2025,Dilanthi Jayasinghe,Kandy,Gampola,Central,8023,5873,13896,320920,234920,555840
3/10/2025,Dilanthi Jayasinghe,Kandy,Gampola,Central,9459,9597,19056,378360,383880,762240
3/11/2025,Dilanthi Jayasinghe,Kandy,Gampola,Central,2383,3029,5412,95320,121160,216480
3/12/2025,Dilanthi Jayasinghe,Kandy,Gampola,Central,687,1689,2376,27480,67560,95040
3/13/2025,Dilanthi Jayasinghe,Kandy,Gampola,Central,3619,9981,13600,144760,399240,544000
3/14/2025,Dilanthi Jayasinghe,Kandy,Gampola,Central,4615,9654,14269,184600,386160,570760
3/15/2025,Dilanthi Jayasinghe,Kandy,Gampola,Central,2410,576,2986,96400,23040,119440
3/16/2025,Dilanthi Jayasinghe,Kandy,Gampola,Central,2979,9972,12951,119160,398880,518040
3/17/2025,Dilanthi Jayasinghe,Kandy,Gampola,Central,8523,3266,11789,340920,130640,471560
3/18/2025,Dilanthi Jayasinghe,Kandy,Gampola,Central,4872,9258,14130,194880,370320,565200
3/19/2025,Dilanthi Jayasinghe,Kandy,Gampola,Central,2918,5327,8245,116720,213080,329800
3/20/2025,Dilanthi Jayasinghe,Kandy,Gampola,Central,9326,438,9764,373040,17520,390560
3/21/2025,Dilanthi Jayasinghe,Kandy,Gampola,Central,4185,7417,11602,167400,296680,464080
3/22/2025,Dilanthi Jayasinghe,Kandy,Gampola,Central,3726,2933,6659,149040,117320,266360
3/23/2025,Dilanthi Jayasinghe,Kandy,Gampola,Central,1418,8126,9544,56720,325040,381760
3/25/2024,Nimali Hettiarachchi,Mannar,Adampan,Northern,8138,9387,17525,325520,375480,701000
3/26/2024,Nimali Hettiarachchi,Mannar,Adampan,Northern,1300,2322,3622,52000,92880,144880
3/27/2024,Nimali Hettiarachchi,Mannar,Adampan,Northern,4871,103,4974,194840,4120,198960
3/28/2024,Nimali Hettiarachchi,Mannar,Adampan,Northern,4962,4733,9695,198480,189320,387800
3/29/2024,Nimali Hettiarachchi,Mannar,Adampan,Northern,9532,2835,12367,381280,113400,494680
3/30/2024,Nimali Hettiarachchi,Mannar,Adampan,Northern,2130,4564,6694,85200,182560,267760
3/31/2024,Nimali Hettiarachchi,Mannar,Adampan,Northern,8556,6913,15469,342240,276520,618760
4/1/2024,Nimali Hettiarachchi,Mannar,Adampan,Northern,5854,2713,8567,234160,108520,342680
4/2/2024,Nimali Hettiarachchi,Mannar,Adampan,Northern,3781,3167,6948,151240,126680,277920
4/3/2024,Nimali Hettiarachchi,Mannar,Adampan,Northern,3043,5524,8567,121720,220960,342680
4/4/2024,Nimali Hettiarachchi,Mannar,Adampan,Northern,7086,3534,10620,283440,141360,424800
4/5/2024,Nimali Hettiarachchi,Mannar,Adampan,Northern,8992,3637,12629,359680,145480,505160
4/6/2024,Nimali Hettiarachchi,Mannar,Adampan,Northern,746,3964,4710,29840,158560,188400
4/7/2024,Nimali Hettiarachchi,Mannar,Adampan,Northern,2939,6851,9790,117560,274040,391600
4/8/2024,Nimali Hettiarachchi,Mannar,Adampan,Northern,5901,7313,13214,236040,292520,528560
4/9/2024,Nimali Hettiarachchi,Mannar,Adampan,Northern,5677,2966,8643,227080,118640,345720
4/10/2024,Nimali Hettiarachchi,Mannar,Adampan,Northern,2608,6185,8793,104320,247400,351720
4/11/2024,Nimali Hettiarachchi,Mannar,Adampan,Northern,8831,2025,10856,353240,81000,434240
4/19/2024,Nimali Hettiarachchi,Mannar,Adampan,Northern,1067,5563,6630,42680,222520,265200
4/20/2024,Nimali Hettiarachchi,Mannar,Adampan,Northern,9629,5077,14706,385160,203080,588240
4/21/2024,Nimali Hettiarachchi,Mannar,Adampan,Northern,4922,6259,11181,196880,250360,447240
4/22/2024,Nimali Hettiarachchi,Mannar,Adampan,Northern,8783,9985,18768,351320,399400,750720
4/23/2024,Nimali Hettiarachchi,Mannar,Adampan,Northern,3952,550,4502,158080,22000,180080
4/24/2024,Nimali Hettiarachchi,Mannar,Adampan,Northern,4421,7060,11481,176840,282400,459240
4/25/2024,Nimali Hettiarachchi,Mannar,Adampan,Northern,2566,6419,8985,102640,256760,359400
4/26/2024,Nimali Hettiarachchi,Mannar,Adampan,Northern,1006,3609,4615,40240,144360,184600
4/27/2024,Nimali Hettiarachchi,Mannar,Adampan,Northern,2283,196,2479,91320,7840,99160
4/28/2024,Nimali Hettiarachchi,Mannar,Adampan,Northern,542,6423,6965,21680,256920,278600
4/29/2024,Nimali Hettiarachchi,Mannar,Adampan,Northern,3547,3740,7287,141880,149600,291480
4/30/2024,Nimali Hettiarachchi,Mannar,Adampan,Northern,6705,9805,16510,268200,392200,660400
5/1/2024,Nimali Hettiarachchi,Mannar,Adampan,Northern,9773,6439,16212,390920,257560,648480
5/2/2024,Nimali Hettiarachchi,Mannar,Adampan,Northern,6102,6336,12438,244080,253440,497520
5/3/2024,Nimali Hettiarachchi,Mannar,Adampan,Northern,6971,1693,8664,278840,67720,346560
5/4/2024,Nimali Hettiarachchi,Mannar,Adampan,Northern,9656,6813,16469,386240,272520,658760
5/5/2024,Nimali Hettiarachchi,Mannar,Adampan,Northern,2447,1833,4280,97880,73320,171200
5/6/2024,Nimali Hettiarachchi,Mannar,Adampan,Northern,3728,6849,10577,149120,273960,423080
5/7/2024,Nimali Hettiarachchi,Mannar,Adampan,Northern,2386,2977,5363,95440,119080,214520
5/8/2024,Nimali Hettiarachchi,Mannar,Adampan,Northern,1271,306,1577,50840,12240,63080
5/9/2024,Nimali Hettiarachchi,Mannar,Adampan,Northern,7632,9718,17350,305280,388720,694000
5/10/2024,Nimali Hettiarachchi,Mannar,Adampan,Northern,638,5721,6359,25520,228840,254360
5/11/2024,Nimali Hettiarachchi,Mannar,Adampan,Northern,307,7987,8294,12280,319480,331760
5/12/2024,Nimali Hettiarachchi,Mannar,Adampan,Northern,9238,5378,14616,369520,215120,584640
5/13/2024,Nimali Hettiarachchi,Mannar,Adampan,Northern,5172,7980,13152,206880,319200,526080
5/14/2024,Nimali Hettiarachchi,Mannar,Adampan,Northern,7916,6327,14243,316640,253080,569720
5/15/2024,Nimali Hettiarachchi,Mannar,Adampan,Northern,8149,7866,16015,325960,314640,640600
5/16/2024,Nimali Hettiarachchi,Mannar,Adampan,Northern,8081,9128,17209,323240,365120,688360
5/17/2024,Nimali Hettiarachchi,Mannar,Adampan,Northern,3276,9839,13115,131040,393560,524600
5/18/2024,Nimali Hettiarachchi,Mannar,Adampan,Northern,558,1379,1937,22320,55160,77480
5/19/2024,Nimali Hettiarachchi,Mannar,Adampan,Northern,5999,1991,7990,239960,79640,319600
5/20/2024,Nimali Hettiarachchi,Mannar,Adampan,Northern,5126,9627,14753,205040,385080,590120
5/21/2024,Nimali Hettiarachchi,Mannar,Adampan,Northern,2135,204,2339,85400,8160,93560
5/22/2024,Nimali Hettiarachchi,Mannar,Adampan,Northern,1904,9851,11755,76160,394040,470200
5/24/2024,Nimali Hettiarachchi,Mannar,Adampan,Northern,774,9401,10175,30960,376040,407000
5/25/2024,Nimali Hettiarachchi,Mannar,Adampan,Northern,2461,3323,5784,98440,132920,231360
5/26/2024,Nimali Hettiarachchi,Mannar,Adampan,Northern,3319,1363,4682,132760,54520,187280
5/27/2024,Nimali Hettiarachchi,Mannar,Adampan,Northern,7895,1255,9150,315800,50200,366000
5/28/2024,Nimali Hettiarachchi,Mannar,Adampan,Northern,2582,880,3462,103280,35200,138480
5/29/2024,Nimali Hettiarachchi,Mannar,Adampan,Northern,1482,680,2162,59280,27200,86480
5/30/2024,Nimali Hettiarachchi,Mannar,Adampan,Northern,4789,3227,8016,191560,129080,320640
5/31/2024,Nimali Hettiarachchi,Mannar,Adampan,Northern,8952,8175,17127,358080,327000,685080
6/1/2024,Nimali Hettiarachchi,Mannar,Adampan,Northern,7553,248,7801,302120,9920,312040
6/2/2024,Nimali Hettiarachchi,Mannar,Adampan,Northern,4296,4972,9268,171840,198880,370720
6/3/2024,Nimali Hettiarachchi,Mannar,Adampan,Northern,7972,6807,14779,318880,272280,591160
6/4/2024,Nimali Hettiarachchi,Mannar,Adampan,Northern,6955,9840,16795,278200,393600,671800
6/5/2024,Nimali Hettiarachchi,Mannar,Adampan,Northern,6671,971,7642,266840,38840,305680
6/6/2024,Nimali Hettiarachchi,Mannar,Adampan,Northern,1142,8062,9204,45680,322480,368160
6/7/2024,Nimali Hettiarachchi,Mannar,Adampan,Northern,7775,8378,16153,311000,335120,646120
6/8/2024,Nimali Hettiarachchi,Mannar,Adampan,Northern,2459,5465,7924,98360,218600,316960
6/9/2024,Nimali Hettiarachchi,Mannar,Adampan,Northern,5548,2791,8339,221920,111640,333560
6/10/2024,Nimali Hettiarachchi,Mannar,Adampan,Northern,9426,3880,13306,377040,155200,532240
6/11/2024,Nimali Hettiarachchi,Mannar,Adampan,Northern,6745,6435,13180,269800,257400,527200
6/12/2024,Nimali Hettiarachchi,Mannar,Adampan,Northern,5781,3956,9737,231240,158240,389480
6/13/2024,Nimali Hettiarachchi,Mannar,Adampan,Northern,4144,6312,10456,165760,252480,418240
6/14/2024,Nimali Hettiarachchi,Mannar,Adampan,Northern,9256,1341,10597,370240,53640,423880
6/15/2024,Nimali Hettiarachchi,Mannar,Adampan,Northern,4245,430,4675,169800,17200,187000
6/16/2024,Nimali Hettiarachchi,Mannar,Adampan,Northern,1888,9054,10942,75520,362160,437680
6/17/2024,Nimali Hettiarachchi,Mannar,Adampan,Northern,8646,588,9234,345840,23520,369360
6/18/2024,Nimali Hettiarachchi,Mannar,Adampan,Northern,3762,4575,8337,150480,183000,333480
6/19/2024,Nimali Hettiarachchi,Mannar,Adampan,Northern,3816,5851,9667,152640,234040,386680
6/20/2024,Nimali Hettiarachchi,Mannar,Adampan,Northern,3584,4577,8161,143360,183080,326440
6/21/2024,Nimali Hettiarachchi,Mannar,Adampan,Northern,8799,9938,18737,351960,397520,749480
6/22/2024,Nimali Hettiarachchi,Mannar,Adampan,Northern,9868,7659,17527,394720,306360,701080
6/23/2024,Nimali Hettiarachchi,Mannar,Adampan,Northern,625,5357,5982,25000,214280,239280
6/24/2024,Nimali Hettiarachchi,Mannar,Adampan,Northern,7997,4267,12264,319880,170680,490560
6/25/2024,Nimali Hettiarachchi,Mannar,Adampan,Northern,156,2841,2997,6240,113640,119880
6/26/2024,Nimali Hettiarachchi,Mannar,Adampan,Northern,8567,4058,12625,342680,162320,505000
6/27/2024,Nimali Hettiarachchi,Mannar,Adampan,Northern,7863,8931,16794,314520,357240,671760
6/28/2024,Nimali Hettiarachchi,Mannar,Adampan,Northern,5059,9484,14543,202360,379360,581720
6/29/2024,Nimali Hettiarachchi,Mannar,Adampan,Northern,3828,4095,7923,153120,163800,316920
6/30/2024,Nimali Hettiarachchi,Mannar,Adampan,Northern,2543,1618,4161,101720,64720,166440
7/1/2024,Nimali Hettiarachchi,Mannar,Adampan,Northern,9650,2234,11884,386000,89360,475360
7/2/2024,Nimali Hettiarachchi,Mannar,Adampan,Northern,3979,1337,5316,159160,53480,212640
7/3/2024,Nimali Hettiarachchi,Mannar,Adampan,Northern,2390,7165,9555,95600,286600,382200
7/4/2024,Nimali Hettiarachchi,Mannar,Adampan,Northern,2806,9438,12244,112240,377520,489760
7/5/2024,Nimali Hettiarachchi,Mannar,Adampan,Northern,1811,30,1841,72440,1200,73640
7/6/2024,Nimali Hettiarachchi,Mannar,Adampan,Northern,1690,9835,11525,67600,393400,461000
7/7/2024,Nimali Hettiarachchi,Mannar,Adampan,Northern,9126,5546,14672,365040,221840,586880
7/8/2024,Nimali Hettiarachchi,Mannar,Adampan,Northern,1042,5338,6380,41680,213520,255200
7/9/2024,Nimali Hettiarachchi,Mannar,Adampan,Northern,1775,1608,3383,71000,64320,135320
7/10/2024,Nimali Hettiarachchi,Mannar,Adampan,Northern,2249,3240,5489,89960,129600,219560
7/11/2024,Nimali Hettiarachchi,Mannar,Adampan,Northern,2695,3209,5904,107800,128360,236160
7/12/2024,Nimali Hettiarachchi,Mannar,Adampan,Northern,2897,58,2955,115880,2320,118200
7/13/2024,Nimali Hettiarachchi,Mannar,Adampan,Northern,4192,8324,12516,167680,332960,500640
7/14/2024,Nimali Hettiarachchi,Mannar,Adampan,Northern,4468,7861,12329,178720,314440,493160
7/15/2024,Nimali Hettiarachchi,Mannar,Adampan,Northern,9465,8595,18060,378600,343800,722400
7/16/2024,Nimali Hettiarachchi,Mannar,Adampan,Northern,2824,3875,6699,112960,155000,267960
7/17/2024,Nimali Hettiarachchi,Mannar,Adampan,Northern,9073,7895,16968,362920,315800,678720
7/18/2024,Nimali Hettiarachchi,Mannar,Adampan,Northern,5166,891,6057,206640,35640,242280
7/19/2024,Nimali Hettiarachchi,Mannar,Adampan,Northern,1717,4846,6563,68680,193840,262520
7/20/2024,Nimali Hettiarachchi,Mannar,Adampan,Northern,9907,6996,16903,396280,279840,676120
7/21/2024,Nimali Hettiarachchi,Mannar,Adampan,Northern,6900,9538,16438,276000,381520,657520
7/22/2024,Nimali Hettiarachchi,Mannar,Adampan,Northern,9823,3035,12858,392920,121400,514320
7/23/2024,Nimali Hettiarachchi,Mannar,Adampan,Northern,5201,4412,9613,208040,176480,384520
7/24/2024,Nimali Hettiarachchi,Mannar,Adampan,Northern,1040,1380,2420,41600,55200,96800
7/25/2024,Nimali Hettiarachchi,Mannar,Adampan,Northern,2890,5349,8239,115600,213960,329560
7/26/2024,Nimali Hettiarachchi,Mannar,Adampan,Northern,3931,5410,9341,157240,216400,373640
7/27/2024,Nimali Hettiarachchi,Mannar,Adampan,Northern,1066,4814,5880,42640,192560,235200
7/28/2024,Nimali Hettiarachchi,Mannar,Adampan,Northern,6987,4990,11977,279480,199600,479080
7/29/2024,Nimali Hettiarachchi,Mannar,Adampan,Northern,8788,4039,12827,351520,161560,513080
7/30/2024,Nimali Hettiarachchi,Mannar,Adampan,Northern,7729,6566,14295,309160,262640,571800
7/31/2024,Nimali Hettiarachchi,Mannar,Adampan,Northern,7379,4646,12025,295160,185840,481000
8/1/2024,Nimali Hettiarachchi,Mannar,Adampan,Northern,1588,9122,10710,63520,364880,428400
8/2/2024,Nimali Hettiarachchi,Mannar,Adampan,Northern,9242,8353,17595,369680,334120,703800
8/3/2024,Nimali Hettiarachchi,Mannar,Adampan,Northern,5247,1330,6577,209880,53200,263080
8/4/2024,Nimali Hettiarachchi,Mannar,Adampan,Northern,2949,8816,11765,117960,352640,470600
8/5/2024,Nimali Hettiarachchi,Mannar,Adampan,Northern,1583,8502,10085,63320,340080,403400
8/6/2024,Nimali Hettiarachchi,Mannar,Adampan,Northern,1280,9925,11205,51200,397000,448200
8/7/2024,Nimali Hettiarachchi,Mannar,Adampan,Northern,2012,4007,6019,80480,160280,240760
8/8/2024,Nimali Hettiarachchi,Mannar,Adampan,Northern,4989,8101,13090,199560,324040,523600
8/9/2024,Nimali Hettiarachchi,Mannar,Adampan,Northern,8421,6549,14970,336840,261960,598800
8/10/2024,Nimali Hettiarachchi,Mannar,Adampan,Northern,887,2388,3275,35480,95520,131000
8/11/2024,Nimali Hettiarachchi,Mannar,Adampan,Northern,9594,4885,14479,383760,195400,579160
8/12/2024,Nimali Hettiarachchi,Mannar,Adampan,Northern,1732,6844,8576,69280,273760,343040
8/13/2024,Nimali Hettiarachchi,Mannar,Adampan,Northern,9659,3390,13049,386360,135600,521960
8/14/2024,Nimali Hettiarachchi,Mannar,Adampan,Northern,4148,1069,5217,165920,42760,208680
8/15/2024,Nimali Hettiarachchi,Mannar,Adampan,Northern,8302,1451,9753,332080,58040,390120
8/16/2024,Nimali Hettiarachchi,Mannar,Adampan,Northern,5301,7716,13017,212040,308640,520680
8/17/2024,Nimali Hettiarachchi,Mannar,Adampan,Northern,5728,4576,10304,229120,183040,412160
8/18/2024,Nimali Hettiarachchi,Mannar,Adampan,Northern,9648,6197,15845,385920,247880,633800
8/19/2024,Nimali Hettiarachchi,Mannar,Adampan,Northern,4677,3542,8219,187080,141680,328760
8/20/2024,Nimali Hettiarachchi,Mannar,Adampan,Northern,4951,3605,8556,198040,144200,342240
8/21/2024,Nimali Hettiarachchi,Mannar,Adampan,Northern,5705,991,6696,228200,39640,267840
8/22/2024,Nimali Hettiarachchi,Mannar,Adampan,Northern,8305,5290,13595,332200,211600,543800
8/23/2024,Nimali Hettiarachchi,Mannar,Adampan,Northern,4099,9752,13851,163960,390080,554040
8/24/2024,Nimali Hettiarachchi,Mannar,Adampan,Northern,7030,9269,16299,281200,370760,651960
8/25/2024,Nimali Hettiarachchi,Mannar,Adampan,Northern,6167,8750,14917,246680,350000,596680
8/26/2024,Nimali Hettiarachchi,Mannar,Adampan,Northern,6913,9580,16493,276520,383200,659720
8/27/2024,Nimali Hettiarachchi,Mannar,Adampan,Northern,2471,9412,11883,98840,376480,475320
8/28/2024,Nimali Hettiarachchi,Mannar,Adampan,Northern,6949,8450,15399,277960,338000,615960
8/29/2024,Nimali Hettiarachchi,Mannar,Adampan,Northern,3501,3343,6844,140040,133720,273760
8/30/2024,Nimali Hettiarachchi,Mannar,Adampan,Northern,2141,5062,7203,85640,202480,288120
8/31/2024,Nimali Hettiarachchi,Mannar,Adampan,Northern,9671,4839,14510,386840,193560,580400
9/1/2024,Nimali Hettiarachchi,Mannar,Adampan,Northern,8762,2613,11375,350480,104520,455000
9/2/2024,Nimali Hettiarachchi,Mannar,Adampan,Northern,1496,538,2034,59840,21520,81360
9/3/2024,Nimali Hettiarachchi,Mannar,Adampan,Northern,3680,2033,5713,147200,81320,228520
9/4/2024,Nimali Hettiarachchi,Mannar,Adampan,Northern,350,5258,5608,14000,210320,224320
9/5/2024,Nimali Hettiarachchi,Mannar,Adampan,Northern,1900,6933,8833,76000,277320,353320
9/6/2024,Nimali Hettiarachchi,Mannar,Adampan,Northern,5437,9098,14535,217480,363920,581400
9/7/2024,Nimali Hettiarachchi,Mannar,Adampan,Northern,6576,8455,15031,263040,338200,601240
9/8/2024,Nimali Hettiarachchi,Mannar,Adampan,Northern,5506,7661,13167,220240,306440,526680
9/9/2024,Nimali Hettiarachchi,Mannar,Adampan,Northern,3593,5024,8617,143720,200960,344680
9/10/2024,Nimali Hettiarachchi,Mannar,Adampan,Northern,5944,6749,12693,237760,269960,507720
9/11/2024,Nimali Hettiarachchi,Mannar,Adampan,Northern,8527,6184,14711,341080,247360,588440
9/12/2024,Nimali Hettiarachchi,Mannar,Adampan,Northern,1531,9912,11443,61240,396480,457720
9/13/2024,Nimali Hettiarachchi,Mannar,Adampan,Northern,1720,2479,4199,68800,99160,167960
9/14/2024,Nimali Hettiarachchi,Mannar,Adampan,Northern,918,8625,9543,36720,345000,381720
9/15/2024,Nimali Hettiarachchi,Mannar,Adampan,Northern,8065,1707,9772,322600,68280,390880
9/16/2024,Nimali Hettiarachchi,Mannar,Adampan,Northern,8799,9203,18002,351960,368120,720080
9/17/2024,Nimali Hettiarachchi,Mannar,Adampan,Northern,5225,6341,11566,209000,253640,462640
9/18/2024,Nimali Hettiarachchi,Mannar,Adampan,Northern,6084,2060,8144,243360,82400,325760
9/19/2024,Nimali Hettiarachchi,Mannar,Adampan,Northern,7145,571,7716,285800,22840,308640
9/20/2024,Nimali Hettiarachchi,Mannar,Adampan,Northern,5412,6334,11746,216480,253360,469840
9/21/2024,Nimali Hettiarachchi,Mannar,Adampan,Northern,8742,2982,11724,349680,119280,468960
9/22/2024,Nimali Hettiarachchi,Mannar,Adampan,Northern,8457,9266,17723,338280,370640,708920
9/23/2024,Nimali Hettiarachchi,Mannar,Adampan,Northern,2736,5935,8671,109440,237400,346840
9/24/2024,Nimali Hettiarachchi,Mannar,Adampan,Northern,8897,1918,10815,355880,76720,432600
9/25/2024,Nimali Hettiarachchi,Mannar,Adampan,Northern,1116,6793,7909,44640,271720,316360
9/26/2024,Nimali Hettiarachchi,Mannar,Adampan,Northern,9226,4038,13264,369040,161520,530560
9/27/2024,Nimali Hettiarachchi,Mannar,Adampan,Northern,8484,2173,10657,339360,86920,426280
9/28/2024,Nimali Hettiarachchi,Mannar,Adampan,Northern,5282,6229,11511,211280,249160,460440
9/29/2024,Nimali Hettiarachchi,Mannar,Adampan,Northern,7837,5316,13153,313480,212640,526120
9/30/2024,Nimali Hettiarachchi,Mannar,Adampan,Northern,3877,5281,9158,155080,211240,366320
10/1/2024,Nimali Hettiarachchi,Mannar,Adampan,Northern,3517,5971,9488,140680,238840,379520
10/2/2024,Nimali Hettiarachchi,Mannar,Adampan,Northern,9021,8980,18001,360840,359200,720040
10/3/2024,Nimali Hettiarachchi,Mannar,Adampan,Northern,8918,3852,12770,356720,154080,510800
10/4/2024,Nimali Hettiarachchi,Mannar,Adampan,Northern,8811,4627,13438,352440,185080,537520
10/5/2024,Nimali Hettiarachchi,Mannar,Adampan,Northern,3112,8024,11136,124480,320960,445440
10/6/2024,Nimali Hettiarachchi,Mannar,Adampan,Northern,2539,1692,4231,101560,67680,169240
10/7/2024,Nimali Hettiarachchi,Mannar,Adampan,Northern,8073,800,8873,322920,32000,354920
10/8/2024,Nimali Hettiarachchi,Mannar,Adampan,Northern,3283,2144,5427,131320,85760,217080
10/9/2024,Nimali Hettiarachchi,Mannar,Adampan,Northern,1641,2366,4007,65640,94640,160280
10/10/2024,Nimali Hettiarachchi,Mannar,Adampan,Northern,7363,2450,9813,294520,98000,392520
10/11/2024,Nimali Hettiarachchi,Mannar,Adampan,Northern,9031,9659,18690,361240,386360,747600
10/12/2024,Nimali Hettiarachchi,Mannar,Adampan,Northern,9975,2477,12452,399000,99080,498080
10/13/2024,Nimali Hettiarachchi,Mannar,Adampan,Northern,5696,5189,10885,227840,207560,435400
10/14/2024,Nimali Hettiarachchi,Mannar,Adampan,Northern,2863,2316,5179,114520,92640,207160
10/15/2024,Nimali Hettiarachchi,Mannar,Adampan,Northern,183,7779,7962,7320,311160,318480
10/16/2024,Nimali Hettiarachchi,Mannar,Adampan,Northern,9279,5592,14871,371160,223680,594840
10/17/2024,Nimali Hettiarachchi,Mannar,Adampan,Northern,3898,8258,12156,155920,330320,486240
10/18/2024,Nimali Hettiarachchi,Mannar,Adampan,Northern,9797,442,10239,391880,17680,409560
10/19/2024,Nimali Hettiarachchi,Mannar,Adampan,Northern,4302,9313,13615,172080,372520,544600
10/20/2024,Nimali Hettiarachchi,Mannar,Adampan,Northern,5079,2790,7869,203160,111600,314760
10/21/2024,Nimali Hettiarachchi,Mannar,Adampan,Northern,6649,6267,12916,265960,250680,516640
10/22/2024,Nimali Hettiarachchi,Mannar,Adampan,Northern,1506,8255,9761,60240,330200,390440
10/23/2024,Nimali Hettiarachchi,Mannar,Adampan,Northern,6299,7634,13933,251960,305360,557320
10/24/2024,Nimali Hettiarachchi,Mannar,Adampan,Northern,5283,4231,9514,211320,169240,380560
10/25/2024,Nimali Hettiarachchi,Mannar,Adampan,Northern,8030,7511,15541,321200,300440,621640
10/26/2024,Nimali Hettiarachchi,Mannar,Adampan,Northern,9295,1408,10703,371800,56320,428120
10/27/2024,Nimali Hettiarachchi,Mannar,Adampan,Northern,1754,5627,7381,70160,225080,295240
10/28/2024,Nimali Hettiarachchi,Mannar,Adampan,Northern,8223,7449,15672,328920,297960,626880
10/29/2024,Nimali Hettiarachchi,Mannar,Adampan,Northern,8838,2487,11325,353520,99480,453000
10/30/2024,Nimali Hettiarachchi,Mannar,Adampan,Northern,4605,9091,13696,184200,363640,547840
10/31/2024,Nimali Hettiarachchi,Mannar,Adampan,Northern,8765,9011,17776,350600,360440,711040
11/1/2024,Nimali Hettiarachchi,Mannar,Adampan,Northern,1769,1175,2944,70760,47000,117760
11/2/2024,Nimali Hettiarachchi,Mannar,Adampan,Northern,9661,7748,17409,386440,309920,696360
11/3/2024,Nimali Hettiarachchi,Mannar,Adampan,Northern,6828,9532,16360,273120,381280,654400
11/4/2024,Nimali Hettiarachchi,Mannar,Adampan,Northern,3398,8910,12308,135920,356400,492320
11/5/2024,Nimali Hettiarachchi,Mannar,Adampan,Northern,5569,6897,12466,222760,275880,498640
11/6/2024,Nimali Hettiarachchi,Mannar,Adampan,Northern,8451,5147,13598,338040,205880,543920
11/7/2024,Nimali Hettiarachchi,Mannar,Adampan,Northern,3824,6512,10336,152960,260480,413440
11/8/2024,Nimali Hettiarachchi,Mannar,Adampan,Northern,1508,5043,6551,60320,201720,262040
11/9/2024,Nimali Hettiarachchi,Mannar,Adampan,Northern,5885,1139,7024,235400,45560,280960
11/10/2024,Nimali Hettiarachchi,Mannar,Adampan,Northern,4353,3471,7824,174120,138840,312960
11/11/2024,Nimali Hettiarachchi,Mannar,Adampan,Northern,8800,6065,14865,352000,242600,594600
11/12/2024,Nimali Hettiarachchi,Mannar,Adampan,Northern,4723,7613,12336,188920,304520,493440
11/13/2024,Nimali Hettiarachchi,Mannar,Adampan,Northern,7332,7818,15150,293280,312720,606000
11/14/2024,Nimali Hettiarachchi,Mannar,Adampan,Northern,9363,4759,14122,374520,190360,564880
11/15/2024,Nimali Hettiarachchi,Mannar,Adampan,Northern,8388,1337,9725,335520,53480,389000
11/16/2024,Nimali Hettiarachchi,Mannar,Adampan,Northern,4302,2188,6490,172080,87520,259600
11/17/2024,Nimali Hettiarachchi,Mannar,Adampan,Northern,7306,7938,15244,292240,317520,609760
11/18/2024,Nimali Hettiarachchi,Mannar,Adampan,Northern,1159,6677,7836,46360,267080,313440
11/19/2024,Nimali Hettiarachchi,Mannar,Adampan,Northern,1138,2398,3536,45520,95920,141440
11/20/2024,Nimali Hettiarachchi,Mannar,Adampan,Northern,6479,34,6513,259160,1360,260520
11/21/2024,Nimali Hettiarachchi,Mannar,Adampan,Northern,9114,3843,12957,364560,153720,518280
11/22/2024,Nimali Hettiarachchi,Mannar,Adampan,Northern,8830,819,9649,353200,32760,385960
11/23/2024,Nimali Hettiarachchi,Mannar,Adampan,Northern,931,2316,3247,37240,92640,129880
11/24/2024,Nimali Hettiarachchi,Mannar,Adampan,Northern,1654,3127,4781,66160,125080,191240
11/25/2024,Nimali Hettiarachchi,Mannar,Adampan,Northern,2167,3763,5930,86680,150520,237200
11/26/2024,Nimali Hettiarachchi,Mannar,Adampan,Northern,2233,1701,3934,89320,68040,157360
11/27/2024,Nimali Hettiarachchi,Mannar,Adampan,Northern,6127,1897,8024,245080,75880,320960
11/28/2024,Nimali Hettiarachchi,Mannar,Adampan,Northern,3384,4172,7556,135360,166880,302240
11/29/2024,Nimali Hettiarachchi,Mannar,Adampan,Northern,1570,3672,5242,62800,146880,209680
11/30/2024,Nimali Hettiarachchi,Mannar,Adampan,Northern,6025,6320,12345,241000,252800,493800
12/1/2024,Nimali Hettiarachchi,Mannar,Adampan,Northern,770,9412,10182,30800,376480,407280
12/2/2024,Nimali Hettiarachchi,Mannar,Adampan,Northern,6973,6776,13749,278920,271040,549960
12/3/2024,Nimali Hettiarachchi,Mannar,Adampan,Northern,8265,6548,14813,330600,261920,592520
12/4/2024,Nimali Hettiarachchi,Mannar,Adampan,Northern,8513,4764,13277,340520,190560,531080
12/5/2024,Nimali Hettiarachchi,Mannar,Adampan,Northern,6839,7541,14380,273560,301640,575200
12/6/2024,Nimali Hettiarachchi,Mannar,Adampan,Northern,328,9224,9552,13120,368960,382080
12/7/2024,Nimali Hettiarachchi,Mannar,Adampan,Northern,7173,5852,13025,286920,234080,521000
12/8/2024,Nimali Hettiarachchi,Mannar,Adampan,Northern,661,860,1521,26440,34400,60840
12/9/2024,Nimali Hettiarachchi,Mannar,Adampan,Northern,6046,4263,10309,241840,170520,412360
12/10/2024,Nimali Hettiarachchi,Mannar,Adampan,Northern,7067,6857,13924,282680,274280,556960
12/11/2024,Nimali Hettiarachchi,Mannar,Adampan,Northern,1449,1060,2509,57960,42400,100360
12/12/2024,Nimali Hettiarachchi,Mannar,Adampan,Northern,2799,1906,4705,111960,76240,188200
12/13/2024,Nimali Hettiarachchi,Mannar,Adampan,Northern,6752,8322,15074,270080,332880,602960
12/14/2024,Nimali Hettiarachchi,Mannar,Adampan,Northern,7451,9930,17381,298040,397200,695240
12/15/2024,Nimali Hettiarachchi,Mannar,Adampan,Northern,3596,8400,11996,143840,336000,479840
12/16/2024,Nimali Hettiarachchi,Mannar,Adampan,Northern,1738,9354,11092,69520,374160,443680
12/17/2024,Nimali Hettiarachchi,Mannar,Adampan,Northern,6408,3918,10326,256320,156720,413040
12/18/2024,Nimali Hettiarachchi,Mannar,Adampan,Northern,3229,1432,4661,129160,57280,186440
12/19/2024,Nimali Hettiarachchi,Mannar,Adampan,Northern,1498,5069,6567,59920,202760,262680
12/20/2024,Nimali Hettiarachchi,Mannar,Adampan,Northern,3526,8663,12189,141040,346520,487560
12/21/2024,Nimali Hettiarachchi,Mannar,Adampan,Northern,1408,222,1630,56320,8880,65200
12/22/2024,Nimali Hettiarachchi,Mannar,Adampan,Northern,3466,9756,13222,138640,390240,528880
12/23/2024,Nimali Hettiarachchi,Mannar,Adampan,Northern,7713,9425,17138,308520,377000,685520
12/24/2024,Nimali Hettiarachchi,Mannar,Adampan,Northern,3580,8738,12318,143200,349520,492720
12/25/2024,Nimali Hettiarachchi,Mannar,Adampan,Northern,3857,8890,12747,154280,355600,509880
12/26/2024,Nimali Hettiarachchi,Mannar,Adampan,Northern,7201,1129,8330,288040,45160,333200
12/27/2024,Nimali Hettiarachchi,Mannar,Adampan,Northern,3344,819,4163,133760,32760,166520
12/28/2024,Nimali Hettiarachchi,Mannar,Adampan,Northern,7173,9182,16355,286920,367280,654200
12/29/2024,Nimali Hettiarachchi,Mannar,Adampan,Northern,3305,7120,10425,132200,284800,417000
12/30/2024,Nimali Hettiarachchi,Mannar,Adampan,Northern,7779,7626,15405,311160,305040,616200
12/31/2024,Nimali Hettiarachchi,Mannar,Adampan,Northern,6523,6769,13292,260920,270760,531680
1/1/2025,Nimali Hettiarachchi,Mannar,Adampan,Northern,7613,3593,11206,304520,143720,448240
1/2/2025,Nimali Hettiarachchi,Mannar,Adampan,Northern,6556,7296,13852,262240,291840,554080
1/3/2025,Nimali Hettiarachchi,Mannar,Adampan,Northern,3861,2743,6604,154440,109720,264160
1/4/2025,Nimali Hettiarachchi,Mannar,Adampan,Northern,5744,8171,13915,229760,326840,556600
1/5/2025,Nimali Hettiarachchi,Mannar,Adampan,Northern,4262,2083,6345,170480,83320,253800
1/6/2025,Nimali Hettiarachchi,Mannar,Adampan,Northern,1155,9261,10416,46200,370440,416640
1/7/2025,Nimali Hettiarachchi,Mannar,Adampan,Northern,374,8516,8890,14960,340640,355600
1/8/2025,Nimali Hettiarachchi,Mannar,Adampan,Northern,5130,6833,11963,205200,273320,478520
1/9/2025,Nimali Hettiarachchi,Mannar,Adampan,Northern,4628,5850,10478,185120,234000,419120
1/10/2025,Nimali Hettiarachchi,Mannar,Adampan,Northern,2450,7962,10412,98000,318480,416480
1/11/2025,Nimali Hettiarachchi,Mannar,Adampan,Northern,2889,8293,11182,115560,331720,447280
1/12/2025,Nimali Hettiarachchi,Mannar,Adampan,Northern,8658,3523,12181,346320,140920,487240
1/13/2025,Nimali Hettiarachchi,Mannar,Adampan,Northern,8819,2753,11572,352760,110120,462880
1/14/2025,Nimali Hettiarachchi,Mannar,Adampan,Northern,7582,9173,16755,303280,366920,670200
1/15/2025,Nimali Hettiarachchi,Mannar,Adampan,Northern,836,4022,4858,33440,160880,194320
1/16/2025,Nimali Hettiarachchi,Mannar,Adampan,Northern,7829,3696,11525,313160,147840,461000
1/17/2025,Nimali Hettiarachchi,Mannar,Adampan,Northern,5743,1791,7534,229720,71640,301360
1/18/2025,Nimali Hettiarachchi,Mannar,Adampan,Northern,8148,4835,12983,325920,193400,519320
1/19/2025,Nimali Hettiarachchi,Mannar,Adampan,Northern,8757,716,9473,350280,28640,378920
1/20/2025,Nimali Hettiarachchi,Mannar,Adampan,Northern,1877,6482,8359,75080,259280,334360
1/21/2025,Nimali Hettiarachchi,Mannar,Adampan,Northern,8401,9332,17733,336040,373280,709320
1/22/2025,Nimali Hettiarachchi,Mannar,Adampan,Northern,7802,7308,15110,312080,292320,604400
1/23/2025,Nimali Hettiarachchi,Mannar,Adampan,Northern,8033,142,8175,321320,5680,327000
1/24/2025,Nimali Hettiarachchi,Mannar,Adampan,Northern,8630,9115,17745,345200,364600,709800
1/25/2025,Nimali Hettiarachchi,Mannar,Adampan,Northern,4668,4251,8919,186720,170040,356760
1/26/2025,Nimali Hettiarachchi,Mannar,Adampan,Northern,1467,9553,11020,58680,382120,440800
1/27/2025,Nimali Hettiarachchi,Mannar,Adampan,Northern,6320,8550,14870,252800,342000,594800
1/28/2025,Nimali Hettiarachchi,Mannar,Adampan,Northern,4633,3839,8472,185320,153560,338880
1/29/2025,Nimali Hettiarachchi,Mannar,Adampan,Northern,2552,5492,8044,102080,219680,321760
1/30/2025,Nimali Hettiarachchi,Mannar,Adampan,Northern,5522,9753,15275,220880,390120,611000
1/31/2025,Nimali Hettiarachchi,Mannar,Adampan,Northern,3448,1863,5311,137920,74520,212440
2/1/2025,Nimali Hettiarachchi,Mannar,Adampan,Northern,1912,412,2324,76480,16480,92960
2/2/2025,Nimali Hettiarachchi,Mannar,Adampan,Northern,5353,9056,14409,214120,362240,576360
2/3/2025,Nimali Hettiarachchi,Mannar,Adampan,Northern,2302,3155,5457,92080,126200,218280
2/4/2025,Nimali Hettiarachchi,Mannar,Adampan,Northern,1527,7235,8762,61080,289400,350480
2/5/2025,Nimali Hettiarachchi,Mannar,Adampan,Northern,584,1239,1823,23360,49560,72920
2/6/2025,Nimali Hettiarachchi,Mannar,Adampan,Northern,5217,3282,8499,208680,131280,339960
2/7/2025,Nimali Hettiarachchi,Mannar,Adampan,Northern,2221,6592,8813,88840,263680,352520
2/8/2025,Nimali Hettiarachchi,Mannar,Adampan,Northern,6017,4434,10451,240680,177360,418040
2/9/2025,Nimali Hettiarachchi,Mannar,Adampan,Northern,6976,7441,14417,279040,297640,576680
2/10/2025,Nimali Hettiarachchi,Mannar,Adampan,Northern,6422,4845,11267,256880,193800,450680
2/11/2025,Nimali Hettiarachchi,Mannar,Adampan,Northern,9699,686,10385,387960,27440,415400
2/12/2025,Nimali Hettiarachchi,Mannar,Adampan,Northern,1025,8374,9399,41000,334960,375960
2/13/2025,Nimali Hettiarachchi,Mannar,Adampan,Northern,5688,9512,15200,227520,380480,608000
2/14/2025,Nimali Hettiarachchi,Mannar,Adampan,Northern,8289,59,8348,331560,2360,333920
2/15/2025,Nimali Hettiarachchi,Mannar,Adampan,Northern,8619,6808,15427,344760,272320,617080
2/16/2025,Nimali Hettiarachchi,Mannar,Adampan,Northern,1016,5732,6748,40640,229280,269920
2/17/2025,Nimali Hettiarachchi,Mannar,Adampan,Northern,1585,9205,10790,63400,368200,431600
2/18/2025,Nimali Hettiarachchi,Mannar,Adampan,Northern,1576,9448,11024,63040,377920,440960
2/19/2025,Nimali Hettiarachchi,Mannar,Adampan,Northern,5977,7155,13132,239080,286200,525280
2/20/2025,Nimali Hettiarachchi,Mannar,Adampan,Northern,9263,9478,18741,370520,379120,749640
2/21/2025,Nimali Hettiarachchi,Mannar,Adampan,Northern,542,7774,8316,21680,310960,332640
2/22/2025,Nimali Hettiarachchi,Mannar,Adampan,Northern,6050,6221,12271,242000,248840,490840
2/23/2025,Nimali Hettiarachchi,Mannar,Adampan,Northern,8180,586,8766,327200,23440,350640
2/24/2025,Nimali Hettiarachchi,Mannar,Adampan,Northern,4909,916,5825,196360,36640,233000
2/25/2025,Nimali Hettiarachchi,Mannar,Adampan,Northern,4334,3613,7947,173360,144520,317880
2/26/2025,Nimali Hettiarachchi,Mannar,Adampan,Northern,5911,1655,7566,236440,66200,302640
2/27/2025,Nimali Hettiarachchi,Mannar,Adampan,Northern,8160,7493,15653,326400,299720,626120
2/28/2025,Nimali Hettiarachchi,Mannar,Adampan,Northern,7353,4339,11692,294120,173560,467680
3/1/2025,Nimali Hettiarachchi,Mannar,Adampan,Northern,2462,8341,10803,98480,333640,432120
3/2/2025,Nimali Hettiarachchi,Mannar,Adampan,Northern,1487,9421,10908,59480,376840,436320
3/3/2025,Nimali Hettiarachchi,Mannar,Adampan,Northern,6811,3887,10698,272440,155480,427920
3/4/2025,Nimali Hettiarachchi,Mannar,Adampan,Northern,5359,5503,10862,214360,220120,434480
3/5/2025,Nimali Hettiarachchi,Mannar,Adampan,Northern,7261,6419,13680,290440,256760,547200
3/6/2025,Nimali Hettiarachchi,Mannar,Adampan,Northern,871,9004,9875,34840,360160,395000
3/7/2025,Nimali Hettiarachchi,Mannar,Adampan,Northern,8284,7945,16229,331360,317800,649160
3/8/2025,Nimali Hettiarachchi,Mannar,Adampan,Northern,7585,2241,9826,303400,89640,393040
3/9/2025,Nimali Hettiarachchi,Mannar,Adampan,Northern,2441,1009,3450,97640,40360,138000
3/10/2025,Nimali Hettiarachchi,Mannar,Adampan,Northern,9456,4061,13517,378240,162440,540680
3/11/2025,Nimali Hettiarachchi,Mannar,Adampan,Northern,5044,7158,12202,201760,286320,488080
3/12/2025,Nimali Hettiarachchi,Mannar,Adampan,Northern,9753,7074,16827,390120,282960,673080
3/13/2025,Nimali Hettiarachchi,Mannar,Adampan,Northern,5604,3375,8979,224160,135000,359160
3/14/2025,Nimali Hettiarachchi,Mannar,Adampan,Northern,5093,738,5831,203720,29520,233240
3/15/2025,Nimali Hettiarachchi,Mannar,Adampan,Northern,4013,4911,8924,160520,196440,356960
3/16/2025,Nimali Hettiarachchi,Mannar,Adampan,Northern,8880,6541,15421,355200,261640,616840
3/17/2025,Nimali Hettiarachchi,Mannar,Adampan,Northern,7039,1810,8849,281560,72400,353960
3/18/2025,Nimali Hettiarachchi,Mannar,Adampan,Northern,747,9728,10475,29880,389120,419000
3/19/2025,Nimali Hettiarachchi,Mannar,Adampan,Northern,3106,6241,9347,124240,249640,373880
3/20/2025,Nimali Hettiarachchi,Mannar,Adampan,Northern,272,4995,5267,10880,199800,210680
3/21/2025,Nimali Hettiarachchi,Mannar,Adampan,Northern,1875,8586,10461,75000,343440,418440
3/22/2025,Nimali Hettiarachchi,Mannar,Adampan,Northern,1008,6143,7151,40320,245720,286040
3/23/2025,Nimali Hettiarachchi,Mannar,Adampan,Northern,3622,2590,6212,144880,103600,248480
3/25/2024,Pradeep Perera,Kandy,Hunnasgiriya,Central,2267,9444,11711,90680,377760,468440
3/26/2024,Pradeep Perera,Kandy,Hunnasgiriya,Central,1563,6245,7808,62520,249800,312320
3/27/2024,Pradeep Perera,Kandy,Hunnasgiriya,Central,1377,4474,5851,55080,178960,234040
3/28/2024,Pradeep Perera,Kandy,Hunnasgiriya,Central,7638,9849,17487,305520,393960,699480
3/29/2024,Pradeep Perera,Kandy,Hunnasgiriya,Central,9712,7449,17161,388480,297960,686440
3/30/2024,Pradeep Perera,Kandy,Hunnasgiriya,Central,1605,1454,3059,64200,58160,122360
3/31/2024,Pradeep Perera,Kandy,Hunnasgiriya,Central,6748,375,7123,269920,15000,284920
4/1/2024,Pradeep Perera,Kandy,Hunnasgiriya,Central,3349,5017,8366,133960,200680,334640
4/2/2024,Pradeep Perera,Kandy,Hunnasgiriya,Central,4234,7345,11579,169360,293800,463160
4/3/2024,Pradeep Perera,Kandy,Hunnasgiriya,Central,8820,4214,13034,352800,168560,521360
4/4/2024,Pradeep Perera,Kandy,Hunnasgiriya,Central,934,4535,5469,37360,181400,218760
4/5/2024,Pradeep Perera,Kandy,Hunnasgiriya,Central,4529,7652,12181,181160,306080,487240
4/6/2024,Pradeep Perera,Kandy,Hunnasgiriya,Central,1549,5640,7189,61960,225600,287560
4/7/2024,Pradeep Perera,Kandy,Hunnasgiriya,Central,6072,6900,12972,242880,276000,518880
4/8/2024,Pradeep Perera,Kandy,Hunnasgiriya,Central,2081,8780,10861,83240,351200,434440
4/9/2024,Pradeep Perera,Kandy,Hunnasgiriya,Central,313,4408,4721,12520,176320,188840
4/10/2024,Pradeep Perera,Kandy,Hunnasgiriya,Central,1353,6433,7786,54120,257320,311440
4/11/2024,Pradeep Perera,Kandy,Hunnasgiriya,Central,7287,4209,11496,291480,168360,459840
4/19/2024,Pradeep Perera,Kandy,Hunnasgiriya,Central,7717,9925,17642,308680,397000,705680
4/20/2024,Pradeep Perera,Kandy,Hunnasgiriya,Central,6206,2049,8255,248240,81960,330200
4/21/2024,Pradeep Perera,Kandy,Hunnasgiriya,Central,680,4042,4722,27200,161680,188880
4/22/2024,Pradeep Perera,Kandy,Hunnasgiriya,Central,3627,1599,5226,145080,63960,209040
4/23/2024,Pradeep Perera,Kandy,Hunnasgiriya,Central,2445,1776,4221,97800,71040,168840
4/24/2024,Pradeep Perera,Kandy,Hunnasgiriya,Central,9177,5780,14957,367080,231200,598280
4/25/2024,Pradeep Perera,Kandy,Hunnasgiriya,Central,8897,5186,14083,355880,207440,563320
4/26/2024,Pradeep Perera,Kandy,Hunnasgiriya,Central,3179,2338,5517,127160,93520,220680
4/27/2024,Pradeep Perera,Kandy,Hunnasgiriya,Central,9137,9783,18920,365480,391320,756800
4/28/2024,Pradeep Perera,Kandy,Hunnasgiriya,Central,7092,7990,15082,283680,319600,603280
4/29/2024,Pradeep Perera,Kandy,Hunnasgiriya,Central,2128,1228,3356,85120,49120,134240
4/30/2024,Pradeep Perera,Kandy,Hunnasgiriya,Central,1241,4917,6158,49640,196680,246320
5/1/2024,Pradeep Perera,Kandy,Hunnasgiriya,Central,5812,3992,9804,232480,159680,392160
5/2/2024,Pradeep Perera,Kandy,Hunnasgiriya,Central,2244,1621,3865,89760,64840,154600
5/3/2024,Pradeep Perera,Kandy,Hunnasgiriya,Central,1327,1546,2873,53080,61840,114920
5/4/2024,Pradeep Perera,Kandy,Hunnasgiriya,Central,1896,5502,7398,75840,220080,295920
5/5/2024,Pradeep Perera,Kandy,Hunnasgiriya,Central,8237,2130,10367,329480,85200,414680
5/6/2024,Pradeep Perera,Kandy,Hunnasgiriya,Central,1159,6590,7749,46360,263600,309960
5/7/2024,Pradeep Perera,Kandy,Hunnasgiriya,Central,3595,1809,5404,143800,72360,216160
5/8/2024,Pradeep Perera,Kandy,Hunnasgiriya,Central,1961,3207,5168,78440,128280,206720
5/9/2024,Pradeep Perera,Kandy,Hunnasgiriya,Central,2638,139,2777,105520,5560,111080
5/10/2024,Pradeep Perera,Kandy,Hunnasgiriya,Central,8667,8978,17645,346680,359120,705800
5/11/2024,Pradeep Perera,Kandy,Hunnasgiriya,Central,6190,301,6491,247600,12040,259640
5/12/2024,Pradeep Perera,Kandy,Hunnasgiriya,Central,1076,7262,8338,43040,290480,333520
5/13/2024,Pradeep Perera,Kandy,Hunnasgiriya,Central,809,1376,2185,32360,55040,87400
5/14/2024,Pradeep Perera,Kandy,Hunnasgiriya,Central,2253,6477,8730,90120,259080,349200
5/15/2024,Pradeep Perera,Kandy,Hunnasgiriya,Central,6779,2927,9706,271160,117080,388240
5/16/2024,Pradeep Perera,Kandy,Hunnasgiriya,Central,7471,5919,13390,298840,236760,535600
5/17/2024,Pradeep Perera,Kandy,Hunnasgiriya,Central,2419,6262,8681,96760,250480,347240
5/18/2024,Pradeep Perera,Kandy,Hunnasgiriya,Central,8638,7893,16531,345520,315720,661240
5/19/2024,Pradeep Perera,Kandy,Hunnasgiriya,Central,6399,2809,9208,255960,112360,368320
5/20/2024,Pradeep Perera,Kandy,Hunnasgiriya,Central,9334,1621,10955,373360,64840,438200
5/21/2024,Pradeep Perera,Kandy,Hunnasgiriya,Central,8730,3175,11905,349200,127000,476200
5/22/2024,Pradeep Perera,Kandy,Hunnasgiriya,Central,5578,8942,14520,223120,357680,580800
5/24/2024,Pradeep Perera,Kandy,Hunnasgiriya,Central,3514,3250,6764,140560,130000,270560
5/25/2024,Pradeep Perera,Kandy,Hunnasgiriya,Central,1687,951,2638,67480,38040,105520
5/26/2024,Pradeep Perera,Kandy,Hunnasgiriya,Central,9480,379,9859,379200,15160,394360
5/27/2024,Pradeep Perera,Kandy,Hunnasgiriya,Central,9466,3664,13130,378640,146560,525200
5/28/2024,Pradeep Perera,Kandy,Hunnasgiriya,Central,2479,8248,10727,99160,329920,429080
5/29/2024,Pradeep Perera,Kandy,Hunnasgiriya,Central,5441,6151,11592,217640,246040,463680
5/30/2024,Pradeep Perera,Kandy,Hunnasgiriya,Central,5080,8355,13435,203200,334200,537400
5/31/2024,Pradeep Perera,Kandy,Hunnasgiriya,Central,7223,2092,9315,288920,83680,372600
6/1/2024,Pradeep Perera,Kandy,Hunnasgiriya,Central,9307,1956,11263,372280,78240,450520
6/2/2024,Pradeep Perera,Kandy,Hunnasgiriya,Central,4916,7934,12850,196640,317360,514000
6/3/2024,Pradeep Perera,Kandy,Hunnasgiriya,Central,1217,5917,7134,48680,236680,285360
6/4/2024,Pradeep Perera,Kandy,Hunnasgiriya,Central,4455,3164,7619,178200,126560,304760
6/5/2024,Pradeep Perera,Kandy,Hunnasgiriya,Central,6752,9806,16558,270080,392240,662320
6/6/2024,Pradeep Perera,Kandy,Hunnasgiriya,Central,4634,4335,8969,185360,173400,358760
6/7/2024,Pradeep Perera,Kandy,Hunnasgiriya,Central,9267,855,10122,370680,34200,404880
6/8/2024,Pradeep Perera,Kandy,Hunnasgiriya,Central,2763,5978,8741,110520,239120,349640
6/9/2024,Pradeep Perera,Kandy,Hunnasgiriya,Central,9172,486,9658,366880,19440,386320
6/10/2024,Pradeep Perera,Kandy,Hunnasgiriya,Central,2252,5999,8251,90080,239960,330040
6/11/2024,Pradeep Perera,Kandy,Hunnasgiriya,Central,5201,3100,8301,208040,124000,332040
6/12/2024,Pradeep Perera,Kandy,Hunnasgiriya,Central,5508,5356,10864,220320,214240,434560
6/13/2024,Pradeep Perera,Kandy,Hunnasgiriya,Central,182,8071,8253,7280,322840,330120
6/14/2024,Pradeep Perera,Kandy,Hunnasgiriya,Central,366,8832,9198,14640,353280,367920
6/15/2024,Pradeep Perera,Kandy,Hunnasgiriya,Central,7281,1587,8868,291240,63480,354720
6/16/2024,Pradeep Perera,Kandy,Hunnasgiriya,Central,3317,1056,4373,132680,42240,174920
6/17/2024,Pradeep Perera,Kandy,Hunnasgiriya,Central,5112,8691,13803,204480,347640,552120
6/18/2024,Pradeep Perera,Kandy,Hunnasgiriya,Central,1356,8117,9473,54240,324680,378920
6/19/2024,Pradeep Perera,Kandy,Hunnasgiriya,Central,6270,9550,15820,250800,382000,632800
6/20/2024,Pradeep Perera,Kandy,Hunnasgiriya,Central,7333,1868,9201,293320,74720,368040
6/21/2024,Pradeep Perera,Kandy,Hunnasgiriya,Central,7035,749,7784,281400,29960,311360
6/22/2024,Pradeep Perera,Kandy,Hunnasgiriya,Central,9237,9545,18782,369480,381800,751280
6/23/2024,Pradeep Perera,Kandy,Hunnasgiriya,Central,615,7074,7689,24600,282960,307560
6/24/2024,Pradeep Perera,Kandy,Hunnasgiriya,Central,702,9522,10224,28080,380880,408960
6/25/2024,Pradeep Perera,Kandy,Hunnasgiriya,Central,7005,6504,13509,280200,260160,540360
6/26/2024,Pradeep Perera,Kandy,Hunnasgiriya,Central,3807,4283,8090,152280,171320,323600
6/27/2024,Pradeep Perera,Kandy,Hunnasgiriya,Central,6225,4345,10570,249000,173800,422800
6/28/2024,Pradeep Perera,Kandy,Hunnasgiriya,Central,5759,9395,15154,230360,375800,606160
6/29/2024,Pradeep Perera,Kandy,Hunnasgiriya,Central,7312,186,7498,292480,7440,299920
6/30/2024,Pradeep Perera,Kandy,Hunnasgiriya,Central,9867,2182,12049,394680,87280,481960
7/1/2024,Pradeep Perera,Kandy,Hunnasgiriya,Central,7255,3654,10909,290200,146160,436360
7/2/2024,Pradeep Perera,Kandy,Hunnasgiriya,Central,7058,4069,11127,282320,162760,445080
7/3/2024,Pradeep Perera,Kandy,Hunnasgiriya,Central,5836,6026,11862,233440,241040,474480
7/4/2024,Pradeep Perera,Kandy,Hunnasgiriya,Central,5285,9115,14400,211400,364600,576000
7/5/2024,Pradeep Perera,Kandy,Hunnasgiriya,Central,7914,8812,16726,316560,352480,669040
7/6/2024,Pradeep Perera,Kandy,Hunnasgiriya,Central,1298,623,1921,51920,24920,76840
7/7/2024,Pradeep Perera,Kandy,Hunnasgiriya,Central,4913,4094,9007,196520,163760,360280
7/8/2024,Pradeep Perera,Kandy,Hunnasgiriya,Central,2555,7996,10551,102200,319840,422040
7/9/2024,Pradeep Perera,Kandy,Hunnasgiriya,Central,2080,3958,6038,83200,158320,241520
7/10/2024,Pradeep Perera,Kandy,Hunnasgiriya,Central,7182,6707,13889,287280,268280,555560
7/11/2024,Pradeep Perera,Kandy,Hunnasgiriya,Central,6863,5201,12064,274520,208040,482560
7/12/2024,Pradeep Perera,Kandy,Hunnasgiriya,Central,2330,7961,10291,93200,318440,411640
7/13/2024,Pradeep Perera,Kandy,Hunnasgiriya,Central,2138,9563,11701,85520,382520,468040
7/14/2024,Pradeep Perera,Kandy,Hunnasgiriya,Central,918,8418,9336,36720,336720,373440
7/15/2024,Pradeep Perera,Kandy,Hunnasgiriya,Central,8167,7366,15533,326680,294640,621320
7/16/2024,Pradeep Perera,Kandy,Hunnasgiriya,Central,7944,9301,17245,317760,372040,689800
7/17/2024,Pradeep Perera,Kandy,Hunnasgiriya,Central,9127,8697,17824,365080,347880,712960
7/18/2024,Pradeep Perera,Kandy,Hunnasgiriya,Central,447,8348,8795,17880,333920,351800
7/19/2024,Pradeep Perera,Kandy,Hunnasgiriya,Central,1064,3376,4440,42560,135040,177600
7/20/2024,Pradeep Perera,Kandy,Hunnasgiriya,Central,6736,1120,7856,269440,44800,314240
7/21/2024,Pradeep Perera,Kandy,Hunnasgiriya,Central,90,4039,4129,3600,161560,165160
7/22/2024,Pradeep Perera,Kandy,Hunnasgiriya,Central,6265,4969,11234,250600,198760,449360
7/23/2024,Pradeep Perera,Kandy,Hunnasgiriya,Central,4349,458,4807,173960,18320,192280
7/24/2024,Pradeep Perera,Kandy,Hunnasgiriya,Central,7347,3404,10751,293880,136160,430040
7/25/2024,Pradeep Perera,Kandy,Hunnasgiriya,Central,5121,475,5596,204840,19000,223840
7/26/2024,Pradeep Perera,Kandy,Hunnasgiriya,Central,9898,7201,17099,395920,288040,683960
7/27/2024,Pradeep Perera,Kandy,Hunnasgiriya,Central,4471,3628,8099,178840,145120,323960
7/28/2024,Pradeep Perera,Kandy,Hunnasgiriya,Central,8219,8255,16474,328760,330200,658960
7/29/2024,Pradeep Perera,Kandy,Hunnasgiriya,Central,9306,6207,15513,372240,248280,620520
7/30/2024,Pradeep Perera,Kandy,Hunnasgiriya,Central,6424,7188,13612,256960,287520,544480
7/31/2024,Pradeep Perera,Kandy,Hunnasgiriya,Central,9934,4341,14275,397360,173640,571000
8/1/2024,Pradeep Perera,Kandy,Hunnasgiriya,Central,6584,2327,8911,263360,93080,356440
8/2/2024,Pradeep Perera,Kandy,Hunnasgiriya,Central,8565,6242,14807,342600,249680,592280
8/3/2024,Pradeep Perera,Kandy,Hunnasgiriya,Central,342,9444,9786,13680,377760,391440
8/4/2024,Pradeep Perera,Kandy,Hunnasgiriya,Central,3455,2572,6027,138200,102880,241080
8/5/2024,Pradeep Perera,Kandy,Hunnasgiriya,Central,7120,323,7443,284800,12920,297720
8/6/2024,Pradeep Perera,Kandy,Hunnasgiriya,Central,6384,8529,14913,255360,341160,596520
8/7/2024,Pradeep Perera,Kandy,Hunnasgiriya,Central,1547,402,1949,61880,16080,77960
8/8/2024,Pradeep Perera,Kandy,Hunnasgiriya,Central,2911,5720,8631,116440,228800,345240
8/9/2024,Pradeep Perera,Kandy,Hunnasgiriya,Central,8879,4538,13417,355160,181520,536680
8/10/2024,Pradeep Perera,Kandy,Hunnasgiriya,Central,7201,2682,9883,288040,107280,395320
8/11/2024,Pradeep Perera,Kandy,Hunnasgiriya,Central,8058,5675,13733,322320,227000,549320
8/12/2024,Pradeep Perera,Kandy,Hunnasgiriya,Central,7915,3302,11217,316600,132080,448680
8/13/2024,Pradeep Perera,Kandy,Hunnasgiriya,Central,360,2860,3220,14400,114400,128800
8/14/2024,Pradeep Perera,Kandy,Hunnasgiriya,Central,279,5280,5559,11160,211200,222360
8/15/2024,Pradeep Perera,Kandy,Hunnasgiriya,Central,4797,6176,10973,191880,247040,438920
8/16/2024,Pradeep Perera,Kandy,Hunnasgiriya,Central,4935,6210,11145,197400,248400,445800
8/17/2024,Pradeep Perera,Kandy,Hunnasgiriya,Central,1561,7836,9397,62440,313440,375880
8/18/2024,Pradeep Perera,Kandy,Hunnasgiriya,Central,7290,6411,13701,291600,256440,548040
8/19/2024,Pradeep Perera,Kandy,Hunnasgiriya,Central,4302,6756,11058,172080,270240,442320
8/20/2024,Pradeep Perera,Kandy,Hunnasgiriya,Central,8073,5042,13115,322920,201680,524600
8/21/2024,Pradeep Perera,Kandy,Hunnasgiriya,Central,2280,890,3170,91200,35600,126800
8/22/2024,Pradeep Perera,Kandy,Hunnasgiriya,Central,2059,6602,8661,82360,264080,346440
8/23/2024,Pradeep Perera,Kandy,Hunnasgiriya,Central,2655,3146,5801,106200,125840,232040
8/24/2024,Pradeep Perera,Kandy,Hunnasgiriya,Central,9424,1605,11029,376960,64200,441160
8/25/2024,Pradeep Perera,Kandy,Hunnasgiriya,Central,5558,7037,12595,222320,281480,503800
8/26/2024,Pradeep Perera,Kandy,Hunnasgiriya,Central,8655,878,9533,346200,35120,381320
8/27/2024,Pradeep Perera,Kandy,Hunnasgiriya,Central,9110,4374,13484,364400,174960,539360
8/28/2024,Pradeep Perera,Kandy,Hunnasgiriya,Central,1463,9197,10660,58520,367880,426400
8/29/2024,Pradeep Perera,Kandy,Hunnasgiriya,Central,5048,9747,14795,201920,389880,591800
8/30/2024,Pradeep Perera,Kandy,Hunnasgiriya,Central,2764,2549,5313,110560,101960,212520
8/31/2024,Pradeep Perera,Kandy,Hunnasgiriya,Central,4230,5347,9577,169200,213880,383080
9/1/2024,Pradeep Perera,Kandy,Hunnasgiriya,Central,6791,3573,10364,271640,142920,414560
9/2/2024,Pradeep Perera,Kandy,Hunnasgiriya,Central,3586,4357,7943,143440,174280,317720
9/3/2024,Pradeep Perera,Kandy,Hunnasgiriya,Central,5542,2154,7696,221680,86160,307840
9/4/2024,Pradeep Perera,Kandy,Hunnasgiriya,Central,7494,6766,14260,299760,270640,570400
9/5/2024,Pradeep Perera,Kandy,Hunnasgiriya,Central,4247,4464,8711,169880,178560,348440
9/6/2024,Pradeep Perera,Kandy,Hunnasgiriya,Central,7275,7665,14940,291000,306600,597600
9/7/2024,Pradeep Perera,Kandy,Hunnasgiriya,Central,9766,8259,18025,390640,330360,721000
9/8/2024,Pradeep Perera,Kandy,Hunnasgiriya,Central,3619,3401,7020,144760,136040,280800
9/9/2024,Pradeep Perera,Kandy,Hunnasgiriya,Central,7269,6474,13743,290760,258960,549720
9/10/2024,Pradeep Perera,Kandy,Hunnasgiriya,Central,366,6339,6705,14640,253560,268200
9/11/2024,Pradeep Perera,Kandy,Hunnasgiriya,Central,9634,539,10173,385360,21560,406920
9/12/2024,Pradeep Perera,Kandy,Hunnasgiriya,Central,704,3018,3722,28160,120720,148880
9/13/2024,Pradeep Perera,Kandy,Hunnasgiriya,Central,6340,5886,12226,253600,235440,489040
9/14/2024,Pradeep Perera,Kandy,Hunnasgiriya,Central,6947,5428,12375,277880,217120,495000
9/15/2024,Pradeep Perera,Kandy,Hunnasgiriya,Central,672,5386,6058,26880,215440,242320
9/16/2024,Pradeep Perera,Kandy,Hunnasgiriya,Central,5798,5063,10861,231920,202520,434440
9/17/2024,Pradeep Perera,Kandy,Hunnasgiriya,Central,4427,5308,9735,177080,212320,389400
9/18/2024,Pradeep Perera,Kandy,Hunnasgiriya,Central,2261,1543,3804,90440,61720,152160
9/19/2024,Pradeep Perera,Kandy,Hunnasgiriya,Central,4343,2383,6726,173720,95320,269040
9/20/2024,Pradeep Perera,Kandy,Hunnasgiriya,Central,3126,9354,12480,125040,374160,499200
9/21/2024,Pradeep Perera,Kandy,Hunnasgiriya,Central,7167,7021,14188,286680,280840,567520
9/22/2024,Pradeep Perera,Kandy,Hunnasgiriya,Central,4135,4,4139,165400,160,165560
9/23/2024,Pradeep Perera,Kandy,Hunnasgiriya,Central,6611,5890,12501,264440,235600,500040
9/24/2024,Pradeep Perera,Kandy,Hunnasgiriya,Central,62,9282,9344,2480,371280,373760
9/25/2024,Pradeep Perera,Kandy,Hunnasgiriya,Central,1399,5755,7154,55960,230200,286160
9/26/2024,Pradeep Perera,Kandy,Hunnasgiriya,Central,6747,9244,15991,269880,369760,639640
9/27/2024,Pradeep Perera,Kandy,Hunnasgiriya,Central,7166,2329,9495,286640,93160,379800
9/28/2024,Pradeep Perera,Kandy,Hunnasgiriya,Central,2342,9137,11479,93680,365480,459160
9/29/2024,Pradeep Perera,Kandy,Hunnasgiriya,Central,1040,9607,10647,41600,384280,425880
9/30/2024,Pradeep Perera,Kandy,Hunnasgiriya,Central,2375,3841,6216,95000,153640,248640
10/1/2024,Pradeep Perera,Kandy,Hunnasgiriya,Central,2886,1783,4669,115440,71320,186760
10/2/2024,Pradeep Perera,Kandy,Hunnasgiriya,Central,970,8503,9473,38800,340120,378920
10/3/2024,Pradeep Perera,Kandy,Hunnasgiriya,Central,8088,8789,16877,323520,351560,675080
10/4/2024,Pradeep Perera,Kandy,Hunnasgiriya,Central,7099,7941,15040,283960,317640,601600
10/5/2024,Pradeep Perera,Kandy,Hunnasgiriya,Central,4614,755,5369,184560,30200,214760
10/6/2024,Pradeep Perera,Kandy,Hunnasgiriya,Central,2167,5934,8101,86680,237360,324040
10/7/2024,Pradeep Perera,Kandy,Hunnasgiriya,Central,6851,9267,16118,274040,370680,644720
10/8/2024,Pradeep Perera,Kandy,Hunnasgiriya,Central,7917,4386,12303,316680,175440,492120
10/9/2024,Pradeep Perera,Kandy,Hunnasgiriya,Central,3879,8595,12474,155160,343800,498960
10/10/2024,Pradeep Perera,Kandy,Hunnasgiriya,Central,462,5451,5913,18480,218040,236520
10/11/2024,Pradeep Perera,Kandy,Hunnasgiriya,Central,8812,2626,11438,352480,105040,457520
10/12/2024,Pradeep Perera,Kandy,Hunnasgiriya,Central,1728,2758,4486,69120,110320,179440
10/13/2024,Pradeep Perera,Kandy,Hunnasgiriya,Central,1943,9050,10993,77720,362000,439720
10/14/2024,Pradeep Perera,Kandy,Hunnasgiriya,Central,8127,1110,9237,325080,44400,369480
10/15/2024,Pradeep Perera,Kandy,Hunnasgiriya,Central,7567,7810,15377,302680,312400,615080
10/16/2024,Pradeep Perera,Kandy,Hunnasgiriya,Central,9651,4053,13704,386040,162120,548160
10/17/2024,Pradeep Perera,Kandy,Hunnasgiriya,Central,2958,5933,8891,118320,237320,355640
10/18/2024,Pradeep Perera,Kandy,Hunnasgiriya,Central,2446,2328,4774,97840,93120,190960
10/19/2024,Pradeep Perera,Kandy,Hunnasgiriya,Central,2929,4477,7406,117160,179080,296240
10/20/2024,Pradeep Perera,Kandy,Hunnasgiriya,Central,8228,7800,16028,329120,312000,641120
10/21/2024,Pradeep Perera,Kandy,Hunnasgiriya,Central,6673,1288,7961,266920,51520,318440
10/22/2024,Pradeep Perera,Kandy,Hunnasgiriya,Central,8059,7006,15065,322360,280240,602600
10/23/2024,Pradeep Perera,Kandy,Hunnasgiriya,Central,1613,4949,6562,64520,197960,262480
10/24/2024,Pradeep Perera,Kandy,Hunnasgiriya,Central,2429,3369,5798,97160,134760,231920
10/25/2024,Pradeep Perera,Kandy,Hunnasgiriya,Central,4671,7161,11832,186840,286440,473280
10/26/2024,Pradeep Perera,Kandy,Hunnasgiriya,Central,1209,3443,4652,48360,137720,186080
10/27/2024,Pradeep Perera,Kandy,Hunnasgiriya,Central,313,4027,4340,12520,161080,173600
10/28/2024,Pradeep Perera,Kandy,Hunnasgiriya,Central,7263,1255,8518,290520,50200,340720
10/29/2024,Pradeep Perera,Kandy,Hunnasgiriya,Central,8593,9975,18568,343720,399000,742720
10/30/2024,Pradeep Perera,Kandy,Hunnasgiriya,Central,4071,706,4777,162840,28240,191080
10/31/2024,Pradeep Perera,Kandy,Hunnasgiriya,Central,2628,6489,9117,105120,259560,364680
11/1/2024,Pradeep Perera,Kandy,Hunnasgiriya,Central,5547,4816,10363,221880,192640,414520
11/2/2024,Pradeep Perera,Kandy,Hunnasgiriya,Central,4037,9411,13448,161480,376440,537920
11/3/2024,Pradeep Perera,Kandy,Hunnasgiriya,Central,4261,5166,9427,170440,206640,377080
11/4/2024,Pradeep Perera,Kandy,Hunnasgiriya,Central,5118,4766,9884,204720,190640,395360
11/5/2024,Pradeep Perera,Kandy,Hunnasgiriya,Central,6589,812,7401,263560,32480,296040
11/6/2024,Pradeep Perera,Kandy,Hunnasgiriya,Central,2313,5687,8000,92520,227480,320000
11/7/2024,Pradeep Perera,Kandy,Hunnasgiriya,Central,8678,4456,13134,347120,178240,525360
11/8/2024,Pradeep Perera,Kandy,Hunnasgiriya,Central,9688,5126,14814,387520,205040,592560
11/9/2024,Pradeep Perera,Kandy,Hunnasgiriya,Central,2097,6326,8423,83880,253040,336920
11/10/2024,Pradeep Perera,Kandy,Hunnasgiriya,Central,2423,7156,9579,96920,286240,383160
11/11/2024,Pradeep Perera,Kandy,Hunnasgiriya,Central,232,6906,7138,9280,276240,285520
11/12/2024,Pradeep Perera,Kandy,Hunnasgiriya,Central,6304,1147,7451,252160,45880,298040
11/13/2024,Pradeep Perera,Kandy,Hunnasgiriya,Central,191,8521,8712,7640,340840,348480
11/14/2024,Pradeep Perera,Kandy,Hunnasgiriya,Central,9910,985,10895,396400,39400,435800
11/15/2024,Pradeep Perera,Kandy,Hunnasgiriya,Central,6134,9953,16087,245360,398120,643480
11/16/2024,Pradeep Perera,Kandy,Hunnasgiriya,Central,9568,8513,18081,382720,340520,723240
11/17/2024,Pradeep Perera,Kandy,Hunnasgiriya,Central,8027,5098,13125,321080,203920,525000
11/18/2024,Pradeep Perera,Kandy,Hunnasgiriya,Central,3391,4274,7665,135640,170960,306600
11/19/2024,Pradeep Perera,Kandy,Hunnasgiriya,Central,6026,5329,11355,241040,213160,454200
11/20/2024,Pradeep Perera,Kandy,Hunnasgiriya,Central,1535,4657,6192,61400,186280,247680
11/21/2024,Pradeep Perera,Kandy,Hunnasgiriya,Central,9286,2555,11841,371440,102200,473640
11/22/2024,Pradeep Perera,Kandy,Hunnasgiriya,Central,4517,9601,14118,180680,384040,564720
11/23/2024,Pradeep Perera,Kandy,Hunnasgiriya,Central,1662,4204,5866,66480,168160,234640
11/24/2024,Pradeep Perera,Kandy,Hunnasgiriya,Central,700,7016,7716,28000,280640,308640
11/25/2024,Pradeep Perera,Kandy,Hunnasgiriya,Central,7433,9731,17164,297320,389240,686560
11/26/2024,Pradeep Perera,Kandy,Hunnasgiriya,Central,6832,2121,8953,273280,84840,358120
11/27/2024,Pradeep Perera,Kandy,Hunnasgiriya,Central,2758,3415,6173,110320,136600,246920
11/28/2024,Pradeep Perera,Kandy,Hunnasgiriya,Central,990,97,1087,39600,3880,43480
11/29/2024,Pradeep Perera,Kandy,Hunnasgiriya,Central,4643,9108,13751,185720,364320,550040
11/30/2024,Pradeep Perera,Kandy,Hunnasgiriya,Central,8374,2072,10446,334960,82880,417840
12/1/2024,Pradeep Perera,Kandy,Hunnasgiriya,Central,1194,3792,4986,47760,151680,199440
12/2/2024,Pradeep Perera,Kandy,Hunnasgiriya,Central,2960,455,3415,118400,18200,136600
12/3/2024,Pradeep Perera,Kandy,Hunnasgiriya,Central,5836,8175,14011,233440,327000,560440
12/4/2024,Pradeep Perera,Kandy,Hunnasgiriya,Central,3647,8580,12227,145880,343200,489080
12/5/2024,Pradeep Perera,Kandy,Hunnasgiriya,Central,8412,3692,12104,336480,147680,484160
12/6/2024,Pradeep Perera,Kandy,Hunnasgiriya,Central,5832,4689,10521,233280,187560,420840
12/7/2024,Pradeep Perera,Kandy,Hunnasgiriya,Central,7917,9310,17227,316680,372400,689080
12/8/2024,Pradeep Perera,Kandy,Hunnasgiriya,Central,5858,1184,7042,234320,47360,281680
12/9/2024,Pradeep Perera,Kandy,Hunnasgiriya,Central,950,2526,3476,38000,101040,139040
12/10/2024,Pradeep Perera,Kandy,Hunnasgiriya,Central,168,7638,7806,6720,305520,312240
12/11/2024,Pradeep Perera,Kandy,Hunnasgiriya,Central,3742,9942,13684,149680,397680,547360
12/12/2024,Pradeep Perera,Kandy,Hunnasgiriya,Central,7706,2911,10617,308240,116440,424680
12/13/2024,Pradeep Perera,Kandy,Hunnasgiriya,Central,5626,9520,15146,225040,380800,605840
12/14/2024,Pradeep Perera,Kandy,Hunnasgiriya,Central,2457,1188,3645,98280,47520,145800
12/15/2024,Pradeep Perera,Kandy,Hunnasgiriya,Central,1237,6589,7826,49480,263560,313040
12/16/2024,Pradeep Perera,Kandy,Hunnasgiriya,Central,1234,4978,6212,49360,199120,248480
12/17/2024,Pradeep Perera,Kandy,Hunnasgiriya,Central,4376,4624,9000,175040,184960,360000
12/18/2024,Pradeep Perera,Kandy,Hunnasgiriya,Central,754,49,803,30160,1960,32120
12/19/2024,Pradeep Perera,Kandy,Hunnasgiriya,Central,2476,9272,11748,99040,370880,469920
12/20/2024,Pradeep Perera,Kandy,Hunnasgiriya,Central,1250,610,1860,50000,24400,74400
12/21/2024,Pradeep Perera,Kandy,Hunnasgiriya,Central,2636,1200,3836,105440,48000,153440
12/22/2024,Pradeep Perera,Kandy,Hunnasgiriya,Central,2477,1992,4469,99080,79680,178760
12/23/2024,Pradeep Perera,Kandy,Hunnasgiriya,Central,3922,2187,6109,156880,87480,244360
12/24/2024,Pradeep Perera,Kandy,Hunnasgiriya,Central,1043,8184,9227,41720,327360,369080
12/25/2024,Pradeep Perera,Kandy,Hunnasgiriya,Central,7551,4994,12545,302040,199760,501800
12/26/2024,Pradeep Perera,Kandy,Hunnasgiriya,Central,8532,3409,11941,341280,136360,477640
12/27/2024,Pradeep Perera,Kandy,Hunnasgiriya,Central,5333,7367,12700,213320,294680,508000
12/28/2024,Pradeep Perera,Kandy,Hunnasgiriya,Central,4590,3281,7871,183600,131240,314840
12/29/2024,Pradeep Perera,Kandy,Hunnasgiriya,Central,472,9926,10398,18880,397040,415920
12/30/2024,Pradeep Perera,Kandy,Hunnasgiriya,Central,4168,4586,8754,166720,183440,350160
12/31/2024,Pradeep Perera,Kandy,Hunnasgiriya,Central,901,239,1140,36040,9560,45600
1/1/2025,Pradeep Perera,Kandy,Hunnasgiriya,Central,9999,3212,13211,399960,128480,528440
1/2/2025,Pradeep Perera,Kandy,Hunnasgiriya,Central,3773,2225,5998,150920,89000,239920
1/3/2025,Pradeep Perera,Kandy,Hunnasgiriya,Central,7040,6493,13533,281600,259720,541320
1/4/2025,Pradeep Perera,Kandy,Hunnasgiriya,Central,7834,6734,14568,313360,269360,582720
1/5/2025,Pradeep Perera,Kandy,Hunnasgiriya,Central,2088,9375,11463,83520,375000,458520
1/6/2025,Pradeep Perera,Kandy,Hunnasgiriya,Central,155,7108,7263,6200,284320,290520
1/7/2025,Pradeep Perera,Kandy,Hunnasgiriya,Central,5567,284,5851,222680,11360,234040
1/8/2025,Pradeep Perera,Kandy,Hunnasgiriya,Central,7396,2194,9590,295840,87760,383600
1/9/2025,Pradeep Perera,Kandy,Hunnasgiriya,Central,6049,8804,14853,241960,352160,594120
1/10/2025,Pradeep Perera,Kandy,Hunnasgiriya,Central,4128,8140,12268,165120,325600,490720
1/11/2025,Pradeep Perera,Kandy,Hunnasgiriya,Central,7384,9247,16631,295360,369880,665240
1/12/2025,Pradeep Perera,Kandy,Hunnasgiriya,Central,3340,8162,11502,133600,326480,460080
1/13/2025,Pradeep Perera,Kandy,Hunnasgiriya,Central,7444,9894,17338,297760,395760,693520
1/14/2025,Pradeep Perera,Kandy,Hunnasgiriya,Central,2993,3580,6573,119720,143200,262920
1/15/2025,Pradeep Perera,Kandy,Hunnasgiriya,Central,286,4846,5132,11440,193840,205280
1/16/2025,Pradeep Perera,Kandy,Hunnasgiriya,Central,7841,7112,14953,313640,284480,598120
1/17/2025,Pradeep Perera,Kandy,Hunnasgiriya,Central,2851,4198,7049,114040,167920,281960
1/18/2025,Pradeep Perera,Kandy,Hunnasgiriya,Central,3415,463,3878,136600,18520,155120
1/19/2025,Pradeep Perera,Kandy,Hunnasgiriya,Central,9707,8500,18207,388280,340000,728280
1/20/2025,Pradeep Perera,Kandy,Hunnasgiriya,Central,6782,4793,11575,271280,191720,463000
1/21/2025,Pradeep Perera,Kandy,Hunnasgiriya,Central,9648,2046,11694,385920,81840,467760
1/22/2025,Pradeep Perera,Kandy,Hunnasgiriya,Central,350,4912,5262,14000,196480,210480
1/23/2025,Pradeep Perera,Kandy,Hunnasgiriya,Central,899,5827,6726,35960,233080,269040
1/24/2025,Pradeep Perera,Kandy,Hunnasgiriya,Central,210,5429,5639,8400,217160,225560
1/25/2025,Pradeep Perera,Kandy,Hunnasgiriya,Central,7509,3312,10821,300360,132480,432840
1/26/2025,Pradeep Perera,Kandy,Hunnasgiriya,Central,8372,4645,13017,334880,185800,520680
1/27/2025,Pradeep Perera,Kandy,Hunnasgiriya,Central,3081,3852,6933,123240,154080,277320
1/28/2025,Pradeep Perera,Kandy,Hunnasgiriya,Central,4030,9020,13050,161200,360800,522000
1/29/2025,Pradeep Perera,Kandy,Hunnasgiriya,Central,3949,8762,12711,157960,350480,508440
1/30/2025,Pradeep Perera,Kandy,Hunnasgiriya,Central,7232,9355,16587,289280,374200,663480
1/31/2025,Pradeep Perera,Kandy,Hunnasgiriya,Central,9386,6083,15469,375440,243320,618760
2/1/2025,Pradeep Perera,Kandy,Hunnasgiriya,Central,9238,3076,12314,369520,123040,492560
2/2/2025,Pradeep Perera,Kandy,Hunnasgiriya,Central,1079,6225,7304,43160,249000,292160
2/3/2025,Pradeep Perera,Kandy,Hunnasgiriya,Central,519,3038,3557,20760,121520,142280
2/4/2025,Pradeep Perera,Kandy,Hunnasgiriya,Central,8539,5622,14161,341560,224880,566440
2/5/2025,Pradeep Perera,Kandy,Hunnasgiriya,Central,6925,2390,9315,277000,95600,372600
2/6/2025,Pradeep Perera,Kandy,Hunnasgiriya,Central,418,1151,1569,16720,46040,62760
2/7/2025,Pradeep Perera,Kandy,Hunnasgiriya,Central,9568,3323,12891,382720,132920,515640
2/8/2025,Pradeep Perera,Kandy,Hunnasgiriya,Central,6241,4551,10792,249640,182040,431680
2/9/2025,Pradeep Perera,Kandy,Hunnasgiriya,Central,7438,1049,8487,297520,41960,339480
2/10/2025,Pradeep Perera,Kandy,Hunnasgiriya,Central,8598,7542,16140,343920,301680,645600
2/11/2025,Pradeep Perera,Kandy,Hunnasgiriya,Central,706,5044,5750,28240,201760,230000
2/12/2025,Pradeep Perera,Kandy,Hunnasgiriya,Central,6870,9650,16520,274800,386000,660800
2/13/2025,Pradeep Perera,Kandy,Hunnasgiriya,Central,4527,592,5119,181080,23680,204760
2/14/2025,Pradeep Perera,Kandy,Hunnasgiriya,Central,196,9223,9419,7840,368920,376760
2/15/2025,Pradeep Perera,Kandy,Hunnasgiriya,Central,6236,7744,13980,249440,309760,559200
2/16/2025,Pradeep Perera,Kandy,Hunnasgiriya,Central,8119,6860,14979,324760,274400,599160
2/17/2025,Pradeep Perera,Kandy,Hunnasgiriya,Central,4346,619,4965,173840,24760,198600
2/18/2025,Pradeep Perera,Kandy,Hunnasgiriya,Central,5391,3113,8504,215640,124520,340160
2/19/2025,Pradeep Perera,Kandy,Hunnasgiriya,Central,5817,6040,11857,232680,241600,474280
2/20/2025,Pradeep Perera,Kandy,Hunnasgiriya,Central,6425,6670,13095,257000,266800,523800
2/21/2025,Pradeep Perera,Kandy,Hunnasgiriya,Central,1907,1156,3063,76280,46240,122520
2/22/2025,Pradeep Perera,Kandy,Hunnasgiriya,Central,9753,5545,15298,390120,221800,611920
2/23/2025,Pradeep Perera,Kandy,Hunnasgiriya,Central,1455,8563,10018,58200,342520,400720
2/24/2025,Pradeep Perera,Kandy,Hunnasgiriya,Central,9371,416,9787,374840,16640,391480
2/25/2025,Pradeep Perera,Kandy,Hunnasgiriya,Central,3202,5126,8328,128080,205040,333120
2/26/2025,Pradeep Perera,Kandy,Hunnasgiriya,Central,8881,2236,11117,355240,89440,444680
2/27/2025,Pradeep Perera,Kandy,Hunnasgiriya,Central,3534,8163,11697,141360,326520,467880
2/28/2025,Pradeep Perera,Kandy,Hunnasgiriya,Central,7051,2055,9106,282040,82200,364240
3/1/2025,Pradeep Perera,Kandy,Hunnasgiriya,Central,5627,1826,7453,225080,73040,298120
3/2/2025,Pradeep Perera,Kandy,Hunnasgiriya,Central,6384,8449,14833,255360,337960,593320
3/3/2025,Pradeep Perera,Kandy,Hunnasgiriya,Central,6749,6729,13478,269960,269160,539120
3/4/2025,Pradeep Perera,Kandy,Hunnasgiriya,Central,7125,930,8055,285000,37200,322200
3/5/2025,Pradeep Perera,Kandy,Hunnasgiriya,Central,9463,3375,12838,378520,135000,513520
3/6/2025,Pradeep Perera,Kandy,Hunnasgiriya,Central,6673,4470,11143,266920,178800,445720
3/7/2025,Pradeep Perera,Kandy,Hunnasgiriya,Central,3491,8603,12094,139640,344120,483760
3/8/2025,Pradeep Perera,Kandy,Hunnasgiriya,Central,7831,3471,11302,313240,138840,452080
3/9/2025,Pradeep Perera,Kandy,Hunnasgiriya,Central,4427,5631,10058,177080,225240,402320
3/10/2025,Pradeep Perera,Kandy,Hunnasgiriya,Central,4962,918,5880,198480,36720,235200
3/11/2025,Pradeep Perera,Kandy,Hunnasgiriya,Central,9017,8667,17684,360680,346680,707360
3/12/2025,Pradeep Perera,Kandy,Hunnasgiriya,Central,8405,9011,17416,336200,360440,696640
3/13/2025,Pradeep Perera,Kandy,Hunnasgiriya,Central,4444,9723,14167,177760,388920,566680
3/14/2025,Pradeep Perera,Kandy,Hunnasgiriya,Central,4246,9595,13841,169840,383800,553640
3/15/2025,Pradeep Perera,Kandy,Hunnasgiriya,Central,9855,6955,16810,394200,278200,672400
3/16/2025,Pradeep Perera,Kandy,Hunnasgiriya,Central,6141,8691,14832,245640,347640,593280
3/17/2025,Pradeep Perera,Kandy,Hunnasgiriya,Central,3681,2533,6214,147240,101320,248560
3/18/2025,Pradeep Perera,Kandy,Hunnasgiriya,Central,3424,2562,5986,136960,102480,239440
3/19/2025,Pradeep Perera,Kandy,Hunnasgiriya,Central,6282,7158,13440,251280,286320,537600
3/20/2025,Pradeep Perera,Kandy,Hunnasgiriya,Central,4380,2199,6579,175200,87960,263160
3/21/2025,Pradeep Perera,Kandy,Hunnasgiriya,Central,7239,1608,8847,289560,64320,353880
3/22/2025,Pradeep Perera,Kandy,Hunnasgiriya,Central,5670,7081,12751,226800,283240,510040
3/23/2025,Pradeep Perera,Kandy,Hunnasgiriya,Central,4585,3028,7613,183400,121120,304520
3/25/2024,Priyanka Ranatunga,Kalutara,Dodangoda,Western,547,890,1437,21880,35600,57480
3/26/2024,Priyanka Ranatunga,Kalutara,Dodangoda,Western,7070,1083,8153,282800,43320,326120
3/27/2024,Priyanka Ranatunga,Kalutara,Dodangoda,Western,7762,404,8166,310480,16160,326640
3/28/2024,Priyanka Ranatunga,Kalutara,Dodangoda,Western,8748,8082,16830,349920,323280,673200
3/29/2024,Priyanka Ranatunga,Kalutara,Dodangoda,Western,2110,8294,10404,84400,331760,416160
3/30/2024,Priyanka Ranatunga,Kalutara,Dodangoda,Western,2067,1772,3839,82680,70880,153560
3/31/2024,Priyanka Ranatunga,Kalutara,Dodangoda,Western,3227,4372,7599,129080,174880,303960
4/1/2024,Priyanka Ranatunga,Kalutara,Dodangoda,Western,1214,8936,10150,48560,357440,406000
4/2/2024,Priyanka Ranatunga,Kalutara,Dodangoda,Western,1163,5435,6598,46520,217400,263920
4/3/2024,Priyanka Ranatunga,Kalutara,Dodangoda,Western,8589,5341,13930,343560,213640,557200
4/4/2024,Priyanka Ranatunga,Kalutara,Dodangoda,Western,2377,2829,5206,95080,113160,208240
4/5/2024,Priyanka Ranatunga,Kalutara,Dodangoda,Western,9418,3362,12780,376720,134480,511200
4/6/2024,Priyanka Ranatunga,Kalutara,Dodangoda,Western,5541,468,6009,221640,18720,240360
4/7/2024,Priyanka Ranatunga,Kalutara,Dodangoda,Western,3265,5099,8364,130600,203960,334560
4/8/2024,Priyanka Ranatunga,Kalutara,Dodangoda,Western,4668,3986,8654,186720,159440,346160
4/9/2024,Priyanka Ranatunga,Kalutara,Dodangoda,Western,8881,1058,9939,355240,42320,397560
4/10/2024,Priyanka Ranatunga,Kalutara,Dodangoda,Western,9154,9442,18596,366160,377680,743840
4/11/2024,Priyanka Ranatunga,Kalutara,Dodangoda,Western,4451,2873,7324,178040,114920,292960
4/19/2024,Priyanka Ranatunga,Kalutara,Dodangoda,Western,1920,5648,7568,76800,225920,302720
4/20/2024,Priyanka Ranatunga,Kalutara,Dodangoda,Western,9252,4733,13985,370080,189320,559400
4/21/2024,Priyanka Ranatunga,Kalutara,Dodangoda,Western,796,1560,2356,31840,62400,94240
4/22/2024,Priyanka Ranatunga,Kalutara,Dodangoda,Western,803,2,805,32120,80,32200
4/23/2024,Priyanka Ranatunga,Kalutara,Dodangoda,Western,5134,8724,13858,205360,348960,554320
4/24/2024,Priyanka Ranatunga,Kalutara,Dodangoda,Western,1570,8914,10484,62800,356560,419360
4/25/2024,Priyanka Ranatunga,Kalutara,Dodangoda,Western,8038,4170,12208,321520,166800,488320
4/26/2024,Priyanka Ranatunga,Kalutara,Dodangoda,Western,5705,7247,12952,228200,289880,518080
4/27/2024,Priyanka Ranatunga,Kalutara,Dodangoda,Western,6364,8541,14905,254560,341640,596200
4/28/2024,Priyanka Ranatunga,Kalutara,Dodangoda,Western,2422,8011,10433,96880,320440,417320
4/29/2024,Priyanka Ranatunga,Kalutara,Dodangoda,Western,590,618,1208,23600,24720,48320
4/30/2024,Priyanka Ranatunga,Kalutara,Dodangoda,Western,3753,8673,12426,150120,346920,497040
5/1/2024,Priyanka Ranatunga,Kalutara,Dodangoda,Western,8021,1403,9424,320840,56120,376960
5/2/2024,Priyanka Ranatunga,Kalutara,Dodangoda,Western,2319,1325,3644,92760,53000,145760
5/3/2024,Priyanka Ranatunga,Kalutara,Dodangoda,Western,9306,8665,17971,372240,346600,718840
5/4/2024,Priyanka Ranatunga,Kalutara,Dodangoda,Western,745,6946,7691,29800,277840,307640
5/5/2024,Priyanka Ranatunga,Kalutara,Dodangoda,Western,5113,7868,12981,204520,314720,519240
5/6/2024,Priyanka Ranatunga,Kalutara,Dodangoda,Western,5452,4978,10430,218080,199120,417200
5/7/2024,Priyanka Ranatunga,Kalutara,Dodangoda,Western,4909,8139,13048,196360,325560,521920
5/8/2024,Priyanka Ranatunga,Kalutara,Dodangoda,Western,4443,1969,6412,177720,78760,256480
5/9/2024,Priyanka Ranatunga,Kalutara,Dodangoda,Western,675,5065,5740,27000,202600,229600
5/10/2024,Priyanka Ranatunga,Kalutara,Dodangoda,Western,286,5733,6019,11440,229320,240760
5/11/2024,Priyanka Ranatunga,Kalutara,Dodangoda,Western,7958,5581,13539,318320,223240,541560
5/12/2024,Priyanka Ranatunga,Kalutara,Dodangoda,Western,2506,3213,5719,100240,128520,228760
5/13/2024,Priyanka Ranatunga,Kalutara,Dodangoda,Western,5648,8789,14437,225920,351560,577480
5/14/2024,Priyanka Ranatunga,Kalutara,Dodangoda,Western,4936,5856,10792,197440,234240,431680
5/15/2024,Priyanka Ranatunga,Kalutara,Dodangoda,Western,3741,6509,10250,149640,260360,410000
5/16/2024,Priyanka Ranatunga,Kalutara,Dodangoda,Western,8007,1050,9057,320280,42000,362280
5/17/2024,Priyanka Ranatunga,Kalutara,Dodangoda,Western,4972,8631,13603,198880,345240,544120
5/18/2024,Priyanka Ranatunga,Kalutara,Dodangoda,Western,9750,5601,15351,390000,224040,614040
5/19/2024,Priyanka Ranatunga,Kalutara,Dodangoda,Western,6101,3116,9217,244040,124640,368680
5/20/2024,Priyanka Ranatunga,Kalutara,Dodangoda,Western,2088,622,2710,83520,24880,108400
5/21/2024,Priyanka Ranatunga,Kalutara,Dodangoda,Western,364,7068,7432,14560,282720,297280
5/22/2024,Priyanka Ranatunga,Kalutara,Dodangoda,Western,4518,7486,12004,180720,299440,480160
5/24/2024,Priyanka Ranatunga,Kalutara,Dodangoda,Western,2491,5740,8231,99640,229600,329240
5/25/2024,Priyanka Ranatunga,Kalutara,Dodangoda,Western,6765,6162,12927,270600,246480,517080
5/26/2024,Priyanka Ranatunga,Kalutara,Dodangoda,Western,7584,517,8101,303360,20680,324040
5/27/2024,Priyanka Ranatunga,Kalutara,Dodangoda,Western,4550,1709,6259,182000,68360,250360
5/28/2024,Priyanka Ranatunga,Kalutara,Dodangoda,Western,1740,6696,8436,69600,267840,337440
5/29/2024,Priyanka Ranatunga,Kalutara,Dodangoda,Western,5213,2035,7248,208520,81400,289920
5/30/2024,Priyanka Ranatunga,Kalutara,Dodangoda,Western,3915,5474,9389,156600,218960,375560
5/31/2024,Priyanka Ranatunga,Kalutara,Dodangoda,Western,9682,319,10001,387280,12760,400040
6/1/2024,Priyanka Ranatunga,Kalutara,Dodangoda,Western,4251,2143,6394,170040,85720,255760
6/2/2024,Priyanka Ranatunga,Kalutara,Dodangoda,Western,243,8105,8348,9720,324200,333920
6/3/2024,Priyanka Ranatunga,Kalutara,Dodangoda,Western,1572,185,1757,62880,7400,70280
6/4/2024,Priyanka Ranatunga,Kalutara,Dodangoda,Western,8042,3534,11576,321680,141360,463040
6/5/2024,Priyanka Ranatunga,Kalutara,Dodangoda,Western,1021,9031,10052,40840,361240,402080
6/6/2024,Priyanka Ranatunga,Kalutara,Dodangoda,Western,5014,5992,11006,200560,239680,440240
6/7/2024,Priyanka Ranatunga,Kalutara,Dodangoda,Western,7079,9791,16870,283160,391640,674800
6/8/2024,Priyanka Ranatunga,Kalutara,Dodangoda,Western,5857,4321,10178,234280,172840,407120
6/9/2024,Priyanka Ranatunga,Kalutara,Dodangoda,Western,8911,9442,18353,356440,377680,734120
6/10/2024,Priyanka Ranatunga,Kalutara,Dodangoda,Western,1408,7947,9355,56320,317880,374200
6/11/2024,Priyanka Ranatunga,Kalutara,Dodangoda,Western,223,1555,1778,8920,62200,71120
6/12/2024,Priyanka Ranatunga,Kalutara,Dodangoda,Western,5796,9249,15045,231840,369960,601800
6/13/2024,Priyanka Ranatunga,Kalutara,Dodangoda,Western,5780,3354,9134,231200,134160,365360
6/14/2024,Priyanka Ranatunga,Kalutara,Dodangoda,Western,6946,7283,14229,277840,291320,569160
6/15/2024,Priyanka Ranatunga,Kalutara,Dodangoda,Western,7142,5358,12500,285680,214320,500000
6/16/2024,Priyanka Ranatunga,Kalutara,Dodangoda,Western,5950,1018,6968,238000,40720,278720
6/17/2024,Priyanka Ranatunga,Kalutara,Dodangoda,Western,6618,7504,14122,264720,300160,564880
6/18/2024,Priyanka Ranatunga,Kalutara,Dodangoda,Western,9374,2614,11988,374960,104560,479520
6/19/2024,Priyanka Ranatunga,Kalutara,Dodangoda,Western,1049,2147,3196,41960,85880,127840
6/20/2024,Priyanka Ranatunga,Kalutara,Dodangoda,Western,1261,8860,10121,50440,354400,404840
6/21/2024,Priyanka Ranatunga,Kalutara,Dodangoda,Western,4564,9321,13885,182560,372840,555400
6/22/2024,Priyanka Ranatunga,Kalutara,Dodangoda,Western,3086,1335,4421,123440,53400,176840
6/23/2024,Priyanka Ranatunga,Kalutara,Dodangoda,Western,1724,3899,5623,68960,155960,224920
6/24/2024,Priyanka Ranatunga,Kalutara,Dodangoda,Western,4808,400,5208,192320,16000,208320
6/25/2024,Priyanka Ranatunga,Kalutara,Dodangoda,Western,3839,8247,12086,153560,329880,483440
6/26/2024,Priyanka Ranatunga,Kalutara,Dodangoda,Western,9764,4708,14472,390560,188320,578880
6/27/2024,Priyanka Ranatunga,Kalutara,Dodangoda,Western,5978,3141,9119,239120,125640,364760
6/28/2024,Priyanka Ranatunga,Kalutara,Dodangoda,Western,5800,3732,9532,232000,149280,381280
6/29/2024,Priyanka Ranatunga,Kalutara,Dodangoda,Western,9254,3427,12681,370160,137080,507240
6/30/2024,Priyanka Ranatunga,Kalutara,Dodangoda,Western,2590,2246,4836,103600,89840,193440
7/1/2024,Priyanka Ranatunga,Kalutara,Dodangoda,Western,7286,1433,8719,291440,57320,348760
7/2/2024,Priyanka Ranatunga,Kalutara,Dodangoda,Western,607,5215,5822,24280,208600,232880
7/3/2024,Priyanka Ranatunga,Kalutara,Dodangoda,Western,1302,4553,5855,52080,182120,234200
7/4/2024,Priyanka Ranatunga,Kalutara,Dodangoda,Western,1390,6126,7516,55600,245040,300640
7/5/2024,Priyanka Ranatunga,Kalutara,Dodangoda,Western,2989,2844,5833,119560,113760,233320
7/6/2024,Priyanka Ranatunga,Kalutara,Dodangoda,Western,5832,4561,10393,233280,182440,415720
7/7/2024,Priyanka Ranatunga,Kalutara,Dodangoda,Western,1072,6939,8011,42880,277560,320440
7/8/2024,Priyanka Ranatunga,Kalutara,Dodangoda,Western,5719,2637,8356,228760,105480,334240
7/9/2024,Priyanka Ranatunga,Kalutara,Dodangoda,Western,1282,1409,2691,51280,56360,107640
7/10/2024,Priyanka Ranatunga,Kalutara,Dodangoda,Western,5363,6990,12353,214520,279600,494120
7/11/2024,Priyanka Ranatunga,Kalutara,Dodangoda,Western,2773,6457,9230,110920,258280,369200
7/12/2024,Priyanka Ranatunga,Kalutara,Dodangoda,Western,6452,1393,7845,258080,55720,313800
7/13/2024,Priyanka Ranatunga,Kalutara,Dodangoda,Western,1100,8175,9275,44000,327000,371000
7/14/2024,Priyanka Ranatunga,Kalutara,Dodangoda,Western,1576,1637,3213,63040,65480,128520
7/15/2024,Priyanka Ranatunga,Kalutara,Dodangoda,Western,9658,9803,19461,386320,392120,778440
7/16/2024,Priyanka Ranatunga,Kalutara,Dodangoda,Western,8520,8507,17027,340800,340280,681080
7/17/2024,Priyanka Ranatunga,Kalutara,Dodangoda,Western,46,3713,3759,1840,148520,150360
7/18/2024,Priyanka Ranatunga,Kalutara,Dodangoda,Western,1205,5602,6807,48200,224080,272280
7/19/2024,Priyanka Ranatunga,Kalutara,Dodangoda,Western,2227,7946,10173,89080,317840,406920
7/20/2024,Priyanka Ranatunga,Kalutara,Dodangoda,Western,3741,46,3787,149640,1840,151480
7/21/2024,Priyanka Ranatunga,Kalutara,Dodangoda,Western,4224,2402,6626,168960,96080,265040
7/22/2024,Priyanka Ranatunga,Kalutara,Dodangoda,Western,4352,1386,5738,174080,55440,229520
7/23/2024,Priyanka Ranatunga,Kalutara,Dodangoda,Western,8286,673,8959,331440,26920,358360
7/24/2024,Priyanka Ranatunga,Kalutara,Dodangoda,Western,1885,6756,8641,75400,270240,345640
7/25/2024,Priyanka Ranatunga,Kalutara,Dodangoda,Western,4845,4613,9458,193800,184520,378320
7/26/2024,Priyanka Ranatunga,Kalutara,Dodangoda,Western,6300,4775,11075,252000,191000,443000
7/27/2024,Priyanka Ranatunga,Kalutara,Dodangoda,Western,1150,5846,6996,46000,233840,279840
7/28/2024,Priyanka Ranatunga,Kalutara,Dodangoda,Western,357,4241,4598,14280,169640,183920
7/29/2024,Priyanka Ranatunga,Kalutara,Dodangoda,Western,7609,7068,14677,304360,282720,587080
7/30/2024,Priyanka Ranatunga,Kalutara,Dodangoda,Western,9211,7706,16917,368440,308240,676680
7/31/2024,Priyanka Ranatunga,Kalutara,Dodangoda,Western,2237,1925,4162,89480,77000,166480
8/1/2024,Priyanka Ranatunga,Kalutara,Dodangoda,Western,3123,4631,7754,124920,185240,310160
8/2/2024,Priyanka Ranatunga,Kalutara,Dodangoda,Western,8841,3510,12351,353640,140400,494040
8/3/2024,Priyanka Ranatunga,Kalutara,Dodangoda,Western,3379,8240,11619,135160,329600,464760
8/4/2024,Priyanka Ranatunga,Kalutara,Dodangoda,Western,6617,2842,9459,264680,113680,378360
8/5/2024,Priyanka Ranatunga,Kalutara,Dodangoda,Western,1825,8522,10347,73000,340880,413880
8/6/2024,Priyanka Ranatunga,Kalutara,Dodangoda,Western,1243,8328,9571,49720,333120,382840
8/7/2024,Priyanka Ranatunga,Kalutara,Dodangoda,Western,5203,8098,13301,208120,323920,532040
8/8/2024,Priyanka Ranatunga,Kalutara,Dodangoda,Western,9099,3068,12167,363960,122720,486680
8/9/2024,Priyanka Ranatunga,Kalutara,Dodangoda,Western,6003,3133,9136,240120,125320,365440
8/10/2024,Priyanka Ranatunga,Kalutara,Dodangoda,Western,9664,4567,14231,386560,182680,569240
8/11/2024,Priyanka Ranatunga,Kalutara,Dodangoda,Western,4514,41,4555,180560,1640,182200
8/12/2024,Priyanka Ranatunga,Kalutara,Dodangoda,Western,7460,8738,16198,298400,349520,647920
8/13/2024,Priyanka Ranatunga,Kalutara,Dodangoda,Western,2615,9103,11718,104600,364120,468720
8/14/2024,Priyanka Ranatunga,Kalutara,Dodangoda,Western,4517,2318,6835,180680,92720,273400
8/15/2024,Priyanka Ranatunga,Kalutara,Dodangoda,Western,279,3457,3736,11160,138280,149440
8/16/2024,Priyanka Ranatunga,Kalutara,Dodangoda,Western,3847,9061,12908,153880,362440,516320
8/17/2024,Priyanka Ranatunga,Kalutara,Dodangoda,Western,7888,5579,13467,315520,223160,538680
8/18/2024,Priyanka Ranatunga,Kalutara,Dodangoda,Western,6799,9498,16297,271960,379920,651880
8/19/2024,Priyanka Ranatunga,Kalutara,Dodangoda,Western,6832,7390,14222,273280,295600,568880
8/20/2024,Priyanka Ranatunga,Kalutara,Dodangoda,Western,6641,2966,9607,265640,118640,384280
8/21/2024,Priyanka Ranatunga,Kalutara,Dodangoda,Western,5146,7687,12833,205840,307480,513320
8/22/2024,Priyanka Ranatunga,Kalutara,Dodangoda,Western,742,6693,7435,29680,267720,297400
8/23/2024,Priyanka Ranatunga,Kalutara,Dodangoda,Western,2834,3668,6502,113360,146720,260080
8/24/2024,Priyanka Ranatunga,Kalutara,Dodangoda,Western,5316,1672,6988,212640,66880,279520
8/25/2024,Priyanka Ranatunga,Kalutara,Dodangoda,Western,2076,9843,11919,83040,393720,476760
8/26/2024,Priyanka Ranatunga,Kalutara,Dodangoda,Western,2913,3412,6325,116520,136480,253000
8/27/2024,Priyanka Ranatunga,Kalutara,Dodangoda,Western,875,4928,5803,35000,197120,232120
8/28/2024,Priyanka Ranatunga,Kalutara,Dodangoda,Western,8525,29,8554,341000,1160,342160
8/29/2024,Priyanka Ranatunga,Kalutara,Dodangoda,Western,4827,5748,10575,193080,229920,423000
8/30/2024,Priyanka Ranatunga,Kalutara,Dodangoda,Western,4780,6120,10900,191200,244800,436000
8/31/2024,Priyanka Ranatunga,Kalutara,Dodangoda,Western,8663,6580,15243,346520,263200,609720
9/1/2024,Priyanka Ranatunga,Kalutara,Dodangoda,Western,556,8983,9539,22240,359320,381560
9/2/2024,Priyanka Ranatunga,Kalutara,Dodangoda,Western,6768,2862,9630,270720,114480,385200
9/3/2024,Priyanka Ranatunga,Kalutara,Dodangoda,Western,8803,4182,12985,352120,167280,519400
9/4/2024,Priyanka Ranatunga,Kalutara,Dodangoda,Western,3760,5124,8884,150400,204960,355360
9/5/2024,Priyanka Ranatunga,Kalutara,Dodangoda,Western,2814,1150,3964,112560,46000,158560
9/6/2024,Priyanka Ranatunga,Kalutara,Dodangoda,Western,3391,6847,10238,135640,273880,409520
9/7/2024,Priyanka Ranatunga,Kalutara,Dodangoda,Western,8002,8585,16587,320080,343400,663480
9/8/2024,Priyanka Ranatunga,Kalutara,Dodangoda,Western,7012,6080,13092,280480,243200,523680
9/9/2024,Priyanka Ranatunga,Kalutara,Dodangoda,Western,9614,1949,11563,384560,77960,462520
9/10/2024,Priyanka Ranatunga,Kalutara,Dodangoda,Western,6512,5969,12481,260480,238760,499240
9/11/2024,Priyanka Ranatunga,Kalutara,Dodangoda,Western,3936,4736,8672,157440,189440,346880
9/12/2024,Priyanka Ranatunga,Kalutara,Dodangoda,Western,4781,8045,12826,191240,321800,513040
9/13/2024,Priyanka Ranatunga,Kalutara,Dodangoda,Western,5493,5176,10669,219720,207040,426760
9/14/2024,Priyanka Ranatunga,Kalutara,Dodangoda,Western,4042,7628,11670,161680,305120,466800
9/15/2024,Priyanka Ranatunga,Kalutara,Dodangoda,Western,9705,662,10367,388200,26480,414680
9/16/2024,Priyanka Ranatunga,Kalutara,Dodangoda,Western,1772,91,1863,70880,3640,74520
9/17/2024,Priyanka Ranatunga,Kalutara,Dodangoda,Western,7479,7370,14849,299160,294800,593960
9/18/2024,Priyanka Ranatunga,Kalutara,Dodangoda,Western,1614,9069,10683,64560,362760,427320
9/19/2024,Priyanka Ranatunga,Kalutara,Dodangoda,Western,4306,8213,12519,172240,328520,500760
9/20/2024,Priyanka Ranatunga,Kalutara,Dodangoda,Western,3830,2817,6647,153200,112680,265880
9/21/2024,Priyanka Ranatunga,Kalutara,Dodangoda,Western,7345,4103,11448,293800,164120,457920
9/22/2024,Priyanka Ranatunga,Kalutara,Dodangoda,Western,4176,4242,8418,167040,169680,336720
9/23/2024,Priyanka Ranatunga,Kalutara,Dodangoda,Western,6700,9360,16060,268000,374400,642400
9/24/2024,Priyanka Ranatunga,Kalutara,Dodangoda,Western,784,2139,2923,31360,85560,116920
9/25/2024,Priyanka Ranatunga,Kalutara,Dodangoda,Western,2286,3148,5434,91440,125920,217360
9/26/2024,Priyanka Ranatunga,Kalutara,Dodangoda,Western,1293,5437,6730,51720,217480,269200
9/27/2024,Priyanka Ranatunga,Kalutara,Dodangoda,Western,2871,9289,12160,114840,371560,486400
9/28/2024,Priyanka Ranatunga,Kalutara,Dodangoda,Western,5675,4511,10186,227000,180440,407440
9/29/2024,Priyanka Ranatunga,Kalutara,Dodangoda,Western,3887,7532,11419,155480,301280,456760
9/30/2024,Priyanka Ranatunga,Kalutara,Dodangoda,Western,2779,5191,7970,111160,207640,318800
10/1/2024,Priyanka Ranatunga,Kalutara,Dodangoda,Western,8948,3881,12829,357920,155240,513160
10/2/2024,Priyanka Ranatunga,Kalutara,Dodangoda,Western,7199,3939,11138,287960,157560,445520
10/3/2024,Priyanka Ranatunga,Kalutara,Dodangoda,Western,1609,738,2347,64360,29520,93880
10/4/2024,Priyanka Ranatunga,Kalutara,Dodangoda,Western,6625,9756,16381,265000,390240,655240
10/5/2024,Priyanka Ranatunga,Kalutara,Dodangoda,Western,663,3495,4158,26520,139800,166320
10/6/2024,Priyanka Ranatunga,Kalutara,Dodangoda,Western,7392,7266,14658,295680,290640,586320
10/7/2024,Priyanka Ranatunga,Kalutara,Dodangoda,Western,3890,4681,8571,155600,187240,342840
10/8/2024,Priyanka Ranatunga,Kalutara,Dodangoda,Western,6201,692,6893,248040,27680,275720
10/9/2024,Priyanka Ranatunga,Kalutara,Dodangoda,Western,4207,8316,12523,168280,332640,500920
10/10/2024,Priyanka Ranatunga,Kalutara,Dodangoda,Western,6588,5375,11963,263520,215000,478520
10/11/2024,Priyanka Ranatunga,Kalutara,Dodangoda,Western,4982,6208,11190,199280,248320,447600
10/12/2024,Priyanka Ranatunga,Kalutara,Dodangoda,Western,9582,6980,16562,383280,279200,662480
10/13/2024,Priyanka Ranatunga,Kalutara,Dodangoda,Western,5,1283,1288,200,51320,51520
10/14/2024,Priyanka Ranatunga,Kalutara,Dodangoda,Western,2593,9046,11639,103720,361840,465560
10/15/2024,Priyanka Ranatunga,Kalutara,Dodangoda,Western,1618,2543,4161,64720,101720,166440
10/16/2024,Priyanka Ranatunga,Kalutara,Dodangoda,Western,2220,8609,10829,88800,344360,433160
10/17/2024,Priyanka Ranatunga,Kalutara,Dodangoda,Western,3296,3997,7293,131840,159880,291720
10/18/2024,Priyanka Ranatunga,Kalutara,Dodangoda,Western,3448,2708,6156,137920,108320,246240
10/19/2024,Priyanka Ranatunga,Kalutara,Dodangoda,Western,7182,918,8100,287280,36720,324000
10/20/2024,Priyanka Ranatunga,Kalutara,Dodangoda,Western,2775,4976,7751,111000,199040,310040
10/21/2024,Priyanka Ranatunga,Kalutara,Dodangoda,Western,7710,9767,17477,308400,390680,699080
10/22/2024,Priyanka Ranatunga,Kalutara,Dodangoda,Western,6080,6798,12878,243200,271920,515120
10/23/2024,Priyanka Ranatunga,Kalutara,Dodangoda,Western,6722,4000,10722,268880,160000,428880
10/24/2024,Priyanka Ranatunga,Kalutara,Dodangoda,Western,6948,6338,13286,277920,253520,531440
10/25/2024,Priyanka Ranatunga,Kalutara,Dodangoda,Western,3981,1231,5212,159240,49240,208480
10/26/2024,Priyanka Ranatunga,Kalutara,Dodangoda,Western,5141,2805,7946,205640,112200,317840
10/27/2024,Priyanka Ranatunga,Kalutara,Dodangoda,Western,6948,2324,9272,277920,92960,370880
10/28/2024,Priyanka Ranatunga,Kalutara,Dodangoda,Western,9617,9588,19205,384680,383520,768200
10/29/2024,Priyanka Ranatunga,Kalutara,Dodangoda,Western,1340,1578,2918,53600,63120,116720
10/30/2024,Priyanka Ranatunga,Kalutara,Dodangoda,Western,6318,4667,10985,252720,186680,439400
10/31/2024,Priyanka Ranatunga,Kalutara,Dodangoda,Western,2715,8619,11334,108600,344760,453360
11/1/2024,Priyanka Ranatunga,Kalutara,Dodangoda,Western,7936,6319,14255,317440,252760,570200
11/2/2024,Priyanka Ranatunga,Kalutara,Dodangoda,Western,9321,9599,18920,372840,383960,756800
11/3/2024,Priyanka Ranatunga,Kalutara,Dodangoda,Western,1063,3619,4682,42520,144760,187280
11/4/2024,Priyanka Ranatunga,Kalutara,Dodangoda,Western,4509,6966,11475,180360,278640,459000
11/5/2024,Priyanka Ranatunga,Kalutara,Dodangoda,Western,1461,8182,9643,58440,327280,385720
11/6/2024,Priyanka Ranatunga,Kalutara,Dodangoda,Western,5401,5858,11259,216040,234320,450360
11/7/2024,Priyanka Ranatunga,Kalutara,Dodangoda,Western,4912,6148,11060,196480,245920,442400
11/8/2024,Priyanka Ranatunga,Kalutara,Dodangoda,Western,4417,2517,6934,176680,100680,277360
11/9/2024,Priyanka Ranatunga,Kalutara,Dodangoda,Western,300,8640,8940,12000,345600,357600
11/10/2024,Priyanka Ranatunga,Kalutara,Dodangoda,Western,660,4384,5044,26400,175360,201760
11/11/2024,Priyanka Ranatunga,Kalutara,Dodangoda,Western,2641,1613,4254,105640,64520,170160
11/12/2024,Priyanka Ranatunga,Kalutara,Dodangoda,Western,1778,9032,10810,71120,361280,432400
11/13/2024,Priyanka Ranatunga,Kalutara,Dodangoda,Western,3664,1859,5523,146560,74360,220920
11/14/2024,Priyanka Ranatunga,Kalutara,Dodangoda,Western,6869,818,7687,274760,32720,307480
11/15/2024,Priyanka Ranatunga,Kalutara,Dodangoda,Western,883,5889,6772,35320,235560,270880
11/16/2024,Priyanka Ranatunga,Kalutara,Dodangoda,Western,1687,3413,5100,67480,136520,204000
11/17/2024,Priyanka Ranatunga,Kalutara,Dodangoda,Western,3124,6373,9497,124960,254920,379880
11/18/2024,Priyanka Ranatunga,Kalutara,Dodangoda,Western,2830,8770,11600,113200,350800,464000
11/19/2024,Priyanka Ranatunga,Kalutara,Dodangoda,Western,465,416,881,18600,16640,35240
11/20/2024,Priyanka Ranatunga,Kalutara,Dodangoda,Western,9700,470,10170,388000,18800,406800
11/21/2024,Priyanka Ranatunga,Kalutara,Dodangoda,Western,3983,6583,10566,159320,263320,422640
11/22/2024,Priyanka Ranatunga,Kalutara,Dodangoda,Western,6612,9627,16239,264480,385080,649560
11/23/2024,Priyanka Ranatunga,Kalutara,Dodangoda,Western,187,799,986,7480,31960,39440
11/24/2024,Priyanka Ranatunga,Kalutara,Dodangoda,Western,7043,1319,8362,281720,52760,334480
11/25/2024,Priyanka Ranatunga,Kalutara,Dodangoda,Western,5857,4695,10552,234280,187800,422080
11/26/2024,Priyanka Ranatunga,Kalutara,Dodangoda,Western,7156,3934,11090,286240,157360,443600
11/27/2024,Priyanka Ranatunga,Kalutara,Dodangoda,Western,5610,4000,9610,224400,160000,384400
11/28/2024,Priyanka Ranatunga,Kalutara,Dodangoda,Western,1061,3565,4626,42440,142600,185040
11/29/2024,Priyanka Ranatunga,Kalutara,Dodangoda,Western,440,2162,2602,17600,86480,104080
11/30/2024,Priyanka Ranatunga,Kalutara,Dodangoda,Western,1195,3767,4962,47800,150680,198480
12/1/2024,Priyanka Ranatunga,Kalutara,Dodangoda,Western,7593,2746,10339,303720,109840,413560
12/2/2024,Priyanka Ranatunga,Kalutara,Dodangoda,Western,8383,5781,14164,335320,231240,566560
12/3/2024,Priyanka Ranatunga,Kalutara,Dodangoda,Western,9010,5754,14764,360400,230160,590560
12/4/2024,Priyanka Ranatunga,Kalutara,Dodangoda,Western,5988,8420,14408,239520,336800,576320
12/5/2024,Priyanka Ranatunga,Kalutara,Dodangoda,Western,1696,5609,7305,67840,224360,292200
12/6/2024,Priyanka Ranatunga,Kalutara,Dodangoda,Western,4505,7197,11702,180200,287880,468080
12/7/2024,Priyanka Ranatunga,Kalutara,Dodangoda,Western,3391,5928,9319,135640,237120,372760
12/8/2024,Priyanka Ranatunga,Kalutara,Dodangoda,Western,8941,2756,11697,357640,110240,467880
12/9/2024,Priyanka Ranatunga,Kalutara,Dodangoda,Western,2659,8577,11236,106360,343080,449440
12/10/2024,Priyanka Ranatunga,Kalutara,Dodangoda,Western,5359,3581,8940,214360,143240,357600
12/11/2024,Priyanka Ranatunga,Kalutara,Dodangoda,Western,5212,824,6036,208480,32960,241440
12/12/2024,Priyanka Ranatunga,Kalutara,Dodangoda,Western,6470,5072,11542,258800,202880,461680
12/13/2024,Priyanka Ranatunga,Kalutara,Dodangoda,Western,8889,1989,10878,355560,79560,435120
12/14/2024,Priyanka Ranatunga,Kalutara,Dodangoda,Western,3619,8514,12133,144760,340560,485320
12/15/2024,Priyanka Ranatunga,Kalutara,Dodangoda,Western,1482,6966,8448,59280,278640,337920
12/16/2024,Priyanka Ranatunga,Kalutara,Dodangoda,Western,7768,3498,11266,310720,139920,450640
12/17/2024,Priyanka Ranatunga,Kalutara,Dodangoda,Western,4083,6687,10770,163320,267480,430800
12/18/2024,Priyanka Ranatunga,Kalutara,Dodangoda,Western,4984,225,5209,199360,9000,208360
12/19/2024,Priyanka Ranatunga,Kalutara,Dodangoda,Western,9287,9515,18802,371480,380600,752080
12/20/2024,Priyanka Ranatunga,Kalutara,Dodangoda,Western,817,3351,4168,32680,134040,166720
12/21/2024,Priyanka Ranatunga,Kalutara,Dodangoda,Western,872,9313,10185,34880,372520,407400
12/22/2024,Priyanka Ranatunga,Kalutara,Dodangoda,Western,8137,1356,9493,325480,54240,379720
12/23/2024,Priyanka Ranatunga,Kalutara,Dodangoda,Western,6684,4413,11097,267360,176520,443880
12/24/2024,Priyanka Ranatunga,Kalutara,Dodangoda,Western,2386,9874,12260,95440,394960,490400
12/25/2024,Priyanka Ranatunga,Kalutara,Dodangoda,Western,5392,6906,12298,215680,276240,491920
12/26/2024,Priyanka Ranatunga,Kalutara,Dodangoda,Western,5137,6744,11881,205480,269760,475240
12/27/2024,Priyanka Ranatunga,Kalutara,Dodangoda,Western,4601,2916,7517,184040,116640,300680
12/28/2024,Priyanka Ranatunga,Kalutara,Dodangoda,Western,5946,2968,8914,237840,118720,356560
12/29/2024,Priyanka Ranatunga,Kalutara,Dodangoda,Western,5932,3516,9448,237280,140640,377920
12/30/2024,Priyanka Ranatunga,Kalutara,Dodangoda,Western,5614,1119,6733,224560,44760,269320
12/31/2024,Priyanka Ranatunga,Kalutara,Dodangoda,Western,1734,6078,7812,69360,243120,312480
1/1/2025,Priyanka Ranatunga,Kalutara,Dodangoda,Western,8781,3107,11888,351240,124280,475520
1/2/2025,Priyanka Ranatunga,Kalutara,Dodangoda,Western,2024,3597,5621,80960,143880,224840
1/3/2025,Priyanka Ranatunga,Kalutara,Dodangoda,Western,5548,2653,8201,221920,106120,328040
1/4/2025,Priyanka Ranatunga,Kalutara,Dodangoda,Western,9440,6145,15585,377600,245800,623400
1/5/2025,Priyanka Ranatunga,Kalutara,Dodangoda,Western,1558,9814,11372,62320,392560,454880
1/6/2025,Priyanka Ranatunga,Kalutara,Dodangoda,Western,7203,8318,15521,288120,332720,620840
1/7/2025,Priyanka Ranatunga,Kalutara,Dodangoda,Western,1893,8581,10474,75720,343240,418960
1/8/2025,Priyanka Ranatunga,Kalutara,Dodangoda,Western,6818,653,7471,272720,26120,298840
1/9/2025,Priyanka Ranatunga,Kalutara,Dodangoda,Western,9495,4668,14163,379800,186720,566520
1/10/2025,Priyanka Ranatunga,Kalutara,Dodangoda,Western,9341,4336,13677,373640,173440,547080
1/11/2025,Priyanka Ranatunga,Kalutara,Dodangoda,Western,3305,9647,12952,132200,385880,518080
1/12/2025,Priyanka Ranatunga,Kalutara,Dodangoda,Western,4043,4040,8083,161720,161600,323320
1/13/2025,Priyanka Ranatunga,Kalutara,Dodangoda,Western,3028,3939,6967,121120,157560,278680
1/14/2025,Priyanka Ranatunga,Kalutara,Dodangoda,Western,3541,8863,12404,141640,354520,496160
1/15/2025,Priyanka Ranatunga,Kalutara,Dodangoda,Western,2142,2486,4628,85680,99440,185120
1/16/2025,Priyanka Ranatunga,Kalutara,Dodangoda,Western,7113,9713,16826,284520,388520,673040
1/17/2025,Priyanka Ranatunga,Kalutara,Dodangoda,Western,5649,5955,11604,225960,238200,464160
1/18/2025,Priyanka Ranatunga,Kalutara,Dodangoda,Western,3956,9837,13793,158240,393480,551720
1/19/2025,Priyanka Ranatunga,Kalutara,Dodangoda,Western,4910,9574,14484,196400,382960,579360
1/20/2025,Priyanka Ranatunga,Kalutara,Dodangoda,Western,6581,8886,15467,263240,355440,618680
1/21/2025,Priyanka Ranatunga,Kalutara,Dodangoda,Western,4091,1342,5433,163640,53680,217320
1/22/2025,Priyanka Ranatunga,Kalutara,Dodangoda,Western,2691,5456,8147,107640,218240,325880
1/23/2025,Priyanka Ranatunga,Kalutara,Dodangoda,Western,3977,4821,8798,159080,192840,351920
1/24/2025,Priyanka Ranatunga,Kalutara,Dodangoda,Western,8925,2338,11263,357000,93520,450520
1/25/2025,Priyanka Ranatunga,Kalutara,Dodangoda,Western,724,8593,9317,28960,343720,372680
1/26/2025,Priyanka Ranatunga,Kalutara,Dodangoda,Western,2066,8019,10085,82640,320760,403400
1/27/2025,Priyanka Ranatunga,Kalutara,Dodangoda,Western,1687,1838,3525,67480,73520,141000
1/28/2025,Priyanka Ranatunga,Kalutara,Dodangoda,Western,790,2089,2879,31600,83560,115160
1/29/2025,Priyanka Ranatunga,Kalutara,Dodangoda,Western,3689,7565,11254,147560,302600,450160
1/30/2025,Priyanka Ranatunga,Kalutara,Dodangoda,Western,6542,3920,10462,261680,156800,418480
1/31/2025,Priyanka Ranatunga,Kalutara,Dodangoda,Western,147,5623,5770,5880,224920,230800
2/1/2025,Priyanka Ranatunga,Kalutara,Dodangoda,Western,2495,3001,5496,99800,120040,219840
2/2/2025,Priyanka Ranatunga,Kalutara,Dodangoda,Western,9072,475,9547,362880,19000,381880
2/3/2025,Priyanka Ranatunga,Kalutara,Dodangoda,Western,8722,5801,14523,348880,232040,580920
2/4/2025,Priyanka Ranatunga,Kalutara,Dodangoda,Western,6549,9588,16137,261960,383520,645480
2/5/2025,Priyanka Ranatunga,Kalutara,Dodangoda,Western,5061,8733,13794,202440,349320,551760
2/6/2025,Priyanka Ranatunga,Kalutara,Dodangoda,Western,8457,1318,9775,338280,52720,391000
2/7/2025,Priyanka Ranatunga,Kalutara,Dodangoda,Western,5665,5924,11589,226600,236960,463560
2/8/2025,Priyanka Ranatunga,Kalutara,Dodangoda,Western,3953,7268,11221,158120,290720,448840
2/9/2025,Priyanka Ranatunga,Kalutara,Dodangoda,Western,884,8200,9084,35360,328000,363360
2/10/2025,Priyanka Ranatunga,Kalutara,Dodangoda,Western,9120,8184,17304,364800,327360,692160
2/11/2025,Priyanka Ranatunga,Kalutara,Dodangoda,Western,7580,816,8396,303200,32640,335840
2/12/2025,Priyanka Ranatunga,Kalutara,Dodangoda,Western,898,3522,4420,35920,140880,176800
2/13/2025,Priyanka Ranatunga,Kalutara,Dodangoda,Western,6248,3791,10039,249920,151640,401560
2/14/2025,Priyanka Ranatunga,Kalutara,Dodangoda,Western,6264,6543,12807,250560,261720,512280
2/15/2025,Priyanka Ranatunga,Kalutara,Dodangoda,Western,7121,9581,16702,284840,383240,668080
2/16/2025,Priyanka Ranatunga,Kalutara,Dodangoda,Western,9856,2516,12372,394240,100640,494880
2/17/2025,Priyanka Ranatunga,Kalutara,Dodangoda,Western,2079,6495,8574,83160,259800,342960
2/18/2025,Priyanka Ranatunga,Kalutara,Dodangoda,Western,6372,7259,13631,254880,290360,545240
2/19/2025,Priyanka Ranatunga,Kalutara,Dodangoda,Western,20,6424,6444,800,256960,257760
2/20/2025,Priyanka Ranatunga,Kalutara,Dodangoda,Western,8570,3392,11962,342800,135680,478480
2/21/2025,Priyanka Ranatunga,Kalutara,Dodangoda,Western,2211,8966,11177,88440,358640,447080
2/22/2025,Priyanka Ranatunga,Kalutara,Dodangoda,Western,7910,3565,11475,316400,142600,459000
2/23/2025,Priyanka Ranatunga,Kalutara,Dodangoda,Western,6706,4050,10756,268240,162000,430240
2/24/2025,Priyanka Ranatunga,Kalutara,Dodangoda,Western,6286,3210,9496,251440,128400,379840
2/25/2025,Priyanka Ranatunga,Kalutara,Dodangoda,Western,1712,6483,8195,68480,259320,327800
2/26/2025,Priyanka Ranatunga,Kalutara,Dodangoda,Western,1219,1230,2449,48760,49200,97960
2/27/2025,Priyanka Ranatunga,Kalutara,Dodangoda,Western,5372,3118,8490,214880,124720,339600
2/28/2025,Priyanka Ranatunga,Kalutara,Dodangoda,Western,1037,683,1720,41480,27320,68800
3/1/2025,Priyanka Ranatunga,Kalutara,Dodangoda,Western,58,9444,9502,2320,377760,380080
3/2/2025,Priyanka Ranatunga,Kalutara,Dodangoda,Western,8734,4981,13715,349360,199240,548600
3/3/2025,Priyanka Ranatunga,Kalutara,Dodangoda,Western,151,764,915,6040,30560,36600
3/4/2025,Priyanka Ranatunga,Kalutara,Dodangoda,Western,471,8621,9092,18840,344840,363680
3/5/2025,Priyanka Ranatunga,Kalutara,Dodangoda,Western,5090,5152,10242,203600,206080,409680
3/6/2025,Priyanka Ranatunga,Kalutara,Dodangoda,Western,1769,9801,11570,70760,392040,462800
3/7/2025,Priyanka Ranatunga,Kalutara,Dodangoda,Western,448,6106,6554,17920,244240,262160
3/8/2025,Priyanka Ranatunga,Kalutara,Dodangoda,Western,3106,5741,8847,124240,229640,353880
3/9/2025,Priyanka Ranatunga,Kalutara,Dodangoda,Western,7819,4311,12130,312760,172440,485200
3/10/2025,Priyanka Ranatunga,Kalutara,Dodangoda,Western,1484,3772,5256,59360,150880,210240
3/11/2025,Priyanka Ranatunga,Kalutara,Dodangoda,Western,9700,7815,17515,388000,312600,700600
3/12/2025,Priyanka Ranatunga,Kalutara,Dodangoda,Western,2272,8596,10868,90880,343840,434720
3/13/2025,Priyanka Ranatunga,Kalutara,Dodangoda,Western,3722,4411,8133,148880,176440,325320
3/14/2025,Priyanka Ranatunga,Kalutara,Dodangoda,Western,2703,3776,6479,108120,151040,259160
3/15/2025,Priyanka Ranatunga,Kalutara,Dodangoda,Western,9349,840,10189,373960,33600,407560
3/16/2025,Priyanka Ranatunga,Kalutara,Dodangoda,Western,9396,4516,13912,375840,180640,556480
3/17/2025,Priyanka Ranatunga,Kalutara,Dodangoda,Western,9979,2034,12013,399160,81360,480520
3/18/2025,Priyanka Ranatunga,Kalutara,Dodangoda,Western,762,6659,7421,30480,266360,296840
3/19/2025,Priyanka Ranatunga,Kalutara,Dodangoda,Western,5458,6237,11695,218320,249480,467800
3/20/2025,Priyanka Ranatunga,Kalutara,Dodangoda,Western,9384,1592,10976,375360,63680,439040
3/21/2025,Priyanka Ranatunga,Kalutara,Dodangoda,Western,3509,7359,10868,140360,294360,434720
3/22/2025,Priyanka Ranatunga,Kalutara,Dodangoda,Western,6332,9419,15751,253280,376760,630040
3/23/2025,Priyanka Ranatunga,Kalutara,Dodangoda,Western,9333,6082,15415,373320,243280,616600
3/25/2024,Sujeewa Rajapaksha,Mannar,Mannar,Northern,6866,8416,15282,274640,336640,611280
3/26/2024,Sujeewa Rajapaksha,Mannar,Mannar,Northern,2379,6935,9314,95160,277400,372560
3/27/2024,Sujeewa Rajapaksha,Mannar,Mannar,Northern,8824,4475,13299,352960,179000,531960
3/28/2024,Sujeewa Rajapaksha,Mannar,Mannar,Northern,6147,9552,15699,245880,382080,627960
3/29/2024,Sujeewa Rajapaksha,Mannar,Mannar,Northern,6254,8251,14505,250160,330040,580200
3/30/2024,Sujeewa Rajapaksha,Mannar,Mannar,Northern,2950,2424,5374,118000,96960,214960
3/31/2024,Sujeewa Rajapaksha,Mannar,Mannar,Northern,9757,3963,13720,390280,158520,548800
4/1/2024,Sujeewa Rajapaksha,Mannar,Mannar,Northern,5181,7830,13011,207240,313200,520440
4/2/2024,Sujeewa Rajapaksha,Mannar,Mannar,Northern,6747,4038,10785,269880,161520,431400
4/3/2024,Sujeewa Rajapaksha,Mannar,Mannar,Northern,4699,9671,14370,187960,386840,574800
4/4/2024,Sujeewa Rajapaksha,Mannar,Mannar,Northern,6468,2033,8501,258720,81320,340040
4/5/2024,Sujeewa Rajapaksha,Mannar,Mannar,Northern,935,5605,6540,37400,224200,261600
4/6/2024,Sujeewa Rajapaksha,Mannar,Mannar,Northern,747,5447,6194,29880,217880,247760
4/7/2024,Sujeewa Rajapaksha,Mannar,Mannar,Northern,3572,5523,9095,142880,220920,363800
4/8/2024,Sujeewa Rajapaksha,Mannar,Mannar,Northern,1286,146,1432,51440,5840,57280
4/9/2024,Sujeewa Rajapaksha,Mannar,Mannar,Northern,3156,9000,12156,126240,360000,486240
4/10/2024,Sujeewa Rajapaksha,Mannar,Mannar,Northern,6160,217,6377,246400,8680,255080
4/11/2024,Sujeewa Rajapaksha,Mannar,Mannar,Northern,8771,928,9699,350840,37120,387960
4/19/2024,Sujeewa Rajapaksha,Mannar,Mannar,Northern,8787,8966,17753,351480,358640,710120
4/20/2024,Sujeewa Rajapaksha,Mannar,Mannar,Northern,795,3238,4033,31800,129520,161320
4/21/2024,Sujeewa Rajapaksha,Mannar,Mannar,Northern,1338,2347,3685,53520,93880,147400
4/22/2024,Sujeewa Rajapaksha,Mannar,Mannar,Northern,6729,8348,15077,269160,333920,603080
4/23/2024,Sujeewa Rajapaksha,Mannar,Mannar,Northern,8994,4838,13832,359760,193520,553280
4/24/2024,Sujeewa Rajapaksha,Mannar,Mannar,Northern,7082,8735,15817,283280,349400,632680
4/25/2024,Sujeewa Rajapaksha,Mannar,Mannar,Northern,5474,7050,12524,218960,282000,500960
4/26/2024,Sujeewa Rajapaksha,Mannar,Mannar,Northern,7446,6852,14298,297840,274080,571920
4/27/2024,Sujeewa Rajapaksha,Mannar,Mannar,Northern,1862,8311,10173,74480,332440,406920
4/28/2024,Sujeewa Rajapaksha,Mannar,Mannar,Northern,333,4828,5161,13320,193120,206440
4/29/2024,Sujeewa Rajapaksha,Mannar,Mannar,Northern,5568,4324,9892,222720,172960,395680
4/30/2024,Sujeewa Rajapaksha,Mannar,Mannar,Northern,5466,3745,9211,218640,149800,368440
5/1/2024,Sujeewa Rajapaksha,Mannar,Mannar,Northern,9842,8937,18779,393680,357480,751160
5/2/2024,Sujeewa Rajapaksha,Mannar,Mannar,Northern,8258,587,8845,330320,23480,353800
5/3/2024,Sujeewa Rajapaksha,Mannar,Mannar,Northern,8960,6113,15073,358400,244520,602920
5/4/2024,Sujeewa Rajapaksha,Mannar,Mannar,Northern,5980,5360,11340,239200,214400,453600
5/5/2024,Sujeewa Rajapaksha,Mannar,Mannar,Northern,4947,7952,12899,197880,318080,515960
5/6/2024,Sujeewa Rajapaksha,Mannar,Mannar,Northern,5755,3855,9610,230200,154200,384400
5/7/2024,Sujeewa Rajapaksha,Mannar,Mannar,Northern,4012,6311,10323,160480,252440,412920
5/8/2024,Sujeewa Rajapaksha,Mannar,Mannar,Northern,2224,1055,3279,88960,42200,131160
5/9/2024,Sujeewa Rajapaksha,Mannar,Mannar,Northern,5224,7381,12605,208960,295240,504200
5/10/2024,Sujeewa Rajapaksha,Mannar,Mannar,Northern,6869,3882,10751,274760,155280,430040
5/11/2024,Sujeewa Rajapaksha,Mannar,Mannar,Northern,2059,6948,9007,82360,277920,360280
5/12/2024,Sujeewa Rajapaksha,Mannar,Mannar,Northern,4528,5642,10170,181120,225680,406800
5/13/2024,Sujeewa Rajapaksha,Mannar,Mannar,Northern,8539,3592,12131,341560,143680,485240
5/14/2024,Sujeewa Rajapaksha,Mannar,Mannar,Northern,7638,8319,15957,305520,332760,638280
5/15/2024,Sujeewa Rajapaksha,Mannar,Mannar,Northern,1338,5055,6393,53520,202200,255720
5/16/2024,Sujeewa Rajapaksha,Mannar,Mannar,Northern,7121,4550,11671,284840,182000,466840
5/17/2024,Sujeewa Rajapaksha,Mannar,Mannar,Northern,6571,7694,14265,262840,307760,570600
5/18/2024,Sujeewa Rajapaksha,Mannar,Mannar,Northern,4610,8560,13170,184400,342400,526800
5/19/2024,Sujeewa Rajapaksha,Mannar,Mannar,Northern,996,1302,2298,39840,52080,91920
5/20/2024,Sujeewa Rajapaksha,Mannar,Mannar,Northern,7256,108,7364,290240,4320,294560
5/21/2024,Sujeewa Rajapaksha,Mannar,Mannar,Northern,6037,4989,11026,241480,199560,441040
5/22/2024,Sujeewa Rajapaksha,Mannar,Mannar,Northern,470,1180,1650,18800,47200,66000
5/24/2024,Sujeewa Rajapaksha,Mannar,Mannar,Northern,1250,6092,7342,50000,243680,293680
5/25/2024,Sujeewa Rajapaksha,Mannar,Mannar,Northern,4509,2588,7097,180360,103520,283880
5/26/2024,Sujeewa Rajapaksha,Mannar,Mannar,Northern,4162,3776,7938,166480,151040,317520
5/27/2024,Sujeewa Rajapaksha,Mannar,Mannar,Northern,328,5971,6299,13120,238840,251960
5/28/2024,Sujeewa Rajapaksha,Mannar,Mannar,Northern,5714,9023,14737,228560,360920,589480
5/29/2024,Sujeewa Rajapaksha,Mannar,Mannar,Northern,1294,1283,2577,51760,51320,103080
5/30/2024,Sujeewa Rajapaksha,Mannar,Mannar,Northern,2482,1696,4178,99280,67840,167120
5/31/2024,Sujeewa Rajapaksha,Mannar,Mannar,Northern,2521,2763,5284,100840,110520,211360
6/1/2024,Sujeewa Rajapaksha,Mannar,Mannar,Northern,5144,2638,7782,205760,105520,311280
6/2/2024,Sujeewa Rajapaksha,Mannar,Mannar,Northern,8329,8654,16983,333160,346160,679320
6/3/2024,Sujeewa Rajapaksha,Mannar,Mannar,Northern,5896,8754,14650,235840,350160,586000
6/4/2024,Sujeewa Rajapaksha,Mannar,Mannar,Northern,9879,3124,13003,395160,124960,520120
6/5/2024,Sujeewa Rajapaksha,Mannar,Mannar,Northern,223,1924,2147,8920,76960,85880
6/6/2024,Sujeewa Rajapaksha,Mannar,Mannar,Northern,5574,8338,13912,222960,333520,556480
6/7/2024,Sujeewa Rajapaksha,Mannar,Mannar,Northern,9331,2270,11601,373240,90800,464040
6/8/2024,Sujeewa Rajapaksha,Mannar,Mannar,Northern,5383,609,5992,215320,24360,239680
6/9/2024,Sujeewa Rajapaksha,Mannar,Mannar,Northern,6650,848,7498,266000,33920,299920
6/10/2024,Sujeewa Rajapaksha,Mannar,Mannar,Northern,5545,3914,9459,221800,156560,378360
6/11/2024,Sujeewa Rajapaksha,Mannar,Mannar,Northern,2420,6909,9329,96800,276360,373160
6/12/2024,Sujeewa Rajapaksha,Mannar,Mannar,Northern,3105,8159,11264,124200,326360,450560
6/13/2024,Sujeewa Rajapaksha,Mannar,Mannar,Northern,9555,7846,17401,382200,313840,696040
6/14/2024,Sujeewa Rajapaksha,Mannar,Mannar,Northern,4181,9210,13391,167240,368400,535640
6/15/2024,Sujeewa Rajapaksha,Mannar,Mannar,Northern,758,3246,4004,30320,129840,160160
6/16/2024,Sujeewa Rajapaksha,Mannar,Mannar,Northern,3768,5110,8878,150720,204400,355120
6/17/2024,Sujeewa Rajapaksha,Mannar,Mannar,Northern,6315,3950,10265,252600,158000,410600
6/18/2024,Sujeewa Rajapaksha,Mannar,Mannar,Northern,3592,5080,8672,143680,203200,346880
6/19/2024,Sujeewa Rajapaksha,Mannar,Mannar,Northern,8444,5035,13479,337760,201400,539160
6/20/2024,Sujeewa Rajapaksha,Mannar,Mannar,Northern,7820,730,8550,312800,29200,342000
6/21/2024,Sujeewa Rajapaksha,Mannar,Mannar,Northern,2761,8259,11020,110440,330360,440800
6/22/2024,Sujeewa Rajapaksha,Mannar,Mannar,Northern,1519,1968,3487,60760,78720,139480
6/23/2024,Sujeewa Rajapaksha,Mannar,Mannar,Northern,3331,8904,12235,133240,356160,489400
6/24/2024,Sujeewa Rajapaksha,Mannar,Mannar,Northern,9347,3118,12465,373880,124720,498600
6/25/2024,Sujeewa Rajapaksha,Mannar,Mannar,Northern,9530,750,10280,381200,30000,411200
6/26/2024,Sujeewa Rajapaksha,Mannar,Mannar,Northern,8880,3335,12215,355200,133400,488600
6/27/2024,Sujeewa Rajapaksha,Mannar,Mannar,Northern,5682,7140,12822,227280,285600,512880
6/28/2024,Sujeewa Rajapaksha,Mannar,Mannar,Northern,9332,480,9812,373280,19200,392480
6/29/2024,Sujeewa Rajapaksha,Mannar,Mannar,Northern,6998,8013,15011,279920,320520,600440
6/30/2024,Sujeewa Rajapaksha,Mannar,Mannar,Northern,9667,447,10114,386680,17880,404560
7/1/2024,Sujeewa Rajapaksha,Mannar,Mannar,Northern,3685,3052,6737,147400,122080,269480
7/2/2024,Sujeewa Rajapaksha,Mannar,Mannar,Northern,5190,9500,14690,207600,380000,587600
7/3/2024,Sujeewa Rajapaksha,Mannar,Mannar,Northern,709,6987,7696,28360,279480,307840
7/4/2024,Sujeewa Rajapaksha,Mannar,Mannar,Northern,3951,1537,5488,158040,61480,219520
7/5/2024,Sujeewa Rajapaksha,Mannar,Mannar,Northern,2635,811,3446,105400,32440,137840
7/6/2024,Sujeewa Rajapaksha,Mannar,Mannar,Northern,2142,6902,9044,85680,276080,361760
7/7/2024,Sujeewa Rajapaksha,Mannar,Mannar,Northern,9911,6060,15971,396440,242400,638840
7/8/2024,Sujeewa Rajapaksha,Mannar,Mannar,Northern,1940,8124,10064,77600,324960,402560
7/9/2024,Sujeewa Rajapaksha,Mannar,Mannar,Northern,6481,5568,12049,259240,222720,481960
7/10/2024,Sujeewa Rajapaksha,Mannar,Mannar,Northern,3804,1382,5186,152160,55280,207440
7/11/2024,Sujeewa Rajapaksha,Mannar,Mannar,Northern,5996,4743,10739,239840,189720,429560
7/12/2024,Sujeewa Rajapaksha,Mannar,Mannar,Northern,3083,7616,10699,123320,304640,427960
7/13/2024,Sujeewa Rajapaksha,Mannar,Mannar,Northern,155,2403,2558,6200,96120,102320
7/14/2024,Sujeewa Rajapaksha,Mannar,Mannar,Northern,3231,2248,5479,129240,89920,219160
7/15/2024,Sujeewa Rajapaksha,Mannar,Mannar,Northern,4239,1780,6019,169560,71200,240760
7/16/2024,Sujeewa Rajapaksha,Mannar,Mannar,Northern,4229,4836,9065,169160,193440,362600
7/17/2024,Sujeewa Rajapaksha,Mannar,Mannar,Northern,5917,7873,13790,236680,314920,551600
7/18/2024,Sujeewa Rajapaksha,Mannar,Mannar,Northern,2064,3119,5183,82560,124760,207320
7/19/2024,Sujeewa Rajapaksha,Mannar,Mannar,Northern,4815,6580,11395,192600,263200,455800
7/20/2024,Sujeewa Rajapaksha,Mannar,Mannar,Northern,585,1097,1682,23400,43880,67280
7/21/2024,Sujeewa Rajapaksha,Mannar,Mannar,Northern,663,3768,4431,26520,150720,177240
7/22/2024,Sujeewa Rajapaksha,Mannar,Mannar,Northern,854,4271,5125,34160,170840,205000
7/23/2024,Sujeewa Rajapaksha,Mannar,Mannar,Northern,5420,6814,12234,216800,272560,489360
7/24/2024,Sujeewa Rajapaksha,Mannar,Mannar,Northern,4068,439,4507,162720,17560,180280
7/25/2024,Sujeewa Rajapaksha,Mannar,Mannar,Northern,5698,5011,10709,227920,200440,428360
7/26/2024,Sujeewa Rajapaksha,Mannar,Mannar,Northern,3612,1393,5005,144480,55720,200200
7/27/2024,Sujeewa Rajapaksha,Mannar,Mannar,Northern,4587,6099,10686,183480,243960,427440
7/28/2024,Sujeewa Rajapaksha,Mannar,Mannar,Northern,3498,8648,12146,139920,345920,485840
7/29/2024,Sujeewa Rajapaksha,Mannar,Mannar,Northern,343,6455,6798,13720,258200,271920
7/30/2024,Sujeewa Rajapaksha,Mannar,Mannar,Northern,1312,2846,4158,52480,113840,166320
7/31/2024,Sujeewa Rajapaksha,Mannar,Mannar,Northern,7610,70,7680,304400,2800,307200
8/1/2024,Sujeewa Rajapaksha,Mannar,Mannar,Northern,2315,4454,6769,92600,178160,270760
8/2/2024,Sujeewa Rajapaksha,Mannar,Mannar,Northern,6564,4238,10802,262560,169520,432080
8/3/2024,Sujeewa Rajapaksha,Mannar,Mannar,Northern,8857,2484,11341,354280,99360,453640
8/4/2024,Sujeewa Rajapaksha,Mannar,Mannar,Northern,7588,6060,13648,303520,242400,545920
8/5/2024,Sujeewa Rajapaksha,Mannar,Mannar,Northern,581,959,1540,23240,38360,61600
8/6/2024,Sujeewa Rajapaksha,Mannar,Mannar,Northern,8799,1777,10576,351960,71080,423040
8/7/2024,Sujeewa Rajapaksha,Mannar,Mannar,Northern,4604,7588,12192,184160,303520,487680
8/8/2024,Sujeewa Rajapaksha,Mannar,Mannar,Northern,9110,1193,10303,364400,47720,412120
8/9/2024,Sujeewa Rajapaksha,Mannar,Mannar,Northern,2325,3218,5543,93000,128720,221720
8/10/2024,Sujeewa Rajapaksha,Mannar,Mannar,Northern,3109,8609,11718,124360,344360,468720
8/11/2024,Sujeewa Rajapaksha,Mannar,Mannar,Northern,7562,2668,10230,302480,106720,409200
8/12/2024,Sujeewa Rajapaksha,Mannar,Mannar,Northern,1850,9693,11543,74000,387720,461720
8/13/2024,Sujeewa Rajapaksha,Mannar,Mannar,Northern,548,8755,9303,21920,350200,372120
8/14/2024,Sujeewa Rajapaksha,Mannar,Mannar,Northern,5082,4901,9983,203280,196040,399320
8/15/2024,Sujeewa Rajapaksha,Mannar,Mannar,Northern,7594,8216,15810,303760,328640,632400
8/16/2024,Sujeewa Rajapaksha,Mannar,Mannar,Northern,6928,6080,13008,277120,243200,520320
8/17/2024,Sujeewa Rajapaksha,Mannar,Mannar,Northern,4171,554,4725,166840,22160,189000
8/18/2024,Sujeewa Rajapaksha,Mannar,Mannar,Northern,8983,2070,11053,359320,82800,442120
8/19/2024,Sujeewa Rajapaksha,Mannar,Mannar,Northern,9141,9920,19061,365640,396800,762440
8/20/2024,Sujeewa Rajapaksha,Mannar,Mannar,Northern,7543,8351,15894,301720,334040,635760
8/21/2024,Sujeewa Rajapaksha,Mannar,Mannar,Northern,9742,5075,14817,389680,203000,592680
8/22/2024,Sujeewa Rajapaksha,Mannar,Mannar,Northern,4369,2118,6487,174760,84720,259480
8/23/2024,Sujeewa Rajapaksha,Mannar,Mannar,Northern,9889,9559,19448,395560,382360,777920
8/24/2024,Sujeewa Rajapaksha,Mannar,Mannar,Northern,849,1387,2236,33960,55480,89440
8/25/2024,Sujeewa Rajapaksha,Mannar,Mannar,Northern,7786,5211,12997,311440,208440,519880
8/26/2024,Sujeewa Rajapaksha,Mannar,Mannar,Northern,5203,7690,12893,208120,307600,515720
8/27/2024,Sujeewa Rajapaksha,Mannar,Mannar,Northern,3424,7814,11238,136960,312560,449520
8/28/2024,Sujeewa Rajapaksha,Mannar,Mannar,Northern,4794,2714,7508,191760,108560,300320
8/29/2024,Sujeewa Rajapaksha,Mannar,Mannar,Northern,2247,3023,5270,89880,120920,210800
8/30/2024,Sujeewa Rajapaksha,Mannar,Mannar,Northern,5198,5674,10872,207920,226960,434880
8/31/2024,Sujeewa Rajapaksha,Mannar,Mannar,Northern,1344,5467,6811,53760,218680,272440
9/1/2024,Sujeewa Rajapaksha,Mannar,Mannar,Northern,6886,970,7856,275440,38800,314240
9/2/2024,Sujeewa Rajapaksha,Mannar,Mannar,Northern,6906,7097,14003,276240,283880,560120
9/3/2024,Sujeewa Rajapaksha,Mannar,Mannar,Northern,1371,4907,6278,54840,196280,251120
9/4/2024,Sujeewa Rajapaksha,Mannar,Mannar,Northern,6138,3560,9698,245520,142400,387920
9/5/2024,Sujeewa Rajapaksha,Mannar,Mannar,Northern,570,320,890,22800,12800,35600
9/6/2024,Sujeewa Rajapaksha,Mannar,Mannar,Northern,7583,3954,11537,303320,158160,461480
9/7/2024,Sujeewa Rajapaksha,Mannar,Mannar,Northern,7046,626,7672,281840,25040,306880
9/8/2024,Sujeewa Rajapaksha,Mannar,Mannar,Northern,2011,9028,11039,80440,361120,441560
9/9/2024,Sujeewa Rajapaksha,Mannar,Mannar,Northern,8786,5320,14106,351440,212800,564240
9/10/2024,Sujeewa Rajapaksha,Mannar,Mannar,Northern,3710,8290,12000,148400,331600,480000
9/11/2024,Sujeewa Rajapaksha,Mannar,Mannar,Northern,5992,5591,11583,239680,223640,463320
9/12/2024,Sujeewa Rajapaksha,Mannar,Mannar,Northern,3839,8680,12519,153560,347200,500760
9/13/2024,Sujeewa Rajapaksha,Mannar,Mannar,Northern,4860,6420,11280,194400,256800,451200
9/14/2024,Sujeewa Rajapaksha,Mannar,Mannar,Northern,6382,7512,13894,255280,300480,555760
9/15/2024,Sujeewa Rajapaksha,Mannar,Mannar,Northern,7060,6663,13723,282400,266520,548920
9/16/2024,Sujeewa Rajapaksha,Mannar,Mannar,Northern,8231,8031,16262,329240,321240,650480
9/17/2024,Sujeewa Rajapaksha,Mannar,Mannar,Northern,8434,109,8543,337360,4360,341720
9/18/2024,Sujeewa Rajapaksha,Mannar,Mannar,Northern,7784,5410,13194,311360,216400,527760
9/19/2024,Sujeewa Rajapaksha,Mannar,Mannar,Northern,5887,5637,11524,235480,225480,460960
9/20/2024,Sujeewa Rajapaksha,Mannar,Mannar,Northern,7740,4435,12175,309600,177400,487000
9/21/2024,Sujeewa Rajapaksha,Mannar,Mannar,Northern,9701,2640,12341,388040,105600,493640
9/22/2024,Sujeewa Rajapaksha,Mannar,Mannar,Northern,6346,4937,11283,253840,197480,451320
9/23/2024,Sujeewa Rajapaksha,Mannar,Mannar,Northern,7518,6748,14266,300720,269920,570640
9/24/2024,Sujeewa Rajapaksha,Mannar,Mannar,Northern,1368,7072,8440,54720,282880,337600
9/25/2024,Sujeewa Rajapaksha,Mannar,Mannar,Northern,2550,8039,10589,102000,321560,423560
9/26/2024,Sujeewa Rajapaksha,Mannar,Mannar,Northern,4080,7594,11674,163200,303760,466960
9/27/2024,Sujeewa Rajapaksha,Mannar,Mannar,Northern,9395,939,10334,375800,37560,413360
9/28/2024,Sujeewa Rajapaksha,Mannar,Mannar,Northern,140,4720,4860,5600,188800,194400
9/29/2024,Sujeewa Rajapaksha,Mannar,Mannar,Northern,2314,5426,7740,92560,217040,309600
9/30/2024,Sujeewa Rajapaksha,Mannar,Mannar,Northern,7387,851,8238,295480,34040,329520
10/1/2024,Sujeewa Rajapaksha,Mannar,Mannar,Northern,7719,1919,9638,308760,76760,385520
10/2/2024,Sujeewa Rajapaksha,Mannar,Mannar,Northern,7883,707,8590,315320,28280,343600
10/3/2024,Sujeewa Rajapaksha,Mannar,Mannar,Northern,197,5987,6184,7880,239480,247360
10/4/2024,Sujeewa Rajapaksha,Mannar,Mannar,Northern,6825,4217,11042,273000,168680,441680
10/5/2024,Sujeewa Rajapaksha,Mannar,Mannar,Northern,2529,2322,4851,101160,92880,194040
10/6/2024,Sujeewa Rajapaksha,Mannar,Mannar,Northern,3861,7859,11720,154440,314360,468800
10/7/2024,Sujeewa Rajapaksha,Mannar,Mannar,Northern,8743,9531,18274,349720,381240,730960
10/8/2024,Sujeewa Rajapaksha,Mannar,Mannar,Northern,2678,8730,11408,107120,349200,456320
10/9/2024,Sujeewa Rajapaksha,Mannar,Mannar,Northern,5500,4723,10223,220000,188920,408920
10/10/2024,Sujeewa Rajapaksha,Mannar,Mannar,Northern,9151,5867,15018,366040,234680,600720
10/11/2024,Sujeewa Rajapaksha,Mannar,Mannar,Northern,8942,1770,10712,357680,70800,428480
10/12/2024,Sujeewa Rajapaksha,Mannar,Mannar,Northern,7446,8115,15561,297840,324600,622440
10/13/2024,Sujeewa Rajapaksha,Mannar,Mannar,Northern,347,4434,4781,13880,177360,191240
10/14/2024,Sujeewa Rajapaksha,Mannar,Mannar,Northern,9377,5869,15246,375080,234760,609840
10/15/2024,Sujeewa Rajapaksha,Mannar,Mannar,Northern,4968,6496,11464,198720,259840,458560
10/16/2024,Sujeewa Rajapaksha,Mannar,Mannar,Northern,4193,4641,8834,167720,185640,353360
10/17/2024,Sujeewa Rajapaksha,Mannar,Mannar,Northern,6825,7094,13919,273000,283760,556760
10/18/2024,Sujeewa Rajapaksha,Mannar,Mannar,Northern,4449,3523,7972,177960,140920,318880
10/19/2024,Sujeewa Rajapaksha,Mannar,Mannar,Northern,1496,2574,4070,59840,102960,162800
10/20/2024,Sujeewa Rajapaksha,Mannar,Mannar,Northern,5105,6544,11649,204200,261760,465960
10/21/2024,Sujeewa Rajapaksha,Mannar,Mannar,Northern,4039,9217,13256,161560,368680,530240
10/22/2024,Sujeewa Rajapaksha,Mannar,Mannar,Northern,1555,8288,9843,62200,331520,393720
10/23/2024,Sujeewa Rajapaksha,Mannar,Mannar,Northern,7516,965,8481,300640,38600,339240
10/24/2024,Sujeewa Rajapaksha,Mannar,Mannar,Northern,8978,1577,10555,359120,63080,422200
10/25/2024,Sujeewa Rajapaksha,Mannar,Mannar,Northern,7991,7124,15115,319640,284960,604600
10/26/2024,Sujeewa Rajapaksha,Mannar,Mannar,Northern,7080,4495,11575,283200,179800,463000
10/27/2024,Sujeewa Rajapaksha,Mannar,Mannar,Northern,5938,6686,12624,237520,267440,504960
10/28/2024,Sujeewa Rajapaksha,Mannar,Mannar,Northern,7431,6048,13479,297240,241920,539160
10/29/2024,Sujeewa Rajapaksha,Mannar,Mannar,Northern,790,8902,9692,31600,356080,387680
10/30/2024,Sujeewa Rajapaksha,Mannar,Mannar,Northern,2700,8341,11041,108000,333640,441640
10/31/2024,Sujeewa Rajapaksha,Mannar,Mannar,Northern,1410,2899,4309,56400,115960,172360
11/1/2024,Sujeewa Rajapaksha,Mannar,Mannar,Northern,8532,1156,9688,341280,46240,387520
11/2/2024,Sujeewa Rajapaksha,Mannar,Mannar,Northern,6817,1445,8262,272680,57800,330480
11/3/2024,Sujeewa Rajapaksha,Mannar,Mannar,Northern,3689,6897,10586,147560,275880,423440
11/4/2024,Sujeewa Rajapaksha,Mannar,Mannar,Northern,257,5858,6115,10280,234320,244600
11/5/2024,Sujeewa Rajapaksha,Mannar,Mannar,Northern,2661,4817,7478,106440,192680,299120
11/6/2024,Sujeewa Rajapaksha,Mannar,Mannar,Northern,6125,8961,15086,245000,358440,603440
11/7/2024,Sujeewa Rajapaksha,Mannar,Mannar,Northern,2292,1914,4206,91680,76560,168240
11/8/2024,Sujeewa Rajapaksha,Mannar,Mannar,Northern,2355,1566,3921,94200,62640,156840
11/9/2024,Sujeewa Rajapaksha,Mannar,Mannar,Northern,1494,1644,3138,59760,65760,125520
11/10/2024,Sujeewa Rajapaksha,Mannar,Mannar,Northern,6918,2883,9801,276720,115320,392040
11/11/2024,Sujeewa Rajapaksha,Mannar,Mannar,Northern,1383,5857,7240,55320,234280,289600
11/12/2024,Sujeewa Rajapaksha,Mannar,Mannar,Northern,6707,3867,10574,268280,154680,422960
11/13/2024,Sujeewa Rajapaksha,Mannar,Mannar,Northern,3687,3496,7183,147480,139840,287320
11/14/2024,Sujeewa Rajapaksha,Mannar,Mannar,Northern,8137,6740,14877,325480,269600,595080
11/15/2024,Sujeewa Rajapaksha,Mannar,Mannar,Northern,2929,9484,12413,117160,379360,496520
11/16/2024,Sujeewa Rajapaksha,Mannar,Mannar,Northern,9089,6992,16081,363560,279680,643240
11/17/2024,Sujeewa Rajapaksha,Mannar,Mannar,Northern,9391,9701,19092,375640,388040,763680
11/18/2024,Sujeewa Rajapaksha,Mannar,Mannar,Northern,1848,6123,7971,73920,244920,318840
11/19/2024,Sujeewa Rajapaksha,Mannar,Mannar,Northern,8108,7140,15248,324320,285600,609920
11/20/2024,Sujeewa Rajapaksha,Mannar,Mannar,Northern,3708,6336,10044,148320,253440,401760
11/21/2024,Sujeewa Rajapaksha,Mannar,Mannar,Northern,6419,9279,15698,256760,371160,627920
11/22/2024,Sujeewa Rajapaksha,Mannar,Mannar,Northern,7492,5163,12655,299680,206520,506200
11/23/2024,Sujeewa Rajapaksha,Mannar,Mannar,Northern,4736,359,5095,189440,14360,203800
11/24/2024,Sujeewa Rajapaksha,Mannar,Mannar,Northern,301,5402,5703,12040,216080,228120
11/25/2024,Sujeewa Rajapaksha,Mannar,Mannar,Northern,8336,7998,16334,333440,319920,653360
11/26/2024,Sujeewa Rajapaksha,Mannar,Mannar,Northern,9028,3717,12745,361120,148680,509800
11/27/2024,Sujeewa Rajapaksha,Mannar,Mannar,Northern,2763,8683,11446,110520,347320,457840
11/28/2024,Sujeewa Rajapaksha,Mannar,Mannar,Northern,3378,9916,13294,135120,396640,531760
11/29/2024,Sujeewa Rajapaksha,Mannar,Mannar,Northern,8244,9463,17707,329760,378520,708280
11/30/2024,Sujeewa Rajapaksha,Mannar,Mannar,Northern,6764,7112,13876,270560,284480,555040
12/1/2024,Sujeewa Rajapaksha,Mannar,Mannar,Northern,9853,8477,18330,394120,339080,733200
12/2/2024,Sujeewa Rajapaksha,Mannar,Mannar,Northern,3236,4911,8147,129440,196440,325880
12/3/2024,Sujeewa Rajapaksha,Mannar,Mannar,Northern,3708,426,4134,148320,17040,165360
12/4/2024,Sujeewa Rajapaksha,Mannar,Mannar,Northern,2065,6766,8831,82600,270640,353240
12/5/2024,Sujeewa Rajapaksha,Mannar,Mannar,Northern,8576,106,8682,343040,4240,347280
12/6/2024,Sujeewa Rajapaksha,Mannar,Mannar,Northern,4079,1247,5326,163160,49880,213040
12/7/2024,Sujeewa Rajapaksha,Mannar,Mannar,Northern,9422,4975,14397,376880,199000,575880
12/8/2024,Sujeewa Rajapaksha,Mannar,Mannar,Northern,543,4860,5403,21720,194400,216120
12/9/2024,Sujeewa Rajapaksha,Mannar,Mannar,Northern,5578,2892,8470,223120,115680,338800
12/10/2024,Sujeewa Rajapaksha,Mannar,Mannar,Northern,745,6976,7721,29800,279040,308840
12/11/2024,Sujeewa Rajapaksha,Mannar,Mannar,Northern,7513,6309,13822,300520,252360,552880
12/12/2024,Sujeewa Rajapaksha,Mannar,Mannar,Northern,9946,1238,11184,397840,49520,447360
12/13/2024,Sujeewa Rajapaksha,Mannar,Mannar,Northern,5658,9446,15104,226320,377840,604160
12/14/2024,Sujeewa Rajapaksha,Mannar,Mannar,Northern,1011,6061,7072,40440,242440,282880
12/15/2024,Sujeewa Rajapaksha,Mannar,Mannar,Northern,694,5095,5789,27760,203800,231560
12/16/2024,Sujeewa Rajapaksha,Mannar,Mannar,Northern,6159,2605,8764,246360,104200,350560
12/17/2024,Sujeewa Rajapaksha,Mannar,Mannar,Northern,8473,5782,14255,338920,231280,570200
12/18/2024,Sujeewa Rajapaksha,Mannar,Mannar,Northern,502,7971,8473,20080,318840,338920
12/19/2024,Sujeewa Rajapaksha,Mannar,Mannar,Northern,9048,9129,18177,361920,365160,727080
12/20/2024,Sujeewa Rajapaksha,Mannar,Mannar,Northern,7195,592,7787,287800,23680,311480
12/21/2024,Sujeewa Rajapaksha,Mannar,Mannar,Northern,8615,3747,12362,344600,149880,494480
12/22/2024,Sujeewa Rajapaksha,Mannar,Mannar,Northern,4588,9481,14069,183520,379240,562760
12/23/2024,Sujeewa Rajapaksha,Mannar,Mannar,Northern,5929,4375,10304,237160,175000,412160
12/24/2024,Sujeewa Rajapaksha,Mannar,Mannar,Northern,2474,1103,3577,98960,44120,143080
12/25/2024,Sujeewa Rajapaksha,Mannar,Mannar,Northern,3771,9011,12782,150840,360440,511280
12/26/2024,Sujeewa Rajapaksha,Mannar,Mannar,Northern,9109,8542,17651,364360,341680,706040
12/27/2024,Sujeewa Rajapaksha,Mannar,Mannar,Northern,2191,6833,9024,87640,273320,360960
12/28/2024,Sujeewa Rajapaksha,Mannar,Mannar,Northern,5007,7289,12296,200280,291560,491840
12/29/2024,Sujeewa Rajapaksha,Mannar,Mannar,Northern,8150,2736,10886,326000,109440,435440
12/30/2024,Sujeewa Rajapaksha,Mannar,Mannar,Northern,2505,6457,8962,100200,258280,358480
12/31/2024,Sujeewa Rajapaksha,Mannar,Mannar,Northern,2939,148,3087,117560,5920,123480
1/1/2025,Sujeewa Rajapaksha,Mannar,Mannar,Northern,4241,6974,11215,169640,278960,448600
1/2/2025,Sujeewa Rajapaksha,Mannar,Mannar,Northern,5336,888,6224,213440,35520,248960
1/3/2025,Sujeewa Rajapaksha,Mannar,Mannar,Northern,2285,5203,7488,91400,208120,299520
1/4/2025,Sujeewa Rajapaksha,Mannar,Mannar,Northern,424,595,1019,16960,23800,40760
1/5/2025,Sujeewa Rajapaksha,Mannar,Mannar,Northern,5770,9860,15630,230800,394400,625200
1/6/2025,Sujeewa Rajapaksha,Mannar,Mannar,Northern,7470,8177,15647,298800,327080,625880
1/7/2025,Sujeewa Rajapaksha,Mannar,Mannar,Northern,6363,7735,14098,254520,309400,563920
1/8/2025,Sujeewa Rajapaksha,Mannar,Mannar,Northern,7283,340,7623,291320,13600,304920
1/9/2025,Sujeewa Rajapaksha,Mannar,Mannar,Northern,2736,1973,4709,109440,78920,188360
1/10/2025,Sujeewa Rajapaksha,Mannar,Mannar,Northern,7895,1352,9247,315800,54080,369880
1/11/2025,Sujeewa Rajapaksha,Mannar,Mannar,Northern,2825,7701,10526,113000,308040,421040
1/12/2025,Sujeewa Rajapaksha,Mannar,Mannar,Northern,5193,2692,7885,207720,107680,315400
1/13/2025,Sujeewa Rajapaksha,Mannar,Mannar,Northern,4918,7837,12755,196720,313480,510200
1/14/2025,Sujeewa Rajapaksha,Mannar,Mannar,Northern,4195,4272,8467,167800,170880,338680
1/15/2025,Sujeewa Rajapaksha,Mannar,Mannar,Northern,2384,9515,11899,95360,380600,475960
1/16/2025,Sujeewa Rajapaksha,Mannar,Mannar,Northern,1950,8133,10083,78000,325320,403320
1/17/2025,Sujeewa Rajapaksha,Mannar,Mannar,Northern,3427,2477,5904,137080,99080,236160
1/18/2025,Sujeewa Rajapaksha,Mannar,Mannar,Northern,1933,8860,10793,77320,354400,431720
1/19/2025,Sujeewa Rajapaksha,Mannar,Mannar,Northern,3305,9924,13229,132200,396960,529160
1/20/2025,Sujeewa Rajapaksha,Mannar,Mannar,Northern,7733,1278,9011,309320,51120,360440
1/21/2025,Sujeewa Rajapaksha,Mannar,Mannar,Northern,5167,9001,14168,206680,360040,566720
1/22/2025,Sujeewa Rajapaksha,Mannar,Mannar,Northern,3228,6919,10147,129120,276760,405880
1/23/2025,Sujeewa Rajapaksha,Mannar,Mannar,Northern,6450,9387,15837,258000,375480,633480
1/24/2025,Sujeewa Rajapaksha,Mannar,Mannar,Northern,6328,3605,9933,253120,144200,397320
1/25/2025,Sujeewa Rajapaksha,Mannar,Mannar,Northern,4786,7416,12202,191440,296640,488080
1/26/2025,Sujeewa Rajapaksha,Mannar,Mannar,Northern,9748,7964,17712,389920,318560,708480
1/27/2025,Sujeewa Rajapaksha,Mannar,Mannar,Northern,1194,1392,2586,47760,55680,103440
1/28/2025,Sujeewa Rajapaksha,Mannar,Mannar,Northern,2608,7672,10280,104320,306880,411200
1/29/2025,Sujeewa Rajapaksha,Mannar,Mannar,Northern,8948,683,9631,357920,27320,385240
1/30/2025,Sujeewa Rajapaksha,Mannar,Mannar,Northern,4351,4454,8805,174040,178160,352200
1/31/2025,Sujeewa Rajapaksha,Mannar,Mannar,Northern,9897,942,10839,395880,37680,433560
2/1/2025,Sujeewa Rajapaksha,Mannar,Mannar,Northern,8449,382,8831,337960,15280,353240
2/2/2025,Sujeewa Rajapaksha,Mannar,Mannar,Northern,9652,3548,13200,386080,141920,528000
2/3/2025,Sujeewa Rajapaksha,Mannar,Mannar,Northern,4851,641,5492,194040,25640,219680
2/4/2025,Sujeewa Rajapaksha,Mannar,Mannar,Northern,2524,3607,6131,100960,144280,245240
2/5/2025,Sujeewa Rajapaksha,Mannar,Mannar,Northern,5587,5681,11268,223480,227240,450720
2/6/2025,Sujeewa Rajapaksha,Mannar,Mannar,Northern,1667,822,2489,66680,32880,99560
2/7/2025,Sujeewa Rajapaksha,Mannar,Mannar,Northern,2574,1911,4485,102960,76440,179400
2/8/2025,Sujeewa Rajapaksha,Mannar,Mannar,Northern,8614,6705,15319,344560,268200,612760
2/9/2025,Sujeewa Rajapaksha,Mannar,Mannar,Northern,5743,2929,8672,229720,117160,346880
2/10/2025,Sujeewa Rajapaksha,Mannar,Mannar,Northern,3816,7552,11368,152640,302080,454720
2/11/2025,Sujeewa Rajapaksha,Mannar,Mannar,Northern,2912,8613,11525,116480,344520,461000
2/12/2025,Sujeewa Rajapaksha,Mannar,Mannar,Northern,9064,9842,18906,362560,393680,756240
2/13/2025,Sujeewa Rajapaksha,Mannar,Mannar,Northern,8600,7967,16567,344000,318680,662680
2/14/2025,Sujeewa Rajapaksha,Mannar,Mannar,Northern,9347,2381,11728,373880,95240,469120
2/15/2025,Sujeewa Rajapaksha,Mannar,Mannar,Northern,4318,5658,9976,172720,226320,399040
2/16/2025,Sujeewa Rajapaksha,Mannar,Mannar,Northern,9995,7006,17001,399800,280240,680040
2/17/2025,Sujeewa Rajapaksha,Mannar,Mannar,Northern,7693,1947,9640,307720,77880,385600
2/18/2025,Sujeewa Rajapaksha,Mannar,Mannar,Northern,1303,6356,7659,52120,254240,306360
2/19/2025,Sujeewa Rajapaksha,Mannar,Mannar,Northern,5174,3626,8800,206960,145040,352000
2/20/2025,Sujeewa Rajapaksha,Mannar,Mannar,Northern,7941,8636,16577,317640,345440,663080
2/21/2025,Sujeewa Rajapaksha,Mannar,Mannar,Northern,4553,8759,13312,182120,350360,532480
2/22/2025,Sujeewa Rajapaksha,Mannar,Mannar,Northern,2396,7372,9768,95840,294880,390720
2/23/2025,Sujeewa Rajapaksha,Mannar,Mannar,Northern,7638,7345,14983,305520,293800,599320
2/24/2025,Sujeewa Rajapaksha,Mannar,Mannar,Northern,4805,8600,13405,192200,344000,536200
2/25/2025,Sujeewa Rajapaksha,Mannar,Mannar,Northern,9948,3079,13027,397920,123160,521080
2/26/2025,Sujeewa Rajapaksha,Mannar,Mannar,Northern,8415,6378,14793,336600,255120,591720
2/27/2025,Sujeewa Rajapaksha,Mannar,Mannar,Northern,8747,7313,16060,349880,292520,642400
2/28/2025,Sujeewa Rajapaksha,Mannar,Mannar,Northern,3870,160,4030,154800,6400,161200
3/1/2025,Sujeewa Rajapaksha,Mannar,Mannar,Northern,8750,5780,14530,350000,231200,581200
3/2/2025,Sujeewa Rajapaksha,Mannar,Mannar,Northern,3016,2769,5785,120640,110760,231400
3/3/2025,Sujeewa Rajapaksha,Mannar,Mannar,Northern,3081,7503,10584,123240,300120,423360
3/4/2025,Sujeewa Rajapaksha,Mannar,Mannar,Northern,8087,9197,17284,323480,367880,691360
3/5/2025,Sujeewa Rajapaksha,Mannar,Mannar,Northern,9676,8935,18611,387040,357400,744440
3/6/2025,Sujeewa Rajapaksha,Mannar,Mannar,Northern,9834,5993,15827,393360,239720,633080
3/7/2025,Sujeewa Rajapaksha,Mannar,Mannar,Northern,2381,5143,7524,95240,205720,300960
3/8/2025,Sujeewa Rajapaksha,Mannar,Mannar,Northern,3198,8531,11729,127920,341240,469160
3/9/2025,Sujeewa Rajapaksha,Mannar,Mannar,Northern,4244,1182,5426,169760,47280,217040
3/10/2025,Sujeewa Rajapaksha,Mannar,Mannar,Northern,231,1040,1271,9240,41600,50840
3/11/2025,Sujeewa Rajapaksha,Mannar,Mannar,Northern,3769,2126,5895,150760,85040,235800
3/12/2025,Sujeewa Rajapaksha,Mannar,Mannar,Northern,5453,55,5508,218120,2200,220320
3/13/2025,Sujeewa Rajapaksha,Mannar,Mannar,Northern,9247,9434,18681,369880,377360,747240
3/14/2025,Sujeewa Rajapaksha,Mannar,Mannar,Northern,3962,9707,13669,158480,388280,546760
3/15/2025,Sujeewa Rajapaksha,Mannar,Mannar,Northern,7425,1500,8925,297000,60000,357000
3/16/2025,Sujeewa Rajapaksha,Mannar,Mannar,Northern,1197,2296,3493,47880,91840,139720
3/17/2025,Sujeewa Rajapaksha,Mannar,Mannar,Northern,9822,9419,19241,392880,376760,769640
3/18/2025,Sujeewa Rajapaksha,Mannar,Mannar,Northern,8507,2582,11089,340280,103280,443560
3/19/2025,Sujeewa Rajapaksha,Mannar,Mannar,Northern,9591,3313,12904,383640,132520,516160
3/20/2025,Sujeewa Rajapaksha,Mannar,Mannar,Northern,1532,6632,8164,61280,265280,326560
3/21/2025,Sujeewa Rajapaksha,Mannar,Mannar,Northern,33,3331,3364,1320,133240,134560
3/22/2025,Sujeewa Rajapaksha,Mannar,Mannar,Northern,6757,1557,8314,270280,62280,332560
3/23/2025,Sujeewa Rajapaksha,Mannar,Mannar,Northern,3639,7207,10846,145560,288280,433840
3/25/2024,Prasanna Kumara,Puttalam,Kalpitiya,North Western,9999,1050,11049,399960,42000,441960
3/26/2024,Prasanna Kumara,Puttalam,Kalpitiya,North Western,2493,1076,3569,99720,43040,142760
3/27/2024,Prasanna Kumara,Puttalam,Kalpitiya,North Western,7475,977,8452,299000,39080,338080
3/28/2024,Prasanna Kumara,Puttalam,Kalpitiya,North Western,4639,2262,6901,185560,90480,276040
3/29/2024,Prasanna Kumara,Puttalam,Kalpitiya,North Western,6958,4377,11335,278320,175080,453400
3/30/2024,Prasanna Kumara,Puttalam,Kalpitiya,North Western,7303,5784,13087,292120,231360,523480
3/31/2024,Prasanna Kumara,Puttalam,Kalpitiya,North Western,8777,317,9094,351080,12680,363760
4/1/2024,Prasanna Kumara,Puttalam,Kalpitiya,North Western,8292,4774,13066,331680,190960,522640
4/2/2024,Prasanna Kumara,Puttalam,Kalpitiya,North Western,3650,3681,7331,146000,147240,293240
4/3/2024,Prasanna Kumara,Puttalam,Kalpitiya,North Western,5875,301,6176,235000,12040,247040
4/4/2024,Prasanna Kumara,Puttalam,Kalpitiya,North Western,3290,9169,12459,131600,366760,498360
4/5/2024,Prasanna Kumara,Puttalam,Kalpitiya,North Western,9809,1034,10843,392360,41360,433720
4/6/2024,Prasanna Kumara,Puttalam,Kalpitiya,North Western,9901,5934,15835,396040,237360,633400
4/7/2024,Prasanna Kumara,Puttalam,Kalpitiya,North Western,6137,3902,10039,245480,156080,401560
4/8/2024,Prasanna Kumara,Puttalam,Kalpitiya,North Western,4225,6448,10673,169000,257920,426920
4/9/2024,Prasanna Kumara,Puttalam,Kalpitiya,North Western,7374,6583,13957,294960,263320,558280
4/10/2024,Prasanna Kumara,Puttalam,Kalpitiya,North Western,4474,2311,6785,178960,92440,271400
4/11/2024,Prasanna Kumara,Puttalam,Kalpitiya,North Western,759,2480,3239,30360,99200,129560
4/19/2024,Prasanna Kumara,Puttalam,Kalpitiya,North Western,2371,556,2927,94840,22240,117080
4/20/2024,Prasanna Kumara,Puttalam,Kalpitiya,North Western,5356,8753,14109,214240,350120,564360
4/21/2024,Prasanna Kumara,Puttalam,Kalpitiya,North Western,2758,5243,8001,110320,209720,320040
4/22/2024,Prasanna Kumara,Puttalam,Kalpitiya,North Western,9327,5073,14400,373080,202920,576000
4/23/2024,Prasanna Kumara,Puttalam,Kalpitiya,North Western,3890,8929,12819,155600,357160,512760
4/24/2024,Prasanna Kumara,Puttalam,Kalpitiya,North Western,9356,4377,13733,374240,175080,549320
4/25/2024,Prasanna Kumara,Puttalam,Kalpitiya,North Western,3791,7023,10814,151640,280920,432560
4/26/2024,Prasanna Kumara,Puttalam,Kalpitiya,North Western,4214,5188,9402,168560,207520,376080
4/27/2024,Prasanna Kumara,Puttalam,Kalpitiya,North Western,8167,8881,17048,326680,355240,681920
4/28/2024,Prasanna Kumara,Puttalam,Kalpitiya,North Western,4180,961,5141,167200,38440,205640
4/29/2024,Prasanna Kumara,Puttalam,Kalpitiya,North Western,1490,299,1789,59600,11960,71560
4/30/2024,Prasanna Kumara,Puttalam,Kalpitiya,North Western,8793,6992,15785,351720,279680,631400
5/1/2024,Prasanna Kumara,Puttalam,Kalpitiya,North Western,6767,8580,15347,270680,343200,613880
5/2/2024,Prasanna Kumara,Puttalam,Kalpitiya,North Western,7321,5439,12760,292840,217560,510400
5/3/2024,Prasanna Kumara,Puttalam,Kalpitiya,North Western,4450,4232,8682,178000,169280,347280
5/4/2024,Prasanna Kumara,Puttalam,Kalpitiya,North Western,3398,8467,11865,135920,338680,474600
5/5/2024,Prasanna Kumara,Puttalam,Kalpitiya,North Western,3517,2044,5561,140680,81760,222440
5/6/2024,Prasanna Kumara,Puttalam,Kalpitiya,North Western,2560,8802,11362,102400,352080,454480
5/7/2024,Prasanna Kumara,Puttalam,Kalpitiya,North Western,7443,1288,8731,297720,51520,349240
5/8/2024,Prasanna Kumara,Puttalam,Kalpitiya,North Western,5311,4137,9448,212440,165480,377920
5/9/2024,Prasanna Kumara,Puttalam,Kalpitiya,North Western,4094,9054,13148,163760,362160,525920
5/10/2024,Prasanna Kumara,Puttalam,Kalpitiya,North Western,4607,7076,11683,184280,283040,467320
5/11/2024,Prasanna Kumara,Puttalam,Kalpitiya,North Western,9653,9297,18950,386120,371880,758000
5/12/2024,Prasanna Kumara,Puttalam,Kalpitiya,North Western,5811,7242,13053,232440,289680,522120
5/13/2024,Prasanna Kumara,Puttalam,Kalpitiya,North Western,2988,2920,5908,119520,116800,236320
5/14/2024,Prasanna Kumara,Puttalam,Kalpitiya,North Western,5373,9251,14624,214920,370040,584960
5/15/2024,Prasanna Kumara,Puttalam,Kalpitiya,North Western,8004,5126,13130,320160,205040,525200
5/16/2024,Prasanna Kumara,Puttalam,Kalpitiya,North Western,3042,1070,4112,121680,42800,164480
5/17/2024,Prasanna Kumara,Puttalam,Kalpitiya,North Western,7972,7541,15513,318880,301640,620520
5/18/2024,Prasanna Kumara,Puttalam,Kalpitiya,North Western,9661,6676,16337,386440,267040,653480
5/19/2024,Prasanna Kumara,Puttalam,Kalpitiya,North Western,1608,900,2508,64320,36000,100320
5/20/2024,Prasanna Kumara,Puttalam,Kalpitiya,North Western,9065,2773,11838,362600,110920,473520
5/21/2024,Prasanna Kumara,Puttalam,Kalpitiya,North Western,4624,3261,7885,184960,130440,315400
5/22/2024,Prasanna Kumara,Puttalam,Kalpitiya,North Western,6816,2475,9291,272640,99000,371640
5/24/2024,Prasanna Kumara,Puttalam,Kalpitiya,North Western,4571,9139,13710,182840,365560,548400
5/25/2024,Prasanna Kumara,Puttalam,Kalpitiya,North Western,981,9070,10051,39240,362800,402040
5/26/2024,Prasanna Kumara,Puttalam,Kalpitiya,North Western,7600,7505,15105,304000,300200,604200
5/27/2024,Prasanna Kumara,Puttalam,Kalpitiya,North Western,6646,4319,10965,265840,172760,438600
5/28/2024,Prasanna Kumara,Puttalam,Kalpitiya,North Western,9632,774,10406,385280,30960,416240
5/29/2024,Prasanna Kumara,Puttalam,Kalpitiya,North Western,2248,9672,11920,89920,386880,476800
5/30/2024,Prasanna Kumara,Puttalam,Kalpitiya,North Western,9122,8714,17836,364880,348560,713440
5/31/2024,Prasanna Kumara,Puttalam,Kalpitiya,North Western,9675,337,10012,387000,13480,400480
6/1/2024,Prasanna Kumara,Puttalam,Kalpitiya,North Western,5960,7581,13541,238400,303240,541640
6/2/2024,Prasanna Kumara,Puttalam,Kalpitiya,North Western,9594,4314,13908,383760,172560,556320
6/3/2024,Prasanna Kumara,Puttalam,Kalpitiya,North Western,1609,8770,10379,64360,350800,415160
6/4/2024,Prasanna Kumara,Puttalam,Kalpitiya,North Western,9457,5123,14580,378280,204920,583200
6/5/2024,Prasanna Kumara,Puttalam,Kalpitiya,North Western,8782,8265,17047,351280,330600,681880
6/6/2024,Prasanna Kumara,Puttalam,Kalpitiya,North Western,2671,4873,7544,106840,194920,301760
6/7/2024,Prasanna Kumara,Puttalam,Kalpitiya,North Western,8017,6836,14853,320680,273440,594120
6/8/2024,Prasanna Kumara,Puttalam,Kalpitiya,North Western,1868,3065,4933,74720,122600,197320
6/9/2024,Prasanna Kumara,Puttalam,Kalpitiya,North Western,7811,2865,10676,312440,114600,427040
6/10/2024,Prasanna Kumara,Puttalam,Kalpitiya,North Western,106,7193,7299,4240,287720,291960
6/11/2024,Prasanna Kumara,Puttalam,Kalpitiya,North Western,3226,4493,7719,129040,179720,308760
6/12/2024,Prasanna Kumara,Puttalam,Kalpitiya,North Western,9011,9761,18772,360440,390440,750880
6/13/2024,Prasanna Kumara,Puttalam,Kalpitiya,North Western,2381,1178,3559,95240,47120,142360
6/14/2024,Prasanna Kumara,Puttalam,Kalpitiya,North Western,705,609,1314,28200,24360,52560
6/15/2024,Prasanna Kumara,Puttalam,Kalpitiya,North Western,7983,8535,16518,319320,341400,660720
6/16/2024,Prasanna Kumara,Puttalam,Kalpitiya,North Western,4414,7141,11555,176560,285640,462200
6/17/2024,Prasanna Kumara,Puttalam,Kalpitiya,North Western,5854,925,6779,234160,37000,271160
6/18/2024,Prasanna Kumara,Puttalam,Kalpitiya,North Western,5016,7819,12835,200640,312760,513400
6/19/2024,Prasanna Kumara,Puttalam,Kalpitiya,North Western,5924,7295,13219,236960,291800,528760
6/20/2024,Prasanna Kumara,Puttalam,Kalpitiya,North Western,5014,5040,10054,200560,201600,402160
6/21/2024,Prasanna Kumara,Puttalam,Kalpitiya,North Western,7246,6109,13355,289840,244360,534200
6/22/2024,Prasanna Kumara,Puttalam,Kalpitiya,North Western,2969,242,3211,118760,9680,128440
6/23/2024,Prasanna Kumara,Puttalam,Kalpitiya,North Western,3760,6382,10142,150400,255280,405680
6/24/2024,Prasanna Kumara,Puttalam,Kalpitiya,North Western,4748,544,5292,189920,21760,211680
6/25/2024,Prasanna Kumara,Puttalam,Kalpitiya,North Western,528,9608,10136,21120,384320,405440
6/26/2024,Prasanna Kumara,Puttalam,Kalpitiya,North Western,8183,6644,14827,327320,265760,593080
6/27/2024,Prasanna Kumara,Puttalam,Kalpitiya,North Western,653,1024,1677,26120,40960,67080
6/28/2024,Prasanna Kumara,Puttalam,Kalpitiya,North Western,1829,831,2660,73160,33240,106400
6/29/2024,Prasanna Kumara,Puttalam,Kalpitiya,North Western,6232,5920,12152,249280,236800,486080
6/30/2024,Prasanna Kumara,Puttalam,Kalpitiya,North Western,2071,1260,3331,82840,50400,133240
7/1/2024,Prasanna Kumara,Puttalam,Kalpitiya,North Western,5109,9797,14906,204360,391880,596240
7/2/2024,Prasanna Kumara,Puttalam,Kalpitiya,North Western,2116,9436,11552,84640,377440,462080
7/3/2024,Prasanna Kumara,Puttalam,Kalpitiya,North Western,8995,1778,10773,359800,71120,430920
7/4/2024,Prasanna Kumara,Puttalam,Kalpitiya,North Western,4347,6411,10758,173880,256440,430320
7/5/2024,Prasanna Kumara,Puttalam,Kalpitiya,North Western,693,9080,9773,27720,363200,390920
7/6/2024,Prasanna Kumara,Puttalam,Kalpitiya,North Western,5133,8798,13931,205320,351920,557240
7/7/2024,Prasanna Kumara,Puttalam,Kalpitiya,North Western,6915,3605,10520,276600,144200,420800
7/8/2024,Prasanna Kumara,Puttalam,Kalpitiya,North Western,9762,4092,13854,390480,163680,554160
7/9/2024,Prasanna Kumara,Puttalam,Kalpitiya,North Western,4069,4458,8527,162760,178320,341080
7/10/2024,Prasanna Kumara,Puttalam,Kalpitiya,North Western,7614,7868,15482,304560,314720,619280
7/11/2024,Prasanna Kumara,Puttalam,Kalpitiya,North Western,9610,3155,12765,384400,126200,510600
7/12/2024,Prasanna Kumara,Puttalam,Kalpitiya,North Western,5008,2225,7233,200320,89000,289320
7/13/2024,Prasanna Kumara,Puttalam,Kalpitiya,North Western,865,7298,8163,34600,291920,326520
7/14/2024,Prasanna Kumara,Puttalam,Kalpitiya,North Western,4171,3821,7992,166840,152840,319680
7/15/2024,Prasanna Kumara,Puttalam,Kalpitiya,North Western,8733,5849,14582,349320,233960,583280
7/16/2024,Prasanna Kumara,Puttalam,Kalpitiya,North Western,1295,4717,6012,51800,188680,240480
7/17/2024,Prasanna Kumara,Puttalam,Kalpitiya,North Western,6174,3981,10155,246960,159240,406200
7/18/2024,Prasanna Kumara,Puttalam,Kalpitiya,North Western,2043,6701,8744,81720,268040,349760
7/19/2024,Prasanna Kumara,Puttalam,Kalpitiya,North Western,6385,3475,9860,255400,139000,394400
7/20/2024,Prasanna Kumara,Puttalam,Kalpitiya,North Western,8135,9555,17690,325400,382200,707600
7/21/2024,Prasanna Kumara,Puttalam,Kalpitiya,North Western,9374,6747,16121,374960,269880,644840
7/22/2024,Prasanna Kumara,Puttalam,Kalpitiya,North Western,3477,9102,12579,139080,364080,503160
7/23/2024,Prasanna Kumara,Puttalam,Kalpitiya,North Western,6618,1510,8128,264720,60400,325120
7/24/2024,Prasanna Kumara,Puttalam,Kalpitiya,North Western,6322,6144,12466,252880,245760,498640
7/25/2024,Prasanna Kumara,Puttalam,Kalpitiya,North Western,3762,9623,13385,150480,384920,535400
7/26/2024,Prasanna Kumara,Puttalam,Kalpitiya,North Western,7938,9869,17807,317520,394760,712280
7/27/2024,Prasanna Kumara,Puttalam,Kalpitiya,North Western,7556,1382,8938,302240,55280,357520
7/28/2024,Prasanna Kumara,Puttalam,Kalpitiya,North Western,3881,6659,10540,155240,266360,421600
7/29/2024,Prasanna Kumara,Puttalam,Kalpitiya,North Western,8016,1238,9254,320640,49520,370160
7/30/2024,Prasanna Kumara,Puttalam,Kalpitiya,North Western,4102,3301,7403,164080,132040,296120
7/31/2024,Prasanna Kumara,Puttalam,Kalpitiya,North Western,2013,8237,10250,80520,329480,410000
8/1/2024,Prasanna Kumara,Puttalam,Kalpitiya,North Western,6706,1516,8222,268240,60640,328880
8/2/2024,Prasanna Kumara,Puttalam,Kalpitiya,North Western,8452,2858,11310,338080,114320,452400
8/3/2024,Prasanna Kumara,Puttalam,Kalpitiya,North Western,5029,2102,7131,201160,84080,285240
8/4/2024,Prasanna Kumara,Puttalam,Kalpitiya,North Western,6261,50,6311,250440,2000,252440
8/5/2024,Prasanna Kumara,Puttalam,Kalpitiya,North Western,7677,292,7969,307080,11680,318760
8/6/2024,Prasanna Kumara,Puttalam,Kalpitiya,North Western,4797,1997,6794,191880,79880,271760
8/7/2024,Prasanna Kumara,Puttalam,Kalpitiya,North Western,9013,9063,18076,360520,362520,723040
8/8/2024,Prasanna Kumara,Puttalam,Kalpitiya,North Western,2500,6474,8974,100000,258960,358960
8/9/2024,Prasanna Kumara,Puttalam,Kalpitiya,North Western,4837,8365,13202,193480,334600,528080
8/10/2024,Prasanna Kumara,Puttalam,Kalpitiya,North Western,8731,4828,13559,349240,193120,542360
8/11/2024,Prasanna Kumara,Puttalam,Kalpitiya,North Western,3070,9984,13054,122800,399360,522160
8/12/2024,Prasanna Kumara,Puttalam,Kalpitiya,North Western,912,5011,5923,36480,200440,236920
8/13/2024,Prasanna Kumara,Puttalam,Kalpitiya,North Western,969,7249,8218,38760,289960,328720
8/14/2024,Prasanna Kumara,Puttalam,Kalpitiya,North Western,5675,7406,13081,227000,296240,523240
8/15/2024,Prasanna Kumara,Puttalam,Kalpitiya,North Western,7741,7053,14794,309640,282120,591760
8/16/2024,Prasanna Kumara,Puttalam,Kalpitiya,North Western,2802,9164,11966,112080,366560,478640
8/17/2024,Prasanna Kumara,Puttalam,Kalpitiya,North Western,6467,5802,12269,258680,232080,490760
8/18/2024,Prasanna Kumara,Puttalam,Kalpitiya,North Western,9236,5130,14366,369440,205200,574640
8/19/2024,Prasanna Kumara,Puttalam,Kalpitiya,North Western,3093,714,3807,123720,28560,152280
8/20/2024,Prasanna Kumara,Puttalam,Kalpitiya,North Western,1243,4709,5952,49720,188360,238080
8/21/2024,Prasanna Kumara,Puttalam,Kalpitiya,North Western,5303,5409,10712,212120,216360,428480
8/22/2024,Prasanna Kumara,Puttalam,Kalpitiya,North Western,3534,3756,7290,141360,150240,291600
8/23/2024,Prasanna Kumara,Puttalam,Kalpitiya,North Western,1897,7408,9305,75880,296320,372200
8/24/2024,Prasanna Kumara,Puttalam,Kalpitiya,North Western,5757,7861,13618,230280,314440,544720
8/25/2024,Prasanna Kumara,Puttalam,Kalpitiya,North Western,2781,9289,12070,111240,371560,482800
8/26/2024,Prasanna Kumara,Puttalam,Kalpitiya,North Western,4670,5181,9851,186800,207240,394040
8/27/2024,Prasanna Kumara,Puttalam,Kalpitiya,North Western,8228,4479,12707,329120,179160,508280
8/28/2024,Prasanna Kumara,Puttalam,Kalpitiya,North Western,5759,9892,15651,230360,395680,626040
8/29/2024,Prasanna Kumara,Puttalam,Kalpitiya,North Western,5068,6896,11964,202720,275840,478560
8/30/2024,Prasanna Kumara,Puttalam,Kalpitiya,North Western,6557,2432,8989,262280,97280,359560
8/31/2024,Prasanna Kumara,Puttalam,Kalpitiya,North Western,7755,8495,16250,310200,339800,650000
9/1/2024,Prasanna Kumara,Puttalam,Kalpitiya,North Western,8468,1358,9826,338720,54320,393040
9/2/2024,Prasanna Kumara,Puttalam,Kalpitiya,North Western,1227,5921,7148,49080,236840,285920
9/3/2024,Prasanna Kumara,Puttalam,Kalpitiya,North Western,8718,5797,14515,348720,231880,580600
9/4/2024,Prasanna Kumara,Puttalam,Kalpitiya,North Western,6241,7117,13358,249640,284680,534320
9/5/2024,Prasanna Kumara,Puttalam,Kalpitiya,North Western,3258,6764,10022,130320,270560,400880
9/6/2024,Prasanna Kumara,Puttalam,Kalpitiya,North Western,9313,6687,16000,372520,267480,640000
9/7/2024,Prasanna Kumara,Puttalam,Kalpitiya,North Western,1846,8426,10272,73840,337040,410880
9/8/2024,Prasanna Kumara,Puttalam,Kalpitiya,North Western,3982,5519,9501,159280,220760,380040
9/9/2024,Prasanna Kumara,Puttalam,Kalpitiya,North Western,5463,2705,8168,218520,108200,326720
9/10/2024,Prasanna Kumara,Puttalam,Kalpitiya,North Western,2051,6719,8770,82040,268760,350800
9/11/2024,Prasanna Kumara,Puttalam,Kalpitiya,North Western,348,254,602,13920,10160,24080
9/12/2024,Prasanna Kumara,Puttalam,Kalpitiya,North Western,8660,9376,18036,346400,375040,721440
9/13/2024,Prasanna Kumara,Puttalam,Kalpitiya,North Western,8837,8637,17474,353480,345480,698960
9/14/2024,Prasanna Kumara,Puttalam,Kalpitiya,North Western,9410,7619,17029,376400,304760,681160
9/15/2024,Prasanna Kumara,Puttalam,Kalpitiya,North Western,4898,1471,6369,195920,58840,254760
9/16/2024,Prasanna Kumara,Puttalam,Kalpitiya,North Western,5706,3581,9287,228240,143240,371480
9/17/2024,Prasanna Kumara,Puttalam,Kalpitiya,North Western,9479,3398,12877,379160,135920,515080
9/18/2024,Prasanna Kumara,Puttalam,Kalpitiya,North Western,3724,985,4709,148960,39400,188360
9/19/2024,Prasanna Kumara,Puttalam,Kalpitiya,North Western,2901,6195,9096,116040,247800,363840
9/20/2024,Prasanna Kumara,Puttalam,Kalpitiya,North Western,7439,6419,13858,297560,256760,554320
9/21/2024,Prasanna Kumara,Puttalam,Kalpitiya,North Western,5207,1695,6902,208280,67800,276080
9/22/2024,Prasanna Kumara,Puttalam,Kalpitiya,North Western,8906,4678,13584,356240,187120,543360
9/23/2024,Prasanna Kumara,Puttalam,Kalpitiya,North Western,7044,6347,13391,281760,253880,535640
9/24/2024,Prasanna Kumara,Puttalam,Kalpitiya,North Western,5212,6276,11488,208480,251040,459520
9/25/2024,Prasanna Kumara,Puttalam,Kalpitiya,North Western,7413,1550,8963,296520,62000,358520
9/26/2024,Prasanna Kumara,Puttalam,Kalpitiya,North Western,7967,5477,13444,318680,219080,537760
9/27/2024,Prasanna Kumara,Puttalam,Kalpitiya,North Western,7923,4472,12395,316920,178880,495800
9/28/2024,Prasanna Kumara,Puttalam,Kalpitiya,North Western,54,1461,1515,2160,58440,60600
9/29/2024,Prasanna Kumara,Puttalam,Kalpitiya,North Western,7317,965,8282,292680,38600,331280
9/30/2024,Prasanna Kumara,Puttalam,Kalpitiya,North Western,5559,6279,11838,222360,251160,473520
10/1/2024,Prasanna Kumara,Puttalam,Kalpitiya,North Western,6121,8628,14749,244840,345120,589960
10/2/2024,Prasanna Kumara,Puttalam,Kalpitiya,North Western,3190,9278,12468,127600,371120,498720
10/3/2024,Prasanna Kumara,Puttalam,Kalpitiya,North Western,1217,6336,7553,48680,253440,302120
10/4/2024,Prasanna Kumara,Puttalam,Kalpitiya,North Western,6701,1429,8130,268040,57160,325200
10/5/2024,Prasanna Kumara,Puttalam,Kalpitiya,North Western,8897,3475,12372,355880,139000,494880
10/6/2024,Prasanna Kumara,Puttalam,Kalpitiya,North Western,2757,2743,5500,110280,109720,220000
10/7/2024,Prasanna Kumara,Puttalam,Kalpitiya,North Western,4382,5239,9621,175280,209560,384840
10/8/2024,Prasanna Kumara,Puttalam,Kalpitiya,North Western,8643,3417,12060,345720,136680,482400
10/9/2024,Prasanna Kumara,Puttalam,Kalpitiya,North Western,9495,626,10121,379800,25040,404840
10/10/2024,Prasanna Kumara,Puttalam,Kalpitiya,North Western,1975,8799,10774,79000,351960,430960
10/11/2024,Prasanna Kumara,Puttalam,Kalpitiya,North Western,1531,8336,9867,61240,333440,394680
10/12/2024,Prasanna Kumara,Puttalam,Kalpitiya,North Western,1802,8229,10031,72080,329160,401240
10/13/2024,Prasanna Kumara,Puttalam,Kalpitiya,North Western,5167,8179,13346,206680,327160,533840
10/14/2024,Prasanna Kumara,Puttalam,Kalpitiya,North Western,3428,6547,9975,137120,261880,399000
10/15/2024,Prasanna Kumara,Puttalam,Kalpitiya,North Western,3927,5886,9813,157080,235440,392520
10/16/2024,Prasanna Kumara,Puttalam,Kalpitiya,North Western,7312,9514,16826,292480,380560,673040
10/17/2024,Prasanna Kumara,Puttalam,Kalpitiya,North Western,8238,4217,12455,329520,168680,498200
10/18/2024,Prasanna Kumara,Puttalam,Kalpitiya,North Western,3480,9726,13206,139200,389040,528240
10/19/2024,Prasanna Kumara,Puttalam,Kalpitiya,North Western,1854,1116,2970,74160,44640,118800
10/20/2024,Prasanna Kumara,Puttalam,Kalpitiya,North Western,5182,3253,8435,207280,130120,337400
10/21/2024,Prasanna Kumara,Puttalam,Kalpitiya,North Western,7483,1898,9381,299320,75920,375240
10/22/2024,Prasanna Kumara,Puttalam,Kalpitiya,North Western,4865,5109,9974,194600,204360,398960
10/23/2024,Prasanna Kumara,Puttalam,Kalpitiya,North Western,3842,7162,11004,153680,286480,440160
10/24/2024,Prasanna Kumara,Puttalam,Kalpitiya,North Western,9222,6458,15680,368880,258320,627200
10/25/2024,Prasanna Kumara,Puttalam,Kalpitiya,North Western,8920,1691,10611,356800,67640,424440
10/26/2024,Prasanna Kumara,Puttalam,Kalpitiya,North Western,7957,6504,14461,318280,260160,578440
10/27/2024,Prasanna Kumara,Puttalam,Kalpitiya,North Western,9613,5970,15583,384520,238800,623320
10/28/2024,Prasanna Kumara,Puttalam,Kalpitiya,North Western,565,6973,7538,22600,278920,301520
10/29/2024,Prasanna Kumara,Puttalam,Kalpitiya,North Western,7902,157,8059,316080,6280,322360
10/30/2024,Prasanna Kumara,Puttalam,Kalpitiya,North Western,625,6900,7525,25000,276000,301000
10/31/2024,Prasanna Kumara,Puttalam,Kalpitiya,North Western,7743,5819,13562,309720,232760,542480
11/1/2024,Prasanna Kumara,Puttalam,Kalpitiya,North Western,9451,7496,16947,378040,299840,677880
11/2/2024,Prasanna Kumara,Puttalam,Kalpitiya,North Western,4265,9598,13863,170600,383920,554520
11/3/2024,Prasanna Kumara,Puttalam,Kalpitiya,North Western,24,641,665,960,25640,26600
11/4/2024,Prasanna Kumara,Puttalam,Kalpitiya,North Western,8844,9471,18315,353760,378840,732600
11/5/2024,Prasanna Kumara,Puttalam,Kalpitiya,North Western,2393,1371,3764,95720,54840,150560
11/6/2024,Prasanna Kumara,Puttalam,Kalpitiya,North Western,2546,7390,9936,101840,295600,397440
11/7/2024,Prasanna Kumara,Puttalam,Kalpitiya,North Western,8061,507,8568,322440,20280,342720
11/8/2024,Prasanna Kumara,Puttalam,Kalpitiya,North Western,2729,1037,3766,109160,41480,150640
11/9/2024,Prasanna Kumara,Puttalam,Kalpitiya,North Western,4629,7216,11845,185160,288640,473800
11/10/2024,Prasanna Kumara,Puttalam,Kalpitiya,North Western,697,230,927,27880,9200,37080
11/11/2024,Prasanna Kumara,Puttalam,Kalpitiya,North Western,347,2273,2620,13880,90920,104800
11/12/2024,Prasanna Kumara,Puttalam,Kalpitiya,North Western,1397,3178,4575,55880,127120,183000
11/13/2024,Prasanna Kumara,Puttalam,Kalpitiya,North Western,1163,6078,7241,46520,243120,289640
11/14/2024,Prasanna Kumara,Puttalam,Kalpitiya,North Western,1093,810,1903,43720,32400,76120
11/15/2024,Prasanna Kumara,Puttalam,Kalpitiya,North Western,3710,9893,13603,148400,395720,544120
11/16/2024,Prasanna Kumara,Puttalam,Kalpitiya,North Western,9059,3642,12701,362360,145680,508040
11/17/2024,Prasanna Kumara,Puttalam,Kalpitiya,North Western,1326,9816,11142,53040,392640,445680
11/18/2024,Prasanna Kumara,Puttalam,Kalpitiya,North Western,2451,8897,11348,98040,355880,453920
11/19/2024,Prasanna Kumara,Puttalam,Kalpitiya,North Western,1454,9784,11238,58160,391360,449520
11/20/2024,Prasanna Kumara,Puttalam,Kalpitiya,North Western,4503,1411,5914,180120,56440,236560
11/21/2024,Prasanna Kumara,Puttalam,Kalpitiya,North Western,2138,1015,3153,85520,40600,126120
11/22/2024,Prasanna Kumara,Puttalam,Kalpitiya,North Western,3512,679,4191,140480,27160,167640
11/23/2024,Prasanna Kumara,Puttalam,Kalpitiya,North Western,4462,2990,7452,178480,119600,298080
11/24/2024,Prasanna Kumara,Puttalam,Kalpitiya,North Western,9543,6979,16522,381720,279160,660880
11/25/2024,Prasanna Kumara,Puttalam,Kalpitiya,North Western,4437,6506,10943,177480,260240,437720
11/26/2024,Prasanna Kumara,Puttalam,Kalpitiya,North Western,5062,729,5791,202480,29160,231640
11/27/2024,Prasanna Kumara,Puttalam,Kalpitiya,North Western,3916,6224,10140,156640,248960,405600
11/28/2024,Prasanna Kumara,Puttalam,Kalpitiya,North Western,6259,8497,14756,250360,339880,590240
11/29/2024,Prasanna Kumara,Puttalam,Kalpitiya,North Western,6865,8841,15706,274600,353640,628240
11/30/2024,Prasanna Kumara,Puttalam,Kalpitiya,North Western,9561,3508,13069,382440,140320,522760
12/1/2024,Prasanna Kumara,Puttalam,Kalpitiya,North Western,6854,3609,10463,274160,144360,418520
12/2/2024,Prasanna Kumara,Puttalam,Kalpitiya,North Western,1364,5809,7173,54560,232360,286920
12/3/2024,Prasanna Kumara,Puttalam,Kalpitiya,North Western,7755,5299,13054,310200,211960,522160
12/4/2024,Prasanna Kumara,Puttalam,Kalpitiya,North Western,6624,167,6791,264960,6680,271640
12/5/2024,Prasanna Kumara,Puttalam,Kalpitiya,North Western,665,2249,2914,26600,89960,116560
12/6/2024,Prasanna Kumara,Puttalam,Kalpitiya,North Western,8143,6074,14217,325720,242960,568680
12/7/2024,Prasanna Kumara,Puttalam,Kalpitiya,North Western,431,6077,6508,17240,243080,260320
12/8/2024,Prasanna Kumara,Puttalam,Kalpitiya,North Western,9155,4286,13441,366200,171440,537640
12/9/2024,Prasanna Kumara,Puttalam,Kalpitiya,North Western,7864,8078,15942,314560,323120,637680
12/10/2024,Prasanna Kumara,Puttalam,Kalpitiya,North Western,3129,8585,11714,125160,343400,468560
12/11/2024,Prasanna Kumara,Puttalam,Kalpitiya,North Western,9288,9099,18387,371520,363960,735480
12/12/2024,Prasanna Kumara,Puttalam,Kalpitiya,North Western,3013,8537,11550,120520,341480,462000
12/13/2024,Prasanna Kumara,Puttalam,Kalpitiya,North Western,9999,6444,16443,399960,257760,657720
12/14/2024,Prasanna Kumara,Puttalam,Kalpitiya,North Western,2730,2266,4996,109200,90640,199840
12/15/2024,Prasanna Kumara,Puttalam,Kalpitiya,North Western,4404,6680,11084,176160,267200,443360
12/16/2024,Prasanna Kumara,Puttalam,Kalpitiya,North Western,8602,7928,16530,344080,317120,661200
12/17/2024,Prasanna Kumara,Puttalam,Kalpitiya,North Western,3720,534,4254,148800,21360,170160
12/18/2024,Prasanna Kumara,Puttalam,Kalpitiya,North Western,3892,2126,6018,155680,85040,240720
12/19/2024,Prasanna Kumara,Puttalam,Kalpitiya,North Western,344,2248,2592,13760,89920,103680
12/20/2024,Prasanna Kumara,Puttalam,Kalpitiya,North Western,9567,6460,16027,382680,258400,641080
12/21/2024,Prasanna Kumara,Puttalam,Kalpitiya,North Western,1816,2092,3908,72640,83680,156320
12/22/2024,Prasanna Kumara,Puttalam,Kalpitiya,North Western,7833,3923,11756,313320,156920,470240
12/23/2024,Prasanna Kumara,Puttalam,Kalpitiya,North Western,6159,7783,13942,246360,311320,557680
12/24/2024,Prasanna Kumara,Puttalam,Kalpitiya,North Western,5558,4592,10150,222320,183680,406000
12/25/2024,Prasanna Kumara,Puttalam,Kalpitiya,North Western,1704,9313,11017,68160,372520,440680
12/26/2024,Prasanna Kumara,Puttalam,Kalpitiya,North Western,3804,9481,13285,152160,379240,531400
12/27/2024,Prasanna Kumara,Puttalam,Kalpitiya,North Western,3369,5562,8931,134760,222480,357240
12/28/2024,Prasanna Kumara,Puttalam,Kalpitiya,North Western,5281,4803,10084,211240,192120,403360
12/29/2024,Prasanna Kumara,Puttalam,Kalpitiya,North Western,4228,7701,11929,169120,308040,477160
12/30/2024,Prasanna Kumara,Puttalam,Kalpitiya,North Western,1474,4810,6284,58960,192400,251360
12/31/2024,Prasanna Kumara,Puttalam,Kalpitiya,North Western,571,914,1485,22840,36560,59400
1/1/2025,Prasanna Kumara,Puttalam,Kalpitiya,North Western,4642,3532,8174,185680,141280,326960
1/2/2025,Prasanna Kumara,Puttalam,Kalpitiya,North Western,7791,4567,12358,311640,182680,494320
1/3/2025,Prasanna Kumara,Puttalam,Kalpitiya,North Western,9196,2819,12015,367840,112760,480600
1/4/2025,Prasanna Kumara,Puttalam,Kalpitiya,North Western,4564,8450,13014,182560,338000,520560
1/5/2025,Prasanna Kumara,Puttalam,Kalpitiya,North Western,2851,5608,8459,114040,224320,338360
1/6/2025,Prasanna Kumara,Puttalam,Kalpitiya,North Western,4246,9681,13927,169840,387240,557080
1/7/2025,Prasanna Kumara,Puttalam,Kalpitiya,North Western,5536,1519,7055,221440,60760,282200
1/8/2025,Prasanna Kumara,Puttalam,Kalpitiya,North Western,4153,4879,9032,166120,195160,361280
1/9/2025,Prasanna Kumara,Puttalam,Kalpitiya,North Western,8710,7917,16627,348400,316680,665080
1/10/2025,Prasanna Kumara,Puttalam,Kalpitiya,North Western,63,1035,1098,2520,41400,43920
1/11/2025,Prasanna Kumara,Puttalam,Kalpitiya,North Western,1160,233,1393,46400,9320,55720
1/12/2025,Prasanna Kumara,Puttalam,Kalpitiya,North Western,1185,1941,3126,47400,77640,125040
1/13/2025,Prasanna Kumara,Puttalam,Kalpitiya,North Western,2898,7484,10382,115920,299360,415280
1/14/2025,Prasanna Kumara,Puttalam,Kalpitiya,North Western,2975,5074,8049,119000,202960,321960
1/15/2025,Prasanna Kumara,Puttalam,Kalpitiya,North Western,3891,2820,6711,155640,112800,268440
1/16/2025,Prasanna Kumara,Puttalam,Kalpitiya,North Western,2930,1154,4084,117200,46160,163360
1/17/2025,Prasanna Kumara,Puttalam,Kalpitiya,North Western,1721,6838,8559,68840,273520,342360
1/18/2025,Prasanna Kumara,Puttalam,Kalpitiya,North Western,1933,8382,10315,77320,335280,412600
1/19/2025,Prasanna Kumara,Puttalam,Kalpitiya,North Western,3872,8579,12451,154880,343160,498040
1/20/2025,Prasanna Kumara,Puttalam,Kalpitiya,North Western,8409,6245,14654,336360,249800,586160
1/21/2025,Prasanna Kumara,Puttalam,Kalpitiya,North Western,3504,9787,13291,140160,391480,531640
1/22/2025,Prasanna Kumara,Puttalam,Kalpitiya,North Western,9906,8657,18563,396240,346280,742520
1/23/2025,Prasanna Kumara,Puttalam,Kalpitiya,North Western,3801,725,4526,152040,29000,181040
1/24/2025,Prasanna Kumara,Puttalam,Kalpitiya,North Western,6258,4647,10905,250320,185880,436200
1/25/2025,Prasanna Kumara,Puttalam,Kalpitiya,North Western,3904,8222,12126,156160,328880,485040
1/26/2025,Prasanna Kumara,Puttalam,Kalpitiya,North Western,3331,4488,7819,133240,179520,312760
1/27/2025,Prasanna Kumara,Puttalam,Kalpitiya,North Western,1241,7780,9021,49640,311200,360840
1/28/2025,Prasanna Kumara,Puttalam,Kalpitiya,North Western,9311,2556,11867,372440,102240,474680
1/29/2025,Prasanna Kumara,Puttalam,Kalpitiya,North Western,8650,534,9184,346000,21360,367360
1/30/2025,Prasanna Kumara,Puttalam,Kalpitiya,North Western,4970,1046,6016,198800,41840,240640
1/31/2025,Prasanna Kumara,Puttalam,Kalpitiya,North Western,6830,2694,9524,273200,107760,380960
2/1/2025,Prasanna Kumara,Puttalam,Kalpitiya,North Western,9795,6371,16166,391800,254840,646640
2/2/2025,Prasanna Kumara,Puttalam,Kalpitiya,North Western,2430,714,3144,97200,28560,125760
2/3/2025,Prasanna Kumara,Puttalam,Kalpitiya,North Western,1676,6262,7938,67040,250480,317520
2/4/2025,Prasanna Kumara,Puttalam,Kalpitiya,North Western,5108,545,5653,204320,21800,226120
2/5/2025,Prasanna Kumara,Puttalam,Kalpitiya,North Western,4569,4274,8843,182760,170960,353720
2/6/2025,Prasanna Kumara,Puttalam,Kalpitiya,North Western,8556,3524,12080,342240,140960,483200
2/7/2025,Prasanna Kumara,Puttalam,Kalpitiya,North Western,5618,7381,12999,224720,295240,519960
2/8/2025,Prasanna Kumara,Puttalam,Kalpitiya,North Western,567,9954,10521,22680,398160,420840
2/9/2025,Prasanna Kumara,Puttalam,Kalpitiya,North Western,5122,6600,11722,204880,264000,468880
2/10/2025,Prasanna Kumara,Puttalam,Kalpitiya,North Western,6666,9590,16256,266640,383600,650240
2/11/2025,Prasanna Kumara,Puttalam,Kalpitiya,North Western,4458,5927,10385,178320,237080,415400
2/12/2025,Prasanna Kumara,Puttalam,Kalpitiya,North Western,8508,914,9422,340320,36560,376880
2/13/2025,Prasanna Kumara,Puttalam,Kalpitiya,North Western,1292,7982,9274,51680,319280,370960
2/14/2025,Prasanna Kumara,Puttalam,Kalpitiya,North Western,8497,8106,16603,339880,324240,664120
2/15/2025,Prasanna Kumara,Puttalam,Kalpitiya,North Western,2385,9688,12073,95400,387520,482920
2/16/2025,Prasanna Kumara,Puttalam,Kalpitiya,North Western,548,9836,10384,21920,393440,415360
2/17/2025,Prasanna Kumara,Puttalam,Kalpitiya,North Western,9093,5521,14614,363720,220840,584560
2/18/2025,Prasanna Kumara,Puttalam,Kalpitiya,North Western,8071,414,8485,322840,16560,339400
2/19/2025,Prasanna Kumara,Puttalam,Kalpitiya,North Western,6599,3795,10394,263960,151800,415760
2/20/2025,Prasanna Kumara,Puttalam,Kalpitiya,North Western,3925,6532,10457,157000,261280,418280
2/21/2025,Prasanna Kumara,Puttalam,Kalpitiya,North Western,5617,6249,11866,224680,249960,474640
2/22/2025,Prasanna Kumara,Puttalam,Kalpitiya,North Western,6284,4939,11223,251360,197560,448920
2/23/2025,Prasanna Kumara,Puttalam,Kalpitiya,North Western,8621,5441,14062,344840,217640,562480
2/24/2025,Prasanna Kumara,Puttalam,Kalpitiya,North Western,8132,1747,9879,325280,69880,395160
2/25/2025,Prasanna Kumara,Puttalam,Kalpitiya,North Western,7405,239,7644,296200,9560,305760
2/26/2025,Prasanna Kumara,Puttalam,Kalpitiya,North Western,7615,607,8222,304600,24280,328880
2/27/2025,Prasanna Kumara,Puttalam,Kalpitiya,North Western,5769,6689,12458,230760,267560,498320
2/28/2025,Prasanna Kumara,Puttalam,Kalpitiya,North Western,9313,1539,10852,372520,61560,434080
3/1/2025,Prasanna Kumara,Puttalam,Kalpitiya,North Western,3853,6587,10440,154120,263480,417600
3/2/2025,Prasanna Kumara,Puttalam,Kalpitiya,North Western,3092,152,3244,123680,6080,129760
3/3/2025,Prasanna Kumara,Puttalam,Kalpitiya,North Western,8470,830,9300,338800,33200,372000
3/4/2025,Prasanna Kumara,Puttalam,Kalpitiya,North Western,2032,2161,4193,81280,86440,167720
3/5/2025,Prasanna Kumara,Puttalam,Kalpitiya,North Western,8558,1438,9996,342320,57520,399840
3/6/2025,Prasanna Kumara,Puttalam,Kalpitiya,North Western,5135,8307,13442,205400,332280,537680
3/7/2025,Prasanna Kumara,Puttalam,Kalpitiya,North Western,4121,5408,9529,164840,216320,381160
3/8/2025,Prasanna Kumara,Puttalam,Kalpitiya,North Western,1802,4132,5934,72080,165280,237360
3/9/2025,Prasanna Kumara,Puttalam,Kalpitiya,North Western,7264,1836,9100,290560,73440,364000
3/10/2025,Prasanna Kumara,Puttalam,Kalpitiya,North Western,7075,3225,10300,283000,129000,412000
3/11/2025,Prasanna Kumara,Puttalam,Kalpitiya,North Western,5630,3743,9373,225200,149720,374920
3/12/2025,Prasanna Kumara,Puttalam,Kalpitiya,North Western,9942,9107,19049,397680,364280,761960
3/13/2025,Prasanna Kumara,Puttalam,Kalpitiya,North Western,7604,52,7656,304160,2080,306240
3/14/2025,Prasanna Kumara,Puttalam,Kalpitiya,North Western,7214,8676,15890,288560,347040,635600
3/15/2025,Prasanna Kumara,Puttalam,Kalpitiya,North Western,8175,7625,15800,327000,305000,632000
3/16/2025,Prasanna Kumara,Puttalam,Kalpitiya,North Western,3996,9242,13238,159840,369680,529520
3/17/2025,Prasanna Kumara,Puttalam,Kalpitiya,North Western,183,6003,6186,7320,240120,247440
3/18/2025,Prasanna Kumara,Puttalam,Kalpitiya,North Western,5749,6876,12625,229960,275040,505000
3/19/2025,Prasanna Kumara,Puttalam,Kalpitiya,North Western,9832,7056,16888,393280,282240,675520
3/20/2025,Prasanna Kumara,Puttalam,Kalpitiya,North Western,4362,4044,8406,174480,161760,336240
3/21/2025,Prasanna Kumara,Puttalam,Kalpitiya,North Western,8900,4491,13391,356000,179640,535640
3/22/2025,Prasanna Kumara,Puttalam,Kalpitiya,North Western,2167,4050,6217,86680,162000,248680
3/23/2025,Prasanna Kumara,Puttalam,Kalpitiya,North Western,1163,5314,6477,46520,212560,259080
3/25/2024,Kanchana Wijewardene,Kalutara,Kalutara,Western,1048,7002,8050,41920,280080,322000
3/26/2024,Kanchana Wijewardene,Kalutara,Kalutara,Western,1930,434,2364,77200,17360,94560
3/27/2024,Kanchana Wijewardene,Kalutara,Kalutara,Western,9992,3420,13412,399680,136800,536480
3/28/2024,Kanchana Wijewardene,Kalutara,Kalutara,Western,7753,7615,15368,310120,304600,614720
3/29/2024,Kanchana Wijewardene,Kalutara,Kalutara,Western,5177,6998,12175,207080,279920,487000
3/30/2024,Kanchana Wijewardene,Kalutara,Kalutara,Western,9993,3053,13046,399720,122120,521840
3/31/2024,Kanchana Wijewardene,Kalutara,Kalutara,Western,2326,8626,10952,93040,345040,438080
4/1/2024,Kanchana Wijewardene,Kalutara,Kalutara,Western,5499,6234,11733,219960,249360,469320
4/2/2024,Kanchana Wijewardene,Kalutara,Kalutara,Western,8977,4875,13852,359080,195000,554080
4/3/2024,Kanchana Wijewardene,Kalutara,Kalutara,Western,2553,9871,12424,102120,394840,496960
4/4/2024,Kanchana Wijewardene,Kalutara,Kalutara,Western,2508,5410,7918,100320,216400,316720
4/5/2024,Kanchana Wijewardene,Kalutara,Kalutara,Western,9173,7277,16450,366920,291080,658000
4/6/2024,Kanchana Wijewardene,Kalutara,Kalutara,Western,8280,8377,16657,331200,335080,666280
4/7/2024,Kanchana Wijewardene,Kalutara,Kalutara,Western,787,6460,7247,31480,258400,289880
4/8/2024,Kanchana Wijewardene,Kalutara,Kalutara,Western,1024,9065,10089,40960,362600,403560
4/9/2024,Kanchana Wijewardene,Kalutara,Kalutara,Western,2191,7195,9386,87640,287800,375440
4/10/2024,Kanchana Wijewardene,Kalutara,Kalutara,Western,3246,1975,5221,129840,79000,208840
4/11/2024,Kanchana Wijewardene,Kalutara,Kalutara,Western,8117,982,9099,324680,39280,363960
4/19/2024,Kanchana Wijewardene,Kalutara,Kalutara,Western,6179,1902,8081,247160,76080,323240
4/20/2024,Kanchana Wijewardene,Kalutara,Kalutara,Western,669,5708,6377,26760,228320,255080
4/21/2024,Kanchana Wijewardene,Kalutara,Kalutara,Western,5929,4054,9983,237160,162160,399320
4/22/2024,Kanchana Wijewardene,Kalutara,Kalutara,Western,3600,6569,10169,144000,262760,406760
4/23/2024,Kanchana Wijewardene,Kalutara,Kalutara,Western,3775,3179,6954,151000,127160,278160
4/24/2024,Kanchana Wijewardene,Kalutara,Kalutara,Western,1041,5728,6769,41640,229120,270760
4/25/2024,Kanchana Wijewardene,Kalutara,Kalutara,Western,1190,8881,10071,47600,355240,402840
4/26/2024,Kanchana Wijewardene,Kalutara,Kalutara,Western,5377,2167,7544,215080,86680,301760
4/27/2024,Kanchana Wijewardene,Kalutara,Kalutara,Western,7658,2081,9739,306320,83240,389560
4/28/2024,Kanchana Wijewardene,Kalutara,Kalutara,Western,8212,4003,12215,328480,160120,488600
4/29/2024,Kanchana Wijewardene,Kalutara,Kalutara,Western,4173,280,4453,166920,11200,178120
4/30/2024,Kanchana Wijewardene,Kalutara,Kalutara,Western,5935,85,6020,237400,3400,240800
5/1/2024,Kanchana Wijewardene,Kalutara,Kalutara,Western,7475,6267,13742,299000,250680,549680
5/2/2024,Kanchana Wijewardene,Kalutara,Kalutara,Western,1372,938,2310,54880,37520,92400
5/3/2024,Kanchana Wijewardene,Kalutara,Kalutara,Western,7176,6980,14156,287040,279200,566240
5/4/2024,Kanchana Wijewardene,Kalutara,Kalutara,Western,5598,116,5714,223920,4640,228560
5/5/2024,Kanchana Wijewardene,Kalutara,Kalutara,Western,8506,6390,14896,340240,255600,595840
5/6/2024,Kanchana Wijewardene,Kalutara,Kalutara,Western,1941,7279,9220,77640,291160,368800
5/7/2024,Kanchana Wijewardene,Kalutara,Kalutara,Western,4140,4853,8993,165600,194120,359720
5/8/2024,Kanchana Wijewardene,Kalutara,Kalutara,Western,2706,3567,6273,108240,142680,250920
5/9/2024,Kanchana Wijewardene,Kalutara,Kalutara,Western,7731,6306,14037,309240,252240,561480
5/10/2024,Kanchana Wijewardene,Kalutara,Kalutara,Western,5316,8033,13349,212640,321320,533960
5/11/2024,Kanchana Wijewardene,Kalutara,Kalutara,Western,4348,3401,7749,173920,136040,309960
5/12/2024,Kanchana Wijewardene,Kalutara,Kalutara,Western,558,7563,8121,22320,302520,324840
5/13/2024,Kanchana Wijewardene,Kalutara,Kalutara,Western,6404,8240,14644,256160,329600,585760
5/14/2024,Kanchana Wijewardene,Kalutara,Kalutara,Western,4849,5517,10366,193960,220680,414640
5/15/2024,Kanchana Wijewardene,Kalutara,Kalutara,Western,7494,4900,12394,299760,196000,495760
5/16/2024,Kanchana Wijewardene,Kalutara,Kalutara,Western,131,8228,8359,5240,329120,334360
5/17/2024,Kanchana Wijewardene,Kalutara,Kalutara,Western,7193,5679,12872,287720,227160,514880
5/18/2024,Kanchana Wijewardene,Kalutara,Kalutara,Western,3158,42,3200,126320,1680,128000
5/19/2024,Kanchana Wijewardene,Kalutara,Kalutara,Western,2024,5997,8021,80960,239880,320840
5/20/2024,Kanchana Wijewardene,Kalutara,Kalutara,Western,3251,8111,11362,130040,324440,454480
5/21/2024,Kanchana Wijewardene,Kalutara,Kalutara,Western,676,9226,9902,27040,369040,396080
5/22/2024,Kanchana Wijewardene,Kalutara,Kalutara,Western,1469,4871,6340,58760,194840,253600
5/24/2024,Kanchana Wijewardene,Kalutara,Kalutara,Western,7172,9558,16730,286880,382320,669200
5/25/2024,Kanchana Wijewardene,Kalutara,Kalutara,Western,715,7557,8272,28600,302280,330880
5/26/2024,Kanchana Wijewardene,Kalutara,Kalutara,Western,1400,1981,3381,56000,79240,135240
5/27/2024,Kanchana Wijewardene,Kalutara,Kalutara,Western,648,9700,10348,25920,388000,413920
5/28/2024,Kanchana Wijewardene,Kalutara,Kalutara,Western,2537,5255,7792,101480,210200,311680
5/29/2024,Kanchana Wijewardene,Kalutara,Kalutara,Western,5145,7382,12527,205800,295280,501080
5/30/2024,Kanchana Wijewardene,Kalutara,Kalutara,Western,3838,7304,11142,153520,292160,445680
5/31/2024,Kanchana Wijewardene,Kalutara,Kalutara,Western,2764,2586,5350,110560,103440,214000
6/1/2024,Kanchana Wijewardene,Kalutara,Kalutara,Western,1923,9937,11860,76920,397480,474400
6/2/2024,Kanchana Wijewardene,Kalutara,Kalutara,Western,9899,3583,13482,395960,143320,539280
6/3/2024,Kanchana Wijewardene,Kalutara,Kalutara,Western,272,8117,8389,10880,324680,335560
6/4/2024,Kanchana Wijewardene,Kalutara,Kalutara,Western,8707,8767,17474,348280,350680,698960
6/5/2024,Kanchana Wijewardene,Kalutara,Kalutara,Western,1540,647,2187,61600,25880,87480
6/6/2024,Kanchana Wijewardene,Kalutara,Kalutara,Western,5152,6268,11420,206080,250720,456800
6/7/2024,Kanchana Wijewardene,Kalutara,Kalutara,Western,5943,972,6915,237720,38880,276600
6/8/2024,Kanchana Wijewardene,Kalutara,Kalutara,Western,3977,2683,6660,159080,107320,266400
6/9/2024,Kanchana Wijewardene,Kalutara,Kalutara,Western,5130,9364,14494,205200,374560,579760
6/10/2024,Kanchana Wijewardene,Kalutara,Kalutara,Western,3893,9334,13227,155720,373360,529080
6/11/2024,Kanchana Wijewardene,Kalutara,Kalutara,Western,7912,6310,14222,316480,252400,568880
6/12/2024,Kanchana Wijewardene,Kalutara,Kalutara,Western,2839,4193,7032,113560,167720,281280
6/13/2024,Kanchana Wijewardene,Kalutara,Kalutara,Western,843,201,1044,33720,8040,41760
6/14/2024,Kanchana Wijewardene,Kalutara,Kalutara,Western,7716,8617,16333,308640,344680,653320
6/15/2024,Kanchana Wijewardene,Kalutara,Kalutara,Western,4125,63,4188,165000,2520,167520
6/16/2024,Kanchana Wijewardene,Kalutara,Kalutara,Western,2659,9714,12373,106360,388560,494920
6/17/2024,Kanchana Wijewardene,Kalutara,Kalutara,Western,9209,8135,17344,368360,325400,693760
6/18/2024,Kanchana Wijewardene,Kalutara,Kalutara,Western,5678,8404,14082,227120,336160,563280
6/19/2024,Kanchana Wijewardene,Kalutara,Kalutara,Western,3346,9192,12538,133840,367680,501520
6/20/2024,Kanchana Wijewardene,Kalutara,Kalutara,Western,6531,8949,15480,261240,357960,619200
6/21/2024,Kanchana Wijewardene,Kalutara,Kalutara,Western,900,1825,2725,36000,73000,109000
6/22/2024,Kanchana Wijewardene,Kalutara,Kalutara,Western,7061,901,7962,282440,36040,318480
6/23/2024,Kanchana Wijewardene,Kalutara,Kalutara,Western,1210,7190,8400,48400,287600,336000
6/24/2024,Kanchana Wijewardene,Kalutara,Kalutara,Western,1118,8346,9464,44720,333840,378560
6/25/2024,Kanchana Wijewardene,Kalutara,Kalutara,Western,3641,2925,6566,145640,117000,262640
6/26/2024,Kanchana Wijewardene,Kalutara,Kalutara,Western,8387,8807,17194,335480,352280,687760
6/27/2024,Kanchana Wijewardene,Kalutara,Kalutara,Western,8816,9635,18451,352640,385400,738040
6/28/2024,Kanchana Wijewardene,Kalutara,Kalutara,Western,4719,7067,11786,188760,282680,471440
6/29/2024,Kanchana Wijewardene,Kalutara,Kalutara,Western,1171,205,1376,46840,8200,55040
6/30/2024,Kanchana Wijewardene,Kalutara,Kalutara,Western,90,8790,8880,3600,351600,355200
7/1/2024,Kanchana Wijewardene,Kalutara,Kalutara,Western,6474,2633,9107,258960,105320,364280
7/2/2024,Kanchana Wijewardene,Kalutara,Kalutara,Western,386,1481,1867,15440,59240,74680
7/3/2024,Kanchana Wijewardene,Kalutara,Kalutara,Western,6042,8091,14133,241680,323640,565320
7/4/2024,Kanchana Wijewardene,Kalutara,Kalutara,Western,7292,3285,10577,291680,131400,423080
7/5/2024,Kanchana Wijewardene,Kalutara,Kalutara,Western,5394,9097,14491,215760,363880,579640
7/6/2024,Kanchana Wijewardene,Kalutara,Kalutara,Western,5984,8691,14675,239360,347640,587000
7/7/2024,Kanchana Wijewardene,Kalutara,Kalutara,Western,9736,9386,19122,389440,375440,764880
7/8/2024,Kanchana Wijewardene,Kalutara,Kalutara,Western,4273,5681,9954,170920,227240,398160
7/9/2024,Kanchana Wijewardene,Kalutara,Kalutara,Western,8153,4172,12325,326120,166880,493000
7/10/2024,Kanchana Wijewardene,Kalutara,Kalutara,Western,9739,2062,11801,389560,82480,472040
7/11/2024,Kanchana Wijewardene,Kalutara,Kalutara,Western,1473,3667,5140,58920,146680,205600
7/12/2024,Kanchana Wijewardene,Kalutara,Kalutara,Western,9674,1399,11073,386960,55960,442920
7/13/2024,Kanchana Wijewardene,Kalutara,Kalutara,Western,4858,4289,9147,194320,171560,365880
7/14/2024,Kanchana Wijewardene,Kalutara,Kalutara,Western,6432,5802,12234,257280,232080,489360
7/15/2024,Kanchana Wijewardene,Kalutara,Kalutara,Western,2323,6736,9059,92920,269440,362360
7/16/2024,Kanchana Wijewardene,Kalutara,Kalutara,Western,5450,2462,7912,218000,98480,316480
7/17/2024,Kanchana Wijewardene,Kalutara,Kalutara,Western,4978,6716,11694,199120,268640,467760
7/18/2024,Kanchana Wijewardene,Kalutara,Kalutara,Western,86,8777,8863,3440,351080,354520
7/19/2024,Kanchana Wijewardene,Kalutara,Kalutara,Western,3841,1252,5093,153640,50080,203720
7/20/2024,Kanchana Wijewardene,Kalutara,Kalutara,Western,3412,182,3594,136480,7280,143760
7/21/2024,Kanchana Wijewardene,Kalutara,Kalutara,Western,9936,3649,13585,397440,145960,543400
7/22/2024,Kanchana Wijewardene,Kalutara,Kalutara,Western,3848,95,3943,153920,3800,157720
7/23/2024,Kanchana Wijewardene,Kalutara,Kalutara,Western,9702,3970,13672,388080,158800,546880
7/24/2024,Kanchana Wijewardene,Kalutara,Kalutara,Western,165,4940,5105,6600,197600,204200
7/25/2024,Kanchana Wijewardene,Kalutara,Kalutara,Western,9610,4929,14539,384400,197160,581560
7/26/2024,Kanchana Wijewardene,Kalutara,Kalutara,Western,8338,3733,12071,333520,149320,482840
7/27/2024,Kanchana Wijewardene,Kalutara,Kalutara,Western,7664,8927,16591,306560,357080,663640
7/28/2024,Kanchana Wijewardene,Kalutara,Kalutara,Western,7389,3023,10412,295560,120920,416480
7/29/2024,Kanchana Wijewardene,Kalutara,Kalutara,Western,6887,3872,10759,275480,154880,430360
7/30/2024,Kanchana Wijewardene,Kalutara,Kalutara,Western,2661,1453,4114,106440,58120,164560
7/31/2024,Kanchana Wijewardene,Kalutara,Kalutara,Western,8540,2827,11367,341600,113080,454680
8/1/2024,Kanchana Wijewardene,Kalutara,Kalutara,Western,3033,1586,4619,121320,63440,184760
8/2/2024,Kanchana Wijewardene,Kalutara,Kalutara,Western,9700,1059,10759,388000,42360,430360
8/3/2024,Kanchana Wijewardene,Kalutara,Kalutara,Western,732,4286,5018,29280,171440,200720
8/4/2024,Kanchana Wijewardene,Kalutara,Kalutara,Western,9290,1327,10617,371600,53080,424680
8/5/2024,Kanchana Wijewardene,Kalutara,Kalutara,Western,4047,2144,6191,161880,85760,247640
8/6/2024,Kanchana Wijewardene,Kalutara,Kalutara,Western,7040,3508,10548,281600,140320,421920
8/7/2024,Kanchana Wijewardene,Kalutara,Kalutara,Western,3677,6606,10283,147080,264240,411320
8/8/2024,Kanchana Wijewardene,Kalutara,Kalutara,Western,6028,8956,14984,241120,358240,599360
8/9/2024,Kanchana Wijewardene,Kalutara,Kalutara,Western,8801,7075,15876,352040,283000,635040
8/10/2024,Kanchana Wijewardene,Kalutara,Kalutara,Western,8862,5593,14455,354480,223720,578200
8/11/2024,Kanchana Wijewardene,Kalutara,Kalutara,Western,323,2555,2878,12920,102200,115120
8/12/2024,Kanchana Wijewardene,Kalutara,Kalutara,Western,3948,9054,13002,157920,362160,520080
8/13/2024,Kanchana Wijewardene,Kalutara,Kalutara,Western,1614,587,2201,64560,23480,88040
8/14/2024,Kanchana Wijewardene,Kalutara,Kalutara,Western,7440,8115,15555,297600,324600,622200
8/15/2024,Kanchana Wijewardene,Kalutara,Kalutara,Western,2600,3009,5609,104000,120360,224360
8/16/2024,Kanchana Wijewardene,Kalutara,Kalutara,Western,5184,1133,6317,207360,45320,252680
8/17/2024,Kanchana Wijewardene,Kalutara,Kalutara,Western,3264,2915,6179,130560,116600,247160
8/18/2024,Kanchana Wijewardene,Kalutara,Kalutara,Western,732,9033,9765,29280,361320,390600
8/19/2024,Kanchana Wijewardene,Kalutara,Kalutara,Western,3296,7048,10344,131840,281920,413760
8/20/2024,Kanchana Wijewardene,Kalutara,Kalutara,Western,6372,7935,14307,254880,317400,572280
8/21/2024,Kanchana Wijewardene,Kalutara,Kalutara,Western,821,9038,9859,32840,361520,394360
8/22/2024,Kanchana Wijewardene,Kalutara,Kalutara,Western,579,2684,3263,23160,107360,130520
8/23/2024,Kanchana Wijewardene,Kalutara,Kalutara,Western,7984,3110,11094,319360,124400,443760
8/24/2024,Kanchana Wijewardene,Kalutara,Kalutara,Western,2879,1146,4025,115160,45840,161000
8/25/2024,Kanchana Wijewardene,Kalutara,Kalutara,Western,7608,1656,9264,304320,66240,370560
8/26/2024,Kanchana Wijewardene,Kalutara,Kalutara,Western,9424,2073,11497,376960,82920,459880
8/27/2024,Kanchana Wijewardene,Kalutara,Kalutara,Western,9405,7776,17181,376200,311040,687240
8/28/2024,Kanchana Wijewardene,Kalutara,Kalutara,Western,1469,1613,3082,58760,64520,123280
8/29/2024,Kanchana Wijewardene,Kalutara,Kalutara,Western,3107,746,3853,124280,29840,154120
8/30/2024,Kanchana Wijewardene,Kalutara,Kalutara,Western,7398,5537,12935,295920,221480,517400
8/31/2024,Kanchana Wijewardene,Kalutara,Kalutara,Western,8423,3389,11812,336920,135560,472480
9/1/2024,Kanchana Wijewardene,Kalutara,Kalutara,Western,9527,3681,13208,381080,147240,528320
9/2/2024,Kanchana Wijewardene,Kalutara,Kalutara,Western,8551,4042,12593,342040,161680,503720
9/3/2024,Kanchana Wijewardene,Kalutara,Kalutara,Western,4601,6009,10610,184040,240360,424400
9/4/2024,Kanchana Wijewardene,Kalutara,Kalutara,Western,8893,6895,15788,355720,275800,631520
9/5/2024,Kanchana Wijewardene,Kalutara,Kalutara,Western,701,6131,6832,28040,245240,273280
9/6/2024,Kanchana Wijewardene,Kalutara,Kalutara,Western,1671,6480,8151,66840,259200,326040
9/7/2024,Kanchana Wijewardene,Kalutara,Kalutara,Western,4384,7764,12148,175360,310560,485920
9/8/2024,Kanchana Wijewardene,Kalutara,Kalutara,Western,7168,1065,8233,286720,42600,329320
9/9/2024,Kanchana Wijewardene,Kalutara,Kalutara,Western,2039,3519,5558,81560,140760,222320
9/10/2024,Kanchana Wijewardene,Kalutara,Kalutara,Western,4406,2600,7006,176240,104000,280240
9/11/2024,Kanchana Wijewardene,Kalutara,Kalutara,Western,7488,3609,11097,299520,144360,443880
9/12/2024,Kanchana Wijewardene,Kalutara,Kalutara,Western,3596,1103,4699,143840,44120,187960
9/13/2024,Kanchana Wijewardene,Kalutara,Kalutara,Western,6862,7118,13980,274480,284720,559200
9/14/2024,Kanchana Wijewardene,Kalutara,Kalutara,Western,3615,2242,5857,144600,89680,234280
9/15/2024,Kanchana Wijewardene,Kalutara,Kalutara,Western,5951,4014,9965,238040,160560,398600
9/16/2024,Kanchana Wijewardene,Kalutara,Kalutara,Western,3399,8723,12122,135960,348920,484880
9/17/2024,Kanchana Wijewardene,Kalutara,Kalutara,Western,4551,7417,11968,182040,296680,478720
9/18/2024,Kanchana Wijewardene,Kalutara,Kalutara,Western,2745,2793,5538,109800,111720,221520
9/19/2024,Kanchana Wijewardene,Kalutara,Kalutara,Western,7825,6668,14493,313000,266720,579720
9/20/2024,Kanchana Wijewardene,Kalutara,Kalutara,Western,3345,7330,10675,133800,293200,427000
9/21/2024,Kanchana Wijewardene,Kalutara,Kalutara,Western,3121,6115,9236,124840,244600,369440
9/22/2024,Kanchana Wijewardene,Kalutara,Kalutara,Western,3187,8832,12019,127480,353280,480760
9/23/2024,Kanchana Wijewardene,Kalutara,Kalutara,Western,9666,7849,17515,386640,313960,700600
9/24/2024,Kanchana Wijewardene,Kalutara,Kalutara,Western,2986,9679,12665,119440,387160,506600
9/25/2024,Kanchana Wijewardene,Kalutara,Kalutara,Western,4019,9165,13184,160760,366600,527360
9/26/2024,Kanchana Wijewardene,Kalutara,Kalutara,Western,2855,2488,5343,114200,99520,213720
9/27/2024,Kanchana Wijewardene,Kalutara,Kalutara,Western,9811,944,10755,392440,37760,430200
9/28/2024,Kanchana Wijewardene,Kalutara,Kalutara,Western,562,3365,3927,22480,134600,157080
9/29/2024,Kanchana Wijewardene,Kalutara,Kalutara,Western,9834,5384,15218,393360,215360,608720
9/30/2024,Kanchana Wijewardene,Kalutara,Kalutara,Western,232,7331,7563,9280,293240,302520
10/1/2024,Kanchana Wijewardene,Kalutara,Kalutara,Western,9200,4670,13870,368000,186800,554800
10/2/2024,Kanchana Wijewardene,Kalutara,Kalutara,Western,3165,3661,6826,126600,146440,273040
10/3/2024,Kanchana Wijewardene,Kalutara,Kalutara,Western,2595,2542,5137,103800,101680,205480
10/4/2024,Kanchana Wijewardene,Kalutara,Kalutara,Western,6395,7828,14223,255800,313120,568920
10/5/2024,Kanchana Wijewardene,Kalutara,Kalutara,Western,4118,226,4344,164720,9040,173760
10/6/2024,Kanchana Wijewardene,Kalutara,Kalutara,Western,8716,8100,16816,348640,324000,672640
10/7/2024,Kanchana Wijewardene,Kalutara,Kalutara,Western,3386,4881,8267,135440,195240,330680
10/8/2024,Kanchana Wijewardene,Kalutara,Kalutara,Western,8421,7648,16069,336840,305920,642760
10/9/2024,Kanchana Wijewardene,Kalutara,Kalutara,Western,3233,6949,10182,129320,277960,407280
10/10/2024,Kanchana Wijewardene,Kalutara,Kalutara,Western,7094,9254,16348,283760,370160,653920
10/11/2024,Kanchana Wijewardene,Kalutara,Kalutara,Western,8380,5825,14205,335200,233000,568200
10/12/2024,Kanchana Wijewardene,Kalutara,Kalutara,Western,103,8672,8775,4120,346880,351000
10/13/2024,Kanchana Wijewardene,Kalutara,Kalutara,Western,4516,8068,12584,180640,322720,503360
10/14/2024,Kanchana Wijewardene,Kalutara,Kalutara,Western,2473,4944,7417,98920,197760,296680
10/15/2024,Kanchana Wijewardene,Kalutara,Kalutara,Western,414,9817,10231,16560,392680,409240
10/16/2024,Kanchana Wijewardene,Kalutara,Kalutara,Western,8847,3226,12073,353880,129040,482920
10/17/2024,Kanchana Wijewardene,Kalutara,Kalutara,Western,5247,9711,14958,209880,388440,598320
10/18/2024,Kanchana Wijewardene,Kalutara,Kalutara,Western,7618,6126,13744,304720,245040,549760
10/19/2024,Kanchana Wijewardene,Kalutara,Kalutara,Western,4169,906,5075,166760,36240,203000
10/20/2024,Kanchana Wijewardene,Kalutara,Kalutara,Western,3445,4090,7535,137800,163600,301400
10/21/2024,Kanchana Wijewardene,Kalutara,Kalutara,Western,9298,7240,16538,371920,289600,661520
10/22/2024,Kanchana Wijewardene,Kalutara,Kalutara,Western,3437,1663,5100,137480,66520,204000
10/23/2024,Kanchana Wijewardene,Kalutara,Kalutara,Western,5616,3896,9512,224640,155840,380480
10/24/2024,Kanchana Wijewardene,Kalutara,Kalutara,Western,9890,9980,19870,395600,399200,794800
10/25/2024,Kanchana Wijewardene,Kalutara,Kalutara,Western,376,1307,1683,15040,52280,67320
10/26/2024,Kanchana Wijewardene,Kalutara,Kalutara,Western,8901,3517,12418,356040,140680,496720
10/27/2024,Kanchana Wijewardene,Kalutara,Kalutara,Western,3570,3875,7445,142800,155000,297800
10/28/2024,Kanchana Wijewardene,Kalutara,Kalutara,Western,2548,5185,7733,101920,207400,309320
10/29/2024,Kanchana Wijewardene,Kalutara,Kalutara,Western,8620,6913,15533,344800,276520,621320
10/30/2024,Kanchana Wijewardene,Kalutara,Kalutara,Western,4304,8168,12472,172160,326720,498880
10/31/2024,Kanchana Wijewardene,Kalutara,Kalutara,Western,8568,6178,14746,342720,247120,589840
11/1/2024,Kanchana Wijewardene,Kalutara,Kalutara,Western,5638,6099,11737,225520,243960,469480
11/2/2024,Kanchana Wijewardene,Kalutara,Kalutara,Western,9956,6357,16313,398240,254280,652520
11/3/2024,Kanchana Wijewardene,Kalutara,Kalutara,Western,2094,2774,4868,83760,110960,194720
11/4/2024,Kanchana Wijewardene,Kalutara,Kalutara,Western,5215,954,6169,208600,38160,246760
11/5/2024,Kanchana Wijewardene,Kalutara,Kalutara,Western,271,7727,7998,10840,309080,319920
11/6/2024,Kanchana Wijewardene,Kalutara,Kalutara,Western,2201,6148,8349,88040,245920,333960
11/7/2024,Kanchana Wijewardene,Kalutara,Kalutara,Western,6402,7193,13595,256080,287720,543800
11/8/2024,Kanchana Wijewardene,Kalutara,Kalutara,Western,8958,4674,13632,358320,186960,545280
11/9/2024,Kanchana Wijewardene,Kalutara,Kalutara,Western,9276,9847,19123,371040,393880,764920
11/10/2024,Kanchana Wijewardene,Kalutara,Kalutara,Western,7245,8709,15954,289800,348360,638160
11/11/2024,Kanchana Wijewardene,Kalutara,Kalutara,Western,510,582,1092,20400,23280,43680
11/12/2024,Kanchana Wijewardene,Kalutara,Kalutara,Western,2610,3746,6356,104400,149840,254240
11/13/2024,Kanchana Wijewardene,Kalutara,Kalutara,Western,3730,8496,12226,149200,339840,489040
11/14/2024,Kanchana Wijewardene,Kalutara,Kalutara,Western,2308,4672,6980,92320,186880,279200
11/15/2024,Kanchana Wijewardene,Kalutara,Kalutara,Western,6449,7762,14211,257960,310480,568440
11/16/2024,Kanchana Wijewardene,Kalutara,Kalutara,Western,7396,6902,14298,295840,276080,571920
11/17/2024,Kanchana Wijewardene,Kalutara,Kalutara,Western,1458,7063,8521,58320,282520,340840
11/18/2024,Kanchana Wijewardene,Kalutara,Kalutara,Western,6956,8569,15525,278240,342760,621000
11/19/2024,Kanchana Wijewardene,Kalutara,Kalutara,Western,2220,7369,9589,88800,294760,383560
11/20/2024,Kanchana Wijewardene,Kalutara,Kalutara,Western,2104,124,2228,84160,4960,89120
11/21/2024,Kanchana Wijewardene,Kalutara,Kalutara,Western,9956,2920,12876,398240,116800,515040
11/22/2024,Kanchana Wijewardene,Kalutara,Kalutara,Western,2694,143,2837,107760,5720,113480
11/23/2024,Kanchana Wijewardene,Kalutara,Kalutara,Western,9597,2765,12362,383880,110600,494480
11/24/2024,Kanchana Wijewardene,Kalutara,Kalutara,Western,8888,6542,15430,355520,261680,617200
11/25/2024,Kanchana Wijewardene,Kalutara,Kalutara,Western,4630,7155,11785,185200,286200,471400
11/26/2024,Kanchana Wijewardene,Kalutara,Kalutara,Western,1718,7380,9098,68720,295200,363920
11/27/2024,Kanchana Wijewardene,Kalutara,Kalutara,Western,9766,1971,11737,390640,78840,469480
11/28/2024,Kanchana Wijewardene,Kalutara,Kalutara,Western,1202,9228,10430,48080,369120,417200
11/29/2024,Kanchana Wijewardene,Kalutara,Kalutara,Western,937,7754,8691,37480,310160,347640
11/30/2024,Kanchana Wijewardene,Kalutara,Kalutara,Western,9738,4406,14144,389520,176240,565760
12/1/2024,Kanchana Wijewardene,Kalutara,Kalutara,Western,2483,6192,8675,99320,247680,347000
12/2/2024,Kanchana Wijewardene,Kalutara,Kalutara,Western,5896,3736,9632,235840,149440,385280
12/3/2024,Kanchana Wijewardene,Kalutara,Kalutara,Western,9919,6144,16063,396760,245760,642520
12/4/2024,Kanchana Wijewardene,Kalutara,Kalutara,Western,1737,209,1946,69480,8360,77840
12/5/2024,Kanchana Wijewardene,Kalutara,Kalutara,Western,2604,4851,7455,104160,194040,298200
12/6/2024,Kanchana Wijewardene,Kalutara,Kalutara,Western,5862,4907,10769,234480,196280,430760
12/7/2024,Kanchana Wijewardene,Kalutara,Kalutara,Western,1007,1165,2172,40280,46600,86880
12/8/2024,Kanchana Wijewardene,Kalutara,Kalutara,Western,2810,6175,8985,112400,247000,359400
12/9/2024,Kanchana Wijewardene,Kalutara,Kalutara,Western,4402,9073,13475,176080,362920,539000
12/10/2024,Kanchana Wijewardene,Kalutara,Kalutara,Western,6542,8450,14992,261680,338000,599680
12/11/2024,Kanchana Wijewardene,Kalutara,Kalutara,Western,2120,4528,6648,84800,181120,265920
12/12/2024,Kanchana Wijewardene,Kalutara,Kalutara,Western,86,2240,2326,3440,89600,93040
12/13/2024,Kanchana Wijewardene,Kalutara,Kalutara,Western,2712,4606,7318,108480,184240,292720
12/14/2024,Kanchana Wijewardene,Kalutara,Kalutara,Western,5779,6819,12598,231160,272760,503920
12/15/2024,Kanchana Wijewardene,Kalutara,Kalutara,Western,1067,5475,6542,42680,219000,261680
12/16/2024,Kanchana Wijewardene,Kalutara,Kalutara,Western,9434,7953,17387,377360,318120,695480
12/17/2024,Kanchana Wijewardene,Kalutara,Kalutara,Western,7773,4797,12570,310920,191880,502800
12/18/2024,Kanchana Wijewardene,Kalutara,Kalutara,Western,8520,4126,12646,340800,165040,505840
12/19/2024,Kanchana Wijewardene,Kalutara,Kalutara,Western,9144,4996,14140,365760,199840,565600
12/20/2024,Kanchana Wijewardene,Kalutara,Kalutara,Western,4548,1201,5749,181920,48040,229960
12/21/2024,Kanchana Wijewardene,Kalutara,Kalutara,Western,8267,4570,12837,330680,182800,513480
12/22/2024,Kanchana Wijewardene,Kalutara,Kalutara,Western,4218,3652,7870,168720,146080,314800
12/23/2024,Kanchana Wijewardene,Kalutara,Kalutara,Western,6130,8985,15115,245200,359400,604600
12/24/2024,Kanchana Wijewardene,Kalutara,Kalutara,Western,9844,1108,10952,393760,44320,438080
12/25/2024,Kanchana Wijewardene,Kalutara,Kalutara,Western,3536,8586,12122,141440,343440,484880
12/26/2024,Kanchana Wijewardene,Kalutara,Kalutara,Western,9037,7371,16408,361480,294840,656320
12/27/2024,Kanchana Wijewardene,Kalutara,Kalutara,Western,2943,3111,6054,117720,124440,242160
12/28/2024,Kanchana Wijewardene,Kalutara,Kalutara,Western,802,4211,5013,32080,168440,200520
12/29/2024,Kanchana Wijewardene,Kalutara,Kalutara,Western,1948,6114,8062,77920,244560,322480
12/30/2024,Kanchana Wijewardene,Kalutara,Kalutara,Western,9567,6688,16255,382680,267520,650200
12/31/2024,Kanchana Wijewardene,Kalutara,Kalutara,Western,4959,1762,6721,198360,70480,268840
1/1/2025,Kanchana Wijewardene,Kalutara,Kalutara,Western,2122,3347,5469,84880,133880,218760
1/2/2025,Kanchana Wijewardene,Kalutara,Kalutara,Western,143,4424,4567,5720,176960,182680
1/3/2025,Kanchana Wijewardene,Kalutara,Kalutara,Western,8987,1783,10770,359480,71320,430800
1/4/2025,Kanchana Wijewardene,Kalutara,Kalutara,Western,3061,9065,12126,122440,362600,485040
1/5/2025,Kanchana Wijewardene,Kalutara,Kalutara,Western,6168,2732,8900,246720,109280,356000
1/6/2025,Kanchana Wijewardene,Kalutara,Kalutara,Western,2111,7706,9817,84440,308240,392680
1/7/2025,Kanchana Wijewardene,Kalutara,Kalutara,Western,7725,1158,8883,309000,46320,355320
1/8/2025,Kanchana Wijewardene,Kalutara,Kalutara,Western,8520,68,8588,340800,2720,343520
1/9/2025,Kanchana Wijewardene,Kalutara,Kalutara,Western,9531,548,10079,381240,21920,403160
1/10/2025,Kanchana Wijewardene,Kalutara,Kalutara,Western,3739,7416,11155,149560,296640,446200
1/11/2025,Kanchana Wijewardene,Kalutara,Kalutara,Western,2193,5371,7564,87720,214840,302560
1/12/2025,Kanchana Wijewardene,Kalutara,Kalutara,Western,8256,678,8934,330240,27120,357360
1/13/2025,Kanchana Wijewardene,Kalutara,Kalutara,Western,6123,4193,10316,244920,167720,412640
1/14/2025,Kanchana Wijewardene,Kalutara,Kalutara,Western,8065,439,8504,322600,17560,340160
1/15/2025,Kanchana Wijewardene,Kalutara,Kalutara,Western,3078,4195,7273,123120,167800,290920
1/16/2025,Kanchana Wijewardene,Kalutara,Kalutara,Western,9833,9933,19766,393320,397320,790640
1/17/2025,Kanchana Wijewardene,Kalutara,Kalutara,Western,5138,5946,11084,205520,237840,443360
1/18/2025,Kanchana Wijewardene,Kalutara,Kalutara,Western,2162,2602,4764,86480,104080,190560
1/19/2025,Kanchana Wijewardene,Kalutara,Kalutara,Western,2174,6780,8954,86960,271200,358160
1/20/2025,Kanchana Wijewardene,Kalutara,Kalutara,Western,7575,439,8014,303000,17560,320560
1/21/2025,Kanchana Wijewardene,Kalutara,Kalutara,Western,6610,25,6635,264400,1000,265400
1/22/2025,Kanchana Wijewardene,Kalutara,Kalutara,Western,5475,2460,7935,219000,98400,317400
1/23/2025,Kanchana Wijewardene,Kalutara,Kalutara,Western,7352,4117,11469,294080,164680,458760
1/24/2025,Kanchana Wijewardene,Kalutara,Kalutara,Western,6079,8227,14306,243160,329080,572240
1/25/2025,Kanchana Wijewardene,Kalutara,Kalutara,Western,7402,8814,16216,296080,352560,648640
1/26/2025,Kanchana Wijewardene,Kalutara,Kalutara,Western,7207,5683,12890,288280,227320,515600
1/27/2025,Kanchana Wijewardene,Kalutara,Kalutara,Western,6407,6639,13046,256280,265560,521840
1/28/2025,Kanchana Wijewardene,Kalutara,Kalutara,Western,5892,8640,14532,235680,345600,581280
1/29/2025,Kanchana Wijewardene,Kalutara,Kalutara,Western,8941,2564,11505,357640,102560,460200
1/30/2025,Kanchana Wijewardene,Kalutara,Kalutara,Western,5535,5240,10775,221400,209600,431000
1/31/2025,Kanchana Wijewardene,Kalutara,Kalutara,Western,7439,2596,10035,297560,103840,401400
2/1/2025,Kanchana Wijewardene,Kalutara,Kalutara,Western,8797,7277,16074,351880,291080,642960
2/2/2025,Kanchana Wijewardene,Kalutara,Kalutara,Western,6307,8847,15154,252280,353880,606160
2/3/2025,Kanchana Wijewardene,Kalutara,Kalutara,Western,8690,7945,16635,347600,317800,665400
2/4/2025,Kanchana Wijewardene,Kalutara,Kalutara,Western,8076,8100,16176,323040,324000,647040
2/5/2025,Kanchana Wijewardene,Kalutara,Kalutara,Western,4541,5988,10529,181640,239520,421160
2/6/2025,Kanchana Wijewardene,Kalutara,Kalutara,Western,906,8959,9865,36240,358360,394600
2/7/2025,Kanchana Wijewardene,Kalutara,Kalutara,Western,9072,8257,17329,362880,330280,693160
2/8/2025,Kanchana Wijewardene,Kalutara,Kalutara,Western,5507,1781,7288,220280,71240,291520
2/9/2025,Kanchana Wijewardene,Kalutara,Kalutara,Western,6366,4042,10408,254640,161680,416320
2/10/2025,Kanchana Wijewardene,Kalutara,Kalutara,Western,9514,5445,14959,380560,217800,598360
2/11/2025,Kanchana Wijewardene,Kalutara,Kalutara,Western,7223,6101,13324,288920,244040,532960
2/12/2025,Kanchana Wijewardene,Kalutara,Kalutara,Western,6847,9759,16606,273880,390360,664240
2/13/2025,Kanchana Wijewardene,Kalutara,Kalutara,Western,570,4554,5124,22800,182160,204960
2/14/2025,Kanchana Wijewardene,Kalutara,Kalutara,Western,6051,3527,9578,242040,141080,383120
2/15/2025,Kanchana Wijewardene,Kalutara,Kalutara,Western,9144,2657,11801,365760,106280,472040
2/16/2025,Kanchana Wijewardene,Kalutara,Kalutara,Western,5367,1331,6698,214680,53240,267920
2/17/2025,Kanchana Wijewardene,Kalutara,Kalutara,Western,5779,4753,10532,231160,190120,421280
2/18/2025,Kanchana Wijewardene,Kalutara,Kalutara,Western,3456,8680,12136,138240,347200,485440
2/19/2025,Kanchana Wijewardene,Kalutara,Kalutara,Western,1287,117,1404,51480,4680,56160
2/20/2025,Kanchana Wijewardene,Kalutara,Kalutara,Western,6443,1443,7886,257720,57720,315440
2/21/2025,Kanchana Wijewardene,Kalutara,Kalutara,Western,9895,9815,19710,395800,392600,788400
2/22/2025,Kanchana Wijewardene,Kalutara,Kalutara,Western,2484,2592,5076,99360,103680,203040
2/23/2025,Kanchana Wijewardene,Kalutara,Kalutara,Western,7611,9856,17467,304440,394240,698680
2/24/2025,Kanchana Wijewardene,Kalutara,Kalutara,Western,4932,4963,9895,197280,198520,395800
2/25/2025,Kanchana Wijewardene,Kalutara,Kalutara,Western,2316,69,2385,92640,2760,95400
2/26/2025,Kanchana Wijewardene,Kalutara,Kalutara,Western,2755,858,3613,110200,34320,144520
2/27/2025,Kanchana Wijewardene,Kalutara,Kalutara,Western,4436,2540,6976,177440,101600,279040
2/28/2025,Kanchana Wijewardene,Kalutara,Kalutara,Western,9498,8679,18177,379920,347160,727080
3/1/2025,Kanchana Wijewardene,Kalutara,Kalutara,Western,4472,9292,13764,178880,371680,550560
3/2/2025,Kanchana Wijewardene,Kalutara,Kalutara,Western,8598,9639,18237,343920,385560,729480
3/3/2025,Kanchana Wijewardene,Kalutara,Kalutara,Western,7810,4004,11814,312400,160160,472560
3/4/2025,Kanchana Wijewardene,Kalutara,Kalutara,Western,2655,1507,4162,106200,60280,166480
3/5/2025,Kanchana Wijewardene,Kalutara,Kalutara,Western,3930,7992,11922,157200,319680,476880
3/6/2025,Kanchana Wijewardene,Kalutara,Kalutara,Western,5230,1502,6732,209200,60080,269280
3/7/2025,Kanchana Wijewardene,Kalutara,Kalutara,Western,8279,4955,13234,331160,198200,529360
3/8/2025,Kanchana Wijewardene,Kalutara,Kalutara,Western,4747,2497,7244,189880,99880,289760
3/9/2025,Kanchana Wijewardene,Kalutara,Kalutara,Western,4309,6955,11264,172360,278200,450560
3/10/2025,Kanchana Wijewardene,Kalutara,Kalutara,Western,8264,6953,15217,330560,278120,608680
3/11/2025,Kanchana Wijewardene,Kalutara,Kalutara,Western,9905,330,10235,396200,13200,409400
3/12/2025,Kanchana Wijewardene,Kalutara,Kalutara,Western,6741,2351,9092,269640,94040,363680
3/13/2025,Kanchana Wijewardene,Kalutara,Kalutara,Western,2993,5967,8960,119720,238680,358400
3/14/2025,Kanchana Wijewardene,Kalutara,Kalutara,Western,4930,8507,13437,197200,340280,537480
3/15/2025,Kanchana Wijewardene,Kalutara,Kalutara,Western,9753,5134,14887,390120,205360,595480
3/16/2025,Kanchana Wijewardene,Kalutara,Kalutara,Western,3423,7984,11407,136920,319360,456280
3/17/2025,Kanchana Wijewardene,Kalutara,Kalutara,Western,4346,9767,14113,173840,390680,564520
3/18/2025,Kanchana Wijewardene,Kalutara,Kalutara,Western,9463,3702,13165,378520,148080,526600
3/19/2025,Kanchana Wijewardene,Kalutara,Kalutara,Western,2817,6541,9358,112680,261640,374320
3/20/2025,Kanchana Wijewardene,Kalutara,Kalutara,Western,4625,8487,13112,185000,339480,524480
3/21/2025,Kanchana Wijewardene,Kalutara,Kalutara,Western,6915,2868,9783,276600,114720,391320
3/22/2025,Kanchana Wijewardene,Kalutara,Kalutara,Western,998,5494,6492,39920,219760,259680
3/23/2025,Kanchana Wijewardene,Kalutara,Kalutara,Western,9199,4050,13249,367960,162000,529960
3/25/2024,Uthpala Rajapaksha,Kurunegala,Dambulla,North Western,3286,4324,7610,131440,172960,304400
3/26/2024,Uthpala Rajapaksha,Kurunegala,Dambulla,North Western,7466,3333,10799,298640,133320,431960
3/27/2024,Uthpala Rajapaksha,Kurunegala,Dambulla,North Western,6928,5682,12610,277120,227280,504400
3/28/2024,Uthpala Rajapaksha,Kurunegala,Dambulla,North Western,2307,5659,7966,92280,226360,318640
3/29/2024,Uthpala Rajapaksha,Kurunegala,Dambulla,North Western,256,5471,5727,10240,218840,229080
3/30/2024,Uthpala Rajapaksha,Kurunegala,Dambulla,North Western,1344,1388,2732,53760,55520,109280
3/31/2024,Uthpala Rajapaksha,Kurunegala,Dambulla,North Western,5062,7250,12312,202480,290000,492480
4/1/2024,Uthpala Rajapaksha,Kurunegala,Dambulla,North Western,757,2632,3389,30280,105280,135560
4/2/2024,Uthpala Rajapaksha,Kurunegala,Dambulla,North Western,1327,8,1335,53080,320,53400
4/3/2024,Uthpala Rajapaksha,Kurunegala,Dambulla,North Western,2616,8070,10686,104640,322800,427440
4/4/2024,Uthpala Rajapaksha,Kurunegala,Dambulla,North Western,9049,6346,15395,361960,253840,615800
4/5/2024,Uthpala Rajapaksha,Kurunegala,Dambulla,North Western,5904,1076,6980,236160,43040,279200
4/6/2024,Uthpala Rajapaksha,Kurunegala,Dambulla,North Western,8156,300,8456,326240,12000,338240
4/7/2024,Uthpala Rajapaksha,Kurunegala,Dambulla,North Western,233,9541,9774,9320,381640,390960
4/8/2024,Uthpala Rajapaksha,Kurunegala,Dambulla,North Western,5884,2853,8737,235360,114120,349480
4/9/2024,Uthpala Rajapaksha,Kurunegala,Dambulla,North Western,6420,9004,15424,256800,360160,616960
4/10/2024,Uthpala Rajapaksha,Kurunegala,Dambulla,North Western,3075,4304,7379,123000,172160,295160
4/11/2024,Uthpala Rajapaksha,Kurunegala,Dambulla,North Western,2352,4874,7226,94080,194960,289040
4/19/2024,Uthpala Rajapaksha,Kurunegala,Dambulla,North Western,8230,2703,10933,329200,108120,437320
4/20/2024,Uthpala Rajapaksha,Kurunegala,Dambulla,North Western,2461,7388,9849,98440,295520,393960
4/21/2024,Uthpala Rajapaksha,Kurunegala,Dambulla,North Western,8624,4284,12908,344960,171360,516320
4/22/2024,Uthpala Rajapaksha,Kurunegala,Dambulla,North Western,3278,5724,9002,131120,228960,360080
4/23/2024,Uthpala Rajapaksha,Kurunegala,Dambulla,North Western,7985,7566,15551,319400,302640,622040
4/24/2024,Uthpala Rajapaksha,Kurunegala,Dambulla,North Western,5309,8746,14055,212360,349840,562200
4/25/2024,Uthpala Rajapaksha,Kurunegala,Dambulla,North Western,2876,4866,7742,115040,194640,309680
4/26/2024,Uthpala Rajapaksha,Kurunegala,Dambulla,North Western,7633,7920,15553,305320,316800,622120
4/27/2024,Uthpala Rajapaksha,Kurunegala,Dambulla,North Western,4941,8662,13603,197640,346480,544120
4/28/2024,Uthpala Rajapaksha,Kurunegala,Dambulla,North Western,3889,5198,9087,155560,207920,363480
4/29/2024,Uthpala Rajapaksha,Kurunegala,Dambulla,North Western,1582,9183,10765,63280,367320,430600
4/30/2024,Uthpala Rajapaksha,Kurunegala,Dambulla,North Western,2594,4584,7178,103760,183360,287120
5/1/2024,Uthpala Rajapaksha,Kurunegala,Dambulla,North Western,8825,3330,12155,353000,133200,486200
5/2/2024,Uthpala Rajapaksha,Kurunegala,Dambulla,North Western,7645,8907,16552,305800,356280,662080
5/3/2024,Uthpala Rajapaksha,Kurunegala,Dambulla,North Western,3826,2898,6724,153040,115920,268960
5/4/2024,Uthpala Rajapaksha,Kurunegala,Dambulla,North Western,4886,1798,6684,195440,71920,267360
5/5/2024,Uthpala Rajapaksha,Kurunegala,Dambulla,North Western,1873,1801,3674,74920,72040,146960
5/6/2024,Uthpala Rajapaksha,Kurunegala,Dambulla,North Western,1053,3074,4127,42120,122960,165080
5/7/2024,Uthpala Rajapaksha,Kurunegala,Dambulla,North Western,7403,7324,14727,296120,292960,589080
5/8/2024,Uthpala Rajapaksha,Kurunegala,Dambulla,North Western,3026,1275,4301,121040,51000,172040
5/9/2024,Uthpala Rajapaksha,Kurunegala,Dambulla,North Western,3881,703,4584,155240,28120,183360
5/10/2024,Uthpala Rajapaksha,Kurunegala,Dambulla,North Western,2548,2004,4552,101920,80160,182080
5/11/2024,Uthpala Rajapaksha,Kurunegala,Dambulla,North Western,9321,8316,17637,372840,332640,705480
5/12/2024,Uthpala Rajapaksha,Kurunegala,Dambulla,North Western,5909,3380,9289,236360,135200,371560
5/13/2024,Uthpala Rajapaksha,Kurunegala,Dambulla,North Western,9919,2307,12226,396760,92280,489040
5/14/2024,Uthpala Rajapaksha,Kurunegala,Dambulla,North Western,1806,4494,6300,72240,179760,252000
5/15/2024,Uthpala Rajapaksha,Kurunegala,Dambulla,North Western,8030,8245,16275,321200,329800,651000
5/16/2024,Uthpala Rajapaksha,Kurunegala,Dambulla,North Western,6204,3432,9636,248160,137280,385440
5/17/2024,Uthpala Rajapaksha,Kurunegala,Dambulla,North Western,2902,8652,11554,116080,346080,462160
5/18/2024,Uthpala Rajapaksha,Kurunegala,Dambulla,North Western,2361,2444,4805,94440,97760,192200
5/19/2024,Uthpala Rajapaksha,Kurunegala,Dambulla,North Western,5473,9380,14853,218920,375200,594120
5/20/2024,Uthpala Rajapaksha,Kurunegala,Dambulla,North Western,5037,1826,6863,201480,73040,274520
5/21/2024,Uthpala Rajapaksha,Kurunegala,Dambulla,North Western,4191,9750,13941,167640,390000,557640
5/22/2024,Uthpala Rajapaksha,Kurunegala,Dambulla,North Western,8444,612,9056,337760,24480,362240
5/24/2024,Uthpala Rajapaksha,Kurunegala,Dambulla,North Western,6149,9906,16055,245960,396240,642200
5/25/2024,Uthpala Rajapaksha,Kurunegala,Dambulla,North Western,4417,8749,13166,176680,349960,526640
5/26/2024,Uthpala Rajapaksha,Kurunegala,Dambulla,North Western,1673,7582,9255,66920,303280,370200
5/27/2024,Uthpala Rajapaksha,Kurunegala,Dambulla,North Western,6343,4416,10759,253720,176640,430360
5/28/2024,Uthpala Rajapaksha,Kurunegala,Dambulla,North Western,3688,4092,7780,147520,163680,311200
5/29/2024,Uthpala Rajapaksha,Kurunegala,Dambulla,North Western,9120,8620,17740,364800,344800,709600
5/30/2024,Uthpala Rajapaksha,Kurunegala,Dambulla,North Western,2301,7367,9668,92040,294680,386720
5/31/2024,Uthpala Rajapaksha,Kurunegala,Dambulla,North Western,4665,9031,13696,186600,361240,547840
6/1/2024,Uthpala Rajapaksha,Kurunegala,Dambulla,North Western,9824,2105,11929,392960,84200,477160
6/2/2024,Uthpala Rajapaksha,Kurunegala,Dambulla,North Western,6637,4223,10860,265480,168920,434400
6/3/2024,Uthpala Rajapaksha,Kurunegala,Dambulla,North Western,1784,3864,5648,71360,154560,225920
6/4/2024,Uthpala Rajapaksha,Kurunegala,Dambulla,North Western,1875,1703,3578,75000,68120,143120
6/5/2024,Uthpala Rajapaksha,Kurunegala,Dambulla,North Western,9944,2467,12411,397760,98680,496440
6/6/2024,Uthpala Rajapaksha,Kurunegala,Dambulla,North Western,4606,5441,10047,184240,217640,401880
6/7/2024,Uthpala Rajapaksha,Kurunegala,Dambulla,North Western,5722,6430,12152,228880,257200,486080
6/8/2024,Uthpala Rajapaksha,Kurunegala,Dambulla,North Western,9250,2608,11858,370000,104320,474320
6/9/2024,Uthpala Rajapaksha,Kurunegala,Dambulla,North Western,7933,3807,11740,317320,152280,469600
6/10/2024,Uthpala Rajapaksha,Kurunegala,Dambulla,North Western,1485,6209,7694,59400,248360,307760
6/11/2024,Uthpala Rajapaksha,Kurunegala,Dambulla,North Western,5672,7906,13578,226880,316240,543120
6/12/2024,Uthpala Rajapaksha,Kurunegala,Dambulla,North Western,5143,7451,12594,205720,298040,503760
6/13/2024,Uthpala Rajapaksha,Kurunegala,Dambulla,North Western,4501,3429,7930,180040,137160,317200
6/14/2024,Uthpala Rajapaksha,Kurunegala,Dambulla,North Western,652,9030,9682,26080,361200,387280
6/15/2024,Uthpala Rajapaksha,Kurunegala,Dambulla,North Western,7241,5248,12489,289640,209920,499560
6/16/2024,Uthpala Rajapaksha,Kurunegala,Dambulla,North Western,7183,3960,11143,287320,158400,445720
6/17/2024,Uthpala Rajapaksha,Kurunegala,Dambulla,North Western,357,8272,8629,14280,330880,345160
6/18/2024,Uthpala Rajapaksha,Kurunegala,Dambulla,North Western,2731,8094,10825,109240,323760,433000
6/19/2024,Uthpala Rajapaksha,Kurunegala,Dambulla,North Western,644,2391,3035,25760,95640,121400
6/20/2024,Uthpala Rajapaksha,Kurunegala,Dambulla,North Western,2652,2006,4658,106080,80240,186320
6/21/2024,Uthpala Rajapaksha,Kurunegala,Dambulla,North Western,6231,9409,15640,249240,376360,625600
6/22/2024,Uthpala Rajapaksha,Kurunegala,Dambulla,North Western,2723,2746,5469,108920,109840,218760
6/23/2024,Uthpala Rajapaksha,Kurunegala,Dambulla,North Western,7185,722,7907,287400,28880,316280
6/24/2024,Uthpala Rajapaksha,Kurunegala,Dambulla,North Western,9016,8053,17069,360640,322120,682760
6/25/2024,Uthpala Rajapaksha,Kurunegala,Dambulla,North Western,7363,442,7805,294520,17680,312200
6/26/2024,Uthpala Rajapaksha,Kurunegala,Dambulla,North Western,6019,1092,7111,240760,43680,284440
6/27/2024,Uthpala Rajapaksha,Kurunegala,Dambulla,North Western,7435,3747,11182,297400,149880,447280
6/28/2024,Uthpala Rajapaksha,Kurunegala,Dambulla,North Western,9699,703,10402,387960,28120,416080
6/29/2024,Uthpala Rajapaksha,Kurunegala,Dambulla,North Western,5716,6466,12182,228640,258640,487280
6/30/2024,Uthpala Rajapaksha,Kurunegala,Dambulla,North Western,9130,9606,18736,365200,384240,749440
7/1/2024,Uthpala Rajapaksha,Kurunegala,Dambulla,North Western,7968,9301,17269,318720,372040,690760
7/2/2024,Uthpala Rajapaksha,Kurunegala,Dambulla,North Western,7301,7709,15010,292040,308360,600400
7/3/2024,Uthpala Rajapaksha,Kurunegala,Dambulla,North Western,8898,8910,17808,355920,356400,712320
7/4/2024,Uthpala Rajapaksha,Kurunegala,Dambulla,North Western,4345,2457,6802,173800,98280,272080
7/5/2024,Uthpala Rajapaksha,Kurunegala,Dambulla,North Western,9828,8207,18035,393120,328280,721400
7/6/2024,Uthpala Rajapaksha,Kurunegala,Dambulla,North Western,3775,1396,5171,151000,55840,206840
7/7/2024,Uthpala Rajapaksha,Kurunegala,Dambulla,North Western,2857,5296,8153,114280,211840,326120
7/8/2024,Uthpala Rajapaksha,Kurunegala,Dambulla,North Western,9664,4988,14652,386560,199520,586080
7/9/2024,Uthpala Rajapaksha,Kurunegala,Dambulla,North Western,7966,7257,15223,318640,290280,608920
7/10/2024,Uthpala Rajapaksha,Kurunegala,Dambulla,North Western,2734,1484,4218,109360,59360,168720
7/11/2024,Uthpala Rajapaksha,Kurunegala,Dambulla,North Western,698,9351,10049,27920,374040,401960
7/12/2024,Uthpala Rajapaksha,Kurunegala,Dambulla,North Western,8288,9589,17877,331520,383560,715080
7/13/2024,Uthpala Rajapaksha,Kurunegala,Dambulla,North Western,2645,4992,7637,105800,199680,305480
7/14/2024,Uthpala Rajapaksha,Kurunegala,Dambulla,North Western,4234,1112,5346,169360,44480,213840
7/15/2024,Uthpala Rajapaksha,Kurunegala,Dambulla,North Western,5717,3378,9095,228680,135120,363800
7/16/2024,Uthpala Rajapaksha,Kurunegala,Dambulla,North Western,2762,5139,7901,110480,205560,316040
7/17/2024,Uthpala Rajapaksha,Kurunegala,Dambulla,North Western,2623,2053,4676,104920,82120,187040
7/18/2024,Uthpala Rajapaksha,Kurunegala,Dambulla,North Western,8959,1947,10906,358360,77880,436240
7/19/2024,Uthpala Rajapaksha,Kurunegala,Dambulla,North Western,8507,937,9444,340280,37480,377760
7/20/2024,Uthpala Rajapaksha,Kurunegala,Dambulla,North Western,1280,4745,6025,51200,189800,241000
7/21/2024,Uthpala Rajapaksha,Kurunegala,Dambulla,North Western,5184,8137,13321,207360,325480,532840
7/22/2024,Uthpala Rajapaksha,Kurunegala,Dambulla,North Western,4391,9219,13610,175640,368760,544400
7/23/2024,Uthpala Rajapaksha,Kurunegala,Dambulla,North Western,7682,12,7694,307280,480,307760
7/24/2024,Uthpala Rajapaksha,Kurunegala,Dambulla,North Western,3260,4687,7947,130400,187480,317880
7/25/2024,Uthpala Rajapaksha,Kurunegala,Dambulla,North Western,4392,8993,13385,175680,359720,535400
7/26/2024,Uthpala Rajapaksha,Kurunegala,Dambulla,North Western,6714,4638,11352,268560,185520,454080
7/27/2024,Uthpala Rajapaksha,Kurunegala,Dambulla,North Western,5205,9491,14696,208200,379640,587840
7/28/2024,Uthpala Rajapaksha,Kurunegala,Dambulla,North Western,2236,6459,8695,89440,258360,347800
7/29/2024,Uthpala Rajapaksha,Kurunegala,Dambulla,North Western,4107,800,4907,164280,32000,196280
7/30/2024,Uthpala Rajapaksha,Kurunegala,Dambulla,North Western,6977,4253,11230,279080,170120,449200
7/31/2024,Uthpala Rajapaksha,Kurunegala,Dambulla,North Western,2649,9438,12087,105960,377520,483480
8/1/2024,Uthpala Rajapaksha,Kurunegala,Dambulla,North Western,9504,1435,10939,380160,57400,437560
8/2/2024,Uthpala Rajapaksha,Kurunegala,Dambulla,North Western,2054,8536,10590,82160,341440,423600
8/3/2024,Uthpala Rajapaksha,Kurunegala,Dambulla,North Western,1015,8526,9541,40600,341040,381640
8/4/2024,Uthpala Rajapaksha,Kurunegala,Dambulla,North Western,9592,7128,16720,383680,285120,668800
8/5/2024,Uthpala Rajapaksha,Kurunegala,Dambulla,North Western,6773,4121,10894,270920,164840,435760
8/6/2024,Uthpala Rajapaksha,Kurunegala,Dambulla,North Western,7037,2482,9519,281480,99280,380760
8/7/2024,Uthpala Rajapaksha,Kurunegala,Dambulla,North Western,6061,9622,15683,242440,384880,627320
8/8/2024,Uthpala Rajapaksha,Kurunegala,Dambulla,North Western,2791,3797,6588,111640,151880,263520
8/9/2024,Uthpala Rajapaksha,Kurunegala,Dambulla,North Western,8058,571,8629,322320,22840,345160
8/10/2024,Uthpala Rajapaksha,Kurunegala,Dambulla,North Western,5939,6693,12632,237560,267720,505280
8/11/2024,Uthpala Rajapaksha,Kurunegala,Dambulla,North Western,4634,7878,12512,185360,315120,500480
8/12/2024,Uthpala Rajapaksha,Kurunegala,Dambulla,North Western,9048,676,9724,361920,27040,388960
8/13/2024,Uthpala Rajapaksha,Kurunegala,Dambulla,North Western,6552,1897,8449,262080,75880,337960
8/14/2024,Uthpala Rajapaksha,Kurunegala,Dambulla,North Western,792,961,1753,31680,38440,70120
8/15/2024,Uthpala Rajapaksha,Kurunegala,Dambulla,North Western,4609,2304,6913,184360,92160,276520
8/16/2024,Uthpala Rajapaksha,Kurunegala,Dambulla,North Western,8767,6492,15259,350680,259680,610360
8/17/2024,Uthpala Rajapaksha,Kurunegala,Dambulla,North Western,2740,1513,4253,109600,60520,170120
8/18/2024,Uthpala Rajapaksha,Kurunegala,Dambulla,North Western,8368,9027,17395,334720,361080,695800
8/19/2024,Uthpala Rajapaksha,Kurunegala,Dambulla,North Western,9883,4376,14259,395320,175040,570360
8/20/2024,Uthpala Rajapaksha,Kurunegala,Dambulla,North Western,1694,8612,10306,67760,344480,412240
8/21/2024,Uthpala Rajapaksha,Kurunegala,Dambulla,North Western,6286,7820,14106,251440,312800,564240
8/22/2024,Uthpala Rajapaksha,Kurunegala,Dambulla,North Western,1263,6244,7507,50520,249760,300280
8/23/2024,Uthpala Rajapaksha,Kurunegala,Dambulla,North Western,1101,3626,4727,44040,145040,189080
8/24/2024,Uthpala Rajapaksha,Kurunegala,Dambulla,North Western,396,345,741,15840,13800,29640
8/25/2024,Uthpala Rajapaksha,Kurunegala,Dambulla,North Western,965,6718,7683,38600,268720,307320
8/26/2024,Uthpala Rajapaksha,Kurunegala,Dambulla,North Western,1381,8426,9807,55240,337040,392280
8/27/2024,Uthpala Rajapaksha,Kurunegala,Dambulla,North Western,4655,5982,10637,186200,239280,425480
8/28/2024,Uthpala Rajapaksha,Kurunegala,Dambulla,North Western,8301,843,9144,332040,33720,365760
8/29/2024,Uthpala Rajapaksha,Kurunegala,Dambulla,North Western,5433,172,5605,217320,6880,224200
8/30/2024,Uthpala Rajapaksha,Kurunegala,Dambulla,North Western,3897,9204,13101,155880,368160,524040
8/31/2024,Uthpala Rajapaksha,Kurunegala,Dambulla,North Western,8258,3171,11429,330320,126840,457160
9/1/2024,Uthpala Rajapaksha,Kurunegala,Dambulla,North Western,3047,9382,12429,121880,375280,497160
9/2/2024,Uthpala Rajapaksha,Kurunegala,Dambulla,North Western,9377,8243,17620,375080,329720,704800
9/3/2024,Uthpala Rajapaksha,Kurunegala,Dambulla,North Western,6226,7852,14078,249040,314080,563120
9/4/2024,Uthpala Rajapaksha,Kurunegala,Dambulla,North Western,3345,9699,13044,133800,387960,521760
9/5/2024,Uthpala Rajapaksha,Kurunegala,Dambulla,North Western,5120,1498,6618,204800,59920,264720
9/6/2024,Uthpala Rajapaksha,Kurunegala,Dambulla,North Western,3898,3710,7608,155920,148400,304320
9/7/2024,Uthpala Rajapaksha,Kurunegala,Dambulla,North Western,5484,1828,7312,219360,73120,292480
9/8/2024,Uthpala Rajapaksha,Kurunegala,Dambulla,North Western,5521,386,5907,220840,15440,236280
9/9/2024,Uthpala Rajapaksha,Kurunegala,Dambulla,North Western,9789,6338,16127,391560,253520,645080
9/10/2024,Uthpala Rajapaksha,Kurunegala,Dambulla,North Western,5320,8088,13408,212800,323520,536320
9/11/2024,Uthpala Rajapaksha,Kurunegala,Dambulla,North Western,286,973,1259,11440,38920,50360
9/12/2024,Uthpala Rajapaksha,Kurunegala,Dambulla,North Western,1112,8617,9729,44480,344680,389160
9/13/2024,Uthpala Rajapaksha,Kurunegala,Dambulla,North Western,1353,8962,10315,54120,358480,412600
9/14/2024,Uthpala Rajapaksha,Kurunegala,Dambulla,North Western,4440,4872,9312,177600,194880,372480
9/15/2024,Uthpala Rajapaksha,Kurunegala,Dambulla,North Western,7527,8563,16090,301080,342520,643600
9/16/2024,Uthpala Rajapaksha,Kurunegala,Dambulla,North Western,9634,1540,11174,385360,61600,446960
9/17/2024,Uthpala Rajapaksha,Kurunegala,Dambulla,North Western,3975,759,4734,159000,30360,189360
9/18/2024,Uthpala Rajapaksha,Kurunegala,Dambulla,North Western,2933,6220,9153,117320,248800,366120
9/19/2024,Uthpala Rajapaksha,Kurunegala,Dambulla,North Western,8738,2382,11120,349520,95280,444800
9/20/2024,Uthpala Rajapaksha,Kurunegala,Dambulla,North Western,5085,8926,14011,203400,357040,560440
9/21/2024,Uthpala Rajapaksha,Kurunegala,Dambulla,North Western,8916,9042,17958,356640,361680,718320
9/22/2024,Uthpala Rajapaksha,Kurunegala,Dambulla,North Western,8734,7608,16342,349360,304320,653680
9/23/2024,Uthpala Rajapaksha,Kurunegala,Dambulla,North Western,385,5208,5593,15400,208320,223720
9/24/2024,Uthpala Rajapaksha,Kurunegala,Dambulla,North Western,9918,8536,18454,396720,341440,738160
9/25/2024,Uthpala Rajapaksha,Kurunegala,Dambulla,North Western,5609,511,6120,224360,20440,244800
9/26/2024,Uthpala Rajapaksha,Kurunegala,Dambulla,North Western,4855,1502,6357,194200,60080,254280
9/27/2024,Uthpala Rajapaksha,Kurunegala,Dambulla,North Western,6589,4840,11429,263560,193600,457160
9/28/2024,Uthpala Rajapaksha,Kurunegala,Dambulla,North Western,992,3867,4859,39680,154680,194360
9/29/2024,Uthpala Rajapaksha,Kurunegala,Dambulla,North Western,8784,9633,18417,351360,385320,736680
9/30/2024,Uthpala Rajapaksha,Kurunegala,Dambulla,North Western,6706,2300,9006,268240,92000,360240
10/1/2024,Uthpala Rajapaksha,Kurunegala,Dambulla,North Western,4646,9786,14432,185840,391440,577280
10/2/2024,Uthpala Rajapaksha,Kurunegala,Dambulla,North Western,7387,1048,8435,295480,41920,337400
10/3/2024,Uthpala Rajapaksha,Kurunegala,Dambulla,North Western,6305,9627,15932,252200,385080,637280
10/4/2024,Uthpala Rajapaksha,Kurunegala,Dambulla,North Western,1020,8797,9817,40800,351880,392680
10/5/2024,Uthpala Rajapaksha,Kurunegala,Dambulla,North Western,4407,1608,6015,176280,64320,240600
10/6/2024,Uthpala Rajapaksha,Kurunegala,Dambulla,North Western,8899,4180,13079,355960,167200,523160
10/7/2024,Uthpala Rajapaksha,Kurunegala,Dambulla,North Western,8231,2561,10792,329240,102440,431680
10/8/2024,Uthpala Rajapaksha,Kurunegala,Dambulla,North Western,5458,9619,15077,218320,384760,603080
10/9/2024,Uthpala Rajapaksha,Kurunegala,Dambulla,North Western,7932,9364,17296,317280,374560,691840
10/10/2024,Uthpala Rajapaksha,Kurunegala,Dambulla,North Western,6811,8459,15270,272440,338360,610800
10/11/2024,Uthpala Rajapaksha,Kurunegala,Dambulla,North Western,4651,3615,8266,186040,144600,330640
10/12/2024,Uthpala Rajapaksha,Kurunegala,Dambulla,North Western,9667,1059,10726,386680,42360,429040
10/13/2024,Uthpala Rajapaksha,Kurunegala,Dambulla,North Western,4000,2152,6152,160000,86080,246080
10/14/2024,Uthpala Rajapaksha,Kurunegala,Dambulla,North Western,7870,4524,12394,314800,180960,495760
10/15/2024,Uthpala Rajapaksha,Kurunegala,Dambulla,North Western,3134,5852,8986,125360,234080,359440
10/16/2024,Uthpala Rajapaksha,Kurunegala,Dambulla,North Western,2365,998,3363,94600,39920,134520
10/17/2024,Uthpala Rajapaksha,Kurunegala,Dambulla,North Western,4406,5288,9694,176240,211520,387760
10/18/2024,Uthpala Rajapaksha,Kurunegala,Dambulla,North Western,6336,4278,10614,253440,171120,424560
10/19/2024,Uthpala Rajapaksha,Kurunegala,Dambulla,North Western,279,9165,9444,11160,366600,377760
10/20/2024,Uthpala Rajapaksha,Kurunegala,Dambulla,North Western,167,1519,1686,6680,60760,67440
10/21/2024,Uthpala Rajapaksha,Kurunegala,Dambulla,North Western,4583,8128,12711,183320,325120,508440
10/22/2024,Uthpala Rajapaksha,Kurunegala,Dambulla,North Western,7437,5946,13383,297480,237840,535320
10/23/2024,Uthpala Rajapaksha,Kurunegala,Dambulla,North Western,104,9485,9589,4160,379400,383560
10/24/2024,Uthpala Rajapaksha,Kurunegala,Dambulla,North Western,3953,9022,12975,158120,360880,519000
10/25/2024,Uthpala Rajapaksha,Kurunegala,Dambulla,North Western,3406,1215,4621,136240,48600,184840
10/26/2024,Uthpala Rajapaksha,Kurunegala,Dambulla,North Western,8704,8754,17458,348160,350160,698320
10/27/2024,Uthpala Rajapaksha,Kurunegala,Dambulla,North Western,3709,3887,7596,148360,155480,303840
10/28/2024,Uthpala Rajapaksha,Kurunegala,Dambulla,North Western,9929,8,9937,397160,320,397480
10/29/2024,Uthpala Rajapaksha,Kurunegala,Dambulla,North Western,3153,116,3269,126120,4640,130760
10/30/2024,Uthpala Rajapaksha,Kurunegala,Dambulla,North Western,9345,1568,10913,373800,62720,436520
10/31/2024,Uthpala Rajapaksha,Kurunegala,Dambulla,North Western,9243,4891,14134,369720,195640,565360
11/1/2024,Uthpala Rajapaksha,Kurunegala,Dambulla,North Western,7730,3826,11556,309200,153040,462240
11/2/2024,Uthpala Rajapaksha,Kurunegala,Dambulla,North Western,1037,2175,3212,41480,87000,128480
11/3/2024,Uthpala Rajapaksha,Kurunegala,Dambulla,North Western,3038,9346,12384,121520,373840,495360
11/4/2024,Uthpala Rajapaksha,Kurunegala,Dambulla,North Western,7473,5755,13228,298920,230200,529120
11/5/2024,Uthpala Rajapaksha,Kurunegala,Dambulla,North Western,5831,842,6673,233240,33680,266920
11/6/2024,Uthpala Rajapaksha,Kurunegala,Dambulla,North Western,4989,4687,9676,199560,187480,387040
11/7/2024,Uthpala Rajapaksha,Kurunegala,Dambulla,North Western,8533,5643,14176,341320,225720,567040
11/8/2024,Uthpala Rajapaksha,Kurunegala,Dambulla,North Western,8025,2502,10527,321000,100080,421080
11/9/2024,Uthpala Rajapaksha,Kurunegala,Dambulla,North Western,297,8691,8988,11880,347640,359520
11/10/2024,Uthpala Rajapaksha,Kurunegala,Dambulla,North Western,6426,45,6471,257040,1800,258840
11/11/2024,Uthpala Rajapaksha,Kurunegala,Dambulla,North Western,5101,5341,10442,204040,213640,417680
11/12/2024,Uthpala Rajapaksha,Kurunegala,Dambulla,North Western,1080,8715,9795,43200,348600,391800
11/13/2024,Uthpala Rajapaksha,Kurunegala,Dambulla,North Western,8592,2406,10998,343680,96240,439920
11/14/2024,Uthpala Rajapaksha,Kurunegala,Dambulla,North Western,7157,6345,13502,286280,253800,540080
11/15/2024,Uthpala Rajapaksha,Kurunegala,Dambulla,North Western,9267,2688,11955,370680,107520,478200
11/16/2024,Uthpala Rajapaksha,Kurunegala,Dambulla,North Western,9825,1283,11108,393000,51320,444320
11/17/2024,Uthpala Rajapaksha,Kurunegala,Dambulla,North Western,2930,3287,6217,117200,131480,248680
11/18/2024,Uthpala Rajapaksha,Kurunegala,Dambulla,North Western,2757,2450,5207,110280,98000,208280
11/19/2024,Uthpala Rajapaksha,Kurunegala,Dambulla,North Western,6614,1241,7855,264560,49640,314200
11/20/2024,Uthpala Rajapaksha,Kurunegala,Dambulla,North Western,4608,1548,6156,184320,61920,246240
11/21/2024,Uthpala Rajapaksha,Kurunegala,Dambulla,North Western,9121,326,9447,364840,13040,377880
11/22/2024,Uthpala Rajapaksha,Kurunegala,Dambulla,North Western,2457,5885,8342,98280,235400,333680
11/23/2024,Uthpala Rajapaksha,Kurunegala,Dambulla,North Western,1997,7464,9461,79880,298560,378440
11/24/2024,Uthpala Rajapaksha,Kurunegala,Dambulla,North Western,5892,375,6267,235680,15000,250680
11/25/2024,Uthpala Rajapaksha,Kurunegala,Dambulla,North Western,8612,234,8846,344480,9360,353840
11/26/2024,Uthpala Rajapaksha,Kurunegala,Dambulla,North Western,2009,671,2680,80360,26840,107200
11/27/2024,Uthpala Rajapaksha,Kurunegala,Dambulla,North Western,9829,1379,11208,393160,55160,448320
11/28/2024,Uthpala Rajapaksha,Kurunegala,Dambulla,North Western,8409,2142,10551,336360,85680,422040
11/29/2024,Uthpala Rajapaksha,Kurunegala,Dambulla,North Western,331,8827,9158,13240,353080,366320
11/30/2024,Uthpala Rajapaksha,Kurunegala,Dambulla,North Western,2604,9491,12095,104160,379640,483800
12/1/2024,Uthpala Rajapaksha,Kurunegala,Dambulla,North Western,1856,5083,6939,74240,203320,277560
12/2/2024,Uthpala Rajapaksha,Kurunegala,Dambulla,North Western,6587,503,7090,263480,20120,283600
12/3/2024,Uthpala Rajapaksha,Kurunegala,Dambulla,North Western,9410,2088,11498,376400,83520,459920
12/4/2024,Uthpala Rajapaksha,Kurunegala,Dambulla,North Western,3375,4148,7523,135000,165920,300920
12/5/2024,Uthpala Rajapaksha,Kurunegala,Dambulla,North Western,4495,83,4578,179800,3320,183120
12/6/2024,Uthpala Rajapaksha,Kurunegala,Dambulla,North Western,1942,623,2565,77680,24920,102600
12/7/2024,Uthpala Rajapaksha,Kurunegala,Dambulla,North Western,2671,5248,7919,106840,209920,316760
12/8/2024,Uthpala Rajapaksha,Kurunegala,Dambulla,North Western,5959,821,6780,238360,32840,271200
12/9/2024,Uthpala Rajapaksha,Kurunegala,Dambulla,North Western,7568,92,7660,302720,3680,306400
12/10/2024,Uthpala Rajapaksha,Kurunegala,Dambulla,North Western,9909,7396,17305,396360,295840,692200
12/11/2024,Uthpala Rajapaksha,Kurunegala,Dambulla,North Western,8394,2322,10716,335760,92880,428640
12/12/2024,Uthpala Rajapaksha,Kurunegala,Dambulla,North Western,4884,9069,13953,195360,362760,558120
12/13/2024,Uthpala Rajapaksha,Kurunegala,Dambulla,North Western,7260,8925,16185,290400,357000,647400
12/14/2024,Uthpala Rajapaksha,Kurunegala,Dambulla,North Western,8965,1416,10381,358600,56640,415240
12/15/2024,Uthpala Rajapaksha,Kurunegala,Dambulla,North Western,7266,2278,9544,290640,91120,381760
12/16/2024,Uthpala Rajapaksha,Kurunegala,Dambulla,North Western,2974,9656,12630,118960,386240,505200
12/17/2024,Uthpala Rajapaksha,Kurunegala,Dambulla,North Western,7330,7618,14948,293200,304720,597920
12/18/2024,Uthpala Rajapaksha,Kurunegala,Dambulla,North Western,692,3678,4370,27680,147120,174800
12/19/2024,Uthpala Rajapaksha,Kurunegala,Dambulla,North Western,2332,1284,3616,93280,51360,144640
12/20/2024,Uthpala Rajapaksha,Kurunegala,Dambulla,North Western,4805,5536,10341,192200,221440,413640
12/21/2024,Uthpala Rajapaksha,Kurunegala,Dambulla,North Western,2497,2762,5259,99880,110480,210360
12/22/2024,Uthpala Rajapaksha,Kurunegala,Dambulla,North Western,4803,3724,8527,192120,148960,341080
12/23/2024,Uthpala Rajapaksha,Kurunegala,Dambulla,North Western,8317,2342,10659,332680,93680,426360
12/24/2024,Uthpala Rajapaksha,Kurunegala,Dambulla,North Western,93,4159,4252,3720,166360,170080
12/25/2024,Uthpala Rajapaksha,Kurunegala,Dambulla,North Western,5149,7973,13122,205960,318920,524880
12/26/2024,Uthpala Rajapaksha,Kurunegala,Dambulla,North Western,3141,5639,8780,125640,225560,351200
12/27/2024,Uthpala Rajapaksha,Kurunegala,Dambulla,North Western,5356,9379,14735,214240,375160,589400
12/28/2024,Uthpala Rajapaksha,Kurunegala,Dambulla,North Western,2339,3383,5722,93560,135320,228880
12/29/2024,Uthpala Rajapaksha,Kurunegala,Dambulla,North Western,4318,4153,8471,172720,166120,338840
12/30/2024,Uthpala Rajapaksha,Kurunegala,Dambulla,North Western,3574,9009,12583,142960,360360,503320
12/31/2024,Uthpala Rajapaksha,Kurunegala,Dambulla,North Western,2837,5837,8674,113480,233480,346960
1/1/2025,Uthpala Rajapaksha,Kurunegala,Dambulla,North Western,4967,8120,13087,198680,324800,523480
1/2/2025,Uthpala Rajapaksha,Kurunegala,Dambulla,North Western,118,5959,6077,4720,238360,243080
1/3/2025,Uthpala Rajapaksha,Kurunegala,Dambulla,North Western,1426,1106,2532,57040,44240,101280
1/4/2025,Uthpala Rajapaksha,Kurunegala,Dambulla,North Western,9844,1351,11195,393760,54040,447800
1/5/2025,Uthpala Rajapaksha,Kurunegala,Dambulla,North Western,6026,1221,7247,241040,48840,289880
1/6/2025,Uthpala Rajapaksha,Kurunegala,Dambulla,North Western,7134,1915,9049,285360,76600,361960
1/7/2025,Uthpala Rajapaksha,Kurunegala,Dambulla,North Western,5571,9639,15210,222840,385560,608400
1/8/2025,Uthpala Rajapaksha,Kurunegala,Dambulla,North Western,9939,7804,17743,397560,312160,709720
1/9/2025,Uthpala Rajapaksha,Kurunegala,Dambulla,North Western,5418,5050,10468,216720,202000,418720
1/10/2025,Uthpala Rajapaksha,Kurunegala,Dambulla,North Western,8589,8742,17331,343560,349680,693240
1/11/2025,Uthpala Rajapaksha,Kurunegala,Dambulla,North Western,1618,7750,9368,64720,310000,374720
1/12/2025,Uthpala Rajapaksha,Kurunegala,Dambulla,North Western,209,4332,4541,8360,173280,181640
1/13/2025,Uthpala Rajapaksha,Kurunegala,Dambulla,North Western,4378,3831,8209,175120,153240,328360
1/14/2025,Uthpala Rajapaksha,Kurunegala,Dambulla,North Western,2589,1920,4509,103560,76800,180360
1/15/2025,Uthpala Rajapaksha,Kurunegala,Dambulla,North Western,2440,9201,11641,97600,368040,465640
1/16/2025,Uthpala Rajapaksha,Kurunegala,Dambulla,North Western,6328,8154,14482,253120,326160,579280
1/17/2025,Uthpala Rajapaksha,Kurunegala,Dambulla,North Western,8950,5531,14481,358000,221240,579240
1/18/2025,Uthpala Rajapaksha,Kurunegala,Dambulla,North Western,7193,1802,8995,287720,72080,359800
1/19/2025,Uthpala Rajapaksha,Kurunegala,Dambulla,North Western,4571,9,4580,182840,360,183200
1/20/2025,Uthpala Rajapaksha,Kurunegala,Dambulla,North Western,8485,7892,16377,339400,315680,655080
1/21/2025,Uthpala Rajapaksha,Kurunegala,Dambulla,North Western,4613,1476,6089,184520,59040,243560
1/22/2025,Uthpala Rajapaksha,Kurunegala,Dambulla,North Western,7818,9856,17674,312720,394240,706960
1/23/2025,Uthpala Rajapaksha,Kurunegala,Dambulla,North Western,3721,8413,12134,148840,336520,485360
1/24/2025,Uthpala Rajapaksha,Kurunegala,Dambulla,North Western,2718,6096,8814,108720,243840,352560
1/25/2025,Uthpala Rajapaksha,Kurunegala,Dambulla,North Western,8497,1401,9898,339880,56040,395920
1/26/2025,Uthpala Rajapaksha,Kurunegala,Dambulla,North Western,9926,2152,12078,397040,86080,483120
1/27/2025,Uthpala Rajapaksha,Kurunegala,Dambulla,North Western,6770,4294,11064,270800,171760,442560
1/28/2025,Uthpala Rajapaksha,Kurunegala,Dambulla,North Western,9667,8792,18459,386680,351680,738360
1/29/2025,Uthpala Rajapaksha,Kurunegala,Dambulla,North Western,4857,8774,13631,194280,350960,545240
1/30/2025,Uthpala Rajapaksha,Kurunegala,Dambulla,North Western,6641,9137,15778,265640,365480,631120
1/31/2025,Uthpala Rajapaksha,Kurunegala,Dambulla,North Western,7405,477,7882,296200,19080,315280
2/1/2025,Uthpala Rajapaksha,Kurunegala,Dambulla,North Western,5161,1432,6593,206440,57280,263720
2/2/2025,Uthpala Rajapaksha,Kurunegala,Dambulla,North Western,4462,4245,8707,178480,169800,348280
2/3/2025,Uthpala Rajapaksha,Kurunegala,Dambulla,North Western,7741,439,8180,309640,17560,327200
2/4/2025,Uthpala Rajapaksha,Kurunegala,Dambulla,North Western,3774,1238,5012,150960,49520,200480
2/5/2025,Uthpala Rajapaksha,Kurunegala,Dambulla,North Western,626,1799,2425,25040,71960,97000
2/6/2025,Uthpala Rajapaksha,Kurunegala,Dambulla,North Western,4104,4761,8865,164160,190440,354600
2/7/2025,Uthpala Rajapaksha,Kurunegala,Dambulla,North Western,4631,6585,11216,185240,263400,448640
2/8/2025,Uthpala Rajapaksha,Kurunegala,Dambulla,North Western,5011,5808,10819,200440,232320,432760
2/9/2025,Uthpala Rajapaksha,Kurunegala,Dambulla,North Western,4788,6882,11670,191520,275280,466800
2/10/2025,Uthpala Rajapaksha,Kurunegala,Dambulla,North Western,2059,3030,5089,82360,121200,203560
2/11/2025,Uthpala Rajapaksha,Kurunegala,Dambulla,North Western,1828,556,2384,73120,22240,95360
2/12/2025,Uthpala Rajapaksha,Kurunegala,Dambulla,North Western,5053,4858,9911,202120,194320,396440
2/13/2025,Uthpala Rajapaksha,Kurunegala,Dambulla,North Western,9952,5128,15080,398080,205120,603200
2/14/2025,Uthpala Rajapaksha,Kurunegala,Dambulla,North Western,9552,2550,12102,382080,102000,484080
2/15/2025,Uthpala Rajapaksha,Kurunegala,Dambulla,North Western,6962,7276,14238,278480,291040,569520
2/16/2025,Uthpala Rajapaksha,Kurunegala,Dambulla,North Western,6096,3875,9971,243840,155000,398840
2/17/2025,Uthpala Rajapaksha,Kurunegala,Dambulla,North Western,2477,9689,12166,99080,387560,486640
2/18/2025,Uthpala Rajapaksha,Kurunegala,Dambulla,North Western,108,5636,5744,4320,225440,229760
2/19/2025,Uthpala Rajapaksha,Kurunegala,Dambulla,North Western,8028,9191,17219,321120,367640,688760
2/20/2025,Uthpala Rajapaksha,Kurunegala,Dambulla,North Western,1865,2168,4033,74600,86720,161320
2/21/2025,Uthpala Rajapaksha,Kurunegala,Dambulla,North Western,8660,8485,17145,346400,339400,685800
2/22/2025,Uthpala Rajapaksha,Kurunegala,Dambulla,North Western,4904,9028,13932,196160,361120,557280
2/23/2025,Uthpala Rajapaksha,Kurunegala,Dambulla,North Western,1965,7487,9452,78600,299480,378080
2/24/2025,Uthpala Rajapaksha,Kurunegala,Dambulla,North Western,9359,6651,16010,374360,266040,640400
2/25/2025,Uthpala Rajapaksha,Kurunegala,Dambulla,North Western,1687,6917,8604,67480,276680,344160
2/26/2025,Uthpala Rajapaksha,Kurunegala,Dambulla,North Western,2812,4262,7074,112480,170480,282960
2/27/2025,Uthpala Rajapaksha,Kurunegala,Dambulla,North Western,2327,2035,4362,93080,81400,174480
2/28/2025,Uthpala Rajapaksha,Kurunegala,Dambulla,North Western,1092,6142,7234,43680,245680,289360
3/1/2025,Uthpala Rajapaksha,Kurunegala,Dambulla,North Western,4974,4729,9703,198960,189160,388120
3/2/2025,Uthpala Rajapaksha,Kurunegala,Dambulla,North Western,5994,5419,11413,239760,216760,456520
3/3/2025,Uthpala Rajapaksha,Kurunegala,Dambulla,North Western,5855,3140,8995,234200,125600,359800
3/4/2025,Uthpala Rajapaksha,Kurunegala,Dambulla,North Western,683,1662,2345,27320,66480,93800
3/5/2025,Uthpala Rajapaksha,Kurunegala,Dambulla,North Western,6718,7006,13724,268720,280240,548960
3/6/2025,Uthpala Rajapaksha,Kurunegala,Dambulla,North Western,8423,9121,17544,336920,364840,701760
3/7/2025,Uthpala Rajapaksha,Kurunegala,Dambulla,North Western,9079,2133,11212,363160,85320,448480
3/8/2025,Uthpala Rajapaksha,Kurunegala,Dambulla,North Western,8604,1887,10491,344160,75480,419640
3/9/2025,Uthpala Rajapaksha,Kurunegala,Dambulla,North Western,1148,6848,7996,45920,273920,319840
3/10/2025,Uthpala Rajapaksha,Kurunegala,Dambulla,North Western,5902,7362,13264,236080,294480,530560
3/11/2025,Uthpala Rajapaksha,Kurunegala,Dambulla,North Western,5682,3352,9034,227280,134080,361360
3/12/2025,Uthpala Rajapaksha,Kurunegala,Dambulla,North Western,3004,7668,10672,120160,306720,426880
3/13/2025,Uthpala Rajapaksha,Kurunegala,Dambulla,North Western,8627,6723,15350,345080,268920,614000
3/14/2025,Uthpala Rajapaksha,Kurunegala,Dambulla,North Western,8120,6568,14688,324800,262720,587520
3/15/2025,Uthpala Rajapaksha,Kurunegala,Dambulla,North Western,3249,4667,7916,129960,186680,316640
3/16/2025,Uthpala Rajapaksha,Kurunegala,Dambulla,North Western,6236,9862,16098,249440,394480,643920
3/17/2025,Uthpala Rajapaksha,Kurunegala,Dambulla,North Western,8045,2252,10297,321800,90080,411880
3/18/2025,Uthpala Rajapaksha,Kurunegala,Dambulla,North Western,5959,4300,10259,238360,172000,410360
3/19/2025,Uthpala Rajapaksha,Kurunegala,Dambulla,North Western,8990,3479,12469,359600,139160,498760
3/20/2025,Uthpala Rajapaksha,Kurunegala,Dambulla,North Western,2325,5132,7457,93000,205280,298280
3/21/2025,Uthpala Rajapaksha,Kurunegala,Dambulla,North Western,3550,3549,7099,142000,141960,283960
3/22/2025,Uthpala Rajapaksha,Kurunegala,Dambulla,North Western,7034,4945,11979,281360,197800,479160
3/23/2025,Uthpala Rajapaksha,Kurunegala,Dambulla,North Western,9849,2075,11924,393960,83000,476960
3/25/2024,Dinesh Perera,Puttalam,Marawila,North Western,1957,8302,10259,78280,332080,410360
3/26/2024,Dinesh Perera,Puttalam,Marawila,North Western,6718,3788,10506,268720,151520,420240
3/27/2024,Dinesh Perera,Puttalam,Marawila,North Western,5109,228,5337,204360,9120,213480
3/28/2024,Dinesh Perera,Puttalam,Marawila,North Western,6455,3716,10171,258200,148640,406840
3/29/2024,Dinesh Perera,Puttalam,Marawila,North Western,8414,4072,12486,336560,162880,499440
3/30/2024,Dinesh Perera,Puttalam,Marawila,North Western,3152,3327,6479,126080,133080,259160
3/31/2024,Dinesh Perera,Puttalam,Marawila,North Western,8964,723,9687,358560,28920,387480
4/1/2024,Dinesh Perera,Puttalam,Marawila,North Western,6225,7732,13957,249000,309280,558280
4/2/2024,Dinesh Perera,Puttalam,Marawila,North Western,6706,3232,9938,268240,129280,397520
4/3/2024,Dinesh Perera,Puttalam,Marawila,North Western,8991,8082,17073,359640,323280,682920
4/4/2024,Dinesh Perera,Puttalam,Marawila,North Western,1413,7323,8736,56520,292920,349440
4/5/2024,Dinesh Perera,Puttalam,Marawila,North Western,1339,6539,7878,53560,261560,315120
4/6/2024,Dinesh Perera,Puttalam,Marawila,North Western,143,107,250,5720,4280,10000
4/7/2024,Dinesh Perera,Puttalam,Marawila,North Western,2416,1396,3812,96640,55840,152480
4/8/2024,Dinesh Perera,Puttalam,Marawila,North Western,4472,7229,11701,178880,289160,468040
4/9/2024,Dinesh Perera,Puttalam,Marawila,North Western,5918,9026,14944,236720,361040,597760
4/10/2024,Dinesh Perera,Puttalam,Marawila,North Western,3153,1461,4614,126120,58440,184560
4/11/2024,Dinesh Perera,Puttalam,Marawila,North Western,1377,2384,3761,55080,95360,150440
4/19/2024,Dinesh Perera,Puttalam,Marawila,North Western,8520,8803,17323,340800,352120,692920
4/20/2024,Dinesh Perera,Puttalam,Marawila,North Western,8478,6654,15132,339120,266160,605280
4/21/2024,Dinesh Perera,Puttalam,Marawila,North Western,8990,1820,10810,359600,72800,432400
4/22/2024,Dinesh Perera,Puttalam,Marawila,North Western,36,5615,5651,1440,224600,226040
4/23/2024,Dinesh Perera,Puttalam,Marawila,North Western,3425,8144,11569,137000,325760,462760
4/24/2024,Dinesh Perera,Puttalam,Marawila,North Western,9649,7571,17220,385960,302840,688800
4/25/2024,Dinesh Perera,Puttalam,Marawila,North Western,681,3330,4011,27240,133200,160440
4/26/2024,Dinesh Perera,Puttalam,Marawila,North Western,7393,4631,12024,295720,185240,480960
4/27/2024,Dinesh Perera,Puttalam,Marawila,North Western,4666,5345,10011,186640,213800,400440
4/28/2024,Dinesh Perera,Puttalam,Marawila,North Western,7176,2691,9867,287040,107640,394680
4/29/2024,Dinesh Perera,Puttalam,Marawila,North Western,1344,2349,3693,53760,93960,147720
4/30/2024,Dinesh Perera,Puttalam,Marawila,North Western,5291,6615,11906,211640,264600,476240
5/1/2024,Dinesh Perera,Puttalam,Marawila,North Western,1871,7362,9233,74840,294480,369320
5/2/2024,Dinesh Perera,Puttalam,Marawila,North Western,5615,1088,6703,224600,43520,268120
5/3/2024,Dinesh Perera,Puttalam,Marawila,North Western,5122,4123,9245,204880,164920,369800
5/4/2024,Dinesh Perera,Puttalam,Marawila,North Western,2992,2657,5649,119680,106280,225960
5/5/2024,Dinesh Perera,Puttalam,Marawila,North Western,1823,124,1947,72920,4960,77880
5/6/2024,Dinesh Perera,Puttalam,Marawila,North Western,4092,3215,7307,163680,128600,292280
5/7/2024,Dinesh Perera,Puttalam,Marawila,North Western,3731,241,3972,149240,9640,158880
5/8/2024,Dinesh Perera,Puttalam,Marawila,North Western,7190,7519,14709,287600,300760,588360
5/9/2024,Dinesh Perera,Puttalam,Marawila,North Western,7144,4333,11477,285760,173320,459080
5/10/2024,Dinesh Perera,Puttalam,Marawila,North Western,9643,7283,16926,385720,291320,677040
5/11/2024,Dinesh Perera,Puttalam,Marawila,North Western,6639,8134,14773,265560,325360,590920
5/12/2024,Dinesh Perera,Puttalam,Marawila,North Western,4299,1518,5817,171960,60720,232680
5/13/2024,Dinesh Perera,Puttalam,Marawila,North Western,8437,8241,16678,337480,329640,667120
5/14/2024,Dinesh Perera,Puttalam,Marawila,North Western,4718,3749,8467,188720,149960,338680
5/15/2024,Dinesh Perera,Puttalam,Marawila,North Western,8966,9624,18590,358640,384960,743600
5/16/2024,Dinesh Perera,Puttalam,Marawila,North Western,175,7509,7684,7000,300360,307360
5/17/2024,Dinesh Perera,Puttalam,Marawila,North Western,142,9025,9167,5680,361000,366680
5/18/2024,Dinesh Perera,Puttalam,Marawila,North Western,1775,3076,4851,71000,123040,194040
5/19/2024,Dinesh Perera,Puttalam,Marawila,North Western,4931,4213,9144,197240,168520,365760
5/20/2024,Dinesh Perera,Puttalam,Marawila,North Western,9900,5756,15656,396000,230240,626240
5/21/2024,Dinesh Perera,Puttalam,Marawila,North Western,9605,1522,11127,384200,60880,445080
5/22/2024,Dinesh Perera,Puttalam,Marawila,North Western,4904,5337,10241,196160,213480,409640
5/24/2024,Dinesh Perera,Puttalam,Marawila,North Western,6698,4248,10946,267920,169920,437840
5/25/2024,Dinesh Perera,Puttalam,Marawila,North Western,5319,891,6210,212760,35640,248400
5/26/2024,Dinesh Perera,Puttalam,Marawila,North Western,9945,7464,17409,397800,298560,696360
5/27/2024,Dinesh Perera,Puttalam,Marawila,North Western,2180,2701,4881,87200,108040,195240
5/28/2024,Dinesh Perera,Puttalam,Marawila,North Western,7743,1410,9153,309720,56400,366120
5/29/2024,Dinesh Perera,Puttalam,Marawila,North Western,1701,4681,6382,68040,187240,255280
5/30/2024,Dinesh Perera,Puttalam,Marawila,North Western,2139,716,2855,85560,28640,114200
5/31/2024,Dinesh Perera,Puttalam,Marawila,North Western,9626,9773,19399,385040,390920,775960
6/1/2024,Dinesh Perera,Puttalam,Marawila,North Western,822,5270,6092,32880,210800,243680
6/2/2024,Dinesh Perera,Puttalam,Marawila,North Western,881,5394,6275,35240,215760,251000
6/3/2024,Dinesh Perera,Puttalam,Marawila,North Western,5259,5621,10880,210360,224840,435200
6/4/2024,Dinesh Perera,Puttalam,Marawila,North Western,405,6227,6632,16200,249080,265280
6/5/2024,Dinesh Perera,Puttalam,Marawila,North Western,2834,5073,7907,113360,202920,316280
6/6/2024,Dinesh Perera,Puttalam,Marawila,North Western,3402,4750,8152,136080,190000,326080
6/7/2024,Dinesh Perera,Puttalam,Marawila,North Western,1962,9579,11541,78480,383160,461640
6/8/2024,Dinesh Perera,Puttalam,Marawila,North Western,3540,4566,8106,141600,182640,324240
6/9/2024,Dinesh Perera,Puttalam,Marawila,North Western,9735,3533,13268,389400,141320,530720
6/10/2024,Dinesh Perera,Puttalam,Marawila,North Western,8262,8168,16430,330480,326720,657200
6/11/2024,Dinesh Perera,Puttalam,Marawila,North Western,9101,9862,18963,364040,394480,758520
6/12/2024,Dinesh Perera,Puttalam,Marawila,North Western,8424,4564,12988,336960,182560,519520
6/13/2024,Dinesh Perera,Puttalam,Marawila,North Western,4890,2314,7204,195600,92560,288160
6/14/2024,Dinesh Perera,Puttalam,Marawila,North Western,2113,1954,4067,84520,78160,162680
6/15/2024,Dinesh Perera,Puttalam,Marawila,North Western,3385,2040,5425,135400,81600,217000
6/16/2024,Dinesh Perera,Puttalam,Marawila,North Western,7592,4291,11883,303680,171640,475320
6/17/2024,Dinesh Perera,Puttalam,Marawila,North Western,6236,4534,10770,249440,181360,430800
6/18/2024,Dinesh Perera,Puttalam,Marawila,North Western,1915,3482,5397,76600,139280,215880
6/19/2024,Dinesh Perera,Puttalam,Marawila,North Western,8735,9039,17774,349400,361560,710960
6/20/2024,Dinesh Perera,Puttalam,Marawila,North Western,5603,972,6575,224120,38880,263000
6/21/2024,Dinesh Perera,Puttalam,Marawila,North Western,6244,1758,8002,249760,70320,320080
6/22/2024,Dinesh Perera,Puttalam,Marawila,North Western,2128,293,2421,85120,11720,96840
6/23/2024,Dinesh Perera,Puttalam,Marawila,North Western,1392,3401,4793,55680,136040,191720
6/24/2024,Dinesh Perera,Puttalam,Marawila,North Western,4407,8484,12891,176280,339360,515640
6/25/2024,Dinesh Perera,Puttalam,Marawila,North Western,1873,8864,10737,74920,354560,429480
6/26/2024,Dinesh Perera,Puttalam,Marawila,North Western,49,9787,9836,1960,391480,393440
6/27/2024,Dinesh Perera,Puttalam,Marawila,North Western,9861,3595,13456,394440,143800,538240
6/28/2024,Dinesh Perera,Puttalam,Marawila,North Western,3766,7618,11384,150640,304720,455360
6/29/2024,Dinesh Perera,Puttalam,Marawila,North Western,749,4229,4978,29960,169160,199120
6/30/2024,Dinesh Perera,Puttalam,Marawila,North Western,640,7592,8232,25600,303680,329280
7/1/2024,Dinesh Perera,Puttalam,Marawila,North Western,8567,9198,17765,342680,367920,710600
7/2/2024,Dinesh Perera,Puttalam,Marawila,North Western,3921,2023,5944,156840,80920,237760
7/3/2024,Dinesh Perera,Puttalam,Marawila,North Western,6184,6965,13149,247360,278600,525960
7/4/2024,Dinesh Perera,Puttalam,Marawila,North Western,6703,9533,16236,268120,381320,649440
7/5/2024,Dinesh Perera,Puttalam,Marawila,North Western,6027,6313,12340,241080,252520,493600
7/6/2024,Dinesh Perera,Puttalam,Marawila,North Western,1818,342,2160,72720,13680,86400
7/7/2024,Dinesh Perera,Puttalam,Marawila,North Western,6274,1325,7599,250960,53000,303960
7/8/2024,Dinesh Perera,Puttalam,Marawila,North Western,5819,6180,11999,232760,247200,479960
7/9/2024,Dinesh Perera,Puttalam,Marawila,North Western,436,1606,2042,17440,64240,81680
7/10/2024,Dinesh Perera,Puttalam,Marawila,North Western,1480,4584,6064,59200,183360,242560
7/11/2024,Dinesh Perera,Puttalam,Marawila,North Western,9157,2990,12147,366280,119600,485880
7/12/2024,Dinesh Perera,Puttalam,Marawila,North Western,3431,2346,5777,137240,93840,231080
7/13/2024,Dinesh Perera,Puttalam,Marawila,North Western,4864,9814,14678,194560,392560,587120
7/14/2024,Dinesh Perera,Puttalam,Marawila,North Western,544,7494,8038,21760,299760,321520
7/15/2024,Dinesh Perera,Puttalam,Marawila,North Western,3369,2656,6025,134760,106240,241000
7/16/2024,Dinesh Perera,Puttalam,Marawila,North Western,4579,9944,14523,183160,397760,580920
7/17/2024,Dinesh Perera,Puttalam,Marawila,North Western,6569,9157,15726,262760,366280,629040
7/18/2024,Dinesh Perera,Puttalam,Marawila,North Western,2209,359,2568,88360,14360,102720
7/19/2024,Dinesh Perera,Puttalam,Marawila,North Western,9636,1331,10967,385440,53240,438680
7/20/2024,Dinesh Perera,Puttalam,Marawila,North Western,3632,4130,7762,145280,165200,310480
7/21/2024,Dinesh Perera,Puttalam,Marawila,North Western,3837,822,4659,153480,32880,186360
7/22/2024,Dinesh Perera,Puttalam,Marawila,North Western,8401,4269,12670,336040,170760,506800
7/23/2024,Dinesh Perera,Puttalam,Marawila,North Western,4433,3757,8190,177320,150280,327600
7/24/2024,Dinesh Perera,Puttalam,Marawila,North Western,9038,3272,12310,361520,130880,492400
7/25/2024,Dinesh Perera,Puttalam,Marawila,North Western,6936,9698,16634,277440,387920,665360
7/26/2024,Dinesh Perera,Puttalam,Marawila,North Western,2826,4684,7510,113040,187360,300400
7/27/2024,Dinesh Perera,Puttalam,Marawila,North Western,7776,4326,12102,311040,173040,484080
7/28/2024,Dinesh Perera,Puttalam,Marawila,North Western,5351,9710,15061,214040,388400,602440
7/29/2024,Dinesh Perera,Puttalam,Marawila,North Western,3418,2843,6261,136720,113720,250440
7/30/2024,Dinesh Perera,Puttalam,Marawila,North Western,1819,4370,6189,72760,174800,247560
7/31/2024,Dinesh Perera,Puttalam,Marawila,North Western,4605,7076,11681,184200,283040,467240
8/1/2024,Dinesh Perera,Puttalam,Marawila,North Western,43,4650,4693,1720,186000,187720
8/2/2024,Dinesh Perera,Puttalam,Marawila,North Western,2713,4288,7001,108520,171520,280040
8/3/2024,Dinesh Perera,Puttalam,Marawila,North Western,3893,9263,13156,155720,370520,526240
8/4/2024,Dinesh Perera,Puttalam,Marawila,North Western,8671,789,9460,346840,31560,378400
8/5/2024,Dinesh Perera,Puttalam,Marawila,North Western,5668,1006,6674,226720,40240,266960
8/6/2024,Dinesh Perera,Puttalam,Marawila,North Western,6786,818,7604,271440,32720,304160
8/7/2024,Dinesh Perera,Puttalam,Marawila,North Western,46,3178,3224,1840,127120,128960
8/8/2024,Dinesh Perera,Puttalam,Marawila,North Western,9478,4072,13550,379120,162880,542000
8/9/2024,Dinesh Perera,Puttalam,Marawila,North Western,47,7792,7839,1880,311680,313560
8/10/2024,Dinesh Perera,Puttalam,Marawila,North Western,6727,3436,10163,269080,137440,406520
8/11/2024,Dinesh Perera,Puttalam,Marawila,North Western,9635,2867,12502,385400,114680,500080
8/12/2024,Dinesh Perera,Puttalam,Marawila,North Western,5292,6182,11474,211680,247280,458960
8/13/2024,Dinesh Perera,Puttalam,Marawila,North Western,5613,3452,9065,224520,138080,362600
8/14/2024,Dinesh Perera,Puttalam,Marawila,North Western,226,1457,1683,9040,58280,67320
8/15/2024,Dinesh Perera,Puttalam,Marawila,North Western,2840,5216,8056,113600,208640,322240
8/16/2024,Dinesh Perera,Puttalam,Marawila,North Western,5201,6768,11969,208040,270720,478760
8/17/2024,Dinesh Perera,Puttalam,Marawila,North Western,562,5787,6349,22480,231480,253960
8/18/2024,Dinesh Perera,Puttalam,Marawila,North Western,7504,6571,14075,300160,262840,563000
8/19/2024,Dinesh Perera,Puttalam,Marawila,North Western,3891,8460,12351,155640,338400,494040
8/20/2024,Dinesh Perera,Puttalam,Marawila,North Western,4676,7011,11687,187040,280440,467480
8/21/2024,Dinesh Perera,Puttalam,Marawila,North Western,5223,955,6178,208920,38200,247120
8/22/2024,Dinesh Perera,Puttalam,Marawila,North Western,3383,1357,4740,135320,54280,189600
8/23/2024,Dinesh Perera,Puttalam,Marawila,North Western,3114,1189,4303,124560,47560,172120
8/24/2024,Dinesh Perera,Puttalam,Marawila,North Western,1694,6812,8506,67760,272480,340240
8/25/2024,Dinesh Perera,Puttalam,Marawila,North Western,2733,9077,11810,109320,363080,472400
8/26/2024,Dinesh Perera,Puttalam,Marawila,North Western,9090,4838,13928,363600,193520,557120
8/27/2024,Dinesh Perera,Puttalam,Marawila,North Western,14,8883,8897,560,355320,355880
8/28/2024,Dinesh Perera,Puttalam,Marawila,North Western,1526,7410,8936,61040,296400,357440
8/29/2024,Dinesh Perera,Puttalam,Marawila,North Western,9232,9568,18800,369280,382720,752000
8/30/2024,Dinesh Perera,Puttalam,Marawila,North Western,6472,5912,12384,258880,236480,495360
8/31/2024,Dinesh Perera,Puttalam,Marawila,North Western,694,5071,5765,27760,202840,230600
9/1/2024,Dinesh Perera,Puttalam,Marawila,North Western,7580,4000,11580,303200,160000,463200
9/2/2024,Dinesh Perera,Puttalam,Marawila,North Western,1364,7079,8443,54560,283160,337720
9/3/2024,Dinesh Perera,Puttalam,Marawila,North Western,7035,8664,15699,281400,346560,627960
9/4/2024,Dinesh Perera,Puttalam,Marawila,North Western,7248,9750,16998,289920,390000,679920
9/5/2024,Dinesh Perera,Puttalam,Marawila,North Western,7723,7052,14775,308920,282080,591000
9/6/2024,Dinesh Perera,Puttalam,Marawila,North Western,928,4428,5356,37120,177120,214240
9/7/2024,Dinesh Perera,Puttalam,Marawila,North Western,9437,6161,15598,377480,246440,623920
9/8/2024,Dinesh Perera,Puttalam,Marawila,North Western,9215,8926,18141,368600,357040,725640
9/9/2024,Dinesh Perera,Puttalam,Marawila,North Western,1397,29,1426,55880,1160,57040
9/10/2024,Dinesh Perera,Puttalam,Marawila,North Western,1243,4115,5358,49720,164600,214320
9/11/2024,Dinesh Perera,Puttalam,Marawila,North Western,517,9110,9627,20680,364400,385080
9/12/2024,Dinesh Perera,Puttalam,Marawila,North Western,3198,1103,4301,127920,44120,172040
9/13/2024,Dinesh Perera,Puttalam,Marawila,North Western,6491,6314,12805,259640,252560,512200
9/14/2024,Dinesh Perera,Puttalam,Marawila,North Western,802,7611,8413,32080,304440,336520
9/15/2024,Dinesh Perera,Puttalam,Marawila,North Western,3316,590,3906,132640,23600,156240
9/16/2024,Dinesh Perera,Puttalam,Marawila,North Western,5862,8766,14628,234480,350640,585120
9/17/2024,Dinesh Perera,Puttalam,Marawila,North Western,2228,2010,4238,89120,80400,169520
9/18/2024,Dinesh Perera,Puttalam,Marawila,North Western,5832,8359,14191,233280,334360,567640
9/19/2024,Dinesh Perera,Puttalam,Marawila,North Western,4835,6842,11677,193400,273680,467080
9/20/2024,Dinesh Perera,Puttalam,Marawila,North Western,4313,9063,13376,172520,362520,535040
9/21/2024,Dinesh Perera,Puttalam,Marawila,North Western,7485,5151,12636,299400,206040,505440
9/22/2024,Dinesh Perera,Puttalam,Marawila,North Western,5117,3567,8684,204680,142680,347360
9/23/2024,Dinesh Perera,Puttalam,Marawila,North Western,2138,5092,7230,85520,203680,289200
9/24/2024,Dinesh Perera,Puttalam,Marawila,North Western,8161,3679,11840,326440,147160,473600
9/25/2024,Dinesh Perera,Puttalam,Marawila,North Western,92,8468,8560,3680,338720,342400
9/26/2024,Dinesh Perera,Puttalam,Marawila,North Western,991,6524,7515,39640,260960,300600
9/27/2024,Dinesh Perera,Puttalam,Marawila,North Western,6517,5227,11744,260680,209080,469760
9/28/2024,Dinesh Perera,Puttalam,Marawila,North Western,2655,4781,7436,106200,191240,297440
9/29/2024,Dinesh Perera,Puttalam,Marawila,North Western,6085,9048,15133,243400,361920,605320
9/30/2024,Dinesh Perera,Puttalam,Marawila,North Western,229,8863,9092,9160,354520,363680
10/1/2024,Dinesh Perera,Puttalam,Marawila,North Western,6196,8140,14336,247840,325600,573440
10/2/2024,Dinesh Perera,Puttalam,Marawila,North Western,8716,512,9228,348640,20480,369120
10/3/2024,Dinesh Perera,Puttalam,Marawila,North Western,7348,6084,13432,293920,243360,537280
10/4/2024,Dinesh Perera,Puttalam,Marawila,North Western,3968,5058,9026,158720,202320,361040
10/5/2024,Dinesh Perera,Puttalam,Marawila,North Western,3962,643,4605,158480,25720,184200
10/6/2024,Dinesh Perera,Puttalam,Marawila,North Western,4326,6847,11173,173040,273880,446920
10/7/2024,Dinesh Perera,Puttalam,Marawila,North Western,8169,8494,16663,326760,339760,666520
10/8/2024,Dinesh Perera,Puttalam,Marawila,North Western,1889,4286,6175,75560,171440,247000
10/9/2024,Dinesh Perera,Puttalam,Marawila,North Western,4977,3947,8924,199080,157880,356960
10/10/2024,Dinesh Perera,Puttalam,Marawila,North Western,1632,3424,5056,65280,136960,202240
10/11/2024,Dinesh Perera,Puttalam,Marawila,North Western,2031,3731,5762,81240,149240,230480
10/12/2024,Dinesh Perera,Puttalam,Marawila,North Western,863,4173,5036,34520,166920,201440
10/13/2024,Dinesh Perera,Puttalam,Marawila,North Western,7544,9630,17174,301760,385200,686960
10/14/2024,Dinesh Perera,Puttalam,Marawila,North Western,8697,1748,10445,347880,69920,417800
10/15/2024,Dinesh Perera,Puttalam,Marawila,North Western,986,2076,3062,39440,83040,122480
10/16/2024,Dinesh Perera,Puttalam,Marawila,North Western,1140,5043,6183,45600,201720,247320
10/17/2024,Dinesh Perera,Puttalam,Marawila,North Western,6386,57,6443,255440,2280,257720
10/18/2024,Dinesh Perera,Puttalam,Marawila,North Western,295,5751,6046,11800,230040,241840
10/19/2024,Dinesh Perera,Puttalam,Marawila,North Western,5776,9985,15761,231040,399400,630440
10/20/2024,Dinesh Perera,Puttalam,Marawila,North Western,6805,9297,16102,272200,371880,644080
10/21/2024,Dinesh Perera,Puttalam,Marawila,North Western,4384,7548,11932,175360,301920,477280
10/22/2024,Dinesh Perera,Puttalam,Marawila,North Western,3911,8639,12550,156440,345560,502000
10/23/2024,Dinesh Perera,Puttalam,Marawila,North Western,7586,824,8410,303440,32960,336400
10/24/2024,Dinesh Perera,Puttalam,Marawila,North Western,7842,3588,11430,313680,143520,457200
10/25/2024,Dinesh Perera,Puttalam,Marawila,North Western,3542,6658,10200,141680,266320,408000
10/26/2024,Dinesh Perera,Puttalam,Marawila,North Western,3907,2780,6687,156280,111200,267480
10/27/2024,Dinesh Perera,Puttalam,Marawila,North Western,1576,1793,3369,63040,71720,134760
10/28/2024,Dinesh Perera,Puttalam,Marawila,North Western,6657,4122,10779,266280,164880,431160
10/29/2024,Dinesh Perera,Puttalam,Marawila,North Western,1949,6334,8283,77960,253360,331320
10/30/2024,Dinesh Perera,Puttalam,Marawila,North Western,5329,4670,9999,213160,186800,399960
10/31/2024,Dinesh Perera,Puttalam,Marawila,North Western,6596,4501,11097,263840,180040,443880
11/1/2024,Dinesh Perera,Puttalam,Marawila,North Western,2633,2567,5200,105320,102680,208000
11/2/2024,Dinesh Perera,Puttalam,Marawila,North Western,5854,5395,11249,234160,215800,449960
11/3/2024,Dinesh Perera,Puttalam,Marawila,North Western,2895,6474,9369,115800,258960,374760
11/4/2024,Dinesh Perera,Puttalam,Marawila,North Western,6559,3965,10524,262360,158600,420960
11/5/2024,Dinesh Perera,Puttalam,Marawila,North Western,848,4441,5289,33920,177640,211560
11/6/2024,Dinesh Perera,Puttalam,Marawila,North Western,2094,4825,6919,83760,193000,276760
11/7/2024,Dinesh Perera,Puttalam,Marawila,North Western,554,8108,8662,22160,324320,346480
11/8/2024,Dinesh Perera,Puttalam,Marawila,North Western,1241,6038,7279,49640,241520,291160
11/9/2024,Dinesh Perera,Puttalam,Marawila,North Western,4710,170,4880,188400,6800,195200
11/10/2024,Dinesh Perera,Puttalam,Marawila,North Western,4628,6738,11366,185120,269520,454640
11/11/2024,Dinesh Perera,Puttalam,Marawila,North Western,4943,4256,9199,197720,170240,367960
11/12/2024,Dinesh Perera,Puttalam,Marawila,North Western,676,9060,9736,27040,362400,389440
11/13/2024,Dinesh Perera,Puttalam,Marawila,North Western,3174,66,3240,126960,2640,129600
11/14/2024,Dinesh Perera,Puttalam,Marawila,North Western,4919,3903,8822,196760,156120,352880
11/15/2024,Dinesh Perera,Puttalam,Marawila,North Western,6742,4158,10900,269680,166320,436000
11/16/2024,Dinesh Perera,Puttalam,Marawila,North Western,7104,4418,11522,284160,176720,460880
11/17/2024,Dinesh Perera,Puttalam,Marawila,North Western,2236,348,2584,89440,13920,103360
11/18/2024,Dinesh Perera,Puttalam,Marawila,North Western,3221,7721,10942,128840,308840,437680
11/19/2024,Dinesh Perera,Puttalam,Marawila,North Western,4388,5272,9660,175520,210880,386400
11/20/2024,Dinesh Perera,Puttalam,Marawila,North Western,5569,189,5758,222760,7560,230320
11/21/2024,Dinesh Perera,Puttalam,Marawila,North Western,2389,2821,5210,95560,112840,208400
11/22/2024,Dinesh Perera,Puttalam,Marawila,North Western,1209,7103,8312,48360,284120,332480
11/23/2024,Dinesh Perera,Puttalam,Marawila,North Western,4355,5222,9577,174200,208880,383080
11/24/2024,Dinesh Perera,Puttalam,Marawila,North Western,1302,3239,4541,52080,129560,181640
11/25/2024,Dinesh Perera,Puttalam,Marawila,North Western,1247,3200,4447,49880,128000,177880
11/26/2024,Dinesh Perera,Puttalam,Marawila,North Western,3926,5976,9902,157040,239040,396080
11/27/2024,Dinesh Perera,Puttalam,Marawila,North Western,3809,4757,8566,152360,190280,342640
11/28/2024,Dinesh Perera,Puttalam,Marawila,North Western,7589,4515,12104,303560,180600,484160
11/29/2024,Dinesh Perera,Puttalam,Marawila,North Western,2601,4924,7525,104040,196960,301000
11/30/2024,Dinesh Perera,Puttalam,Marawila,North Western,7556,762,8318,302240,30480,332720
12/1/2024,Dinesh Perera,Puttalam,Marawila,North Western,9326,5508,14834,373040,220320,593360
12/2/2024,Dinesh Perera,Puttalam,Marawila,North Western,4770,2936,7706,190800,117440,308240
12/3/2024,Dinesh Perera,Puttalam,Marawila,North Western,3078,1062,4140,123120,42480,165600
12/4/2024,Dinesh Perera,Puttalam,Marawila,North Western,2121,8917,11038,84840,356680,441520
12/5/2024,Dinesh Perera,Puttalam,Marawila,North Western,2381,884,3265,95240,35360,130600
12/6/2024,Dinesh Perera,Puttalam,Marawila,North Western,9472,4069,13541,378880,162760,541640
12/7/2024,Dinesh Perera,Puttalam,Marawila,North Western,3840,2909,6749,153600,116360,269960
12/8/2024,Dinesh Perera,Puttalam,Marawila,North Western,3778,1141,4919,151120,45640,196760
12/9/2024,Dinesh Perera,Puttalam,Marawila,North Western,2808,3637,6445,112320,145480,257800
12/10/2024,Dinesh Perera,Puttalam,Marawila,North Western,3127,1025,4152,125080,41000,166080
12/11/2024,Dinesh Perera,Puttalam,Marawila,North Western,366,6963,7329,14640,278520,293160
12/12/2024,Dinesh Perera,Puttalam,Marawila,North Western,6228,6039,12267,249120,241560,490680
12/13/2024,Dinesh Perera,Puttalam,Marawila,North Western,280,2886,3166,11200,115440,126640
12/14/2024,Dinesh Perera,Puttalam,Marawila,North Western,465,1122,1587,18600,44880,63480
12/15/2024,Dinesh Perera,Puttalam,Marawila,North Western,9782,9814,19596,391280,392560,783840
12/16/2024,Dinesh Perera,Puttalam,Marawila,North Western,9211,6260,15471,368440,250400,618840
12/17/2024,Dinesh Perera,Puttalam,Marawila,North Western,7009,6945,13954,280360,277800,558160
12/18/2024,Dinesh Perera,Puttalam,Marawila,North Western,3109,9679,12788,124360,387160,511520
12/19/2024,Dinesh Perera,Puttalam,Marawila,North Western,8430,3412,11842,337200,136480,473680
12/20/2024,Dinesh Perera,Puttalam,Marawila,North Western,9841,9762,19603,393640,390480,784120
12/21/2024,Dinesh Perera,Puttalam,Marawila,North Western,5262,6065,11327,210480,242600,453080
12/22/2024,Dinesh Perera,Puttalam,Marawila,North Western,2759,9429,12188,110360,377160,487520
12/23/2024,Dinesh Perera,Puttalam,Marawila,North Western,6196,1567,7763,247840,62680,310520
12/24/2024,Dinesh Perera,Puttalam,Marawila,North Western,1970,2976,4946,78800,119040,197840
12/25/2024,Dinesh Perera,Puttalam,Marawila,North Western,9859,9357,19216,394360,374280,768640
12/26/2024,Dinesh Perera,Puttalam,Marawila,North Western,1455,3129,4584,58200,125160,183360
12/27/2024,Dinesh Perera,Puttalam,Marawila,North Western,1969,4818,6787,78760,192720,271480
12/28/2024,Dinesh Perera,Puttalam,Marawila,North Western,960,7744,8704,38400,309760,348160
12/29/2024,Dinesh Perera,Puttalam,Marawila,North Western,7593,6334,13927,303720,253360,557080
12/30/2024,Dinesh Perera,Puttalam,Marawila,North Western,718,1583,2301,28720,63320,92040
12/31/2024,Dinesh Perera,Puttalam,Marawila,North Western,4689,850,5539,187560,34000,221560
1/1/2025,Dinesh Perera,Puttalam,Marawila,North Western,7054,920,7974,282160,36800,318960
1/2/2025,Dinesh Perera,Puttalam,Marawila,North Western,4253,1453,5706,170120,58120,228240
1/3/2025,Dinesh Perera,Puttalam,Marawila,North Western,5030,7031,12061,201200,281240,482440
1/4/2025,Dinesh Perera,Puttalam,Marawila,North Western,7598,6717,14315,303920,268680,572600
1/5/2025,Dinesh Perera,Puttalam,Marawila,North Western,3794,3562,7356,151760,142480,294240
1/6/2025,Dinesh Perera,Puttalam,Marawila,North Western,5509,8797,14306,220360,351880,572240
1/7/2025,Dinesh Perera,Puttalam,Marawila,North Western,6446,8784,15230,257840,351360,609200
1/8/2025,Dinesh Perera,Puttalam,Marawila,North Western,5499,3627,9126,219960,145080,365040
1/9/2025,Dinesh Perera,Puttalam,Marawila,North Western,6135,8519,14654,245400,340760,586160
1/10/2025,Dinesh Perera,Puttalam,Marawila,North Western,7585,8927,16512,303400,357080,660480
1/11/2025,Dinesh Perera,Puttalam,Marawila,North Western,3276,4861,8137,131040,194440,325480
1/12/2025,Dinesh Perera,Puttalam,Marawila,North Western,2264,248,2512,90560,9920,100480
1/13/2025,Dinesh Perera,Puttalam,Marawila,North Western,7009,4229,11238,280360,169160,449520
1/14/2025,Dinesh Perera,Puttalam,Marawila,North Western,417,6396,6813,16680,255840,272520
1/15/2025,Dinesh Perera,Puttalam,Marawila,North Western,4143,2427,6570,165720,97080,262800
1/16/2025,Dinesh Perera,Puttalam,Marawila,North Western,5229,2328,7557,209160,93120,302280
1/17/2025,Dinesh Perera,Puttalam,Marawila,North Western,1292,4018,5310,51680,160720,212400
1/18/2025,Dinesh Perera,Puttalam,Marawila,North Western,7335,1977,9312,293400,79080,372480
1/19/2025,Dinesh Perera,Puttalam,Marawila,North Western,87,3188,3275,3480,127520,131000
1/20/2025,Dinesh Perera,Puttalam,Marawila,North Western,2623,856,3479,104920,34240,139160
1/21/2025,Dinesh Perera,Puttalam,Marawila,North Western,3820,231,4051,152800,9240,162040
1/22/2025,Dinesh Perera,Puttalam,Marawila,North Western,9412,9432,18844,376480,377280,753760
1/23/2025,Dinesh Perera,Puttalam,Marawila,North Western,2911,6871,9782,116440,274840,391280
1/24/2025,Dinesh Perera,Puttalam,Marawila,North Western,8919,1138,10057,356760,45520,402280
1/25/2025,Dinesh Perera,Puttalam,Marawila,North Western,1439,3019,4458,57560,120760,178320
1/26/2025,Dinesh Perera,Puttalam,Marawila,North Western,6636,8874,15510,265440,354960,620400
1/27/2025,Dinesh Perera,Puttalam,Marawila,North Western,6067,5868,11935,242680,234720,477400
1/28/2025,Dinesh Perera,Puttalam,Marawila,North Western,4201,355,4556,168040,14200,182240
1/29/2025,Dinesh Perera,Puttalam,Marawila,North Western,4625,2129,6754,185000,85160,270160
1/30/2025,Dinesh Perera,Puttalam,Marawila,North Western,9202,4387,13589,368080,175480,543560
1/31/2025,Dinesh Perera,Puttalam,Marawila,North Western,7136,7839,14975,285440,313560,599000
2/1/2025,Dinesh Perera,Puttalam,Marawila,North Western,3395,3403,6798,135800,136120,271920
2/2/2025,Dinesh Perera,Puttalam,Marawila,North Western,9539,8512,18051,381560,340480,722040
2/3/2025,Dinesh Perera,Puttalam,Marawila,North Western,4068,6238,10306,162720,249520,412240
2/4/2025,Dinesh Perera,Puttalam,Marawila,North Western,2553,1408,3961,102120,56320,158440
2/5/2025,Dinesh Perera,Puttalam,Marawila,North Western,9717,6103,15820,388680,244120,632800
2/6/2025,Dinesh Perera,Puttalam,Marawila,North Western,2032,8281,10313,81280,331240,412520
2/7/2025,Dinesh Perera,Puttalam,Marawila,North Western,8484,4805,13289,339360,192200,531560
2/8/2025,Dinesh Perera,Puttalam,Marawila,North Western,5135,6227,11362,205400,249080,454480
2/9/2025,Dinesh Perera,Puttalam,Marawila,North Western,9762,9064,18826,390480,362560,753040
2/10/2025,Dinesh Perera,Puttalam,Marawila,North Western,3548,6673,10221,141920,266920,408840
2/11/2025,Dinesh Perera,Puttalam,Marawila,North Western,1205,2226,3431,48200,89040,137240
2/12/2025,Dinesh Perera,Puttalam,Marawila,North Western,3162,7239,10401,126480,289560,416040
2/13/2025,Dinesh Perera,Puttalam,Marawila,North Western,3672,3199,6871,146880,127960,274840
2/14/2025,Dinesh Perera,Puttalam,Marawila,North Western,70,5541,5611,2800,221640,224440
2/15/2025,Dinesh Perera,Puttalam,Marawila,North Western,309,3291,3600,12360,131640,144000
2/16/2025,Dinesh Perera,Puttalam,Marawila,North Western,1030,7025,8055,41200,281000,322200
2/17/2025,Dinesh Perera,Puttalam,Marawila,North Western,7313,4912,12225,292520,196480,489000
2/18/2025,Dinesh Perera,Puttalam,Marawila,North Western,6176,8276,14452,247040,331040,578080
2/19/2025,Dinesh Perera,Puttalam,Marawila,North Western,9394,9709,19103,375760,388360,764120
2/20/2025,Dinesh Perera,Puttalam,Marawila,North Western,9202,9245,18447,368080,369800,737880
2/21/2025,Dinesh Perera,Puttalam,Marawila,North Western,7162,8077,15239,286480,323080,609560
2/22/2025,Dinesh Perera,Puttalam,Marawila,North Western,5085,5139,10224,203400,205560,408960
2/23/2025,Dinesh Perera,Puttalam,Marawila,North Western,8273,1870,10143,330920,74800,405720
2/24/2025,Dinesh Perera,Puttalam,Marawila,North Western,4331,9898,14229,173240,395920,569160
2/25/2025,Dinesh Perera,Puttalam,Marawila,North Western,3663,6623,10286,146520,264920,411440
2/26/2025,Dinesh Perera,Puttalam,Marawila,North Western,1812,1721,3533,72480,68840,141320
2/27/2025,Dinesh Perera,Puttalam,Marawila,North Western,7336,9493,16829,293440,379720,673160
2/28/2025,Dinesh Perera,Puttalam,Marawila,North Western,8339,5679,14018,333560,227160,560720
3/1/2025,Dinesh Perera,Puttalam,Marawila,North Western,1663,1031,2694,66520,41240,107760
3/2/2025,Dinesh Perera,Puttalam,Marawila,North Western,9216,8167,17383,368640,326680,695320
3/3/2025,Dinesh Perera,Puttalam,Marawila,North Western,6260,3791,10051,250400,151640,402040
3/4/2025,Dinesh Perera,Puttalam,Marawila,North Western,4303,6420,10723,172120,256800,428920
3/5/2025,Dinesh Perera,Puttalam,Marawila,North Western,8471,6057,14528,338840,242280,581120
3/6/2025,Dinesh Perera,Puttalam,Marawila,North Western,5286,6283,11569,211440,251320,462760
3/7/2025,Dinesh Perera,Puttalam,Marawila,North Western,4015,6278,10293,160600,251120,411720
3/8/2025,Dinesh Perera,Puttalam,Marawila,North Western,4943,2835,7778,197720,113400,311120
3/9/2025,Dinesh Perera,Puttalam,Marawila,North Western,9035,5749,14784,361400,229960,591360
3/10/2025,Dinesh Perera,Puttalam,Marawila,North Western,8964,372,9336,358560,14880,373440
3/11/2025,Dinesh Perera,Puttalam,Marawila,North Western,194,358,552,7760,14320,22080
3/12/2025,Dinesh Perera,Puttalam,Marawila,North Western,8384,6053,14437,335360,242120,577480
3/13/2025,Dinesh Perera,Puttalam,Marawila,North Western,2950,4702,7652,118000,188080,306080
3/14/2025,Dinesh Perera,Puttalam,Marawila,North Western,7332,5821,13153,293280,232840,526120
3/15/2025,Dinesh Perera,Puttalam,Marawila,North Western,4243,7562,11805,169720,302480,472200
3/16/2025,Dinesh Perera,Puttalam,Marawila,North Western,4137,3473,7610,165480,138920,304400
3/17/2025,Dinesh Perera,Puttalam,Marawila,North Western,1439,7390,8829,57560,295600,353160
3/18/2025,Dinesh Perera,Puttalam,Marawila,North Western,9761,5199,14960,390440,207960,598400
3/19/2025,Dinesh Perera,Puttalam,Marawila,North Western,1645,31,1676,65800,1240,67040
3/20/2025,Dinesh Perera,Puttalam,Marawila,North Western,1698,1145,2843,67920,45800,113720
3/21/2025,Dinesh Perera,Puttalam,Marawila,North Western,5761,4577,10338,230440,183080,413520
3/22/2025,Dinesh Perera,Puttalam,Marawila,North Western,411,2211,2622,16440,88440,104880
3/23/2025,Dinesh Perera,Puttalam,Marawila,North Western,5911,9804,15715,236440,392160,628600
3/25/2024,Aishwarya Gunawardena,Ampara,Chenkaladi,Eastern,6966,1019,7985,278640,40760,319400
3/26/2024,Aishwarya Gunawardena,Ampara,Chenkaladi,Eastern,8537,4587,13124,341480,183480,524960
3/27/2024,Aishwarya Gunawardena,Ampara,Chenkaladi,Eastern,6977,951,7928,279080,38040,317120
3/28/2024,Aishwarya Gunawardena,Ampara,Chenkaladi,Eastern,6449,8103,14552,257960,324120,582080
3/29/2024,Aishwarya Gunawardena,Ampara,Chenkaladi,Eastern,3569,6094,9663,142760,243760,386520
3/30/2024,Aishwarya Gunawardena,Ampara,Chenkaladi,Eastern,7320,1397,8717,292800,55880,348680
3/31/2024,Aishwarya Gunawardena,Ampara,Chenkaladi,Eastern,4524,3144,7668,180960,125760,306720
4/1/2024,Aishwarya Gunawardena,Ampara,Chenkaladi,Eastern,1846,9692,11538,73840,387680,461520
4/2/2024,Aishwarya Gunawardena,Ampara,Chenkaladi,Eastern,1948,8684,10632,77920,347360,425280
4/3/2024,Aishwarya Gunawardena,Ampara,Chenkaladi,Eastern,2147,5726,7873,85880,229040,314920
4/4/2024,Aishwarya Gunawardena,Ampara,Chenkaladi,Eastern,8377,818,9195,335080,32720,367800
4/5/2024,Aishwarya Gunawardena,Ampara,Chenkaladi,Eastern,305,200,505,12200,8000,20200
4/6/2024,Aishwarya Gunawardena,Ampara,Chenkaladi,Eastern,804,4651,5455,32160,186040,218200
4/7/2024,Aishwarya Gunawardena,Ampara,Chenkaladi,Eastern,7040,3212,10252,281600,128480,410080
4/8/2024,Aishwarya Gunawardena,Ampara,Chenkaladi,Eastern,6472,1416,7888,258880,56640,315520
4/9/2024,Aishwarya Gunawardena,Ampara,Chenkaladi,Eastern,3695,7188,10883,147800,287520,435320
4/10/2024,Aishwarya Gunawardena,Ampara,Chenkaladi,Eastern,8663,1983,10646,346520,79320,425840
4/11/2024,Aishwarya Gunawardena,Ampara,Chenkaladi,Eastern,6189,3933,10122,247560,157320,404880
4/19/2024,Aishwarya Gunawardena,Ampara,Chenkaladi,Eastern,7796,2598,10394,311840,103920,415760
4/20/2024,Aishwarya Gunawardena,Ampara,Chenkaladi,Eastern,2106,8600,10706,84240,344000,428240
4/21/2024,Aishwarya Gunawardena,Ampara,Chenkaladi,Eastern,5485,2123,7608,219400,84920,304320
4/22/2024,Aishwarya Gunawardena,Ampara,Chenkaladi,Eastern,8039,9912,17951,321560,396480,718040
4/23/2024,Aishwarya Gunawardena,Ampara,Chenkaladi,Eastern,2111,5129,7240,84440,205160,289600
4/24/2024,Aishwarya Gunawardena,Ampara,Chenkaladi,Eastern,7629,2767,10396,305160,110680,415840
4/25/2024,Aishwarya Gunawardena,Ampara,Chenkaladi,Eastern,9774,2548,12322,390960,101920,492880
4/26/2024,Aishwarya Gunawardena,Ampara,Chenkaladi,Eastern,6488,7876,14364,259520,315040,574560
4/27/2024,Aishwarya Gunawardena,Ampara,Chenkaladi,Eastern,4320,7976,12296,172800,319040,491840
4/28/2024,Aishwarya Gunawardena,Ampara,Chenkaladi,Eastern,1985,5213,7198,79400,208520,287920
4/29/2024,Aishwarya Gunawardena,Ampara,Chenkaladi,Eastern,5980,5676,11656,239200,227040,466240
4/30/2024,Aishwarya Gunawardena,Ampara,Chenkaladi,Eastern,2538,4504,7042,101520,180160,281680
5/1/2024,Aishwarya Gunawardena,Ampara,Chenkaladi,Eastern,3500,8063,11563,140000,322520,462520
5/2/2024,Aishwarya Gunawardena,Ampara,Chenkaladi,Eastern,1196,4014,5210,47840,160560,208400
5/3/2024,Aishwarya Gunawardena,Ampara,Chenkaladi,Eastern,3545,2307,5852,141800,92280,234080
5/4/2024,Aishwarya Gunawardena,Ampara,Chenkaladi,Eastern,5971,8138,14109,238840,325520,564360
5/5/2024,Aishwarya Gunawardena,Ampara,Chenkaladi,Eastern,3603,4992,8595,144120,199680,343800
5/6/2024,Aishwarya Gunawardena,Ampara,Chenkaladi,Eastern,3266,5035,8301,130640,201400,332040
5/7/2024,Aishwarya Gunawardena,Ampara,Chenkaladi,Eastern,8579,5470,14049,343160,218800,561960
5/8/2024,Aishwarya Gunawardena,Ampara,Chenkaladi,Eastern,6197,2963,9160,247880,118520,366400
5/9/2024,Aishwarya Gunawardena,Ampara,Chenkaladi,Eastern,2010,2107,4117,80400,84280,164680
5/10/2024,Aishwarya Gunawardena,Ampara,Chenkaladi,Eastern,2306,1623,3929,92240,64920,157160
5/11/2024,Aishwarya Gunawardena,Ampara,Chenkaladi,Eastern,6621,3574,10195,264840,142960,407800
5/12/2024,Aishwarya Gunawardena,Ampara,Chenkaladi,Eastern,4264,9326,13590,170560,373040,543600
5/13/2024,Aishwarya Gunawardena,Ampara,Chenkaladi,Eastern,5537,1110,6647,221480,44400,265880
5/14/2024,Aishwarya Gunawardena,Ampara,Chenkaladi,Eastern,3882,8474,12356,155280,338960,494240
5/15/2024,Aishwarya Gunawardena,Ampara,Chenkaladi,Eastern,4430,9846,14276,177200,393840,571040
5/16/2024,Aishwarya Gunawardena,Ampara,Chenkaladi,Eastern,7676,9725,17401,307040,389000,696040
5/17/2024,Aishwarya Gunawardena,Ampara,Chenkaladi,Eastern,5703,380,6083,228120,15200,243320
5/18/2024,Aishwarya Gunawardena,Ampara,Chenkaladi,Eastern,1223,8134,9357,48920,325360,374280
5/19/2024,Aishwarya Gunawardena,Ampara,Chenkaladi,Eastern,1860,2119,3979,74400,84760,159160
5/20/2024,Aishwarya Gunawardena,Ampara,Chenkaladi,Eastern,3153,8440,11593,126120,337600,463720
5/21/2024,Aishwarya Gunawardena,Ampara,Chenkaladi,Eastern,5162,3505,8667,206480,140200,346680
5/22/2024,Aishwarya Gunawardena,Ampara,Chenkaladi,Eastern,7443,7039,14482,297720,281560,579280
5/24/2024,Aishwarya Gunawardena,Ampara,Chenkaladi,Eastern,3226,3224,6450,129040,128960,258000
5/25/2024,Aishwarya Gunawardena,Ampara,Chenkaladi,Eastern,8227,7741,15968,329080,309640,638720
5/26/2024,Aishwarya Gunawardena,Ampara,Chenkaladi,Eastern,3837,8410,12247,153480,336400,489880
5/27/2024,Aishwarya Gunawardena,Ampara,Chenkaladi,Eastern,7855,5256,13111,314200,210240,524440
5/28/2024,Aishwarya Gunawardena,Ampara,Chenkaladi,Eastern,8553,4742,13295,342120,189680,531800
5/29/2024,Aishwarya Gunawardena,Ampara,Chenkaladi,Eastern,5175,5486,10661,207000,219440,426440
5/30/2024,Aishwarya Gunawardena,Ampara,Chenkaladi,Eastern,2043,3999,6042,81720,159960,241680
5/31/2024,Aishwarya Gunawardena,Ampara,Chenkaladi,Eastern,4594,4347,8941,183760,173880,357640
6/1/2024,Aishwarya Gunawardena,Ampara,Chenkaladi,Eastern,1513,5212,6725,60520,208480,269000
6/2/2024,Aishwarya Gunawardena,Ampara,Chenkaladi,Eastern,713,5867,6580,28520,234680,263200
6/3/2024,Aishwarya Gunawardena,Ampara,Chenkaladi,Eastern,3736,9644,13380,149440,385760,535200
6/4/2024,Aishwarya Gunawardena,Ampara,Chenkaladi,Eastern,9867,8927,18794,394680,357080,751760
6/5/2024,Aishwarya Gunawardena,Ampara,Chenkaladi,Eastern,5751,5815,11566,230040,232600,462640
6/6/2024,Aishwarya Gunawardena,Ampara,Chenkaladi,Eastern,6272,2093,8365,250880,83720,334600
6/7/2024,Aishwarya Gunawardena,Ampara,Chenkaladi,Eastern,9451,5012,14463,378040,200480,578520
6/8/2024,Aishwarya Gunawardena,Ampara,Chenkaladi,Eastern,6377,2453,8830,255080,98120,353200
6/9/2024,Aishwarya Gunawardena,Ampara,Chenkaladi,Eastern,7778,2106,9884,311120,84240,395360
6/10/2024,Aishwarya Gunawardena,Ampara,Chenkaladi,Eastern,5987,6187,12174,239480,247480,486960
6/11/2024,Aishwarya Gunawardena,Ampara,Chenkaladi,Eastern,2501,7850,10351,100040,314000,414040
6/12/2024,Aishwarya Gunawardena,Ampara,Chenkaladi,Eastern,172,9385,9557,6880,375400,382280
6/13/2024,Aishwarya Gunawardena,Ampara,Chenkaladi,Eastern,2186,1500,3686,87440,60000,147440
6/14/2024,Aishwarya Gunawardena,Ampara,Chenkaladi,Eastern,6516,8932,15448,260640,357280,617920
6/15/2024,Aishwarya Gunawardena,Ampara,Chenkaladi,Eastern,6236,9662,15898,249440,386480,635920
6/16/2024,Aishwarya Gunawardena,Ampara,Chenkaladi,Eastern,6987,3692,10679,279480,147680,427160
6/17/2024,Aishwarya Gunawardena,Ampara,Chenkaladi,Eastern,8639,6455,15094,345560,258200,603760
6/18/2024,Aishwarya Gunawardena,Ampara,Chenkaladi,Eastern,4142,4767,8909,165680,190680,356360
6/19/2024,Aishwarya Gunawardena,Ampara,Chenkaladi,Eastern,7967,1861,9828,318680,74440,393120
6/20/2024,Aishwarya Gunawardena,Ampara,Chenkaladi,Eastern,7117,5194,12311,284680,207760,492440
6/21/2024,Aishwarya Gunawardena,Ampara,Chenkaladi,Eastern,6531,744,7275,261240,29760,291000
6/22/2024,Aishwarya Gunawardena,Ampara,Chenkaladi,Eastern,8755,3525,12280,350200,141000,491200
6/23/2024,Aishwarya Gunawardena,Ampara,Chenkaladi,Eastern,1842,6659,8501,73680,266360,340040
6/24/2024,Aishwarya Gunawardena,Ampara,Chenkaladi,Eastern,2291,6912,9203,91640,276480,368120
6/25/2024,Aishwarya Gunawardena,Ampara,Chenkaladi,Eastern,5970,541,6511,238800,21640,260440
6/26/2024,Aishwarya Gunawardena,Ampara,Chenkaladi,Eastern,535,5152,5687,21400,206080,227480
6/27/2024,Aishwarya Gunawardena,Ampara,Chenkaladi,Eastern,2227,9091,11318,89080,363640,452720
6/28/2024,Aishwarya Gunawardena,Ampara,Chenkaladi,Eastern,7000,1470,8470,280000,58800,338800
6/29/2024,Aishwarya Gunawardena,Ampara,Chenkaladi,Eastern,8728,1417,10145,349120,56680,405800
6/30/2024,Aishwarya Gunawardena,Ampara,Chenkaladi,Eastern,5365,7507,12872,214600,300280,514880
7/1/2024,Aishwarya Gunawardena,Ampara,Chenkaladi,Eastern,4929,4808,9737,197160,192320,389480
7/2/2024,Aishwarya Gunawardena,Ampara,Chenkaladi,Eastern,1158,1279,2437,46320,51160,97480
7/3/2024,Aishwarya Gunawardena,Ampara,Chenkaladi,Eastern,2471,405,2876,98840,16200,115040
7/4/2024,Aishwarya Gunawardena,Ampara,Chenkaladi,Eastern,3899,7462,11361,155960,298480,454440
7/5/2024,Aishwarya Gunawardena,Ampara,Chenkaladi,Eastern,9996,3678,13674,399840,147120,546960
7/6/2024,Aishwarya Gunawardena,Ampara,Chenkaladi,Eastern,9841,4341,14182,393640,173640,567280
7/7/2024,Aishwarya Gunawardena,Ampara,Chenkaladi,Eastern,8625,651,9276,345000,26040,371040
7/8/2024,Aishwarya Gunawardena,Ampara,Chenkaladi,Eastern,9664,7025,16689,386560,281000,667560
7/9/2024,Aishwarya Gunawardena,Ampara,Chenkaladi,Eastern,2524,7652,10176,100960,306080,407040
7/10/2024,Aishwarya Gunawardena,Ampara,Chenkaladi,Eastern,2617,4518,7135,104680,180720,285400
7/11/2024,Aishwarya Gunawardena,Ampara,Chenkaladi,Eastern,3995,3492,7487,159800,139680,299480
7/12/2024,Aishwarya Gunawardena,Ampara,Chenkaladi,Eastern,5421,7258,12679,216840,290320,507160
7/13/2024,Aishwarya Gunawardena,Ampara,Chenkaladi,Eastern,8419,7364,15783,336760,294560,631320
7/14/2024,Aishwarya Gunawardena,Ampara,Chenkaladi,Eastern,5453,1616,7069,218120,64640,282760
7/15/2024,Aishwarya Gunawardena,Ampara,Chenkaladi,Eastern,3319,8130,11449,132760,325200,457960
7/16/2024,Aishwarya Gunawardena,Ampara,Chenkaladi,Eastern,5499,2639,8138,219960,105560,325520
7/17/2024,Aishwarya Gunawardena,Ampara,Chenkaladi,Eastern,7179,8575,15754,287160,343000,630160
7/18/2024,Aishwarya Gunawardena,Ampara,Chenkaladi,Eastern,707,2007,2714,28280,80280,108560
7/19/2024,Aishwarya Gunawardena,Ampara,Chenkaladi,Eastern,6812,322,7134,272480,12880,285360
7/20/2024,Aishwarya Gunawardena,Ampara,Chenkaladi,Eastern,5597,9095,14692,223880,363800,587680
7/21/2024,Aishwarya Gunawardena,Ampara,Chenkaladi,Eastern,6827,5940,12767,273080,237600,510680
7/22/2024,Aishwarya Gunawardena,Ampara,Chenkaladi,Eastern,4194,1120,5314,167760,44800,212560
7/23/2024,Aishwarya Gunawardena,Ampara,Chenkaladi,Eastern,6678,1685,8363,267120,67400,334520
7/24/2024,Aishwarya Gunawardena,Ampara,Chenkaladi,Eastern,337,2559,2896,13480,102360,115840
7/25/2024,Aishwarya Gunawardena,Ampara,Chenkaladi,Eastern,4237,4499,8736,169480,179960,349440
7/26/2024,Aishwarya Gunawardena,Ampara,Chenkaladi,Eastern,3544,8578,12122,141760,343120,484880
7/27/2024,Aishwarya Gunawardena,Ampara,Chenkaladi,Eastern,2039,9634,11673,81560,385360,466920
7/28/2024,Aishwarya Gunawardena,Ampara,Chenkaladi,Eastern,7135,9126,16261,285400,365040,650440
7/29/2024,Aishwarya Gunawardena,Ampara,Chenkaladi,Eastern,4677,9953,14630,187080,398120,585200
7/30/2024,Aishwarya Gunawardena,Ampara,Chenkaladi,Eastern,315,8523,8838,12600,340920,353520
7/31/2024,Aishwarya Gunawardena,Ampara,Chenkaladi,Eastern,7445,7964,15409,297800,318560,616360
8/1/2024,Aishwarya Gunawardena,Ampara,Chenkaladi,Eastern,6690,4977,11667,267600,199080,466680
8/2/2024,Aishwarya Gunawardena,Ampara,Chenkaladi,Eastern,8241,1567,9808,329640,62680,392320
8/3/2024,Aishwarya Gunawardena,Ampara,Chenkaladi,Eastern,4622,5607,10229,184880,224280,409160
8/4/2024,Aishwarya Gunawardena,Ampara,Chenkaladi,Eastern,4270,7603,11873,170800,304120,474920
8/5/2024,Aishwarya Gunawardena,Ampara,Chenkaladi,Eastern,8558,6875,15433,342320,275000,617320
8/6/2024,Aishwarya Gunawardena,Ampara,Chenkaladi,Eastern,7235,4624,11859,289400,184960,474360
8/7/2024,Aishwarya Gunawardena,Ampara,Chenkaladi,Eastern,6029,7150,13179,241160,286000,527160
8/8/2024,Aishwarya Gunawardena,Ampara,Chenkaladi,Eastern,4611,9362,13973,184440,374480,558920
8/9/2024,Aishwarya Gunawardena,Ampara,Chenkaladi,Eastern,5042,9371,14413,201680,374840,576520
8/10/2024,Aishwarya Gunawardena,Ampara,Chenkaladi,Eastern,8544,9859,18403,341760,394360,736120
8/11/2024,Aishwarya Gunawardena,Ampara,Chenkaladi,Eastern,3914,5633,9547,156560,225320,381880
8/12/2024,Aishwarya Gunawardena,Ampara,Chenkaladi,Eastern,7494,571,8065,299760,22840,322600
8/13/2024,Aishwarya Gunawardena,Ampara,Chenkaladi,Eastern,5409,512,5921,216360,20480,236840
8/14/2024,Aishwarya Gunawardena,Ampara,Chenkaladi,Eastern,4467,6937,11404,178680,277480,456160
8/15/2024,Aishwarya Gunawardena,Ampara,Chenkaladi,Eastern,8881,2474,11355,355240,98960,454200
8/16/2024,Aishwarya Gunawardena,Ampara,Chenkaladi,Eastern,2291,8838,11129,91640,353520,445160
8/17/2024,Aishwarya Gunawardena,Ampara,Chenkaladi,Eastern,2004,1539,3543,80160,61560,141720
8/18/2024,Aishwarya Gunawardena,Ampara,Chenkaladi,Eastern,1288,5875,7163,51520,235000,286520
8/19/2024,Aishwarya Gunawardena,Ampara,Chenkaladi,Eastern,1051,5331,6382,42040,213240,255280
8/20/2024,Aishwarya Gunawardena,Ampara,Chenkaladi,Eastern,5866,6051,11917,234640,242040,476680
8/21/2024,Aishwarya Gunawardena,Ampara,Chenkaladi,Eastern,9492,9306,18798,379680,372240,751920
8/22/2024,Aishwarya Gunawardena,Ampara,Chenkaladi,Eastern,7373,2058,9431,294920,82320,377240
8/23/2024,Aishwarya Gunawardena,Ampara,Chenkaladi,Eastern,9501,9324,18825,380040,372960,753000
8/24/2024,Aishwarya Gunawardena,Ampara,Chenkaladi,Eastern,5740,755,6495,229600,30200,259800
8/25/2024,Aishwarya Gunawardena,Ampara,Chenkaladi,Eastern,3248,1772,5020,129920,70880,200800
8/26/2024,Aishwarya Gunawardena,Ampara,Chenkaladi,Eastern,6478,3024,9502,259120,120960,380080
8/27/2024,Aishwarya Gunawardena,Ampara,Chenkaladi,Eastern,4397,9790,14187,175880,391600,567480
8/28/2024,Aishwarya Gunawardena,Ampara,Chenkaladi,Eastern,8290,4269,12559,331600,170760,502360
8/29/2024,Aishwarya Gunawardena,Ampara,Chenkaladi,Eastern,1851,927,2778,74040,37080,111120
8/30/2024,Aishwarya Gunawardena,Ampara,Chenkaladi,Eastern,9284,3893,13177,371360,155720,527080
8/31/2024,Aishwarya Gunawardena,Ampara,Chenkaladi,Eastern,384,6060,6444,15360,242400,257760
9/1/2024,Aishwarya Gunawardena,Ampara,Chenkaladi,Eastern,192,7044,7236,7680,281760,289440
9/2/2024,Aishwarya Gunawardena,Ampara,Chenkaladi,Eastern,5556,457,6013,222240,18280,240520
9/3/2024,Aishwarya Gunawardena,Ampara,Chenkaladi,Eastern,4557,3121,7678,182280,124840,307120
9/4/2024,Aishwarya Gunawardena,Ampara,Chenkaladi,Eastern,8724,2651,11375,348960,106040,455000
9/5/2024,Aishwarya Gunawardena,Ampara,Chenkaladi,Eastern,4072,5192,9264,162880,207680,370560
9/6/2024,Aishwarya Gunawardena,Ampara,Chenkaladi,Eastern,5875,7724,13599,235000,308960,543960
9/7/2024,Aishwarya Gunawardena,Ampara,Chenkaladi,Eastern,4040,7848,11888,161600,313920,475520
9/8/2024,Aishwarya Gunawardena,Ampara,Chenkaladi,Eastern,2994,8584,11578,119760,343360,463120
9/9/2024,Aishwarya Gunawardena,Ampara,Chenkaladi,Eastern,8833,180,9013,353320,7200,360520
9/10/2024,Aishwarya Gunawardena,Ampara,Chenkaladi,Eastern,5591,2077,7668,223640,83080,306720
9/11/2024,Aishwarya Gunawardena,Ampara,Chenkaladi,Eastern,2215,5478,7693,88600,219120,307720
9/12/2024,Aishwarya Gunawardena,Ampara,Chenkaladi,Eastern,2741,5556,8297,109640,222240,331880
9/13/2024,Aishwarya Gunawardena,Ampara,Chenkaladi,Eastern,7438,2046,9484,297520,81840,379360
9/14/2024,Aishwarya Gunawardena,Ampara,Chenkaladi,Eastern,3559,3564,7123,142360,142560,284920
9/15/2024,Aishwarya Gunawardena,Ampara,Chenkaladi,Eastern,2996,4023,7019,119840,160920,280760
9/16/2024,Aishwarya Gunawardena,Ampara,Chenkaladi,Eastern,9627,1239,10866,385080,49560,434640
9/17/2024,Aishwarya Gunawardena,Ampara,Chenkaladi,Eastern,320,6087,6407,12800,243480,256280
9/18/2024,Aishwarya Gunawardena,Ampara,Chenkaladi,Eastern,7011,9971,16982,280440,398840,679280
9/19/2024,Aishwarya Gunawardena,Ampara,Chenkaladi,Eastern,4815,9380,14195,192600,375200,567800
9/20/2024,Aishwarya Gunawardena,Ampara,Chenkaladi,Eastern,7045,4762,11807,281800,190480,472280
9/21/2024,Aishwarya Gunawardena,Ampara,Chenkaladi,Eastern,3849,9263,13112,153960,370520,524480
9/22/2024,Aishwarya Gunawardena,Ampara,Chenkaladi,Eastern,172,5812,5984,6880,232480,239360
9/23/2024,Aishwarya Gunawardena,Ampara,Chenkaladi,Eastern,1642,6266,7908,65680,250640,316320
9/24/2024,Aishwarya Gunawardena,Ampara,Chenkaladi,Eastern,3299,6183,9482,131960,247320,379280
9/25/2024,Aishwarya Gunawardena,Ampara,Chenkaladi,Eastern,6876,8541,15417,275040,341640,616680
9/26/2024,Aishwarya Gunawardena,Ampara,Chenkaladi,Eastern,6606,8110,14716,264240,324400,588640
9/27/2024,Aishwarya Gunawardena,Ampara,Chenkaladi,Eastern,2008,6321,8329,80320,252840,333160
9/28/2024,Aishwarya Gunawardena,Ampara,Chenkaladi,Eastern,3667,267,3934,146680,10680,157360
9/29/2024,Aishwarya Gunawardena,Ampara,Chenkaladi,Eastern,3238,7418,10656,129520,296720,426240
9/30/2024,Aishwarya Gunawardena,Ampara,Chenkaladi,Eastern,5825,1335,7160,233000,53400,286400
10/1/2024,Aishwarya Gunawardena,Ampara,Chenkaladi,Eastern,7389,8351,15740,295560,334040,629600
10/2/2024,Aishwarya Gunawardena,Ampara,Chenkaladi,Eastern,2743,134,2877,109720,5360,115080
10/3/2024,Aishwarya Gunawardena,Ampara,Chenkaladi,Eastern,2729,3734,6463,109160,149360,258520
10/4/2024,Aishwarya Gunawardena,Ampara,Chenkaladi,Eastern,4588,8938,13526,183520,357520,541040
10/5/2024,Aishwarya Gunawardena,Ampara,Chenkaladi,Eastern,1629,9435,11064,65160,377400,442560
10/6/2024,Aishwarya Gunawardena,Ampara,Chenkaladi,Eastern,4331,7213,11544,173240,288520,461760
10/7/2024,Aishwarya Gunawardena,Ampara,Chenkaladi,Eastern,4130,2409,6539,165200,96360,261560
10/8/2024,Aishwarya Gunawardena,Ampara,Chenkaladi,Eastern,563,9644,10207,22520,385760,408280
10/9/2024,Aishwarya Gunawardena,Ampara,Chenkaladi,Eastern,8707,9645,18352,348280,385800,734080
10/10/2024,Aishwarya Gunawardena,Ampara,Chenkaladi,Eastern,7331,9653,16984,293240,386120,679360
10/11/2024,Aishwarya Gunawardena,Ampara,Chenkaladi,Eastern,2967,7397,10364,118680,295880,414560
10/12/2024,Aishwarya Gunawardena,Ampara,Chenkaladi,Eastern,3664,8938,12602,146560,357520,504080
10/13/2024,Aishwarya Gunawardena,Ampara,Chenkaladi,Eastern,1376,985,2361,55040,39400,94440
10/14/2024,Aishwarya Gunawardena,Ampara,Chenkaladi,Eastern,1223,836,2059,48920,33440,82360
10/15/2024,Aishwarya Gunawardena,Ampara,Chenkaladi,Eastern,2557,225,2782,102280,9000,111280
10/16/2024,Aishwarya Gunawardena,Ampara,Chenkaladi,Eastern,8686,3887,12573,347440,155480,502920
10/17/2024,Aishwarya Gunawardena,Ampara,Chenkaladi,Eastern,9877,1322,11199,395080,52880,447960
10/18/2024,Aishwarya Gunawardena,Ampara,Chenkaladi,Eastern,9529,3789,13318,381160,151560,532720
10/19/2024,Aishwarya Gunawardena,Ampara,Chenkaladi,Eastern,124,9938,10062,4960,397520,402480
10/20/2024,Aishwarya Gunawardena,Ampara,Chenkaladi,Eastern,5873,8035,13908,234920,321400,556320
10/21/2024,Aishwarya Gunawardena,Ampara,Chenkaladi,Eastern,3632,7345,10977,145280,293800,439080
10/22/2024,Aishwarya Gunawardena,Ampara,Chenkaladi,Eastern,6724,1761,8485,268960,70440,339400
10/23/2024,Aishwarya Gunawardena,Ampara,Chenkaladi,Eastern,624,9743,10367,24960,389720,414680
10/24/2024,Aishwarya Gunawardena,Ampara,Chenkaladi,Eastern,1199,4665,5864,47960,186600,234560
10/25/2024,Aishwarya Gunawardena,Ampara,Chenkaladi,Eastern,8818,1575,10393,352720,63000,415720
10/26/2024,Aishwarya Gunawardena,Ampara,Chenkaladi,Eastern,8819,8694,17513,352760,347760,700520
10/27/2024,Aishwarya Gunawardena,Ampara,Chenkaladi,Eastern,2903,5651,8554,116120,226040,342160
10/28/2024,Aishwarya Gunawardena,Ampara,Chenkaladi,Eastern,1101,9191,10292,44040,367640,411680
10/29/2024,Aishwarya Gunawardena,Ampara,Chenkaladi,Eastern,7694,212,7906,307760,8480,316240
10/30/2024,Aishwarya Gunawardena,Ampara,Chenkaladi,Eastern,9166,1918,11084,366640,76720,443360
10/31/2024,Aishwarya Gunawardena,Ampara,Chenkaladi,Eastern,103,9181,9284,4120,367240,371360
11/1/2024,Aishwarya Gunawardena,Ampara,Chenkaladi,Eastern,1215,1275,2490,48600,51000,99600
11/2/2024,Aishwarya Gunawardena,Ampara,Chenkaladi,Eastern,6208,6822,13030,248320,272880,521200
11/3/2024,Aishwarya Gunawardena,Ampara,Chenkaladi,Eastern,9630,7281,16911,385200,291240,676440
11/4/2024,Aishwarya Gunawardena,Ampara,Chenkaladi,Eastern,4284,2382,6666,171360,95280,266640
11/5/2024,Aishwarya Gunawardena,Ampara,Chenkaladi,Eastern,9757,2206,11963,390280,88240,478520
11/6/2024,Aishwarya Gunawardena,Ampara,Chenkaladi,Eastern,3995,6321,10316,159800,252840,412640
11/7/2024,Aishwarya Gunawardena,Ampara,Chenkaladi,Eastern,667,518,1185,26680,20720,47400
11/8/2024,Aishwarya Gunawardena,Ampara,Chenkaladi,Eastern,7255,2780,10035,290200,111200,401400
11/9/2024,Aishwarya Gunawardena,Ampara,Chenkaladi,Eastern,5237,9306,14543,209480,372240,581720
11/10/2024,Aishwarya Gunawardena,Ampara,Chenkaladi,Eastern,5332,3145,8477,213280,125800,339080
11/11/2024,Aishwarya Gunawardena,Ampara,Chenkaladi,Eastern,7423,1447,8870,296920,57880,354800
11/12/2024,Aishwarya Gunawardena,Ampara,Chenkaladi,Eastern,1750,3624,5374,70000,144960,214960
11/13/2024,Aishwarya Gunawardena,Ampara,Chenkaladi,Eastern,3282,7257,10539,131280,290280,421560
11/14/2024,Aishwarya Gunawardena,Ampara,Chenkaladi,Eastern,5331,4696,10027,213240,187840,401080
11/15/2024,Aishwarya Gunawardena,Ampara,Chenkaladi,Eastern,1760,8016,9776,70400,320640,391040
11/16/2024,Aishwarya Gunawardena,Ampara,Chenkaladi,Eastern,4022,4313,8335,160880,172520,333400
11/17/2024,Aishwarya Gunawardena,Ampara,Chenkaladi,Eastern,7890,3967,11857,315600,158680,474280
11/18/2024,Aishwarya Gunawardena,Ampara,Chenkaladi,Eastern,2693,7718,10411,107720,308720,416440
11/19/2024,Aishwarya Gunawardena,Ampara,Chenkaladi,Eastern,1390,9115,10505,55600,364600,420200
11/20/2024,Aishwarya Gunawardena,Ampara,Chenkaladi,Eastern,3343,5751,9094,133720,230040,363760
11/21/2024,Aishwarya Gunawardena,Ampara,Chenkaladi,Eastern,5005,1704,6709,200200,68160,268360
11/22/2024,Aishwarya Gunawardena,Ampara,Chenkaladi,Eastern,8147,3740,11887,325880,149600,475480
11/23/2024,Aishwarya Gunawardena,Ampara,Chenkaladi,Eastern,1282,7825,9107,51280,313000,364280
11/24/2024,Aishwarya Gunawardena,Ampara,Chenkaladi,Eastern,468,466,934,18720,18640,37360
11/25/2024,Aishwarya Gunawardena,Ampara,Chenkaladi,Eastern,7721,4214,11935,308840,168560,477400
11/26/2024,Aishwarya Gunawardena,Ampara,Chenkaladi,Eastern,2629,2341,4970,105160,93640,198800
11/27/2024,Aishwarya Gunawardena,Ampara,Chenkaladi,Eastern,4007,3050,7057,160280,122000,282280
11/28/2024,Aishwarya Gunawardena,Ampara,Chenkaladi,Eastern,1742,1430,3172,69680,57200,126880
11/29/2024,Aishwarya Gunawardena,Ampara,Chenkaladi,Eastern,264,5484,5748,10560,219360,229920
11/30/2024,Aishwarya Gunawardena,Ampara,Chenkaladi,Eastern,5621,60,5681,224840,2400,227240
12/1/2024,Aishwarya Gunawardena,Ampara,Chenkaladi,Eastern,8463,2076,10539,338520,83040,421560
12/2/2024,Aishwarya Gunawardena,Ampara,Chenkaladi,Eastern,1413,2179,3592,56520,87160,143680
12/3/2024,Aishwarya Gunawardena,Ampara,Chenkaladi,Eastern,872,9450,10322,34880,378000,412880
12/4/2024,Aishwarya Gunawardena,Ampara,Chenkaladi,Eastern,7405,1115,8520,296200,44600,340800
12/5/2024,Aishwarya Gunawardena,Ampara,Chenkaladi,Eastern,6164,9323,15487,246560,372920,619480
12/6/2024,Aishwarya Gunawardena,Ampara,Chenkaladi,Eastern,9804,9725,19529,392160,389000,781160
12/7/2024,Aishwarya Gunawardena,Ampara,Chenkaladi,Eastern,5902,477,6379,236080,19080,255160
12/8/2024,Aishwarya Gunawardena,Ampara,Chenkaladi,Eastern,4042,3987,8029,161680,159480,321160
12/9/2024,Aishwarya Gunawardena,Ampara,Chenkaladi,Eastern,5336,9857,15193,213440,394280,607720
12/10/2024,Aishwarya Gunawardena,Ampara,Chenkaladi,Eastern,7993,7116,15109,319720,284640,604360
12/11/2024,Aishwarya Gunawardena,Ampara,Chenkaladi,Eastern,286,523,809,11440,20920,32360
12/12/2024,Aishwarya Gunawardena,Ampara,Chenkaladi,Eastern,2423,2150,4573,96920,86000,182920
12/13/2024,Aishwarya Gunawardena,Ampara,Chenkaladi,Eastern,8849,4301,13150,353960,172040,526000
12/14/2024,Aishwarya Gunawardena,Ampara,Chenkaladi,Eastern,1147,1954,3101,45880,78160,124040
12/15/2024,Aishwarya Gunawardena,Ampara,Chenkaladi,Eastern,8162,8854,17016,326480,354160,680640
12/16/2024,Aishwarya Gunawardena,Ampara,Chenkaladi,Eastern,7377,7215,14592,295080,288600,583680
12/17/2024,Aishwarya Gunawardena,Ampara,Chenkaladi,Eastern,7263,3595,10858,290520,143800,434320
12/18/2024,Aishwarya Gunawardena,Ampara,Chenkaladi,Eastern,2293,2400,4693,91720,96000,187720
12/19/2024,Aishwarya Gunawardena,Ampara,Chenkaladi,Eastern,1464,3905,5369,58560,156200,214760
12/20/2024,Aishwarya Gunawardena,Ampara,Chenkaladi,Eastern,2534,8240,10774,101360,329600,430960
12/21/2024,Aishwarya Gunawardena,Ampara,Chenkaladi,Eastern,1555,5659,7214,62200,226360,288560
12/22/2024,Aishwarya Gunawardena,Ampara,Chenkaladi,Eastern,9383,2495,11878,375320,99800,475120
12/23/2024,Aishwarya Gunawardena,Ampara,Chenkaladi,Eastern,3190,6598,9788,127600,263920,391520
12/24/2024,Aishwarya Gunawardena,Ampara,Chenkaladi,Eastern,6531,787,7318,261240,31480,292720
12/25/2024,Aishwarya Gunawardena,Ampara,Chenkaladi,Eastern,6062,6859,12921,242480,274360,516840
12/26/2024,Aishwarya Gunawardena,Ampara,Chenkaladi,Eastern,2181,3487,5668,87240,139480,226720
12/27/2024,Aishwarya Gunawardena,Ampara,Chenkaladi,Eastern,1022,5502,6524,40880,220080,260960
12/28/2024,Aishwarya Gunawardena,Ampara,Chenkaladi,Eastern,7822,4497,12319,312880,179880,492760
12/29/2024,Aishwarya Gunawardena,Ampara,Chenkaladi,Eastern,7616,5896,13512,304640,235840,540480
12/30/2024,Aishwarya Gunawardena,Ampara,Chenkaladi,Eastern,5196,4695,9891,207840,187800,395640
12/31/2024,Aishwarya Gunawardena,Ampara,Chenkaladi,Eastern,9473,656,10129,378920,26240,405160
1/1/2025,Aishwarya Gunawardena,Ampara,Chenkaladi,Eastern,3197,6708,9905,127880,268320,396200
1/2/2025,Aishwarya Gunawardena,Ampara,Chenkaladi,Eastern,5918,4406,10324,236720,176240,412960
1/3/2025,Aishwarya Gunawardena,Ampara,Chenkaladi,Eastern,1309,8342,9651,52360,333680,386040
1/4/2025,Aishwarya Gunawardena,Ampara,Chenkaladi,Eastern,4568,6149,10717,182720,245960,428680
1/5/2025,Aishwarya Gunawardena,Ampara,Chenkaladi,Eastern,3776,9395,13171,151040,375800,526840
1/6/2025,Aishwarya Gunawardena,Ampara,Chenkaladi,Eastern,5198,1575,6773,207920,63000,270920
1/7/2025,Aishwarya Gunawardena,Ampara,Chenkaladi,Eastern,9336,2603,11939,373440,104120,477560
1/8/2025,Aishwarya Gunawardena,Ampara,Chenkaladi,Eastern,1920,7201,9121,76800,288040,364840
1/9/2025,Aishwarya Gunawardena,Ampara,Chenkaladi,Eastern,5772,88,5860,230880,3520,234400
1/10/2025,Aishwarya Gunawardena,Ampara,Chenkaladi,Eastern,4265,7209,11474,170600,288360,458960
1/11/2025,Aishwarya Gunawardena,Ampara,Chenkaladi,Eastern,8341,3187,11528,333640,127480,461120
1/12/2025,Aishwarya Gunawardena,Ampara,Chenkaladi,Eastern,8652,4534,13186,346080,181360,527440
1/13/2025,Aishwarya Gunawardena,Ampara,Chenkaladi,Eastern,9982,931,10913,399280,37240,436520
1/14/2025,Aishwarya Gunawardena,Ampara,Chenkaladi,Eastern,8149,9932,18081,325960,397280,723240
1/15/2025,Aishwarya Gunawardena,Ampara,Chenkaladi,Eastern,2928,8115,11043,117120,324600,441720
1/16/2025,Aishwarya Gunawardena,Ampara,Chenkaladi,Eastern,9361,5474,14835,374440,218960,593400
1/17/2025,Aishwarya Gunawardena,Ampara,Chenkaladi,Eastern,8512,6148,14660,340480,245920,586400
1/18/2025,Aishwarya Gunawardena,Ampara,Chenkaladi,Eastern,4039,5570,9609,161560,222800,384360
1/19/2025,Aishwarya Gunawardena,Ampara,Chenkaladi,Eastern,1865,6214,8079,74600,248560,323160
1/20/2025,Aishwarya Gunawardena,Ampara,Chenkaladi,Eastern,1276,2284,3560,51040,91360,142400
1/21/2025,Aishwarya Gunawardena,Ampara,Chenkaladi,Eastern,3328,3021,6349,133120,120840,253960
1/22/2025,Aishwarya Gunawardena,Ampara,Chenkaladi,Eastern,9674,9627,19301,386960,385080,772040
1/23/2025,Aishwarya Gunawardena,Ampara,Chenkaladi,Eastern,1631,5404,7035,65240,216160,281400
1/24/2025,Aishwarya Gunawardena,Ampara,Chenkaladi,Eastern,6605,9128,15733,264200,365120,629320
1/25/2025,Aishwarya Gunawardena,Ampara,Chenkaladi,Eastern,7374,311,7685,294960,12440,307400
1/26/2025,Aishwarya Gunawardena,Ampara,Chenkaladi,Eastern,4715,4391,9106,188600,175640,364240
1/27/2025,Aishwarya Gunawardena,Ampara,Chenkaladi,Eastern,3105,9889,12994,124200,395560,519760
1/28/2025,Aishwarya Gunawardena,Ampara,Chenkaladi,Eastern,1318,9103,10421,52720,364120,416840
1/29/2025,Aishwarya Gunawardena,Ampara,Chenkaladi,Eastern,8610,8582,17192,344400,343280,687680
1/30/2025,Aishwarya Gunawardena,Ampara,Chenkaladi,Eastern,4878,996,5874,195120,39840,234960
1/31/2025,Aishwarya Gunawardena,Ampara,Chenkaladi,Eastern,4781,526,5307,191240,21040,212280
2/1/2025,Aishwarya Gunawardena,Ampara,Chenkaladi,Eastern,4035,7939,11974,161400,317560,478960
2/2/2025,Aishwarya Gunawardena,Ampara,Chenkaladi,Eastern,3619,6660,10279,144760,266400,411160
2/3/2025,Aishwarya Gunawardena,Ampara,Chenkaladi,Eastern,3757,3983,7740,150280,159320,309600
2/4/2025,Aishwarya Gunawardena,Ampara,Chenkaladi,Eastern,3720,4644,8364,148800,185760,334560
2/5/2025,Aishwarya Gunawardena,Ampara,Chenkaladi,Eastern,19,8953,8972,760,358120,358880
2/6/2025,Aishwarya Gunawardena,Ampara,Chenkaladi,Eastern,2908,4842,7750,116320,193680,310000
2/7/2025,Aishwarya Gunawardena,Ampara,Chenkaladi,Eastern,3326,8188,11514,133040,327520,460560
2/8/2025,Aishwarya Gunawardena,Ampara,Chenkaladi,Eastern,4730,3937,8667,189200,157480,346680
2/9/2025,Aishwarya Gunawardena,Ampara,Chenkaladi,Eastern,7939,7294,15233,317560,291760,609320
2/10/2025,Aishwarya Gunawardena,Ampara,Chenkaladi,Eastern,6059,4267,10326,242360,170680,413040
2/11/2025,Aishwarya Gunawardena,Ampara,Chenkaladi,Eastern,653,3516,4169,26120,140640,166760
2/12/2025,Aishwarya Gunawardena,Ampara,Chenkaladi,Eastern,6792,6049,12841,271680,241960,513640
2/13/2025,Aishwarya Gunawardena,Ampara,Chenkaladi,Eastern,8827,3771,12598,353080,150840,503920
2/14/2025,Aishwarya Gunawardena,Ampara,Chenkaladi,Eastern,3125,8176,11301,125000,327040,452040
2/15/2025,Aishwarya Gunawardena,Ampara,Chenkaladi,Eastern,2327,3923,6250,93080,156920,250000
2/16/2025,Aishwarya Gunawardena,Ampara,Chenkaladi,Eastern,74,4092,4166,2960,163680,166640
2/17/2025,Aishwarya Gunawardena,Ampara,Chenkaladi,Eastern,157,7398,7555,6280,295920,302200
2/18/2025,Aishwarya Gunawardena,Ampara,Chenkaladi,Eastern,4848,9210,14058,193920,368400,562320
2/19/2025,Aishwarya Gunawardena,Ampara,Chenkaladi,Eastern,7826,6015,13841,313040,240600,553640
2/20/2025,Aishwarya Gunawardena,Ampara,Chenkaladi,Eastern,1069,9397,10466,42760,375880,418640
2/21/2025,Aishwarya Gunawardena,Ampara,Chenkaladi,Eastern,1304,6630,7934,52160,265200,317360
2/22/2025,Aishwarya Gunawardena,Ampara,Chenkaladi,Eastern,3474,5948,9422,138960,237920,376880
2/23/2025,Aishwarya Gunawardena,Ampara,Chenkaladi,Eastern,4914,5498,10412,196560,219920,416480
2/24/2025,Aishwarya Gunawardena,Ampara,Chenkaladi,Eastern,4093,7828,11921,163720,313120,476840
2/25/2025,Aishwarya Gunawardena,Ampara,Chenkaladi,Eastern,5919,973,6892,236760,38920,275680
2/26/2025,Aishwarya Gunawardena,Ampara,Chenkaladi,Eastern,41,1137,1178,1640,45480,47120
2/27/2025,Aishwarya Gunawardena,Ampara,Chenkaladi,Eastern,1461,7399,8860,58440,295960,354400
2/28/2025,Aishwarya Gunawardena,Ampara,Chenkaladi,Eastern,846,5826,6672,33840,233040,266880
3/1/2025,Aishwarya Gunawardena,Ampara,Chenkaladi,Eastern,847,8381,9228,33880,335240,369120
3/2/2025,Aishwarya Gunawardena,Ampara,Chenkaladi,Eastern,2355,8123,10478,94200,324920,419120
3/3/2025,Aishwarya Gunawardena,Ampara,Chenkaladi,Eastern,5992,1486,7478,239680,59440,299120
3/4/2025,Aishwarya Gunawardena,Ampara,Chenkaladi,Eastern,9589,1309,10898,383560,52360,435920
3/5/2025,Aishwarya Gunawardena,Ampara,Chenkaladi,Eastern,973,1534,2507,38920,61360,100280
3/6/2025,Aishwarya Gunawardena,Ampara,Chenkaladi,Eastern,7976,9420,17396,319040,376800,695840
3/7/2025,Aishwarya Gunawardena,Ampara,Chenkaladi,Eastern,7120,7709,14829,284800,308360,593160
3/8/2025,Aishwarya Gunawardena,Ampara,Chenkaladi,Eastern,8165,4085,12250,326600,163400,490000
3/9/2025,Aishwarya Gunawardena,Ampara,Chenkaladi,Eastern,8856,7369,16225,354240,294760,649000
3/10/2025,Aishwarya Gunawardena,Ampara,Chenkaladi,Eastern,2511,2654,5165,100440,106160,206600
3/11/2025,Aishwarya Gunawardena,Ampara,Chenkaladi,Eastern,3520,5528,9048,140800,221120,361920
3/12/2025,Aishwarya Gunawardena,Ampara,Chenkaladi,Eastern,2743,8218,10961,109720,328720,438440
3/13/2025,Aishwarya Gunawardena,Ampara,Chenkaladi,Eastern,6337,4295,10632,253480,171800,425280
3/14/2025,Aishwarya Gunawardena,Ampara,Chenkaladi,Eastern,6119,3452,9571,244760,138080,382840
3/15/2025,Aishwarya Gunawardena,Ampara,Chenkaladi,Eastern,8082,8240,16322,323280,329600,652880
3/16/2025,Aishwarya Gunawardena,Ampara,Chenkaladi,Eastern,518,1460,1978,20720,58400,79120
3/17/2025,Aishwarya Gunawardena,Ampara,Chenkaladi,Eastern,2481,2740,5221,99240,109600,208840
3/18/2025,Aishwarya Gunawardena,Ampara,Chenkaladi,Eastern,8202,5268,13470,328080,210720,538800
3/19/2025,Aishwarya Gunawardena,Ampara,Chenkaladi,Eastern,2600,1951,4551,104000,78040,182040
3/20/2025,Aishwarya Gunawardena,Ampara,Chenkaladi,Eastern,7052,6919,13971,282080,276760,558840
3/21/2025,Aishwarya Gunawardena,Ampara,Chenkaladi,Eastern,309,7761,8070,12360,310440,322800
3/22/2025,Aishwarya Gunawardena,Ampara,Chenkaladi,Eastern,1942,5287,7229,77680,211480,289160
3/23/2025,Aishwarya Gunawardena,Ampara,Chenkaladi,Eastern,3933,8420,12353,157320,336800,494120
3/25/2024,Sandeepa De Silva,Colombo,Colombo,Western,5397,3615,9012,215880,144600,360480
3/26/2024,Sandeepa De Silva,Colombo,Colombo,Western,5188,7631,12819,207520,305240,512760
3/27/2024,Sandeepa De Silva,Colombo,Colombo,Western,27,6583,6610,1080,263320,264400
3/28/2024,Sandeepa De Silva,Colombo,Colombo,Western,6596,2530,9126,263840,101200,365040
3/29/2024,Sandeepa De Silva,Colombo,Colombo,Western,9792,4966,14758,391680,198640,590320
3/30/2024,Sandeepa De Silva,Colombo,Colombo,Western,2996,7996,10992,119840,319840,439680
3/31/2024,Sandeepa De Silva,Colombo,Colombo,Western,5333,3549,8882,213320,141960,355280
4/1/2024,Sandeepa De Silva,Colombo,Colombo,Western,7213,7247,14460,288520,289880,578400
4/2/2024,Sandeepa De Silva,Colombo,Colombo,Western,5978,8524,14502,239120,340960,580080
4/3/2024,Sandeepa De Silva,Colombo,Colombo,Western,7441,9238,16679,297640,369520,667160
4/4/2024,Sandeepa De Silva,Colombo,Colombo,Western,609,8270,8879,24360,330800,355160
4/5/2024,Sandeepa De Silva,Colombo,Colombo,Western,7838,5,7843,313520,200,313720
4/6/2024,Sandeepa De Silva,Colombo,Colombo,Western,474,3619,4093,18960,144760,163720
4/7/2024,Sandeepa De Silva,Colombo,Colombo,Western,5941,7144,13085,237640,285760,523400
4/8/2024,Sandeepa De Silva,Colombo,Colombo,Western,7293,5244,12537,291720,209760,501480
4/9/2024,Sandeepa De Silva,Colombo,Colombo,Western,5981,2151,8132,239240,86040,325280
4/10/2024,Sandeepa De Silva,Colombo,Colombo,Western,738,6765,7503,29520,270600,300120
4/11/2024,Sandeepa De Silva,Colombo,Colombo,Western,3908,8751,12659,156320,350040,506360
4/19/2024,Sandeepa De Silva,Colombo,Colombo,Western,6003,6657,12660,240120,266280,506400
4/20/2024,Sandeepa De Silva,Colombo,Colombo,Western,7793,8286,16079,311720,331440,643160
4/21/2024,Sandeepa De Silva,Colombo,Colombo,Western,3356,5337,8693,134240,213480,347720
4/22/2024,Sandeepa De Silva,Colombo,Colombo,Western,4291,1276,5567,171640,51040,222680
4/23/2024,Sandeepa De Silva,Colombo,Colombo,Western,1267,609,1876,50680,24360,75040
4/24/2024,Sandeepa De Silva,Colombo,Colombo,Western,9759,5668,15427,390360,226720,617080
4/25/2024,Sandeepa De Silva,Colombo,Colombo,Western,5100,3735,8835,204000,149400,353400
4/26/2024,Sandeepa De Silva,Colombo,Colombo,Western,7222,8280,15502,288880,331200,620080
4/27/2024,Sandeepa De Silva,Colombo,Colombo,Western,1804,9190,10994,72160,367600,439760
4/28/2024,Sandeepa De Silva,Colombo,Colombo,Western,9555,5749,15304,382200,229960,612160
4/29/2024,Sandeepa De Silva,Colombo,Colombo,Western,9864,1520,11384,394560,60800,455360
4/30/2024,Sandeepa De Silva,Colombo,Colombo,Western,5079,1033,6112,203160,41320,244480
5/1/2024,Sandeepa De Silva,Colombo,Colombo,Western,4555,4727,9282,182200,189080,371280
5/2/2024,Sandeepa De Silva,Colombo,Colombo,Western,276,3248,3524,11040,129920,140960
5/3/2024,Sandeepa De Silva,Colombo,Colombo,Western,4150,3089,7239,166000,123560,289560
5/4/2024,Sandeepa De Silva,Colombo,Colombo,Western,177,1004,1181,7080,40160,47240
5/5/2024,Sandeepa De Silva,Colombo,Colombo,Western,5754,4749,10503,230160,189960,420120
5/6/2024,Sandeepa De Silva,Colombo,Colombo,Western,4110,6475,10585,164400,259000,423400
5/7/2024,Sandeepa De Silva,Colombo,Colombo,Western,9410,5217,14627,376400,208680,585080
5/8/2024,Sandeepa De Silva,Colombo,Colombo,Western,9061,2562,11623,362440,102480,464920
5/9/2024,Sandeepa De Silva,Colombo,Colombo,Western,8516,6203,14719,340640,248120,588760
5/10/2024,Sandeepa De Silva,Colombo,Colombo,Western,4692,703,5395,187680,28120,215800
5/11/2024,Sandeepa De Silva,Colombo,Colombo,Western,8974,5087,14061,358960,203480,562440
5/12/2024,Sandeepa De Silva,Colombo,Colombo,Western,3116,2369,5485,124640,94760,219400
5/13/2024,Sandeepa De Silva,Colombo,Colombo,Western,4160,2174,6334,166400,86960,253360
5/14/2024,Sandeepa De Silva,Colombo,Colombo,Western,9353,4279,13632,374120,171160,545280
5/15/2024,Sandeepa De Silva,Colombo,Colombo,Western,8171,1457,9628,326840,58280,385120
5/16/2024,Sandeepa De Silva,Colombo,Colombo,Western,5841,5275,11116,233640,211000,444640
5/17/2024,Sandeepa De Silva,Colombo,Colombo,Western,6263,1224,7487,250520,48960,299480
5/18/2024,Sandeepa De Silva,Colombo,Colombo,Western,8182,2161,10343,327280,86440,413720
5/19/2024,Sandeepa De Silva,Colombo,Colombo,Western,9664,5318,14982,386560,212720,599280
5/20/2024,Sandeepa De Silva,Colombo,Colombo,Western,489,161,650,19560,6440,26000
5/21/2024,Sandeepa De Silva,Colombo,Colombo,Western,6854,7166,14020,274160,286640,560800
5/22/2024,Sandeepa De Silva,Colombo,Colombo,Western,8544,6808,15352,341760,272320,614080
5/24/2024,Sandeepa De Silva,Colombo,Colombo,Western,325,2050,2375,13000,82000,95000
5/25/2024,Sandeepa De Silva,Colombo,Colombo,Western,4059,2580,6639,162360,103200,265560
5/26/2024,Sandeepa De Silva,Colombo,Colombo,Western,9758,3223,12981,390320,128920,519240
5/27/2024,Sandeepa De Silva,Colombo,Colombo,Western,7587,9916,17503,303480,396640,700120
5/28/2024,Sandeepa De Silva,Colombo,Colombo,Western,7247,7647,14894,289880,305880,595760
5/29/2024,Sandeepa De Silva,Colombo,Colombo,Western,2759,7936,10695,110360,317440,427800
5/30/2024,Sandeepa De Silva,Colombo,Colombo,Western,5036,8710,13746,201440,348400,549840
5/31/2024,Sandeepa De Silva,Colombo,Colombo,Western,5489,4491,9980,219560,179640,399200
6/1/2024,Sandeepa De Silva,Colombo,Colombo,Western,4862,4980,9842,194480,199200,393680
6/2/2024,Sandeepa De Silva,Colombo,Colombo,Western,8488,2697,11185,339520,107880,447400
6/3/2024,Sandeepa De Silva,Colombo,Colombo,Western,8952,4537,13489,358080,181480,539560
6/4/2024,Sandeepa De Silva,Colombo,Colombo,Western,8140,5628,13768,325600,225120,550720
6/5/2024,Sandeepa De Silva,Colombo,Colombo,Western,6874,5252,12126,274960,210080,485040
6/6/2024,Sandeepa De Silva,Colombo,Colombo,Western,2058,2242,4300,82320,89680,172000
6/7/2024,Sandeepa De Silva,Colombo,Colombo,Western,1103,1615,2718,44120,64600,108720
6/8/2024,Sandeepa De Silva,Colombo,Colombo,Western,5605,3709,9314,224200,148360,372560
6/9/2024,Sandeepa De Silva,Colombo,Colombo,Western,3318,7279,10597,132720,291160,423880
6/10/2024,Sandeepa De Silva,Colombo,Colombo,Western,4359,6901,11260,174360,276040,450400
6/11/2024,Sandeepa De Silva,Colombo,Colombo,Western,1176,3135,4311,47040,125400,172440
6/12/2024,Sandeepa De Silva,Colombo,Colombo,Western,3168,3991,7159,126720,159640,286360
6/13/2024,Sandeepa De Silva,Colombo,Colombo,Western,7208,9645,16853,288320,385800,674120
6/14/2024,Sandeepa De Silva,Colombo,Colombo,Western,3685,6551,10236,147400,262040,409440
6/15/2024,Sandeepa De Silva,Colombo,Colombo,Western,3653,8183,11836,146120,327320,473440
6/16/2024,Sandeepa De Silva,Colombo,Colombo,Western,1037,7457,8494,41480,298280,339760
6/17/2024,Sandeepa De Silva,Colombo,Colombo,Western,9520,9147,18667,380800,365880,746680
6/18/2024,Sandeepa De Silva,Colombo,Colombo,Western,7074,1582,8656,282960,63280,346240
6/19/2024,Sandeepa De Silva,Colombo,Colombo,Western,4097,5570,9667,163880,222800,386680
6/20/2024,Sandeepa De Silva,Colombo,Colombo,Western,8156,5282,13438,326240,211280,537520
6/21/2024,Sandeepa De Silva,Colombo,Colombo,Western,1128,3628,4756,45120,145120,190240
6/22/2024,Sandeepa De Silva,Colombo,Colombo,Western,3487,7915,11402,139480,316600,456080
6/23/2024,Sandeepa De Silva,Colombo,Colombo,Western,1957,5988,7945,78280,239520,317800
6/24/2024,Sandeepa De Silva,Colombo,Colombo,Western,9389,6499,15888,375560,259960,635520
6/25/2024,Sandeepa De Silva,Colombo,Colombo,Western,7862,4584,12446,314480,183360,497840
6/26/2024,Sandeepa De Silva,Colombo,Colombo,Western,3978,5974,9952,159120,238960,398080
6/27/2024,Sandeepa De Silva,Colombo,Colombo,Western,7037,8246,15283,281480,329840,611320
6/28/2024,Sandeepa De Silva,Colombo,Colombo,Western,3134,3245,6379,125360,129800,255160
6/29/2024,Sandeepa De Silva,Colombo,Colombo,Western,7199,7498,14697,287960,299920,587880
6/30/2024,Sandeepa De Silva,Colombo,Colombo,Western,4810,5463,10273,192400,218520,410920
7/1/2024,Sandeepa De Silva,Colombo,Colombo,Western,5246,3122,8368,209840,124880,334720
7/2/2024,Sandeepa De Silva,Colombo,Colombo,Western,1618,1186,2804,64720,47440,112160
7/3/2024,Sandeepa De Silva,Colombo,Colombo,Western,1242,1191,2433,49680,47640,97320
7/4/2024,Sandeepa De Silva,Colombo,Colombo,Western,3051,9872,12923,122040,394880,516920
7/5/2024,Sandeepa De Silva,Colombo,Colombo,Western,469,722,1191,18760,28880,47640
7/6/2024,Sandeepa De Silva,Colombo,Colombo,Western,158,6363,6521,6320,254520,260840
7/7/2024,Sandeepa De Silva,Colombo,Colombo,Western,4895,789,5684,195800,31560,227360
7/8/2024,Sandeepa De Silva,Colombo,Colombo,Western,1841,450,2291,73640,18000,91640
7/9/2024,Sandeepa De Silva,Colombo,Colombo,Western,8897,7294,16191,355880,291760,647640
7/10/2024,Sandeepa De Silva,Colombo,Colombo,Western,6408,5839,12247,256320,233560,489880
7/11/2024,Sandeepa De Silva,Colombo,Colombo,Western,4889,9482,14371,195560,379280,574840
7/12/2024,Sandeepa De Silva,Colombo,Colombo,Western,1454,9738,11192,58160,389520,447680
7/13/2024,Sandeepa De Silva,Colombo,Colombo,Western,7674,1877,9551,306960,75080,382040
7/14/2024,Sandeepa De Silva,Colombo,Colombo,Western,9428,3260,12688,377120,130400,507520
7/15/2024,Sandeepa De Silva,Colombo,Colombo,Western,760,401,1161,30400,16040,46440
7/16/2024,Sandeepa De Silva,Colombo,Colombo,Western,3939,4268,8207,157560,170720,328280
7/17/2024,Sandeepa De Silva,Colombo,Colombo,Western,8470,4489,12959,338800,179560,518360
7/18/2024,Sandeepa De Silva,Colombo,Colombo,Western,7321,5564,12885,292840,222560,515400
7/19/2024,Sandeepa De Silva,Colombo,Colombo,Western,5436,4339,9775,217440,173560,391000
7/20/2024,Sandeepa De Silva,Colombo,Colombo,Western,9905,4710,14615,396200,188400,584600
7/21/2024,Sandeepa De Silva,Colombo,Colombo,Western,5154,5316,10470,206160,212640,418800
7/22/2024,Sandeepa De Silva,Colombo,Colombo,Western,5134,5867,11001,205360,234680,440040
7/23/2024,Sandeepa De Silva,Colombo,Colombo,Western,2159,8502,10661,86360,340080,426440
7/24/2024,Sandeepa De Silva,Colombo,Colombo,Western,6543,3315,9858,261720,132600,394320
7/25/2024,Sandeepa De Silva,Colombo,Colombo,Western,4658,8142,12800,186320,325680,512000
7/26/2024,Sandeepa De Silva,Colombo,Colombo,Western,6866,9483,16349,274640,379320,653960
7/27/2024,Sandeepa De Silva,Colombo,Colombo,Western,5580,9329,14909,223200,373160,596360
7/28/2024,Sandeepa De Silva,Colombo,Colombo,Western,6890,7335,14225,275600,293400,569000
7/29/2024,Sandeepa De Silva,Colombo,Colombo,Western,2517,5649,8166,100680,225960,326640
7/30/2024,Sandeepa De Silva,Colombo,Colombo,Western,6384,1390,7774,255360,55600,310960
7/31/2024,Sandeepa De Silva,Colombo,Colombo,Western,3419,8475,11894,136760,339000,475760
8/1/2024,Sandeepa De Silva,Colombo,Colombo,Western,2356,3879,6235,94240,155160,249400
8/2/2024,Sandeepa De Silva,Colombo,Colombo,Western,900,6071,6971,36000,242840,278840
8/3/2024,Sandeepa De Silva,Colombo,Colombo,Western,7032,9969,17001,281280,398760,680040
8/4/2024,Sandeepa De Silva,Colombo,Colombo,Western,6600,5310,11910,264000,212400,476400
8/5/2024,Sandeepa De Silva,Colombo,Colombo,Western,2695,131,2826,107800,5240,113040
8/6/2024,Sandeepa De Silva,Colombo,Colombo,Western,9184,6564,15748,367360,262560,629920
8/7/2024,Sandeepa De Silva,Colombo,Colombo,Western,3005,101,3106,120200,4040,124240
8/8/2024,Sandeepa De Silva,Colombo,Colombo,Western,6009,8277,14286,240360,331080,571440
8/9/2024,Sandeepa De Silva,Colombo,Colombo,Western,1383,683,2066,55320,27320,82640
8/10/2024,Sandeepa De Silva,Colombo,Colombo,Western,6267,7037,13304,250680,281480,532160
8/11/2024,Sandeepa De Silva,Colombo,Colombo,Western,1178,9975,11153,47120,399000,446120
8/12/2024,Sandeepa De Silva,Colombo,Colombo,Western,2492,4890,7382,99680,195600,295280
8/13/2024,Sandeepa De Silva,Colombo,Colombo,Western,6214,766,6980,248560,30640,279200
8/14/2024,Sandeepa De Silva,Colombo,Colombo,Western,695,3348,4043,27800,133920,161720
8/15/2024,Sandeepa De Silva,Colombo,Colombo,Western,7940,5276,13216,317600,211040,528640
8/16/2024,Sandeepa De Silva,Colombo,Colombo,Western,6446,4492,10938,257840,179680,437520
8/17/2024,Sandeepa De Silva,Colombo,Colombo,Western,2313,654,2967,92520,26160,118680
8/18/2024,Sandeepa De Silva,Colombo,Colombo,Western,5974,6695,12669,238960,267800,506760
8/19/2024,Sandeepa De Silva,Colombo,Colombo,Western,687,1732,2419,27480,69280,96760
8/20/2024,Sandeepa De Silva,Colombo,Colombo,Western,8844,504,9348,353760,20160,373920
8/21/2024,Sandeepa De Silva,Colombo,Colombo,Western,7357,5682,13039,294280,227280,521560
8/22/2024,Sandeepa De Silva,Colombo,Colombo,Western,7098,3137,10235,283920,125480,409400
8/23/2024,Sandeepa De Silva,Colombo,Colombo,Western,1397,6009,7406,55880,240360,296240
8/24/2024,Sandeepa De Silva,Colombo,Colombo,Western,2391,8813,11204,95640,352520,448160
8/25/2024,Sandeepa De Silva,Colombo,Colombo,Western,4501,5727,10228,180040,229080,409120
8/26/2024,Sandeepa De Silva,Colombo,Colombo,Western,1057,8134,9191,42280,325360,367640
8/27/2024,Sandeepa De Silva,Colombo,Colombo,Western,4383,4696,9079,175320,187840,363160
8/28/2024,Sandeepa De Silva,Colombo,Colombo,Western,5985,2912,8897,239400,116480,355880
8/29/2024,Sandeepa De Silva,Colombo,Colombo,Western,2423,6544,8967,96920,261760,358680
8/30/2024,Sandeepa De Silva,Colombo,Colombo,Western,8793,2407,11200,351720,96280,448000
8/31/2024,Sandeepa De Silva,Colombo,Colombo,Western,9511,7249,16760,380440,289960,670400
9/1/2024,Sandeepa De Silva,Colombo,Colombo,Western,2379,9690,12069,95160,387600,482760
9/2/2024,Sandeepa De Silva,Colombo,Colombo,Western,7740,7417,15157,309600,296680,606280
9/3/2024,Sandeepa De Silva,Colombo,Colombo,Western,9271,3764,13035,370840,150560,521400
9/4/2024,Sandeepa De Silva,Colombo,Colombo,Western,1005,7428,8433,40200,297120,337320
9/5/2024,Sandeepa De Silva,Colombo,Colombo,Western,1397,2732,4129,55880,109280,165160
9/6/2024,Sandeepa De Silva,Colombo,Colombo,Western,3928,97,4025,157120,3880,161000
9/7/2024,Sandeepa De Silva,Colombo,Colombo,Western,9490,4199,13689,379600,167960,547560
9/8/2024,Sandeepa De Silva,Colombo,Colombo,Western,5354,7167,12521,214160,286680,500840
9/9/2024,Sandeepa De Silva,Colombo,Colombo,Western,7261,7036,14297,290440,281440,571880
9/10/2024,Sandeepa De Silva,Colombo,Colombo,Western,3548,9358,12906,141920,374320,516240
9/11/2024,Sandeepa De Silva,Colombo,Colombo,Western,10,4403,4413,400,176120,176520
9/12/2024,Sandeepa De Silva,Colombo,Colombo,Western,1480,8729,10209,59200,349160,408360
9/13/2024,Sandeepa De Silva,Colombo,Colombo,Western,3356,8787,12143,134240,351480,485720
9/14/2024,Sandeepa De Silva,Colombo,Colombo,Western,3264,1187,4451,130560,47480,178040
9/15/2024,Sandeepa De Silva,Colombo,Colombo,Western,9872,1259,11131,394880,50360,445240
9/16/2024,Sandeepa De Silva,Colombo,Colombo,Western,4293,6152,10445,171720,246080,417800
9/17/2024,Sandeepa De Silva,Colombo,Colombo,Western,2199,8552,10751,87960,342080,430040
9/18/2024,Sandeepa De Silva,Colombo,Colombo,Western,3843,3485,7328,153720,139400,293120
9/19/2024,Sandeepa De Silva,Colombo,Colombo,Western,1806,7821,9627,72240,312840,385080
9/20/2024,Sandeepa De Silva,Colombo,Colombo,Western,5309,447,5756,212360,17880,230240
9/21/2024,Sandeepa De Silva,Colombo,Colombo,Western,1658,5400,7058,66320,216000,282320
9/22/2024,Sandeepa De Silva,Colombo,Colombo,Western,4940,4333,9273,197600,173320,370920
9/23/2024,Sandeepa De Silva,Colombo,Colombo,Western,6894,3055,9949,275760,122200,397960
9/24/2024,Sandeepa De Silva,Colombo,Colombo,Western,2769,7569,10338,110760,302760,413520
9/25/2024,Sandeepa De Silva,Colombo,Colombo,Western,7947,6067,14014,317880,242680,560560
9/26/2024,Sandeepa De Silva,Colombo,Colombo,Western,2062,4294,6356,82480,171760,254240
9/27/2024,Sandeepa De Silva,Colombo,Colombo,Western,3573,6470,10043,142920,258800,401720
9/28/2024,Sandeepa De Silva,Colombo,Colombo,Western,5375,4359,9734,215000,174360,389360
9/29/2024,Sandeepa De Silva,Colombo,Colombo,Western,5095,1053,6148,203800,42120,245920
9/30/2024,Sandeepa De Silva,Colombo,Colombo,Western,410,721,1131,16400,28840,45240
10/1/2024,Sandeepa De Silva,Colombo,Colombo,Western,8461,5349,13810,338440,213960,552400
10/2/2024,Sandeepa De Silva,Colombo,Colombo,Western,7926,2314,10240,317040,92560,409600
10/3/2024,Sandeepa De Silva,Colombo,Colombo,Western,3099,8085,11184,123960,323400,447360
10/4/2024,Sandeepa De Silva,Colombo,Colombo,Western,5417,680,6097,216680,27200,243880
10/5/2024,Sandeepa De Silva,Colombo,Colombo,Western,4840,4444,9284,193600,177760,371360
10/6/2024,Sandeepa De Silva,Colombo,Colombo,Western,1747,3412,5159,69880,136480,206360
10/7/2024,Sandeepa De Silva,Colombo,Colombo,Western,5047,1293,6340,201880,51720,253600
10/8/2024,Sandeepa De Silva,Colombo,Colombo,Western,2078,9032,11110,83120,361280,444400
10/9/2024,Sandeepa De Silva,Colombo,Colombo,Western,7816,5654,13470,312640,226160,538800
10/10/2024,Sandeepa De Silva,Colombo,Colombo,Western,4611,7087,11698,184440,283480,467920
10/11/2024,Sandeepa De Silva,Colombo,Colombo,Western,1448,2768,4216,57920,110720,168640
10/12/2024,Sandeepa De Silva,Colombo,Colombo,Western,1651,2617,4268,66040,104680,170720
10/13/2024,Sandeepa De Silva,Colombo,Colombo,Western,6923,9657,16580,276920,386280,663200
10/14/2024,Sandeepa De Silva,Colombo,Colombo,Western,9129,1365,10494,365160,54600,419760
10/15/2024,Sandeepa De Silva,Colombo,Colombo,Western,162,8098,8260,6480,323920,330400
10/16/2024,Sandeepa De Silva,Colombo,Colombo,Western,9932,4305,14237,397280,172200,569480
10/17/2024,Sandeepa De Silva,Colombo,Colombo,Western,2218,7283,9501,88720,291320,380040
10/18/2024,Sandeepa De Silva,Colombo,Colombo,Western,3247,1658,4905,129880,66320,196200
10/19/2024,Sandeepa De Silva,Colombo,Colombo,Western,8159,2797,10956,326360,111880,438240
10/20/2024,Sandeepa De Silva,Colombo,Colombo,Western,1722,6890,8612,68880,275600,344480
10/21/2024,Sandeepa De Silva,Colombo,Colombo,Western,6937,370,7307,277480,14800,292280
10/22/2024,Sandeepa De Silva,Colombo,Colombo,Western,5548,9923,15471,221920,396920,618840
10/23/2024,Sandeepa De Silva,Colombo,Colombo,Western,5572,2437,8009,222880,97480,320360
10/24/2024,Sandeepa De Silva,Colombo,Colombo,Western,9326,1294,10620,373040,51760,424800
10/25/2024,Sandeepa De Silva,Colombo,Colombo,Western,9169,27,9196,366760,1080,367840
10/26/2024,Sandeepa De Silva,Colombo,Colombo,Western,891,9722,10613,35640,388880,424520
10/27/2024,Sandeepa De Silva,Colombo,Colombo,Western,8013,380,8393,320520,15200,335720
10/28/2024,Sandeepa De Silva,Colombo,Colombo,Western,6079,3119,9198,243160,124760,367920
10/29/2024,Sandeepa De Silva,Colombo,Colombo,Western,7496,6120,13616,299840,244800,544640
10/30/2024,Sandeepa De Silva,Colombo,Colombo,Western,7010,4235,11245,280400,169400,449800
10/31/2024,Sandeepa De Silva,Colombo,Colombo,Western,1452,2627,4079,58080,105080,163160
11/1/2024,Sandeepa De Silva,Colombo,Colombo,Western,271,6318,6589,10840,252720,263560
11/2/2024,Sandeepa De Silva,Colombo,Colombo,Western,4676,5505,10181,187040,220200,407240
11/3/2024,Sandeepa De Silva,Colombo,Colombo,Western,6907,8154,15061,276280,326160,602440
11/4/2024,Sandeepa De Silva,Colombo,Colombo,Western,8750,3281,12031,350000,131240,481240
11/5/2024,Sandeepa De Silva,Colombo,Colombo,Western,5015,8706,13721,200600,348240,548840
11/6/2024,Sandeepa De Silva,Colombo,Colombo,Western,3151,9230,12381,126040,369200,495240
11/7/2024,Sandeepa De Silva,Colombo,Colombo,Western,7916,7996,15912,316640,319840,636480
11/8/2024,Sandeepa De Silva,Colombo,Colombo,Western,5741,8750,14491,229640,350000,579640
11/9/2024,Sandeepa De Silva,Colombo,Colombo,Western,8012,9389,17401,320480,375560,696040
11/10/2024,Sandeepa De Silva,Colombo,Colombo,Western,9567,4330,13897,382680,173200,555880
11/11/2024,Sandeepa De Silva,Colombo,Colombo,Western,9372,8660,18032,374880,346400,721280
11/12/2024,Sandeepa De Silva,Colombo,Colombo,Western,4018,1624,5642,160720,64960,225680
11/13/2024,Sandeepa De Silva,Colombo,Colombo,Western,4219,5208,9427,168760,208320,377080
11/14/2024,Sandeepa De Silva,Colombo,Colombo,Western,971,6776,7747,38840,271040,309880
11/15/2024,Sandeepa De Silva,Colombo,Colombo,Western,3793,6828,10621,151720,273120,424840
11/16/2024,Sandeepa De Silva,Colombo,Colombo,Western,3307,7315,10622,132280,292600,424880
11/17/2024,Sandeepa De Silva,Colombo,Colombo,Western,6988,8061,15049,279520,322440,601960
11/18/2024,Sandeepa De Silva,Colombo,Colombo,Western,3260,7108,10368,130400,284320,414720
11/19/2024,Sandeepa De Silva,Colombo,Colombo,Western,1177,7791,8968,47080,311640,358720
11/20/2024,Sandeepa De Silva,Colombo,Colombo,Western,2015,214,2229,80600,8560,89160
11/21/2024,Sandeepa De Silva,Colombo,Colombo,Western,5220,1092,6312,208800,43680,252480
11/22/2024,Sandeepa De Silva,Colombo,Colombo,Western,3280,4646,7926,131200,185840,317040
11/23/2024,Sandeepa De Silva,Colombo,Colombo,Western,7079,8014,15093,283160,320560,603720
11/24/2024,Sandeepa De Silva,Colombo,Colombo,Western,8658,8604,17262,346320,344160,690480
11/25/2024,Sandeepa De Silva,Colombo,Colombo,Western,1701,787,2488,68040,31480,99520
11/26/2024,Sandeepa De Silva,Colombo,Colombo,Western,4007,1410,5417,160280,56400,216680
11/27/2024,Sandeepa De Silva,Colombo,Colombo,Western,1081,4169,5250,43240,166760,210000
11/28/2024,Sandeepa De Silva,Colombo,Colombo,Western,9243,5787,15030,369720,231480,601200
11/29/2024,Sandeepa De Silva,Colombo,Colombo,Western,6568,8439,15007,262720,337560,600280
11/30/2024,Sandeepa De Silva,Colombo,Colombo,Western,6604,1763,8367,264160,70520,334680
12/1/2024,Sandeepa De Silva,Colombo,Colombo,Western,4468,4931,9399,178720,197240,375960
12/2/2024,Sandeepa De Silva,Colombo,Colombo,Western,7294,3060,10354,291760,122400,414160
12/3/2024,Sandeepa De Silva,Colombo,Colombo,Western,4596,7127,11723,183840,285080,468920
12/4/2024,Sandeepa De Silva,Colombo,Colombo,Western,4420,3642,8062,176800,145680,322480
12/5/2024,Sandeepa De Silva,Colombo,Colombo,Western,7112,3067,10179,284480,122680,407160
12/6/2024,Sandeepa De Silva,Colombo,Colombo,Western,7421,5942,13363,296840,237680,534520
12/7/2024,Sandeepa De Silva,Colombo,Colombo,Western,6145,1539,7684,245800,61560,307360
12/8/2024,Sandeepa De Silva,Colombo,Colombo,Western,6015,5289,11304,240600,211560,452160
12/9/2024,Sandeepa De Silva,Colombo,Colombo,Western,1491,6365,7856,59640,254600,314240
12/10/2024,Sandeepa De Silva,Colombo,Colombo,Western,5207,3878,9085,208280,155120,363400
12/11/2024,Sandeepa De Silva,Colombo,Colombo,Western,9821,7407,17228,392840,296280,689120
12/12/2024,Sandeepa De Silva,Colombo,Colombo,Western,4515,8319,12834,180600,332760,513360
12/13/2024,Sandeepa De Silva,Colombo,Colombo,Western,8577,6996,15573,343080,279840,622920
12/14/2024,Sandeepa De Silva,Colombo,Colombo,Western,5929,4032,9961,237160,161280,398440
12/15/2024,Sandeepa De Silva,Colombo,Colombo,Western,3206,5807,9013,128240,232280,360520
12/16/2024,Sandeepa De Silva,Colombo,Colombo,Western,8816,4886,13702,352640,195440,548080
12/17/2024,Sandeepa De Silva,Colombo,Colombo,Western,7601,7620,15221,304040,304800,608840
12/18/2024,Sandeepa De Silva,Colombo,Colombo,Western,620,1527,2147,24800,61080,85880
12/19/2024,Sandeepa De Silva,Colombo,Colombo,Western,9277,1604,10881,371080,64160,435240
12/20/2024,Sandeepa De Silva,Colombo,Colombo,Western,9717,8366,18083,388680,334640,723320
12/21/2024,Sandeepa De Silva,Colombo,Colombo,Western,5455,3588,9043,218200,143520,361720
12/22/2024,Sandeepa De Silva,Colombo,Colombo,Western,9630,9727,19357,385200,389080,774280
12/23/2024,Sandeepa De Silva,Colombo,Colombo,Western,6885,6981,13866,275400,279240,554640
12/24/2024,Sandeepa De Silva,Colombo,Colombo,Western,650,3540,4190,26000,141600,167600
12/25/2024,Sandeepa De Silva,Colombo,Colombo,Western,3472,2021,5493,138880,80840,219720
12/26/2024,Sandeepa De Silva,Colombo,Colombo,Western,7656,7296,14952,306240,291840,598080
12/27/2024,Sandeepa De Silva,Colombo,Colombo,Western,9730,4935,14665,389200,197400,586600
12/28/2024,Sandeepa De Silva,Colombo,Colombo,Western,8009,5003,13012,320360,200120,520480
12/29/2024,Sandeepa De Silva,Colombo,Colombo,Western,4772,5680,10452,190880,227200,418080
12/30/2024,Sandeepa De Silva,Colombo,Colombo,Western,1482,2007,3489,59280,80280,139560
12/31/2024,Sandeepa De Silva,Colombo,Colombo,Western,6319,9628,15947,252760,385120,637880
1/1/2025,Sandeepa De Silva,Colombo,Colombo,Western,2994,343,3337,119760,13720,133480
1/2/2025,Sandeepa De Silva,Colombo,Colombo,Western,6531,9877,16408,261240,395080,656320
1/3/2025,Sandeepa De Silva,Colombo,Colombo,Western,6431,8694,15125,257240,347760,605000
1/4/2025,Sandeepa De Silva,Colombo,Colombo,Western,4374,4620,8994,174960,184800,359760
1/5/2025,Sandeepa De Silva,Colombo,Colombo,Western,3569,6041,9610,142760,241640,384400
1/6/2025,Sandeepa De Silva,Colombo,Colombo,Western,9072,4438,13510,362880,177520,540400
1/7/2025,Sandeepa De Silva,Colombo,Colombo,Western,2097,1008,3105,83880,40320,124200
1/8/2025,Sandeepa De Silva,Colombo,Colombo,Western,4092,9995,14087,163680,399800,563480
1/9/2025,Sandeepa De Silva,Colombo,Colombo,Western,1429,2580,4009,57160,103200,160360
1/10/2025,Sandeepa De Silva,Colombo,Colombo,Western,9708,3713,13421,388320,148520,536840
1/11/2025,Sandeepa De Silva,Colombo,Colombo,Western,9833,746,10579,393320,29840,423160
1/12/2025,Sandeepa De Silva,Colombo,Colombo,Western,6051,1583,7634,242040,63320,305360
1/13/2025,Sandeepa De Silva,Colombo,Colombo,Western,5994,1405,7399,239760,56200,295960
1/14/2025,Sandeepa De Silva,Colombo,Colombo,Western,1784,1946,3730,71360,77840,149200
1/15/2025,Sandeepa De Silva,Colombo,Colombo,Western,1378,4780,6158,55120,191200,246320
1/16/2025,Sandeepa De Silva,Colombo,Colombo,Western,8733,2141,10874,349320,85640,434960
1/17/2025,Sandeepa De Silva,Colombo,Colombo,Western,1185,7526,8711,47400,301040,348440
1/18/2025,Sandeepa De Silva,Colombo,Colombo,Western,4253,9407,13660,170120,376280,546400
1/19/2025,Sandeepa De Silva,Colombo,Colombo,Western,4008,4336,8344,160320,173440,333760
1/20/2025,Sandeepa De Silva,Colombo,Colombo,Western,4718,314,5032,188720,12560,201280
1/21/2025,Sandeepa De Silva,Colombo,Colombo,Western,4444,7136,11580,177760,285440,463200
1/22/2025,Sandeepa De Silva,Colombo,Colombo,Western,7132,210,7342,285280,8400,293680
1/23/2025,Sandeepa De Silva,Colombo,Colombo,Western,1285,654,1939,51400,26160,77560
1/24/2025,Sandeepa De Silva,Colombo,Colombo,Western,8483,7395,15878,339320,295800,635120
1/25/2025,Sandeepa De Silva,Colombo,Colombo,Western,5185,1371,6556,207400,54840,262240
1/26/2025,Sandeepa De Silva,Colombo,Colombo,Western,4903,9450,14353,196120,378000,574120
1/27/2025,Sandeepa De Silva,Colombo,Colombo,Western,3866,4688,8554,154640,187520,342160
1/28/2025,Sandeepa De Silva,Colombo,Colombo,Western,4682,158,4840,187280,6320,193600
1/29/2025,Sandeepa De Silva,Colombo,Colombo,Western,3711,449,4160,148440,17960,166400
1/30/2025,Sandeepa De Silva,Colombo,Colombo,Western,2313,245,2558,92520,9800,102320
1/31/2025,Sandeepa De Silva,Colombo,Colombo,Western,2954,2956,5910,118160,118240,236400
2/1/2025,Sandeepa De Silva,Colombo,Colombo,Western,8804,6305,15109,352160,252200,604360
2/2/2025,Sandeepa De Silva,Colombo,Colombo,Western,2498,4950,7448,99920,198000,297920
2/3/2025,Sandeepa De Silva,Colombo,Colombo,Western,1105,3772,4877,44200,150880,195080
2/4/2025,Sandeepa De Silva,Colombo,Colombo,Western,5316,2100,7416,212640,84000,296640
2/5/2025,Sandeepa De Silva,Colombo,Colombo,Western,4343,2543,6886,173720,101720,275440
2/6/2025,Sandeepa De Silva,Colombo,Colombo,Western,1164,9768,10932,46560,390720,437280
2/7/2025,Sandeepa De Silva,Colombo,Colombo,Western,6330,8407,14737,253200,336280,589480
2/8/2025,Sandeepa De Silva,Colombo,Colombo,Western,3454,9576,13030,138160,383040,521200
2/9/2025,Sandeepa De Silva,Colombo,Colombo,Western,1994,7218,9212,79760,288720,368480
2/10/2025,Sandeepa De Silva,Colombo,Colombo,Western,7654,3684,11338,306160,147360,453520
2/11/2025,Sandeepa De Silva,Colombo,Colombo,Western,7517,2468,9985,300680,98720,399400
2/12/2025,Sandeepa De Silva,Colombo,Colombo,Western,4226,9004,13230,169040,360160,529200
2/13/2025,Sandeepa De Silva,Colombo,Colombo,Western,40,921,961,1600,36840,38440
2/14/2025,Sandeepa De Silva,Colombo,Colombo,Western,8578,4370,12948,343120,174800,517920
2/15/2025,Sandeepa De Silva,Colombo,Colombo,Western,6222,2808,9030,248880,112320,361200
2/16/2025,Sandeepa De Silva,Colombo,Colombo,Western,7915,4204,12119,316600,168160,484760
2/17/2025,Sandeepa De Silva,Colombo,Colombo,Western,1972,4915,6887,78880,196600,275480
2/18/2025,Sandeepa De Silva,Colombo,Colombo,Western,5814,8205,14019,232560,328200,560760
2/19/2025,Sandeepa De Silva,Colombo,Colombo,Western,7635,764,8399,305400,30560,335960
2/20/2025,Sandeepa De Silva,Colombo,Colombo,Western,408,3949,4357,16320,157960,174280
2/21/2025,Sandeepa De Silva,Colombo,Colombo,Western,8235,3197,11432,329400,127880,457280
2/22/2025,Sandeepa De Silva,Colombo,Colombo,Western,6915,2287,9202,276600,91480,368080
2/23/2025,Sandeepa De Silva,Colombo,Colombo,Western,269,1720,1989,10760,68800,79560
2/24/2025,Sandeepa De Silva,Colombo,Colombo,Western,7835,7896,15731,313400,315840,629240
2/25/2025,Sandeepa De Silva,Colombo,Colombo,Western,7425,7014,14439,297000,280560,577560
2/26/2025,Sandeepa De Silva,Colombo,Colombo,Western,2673,8635,11308,106920,345400,452320
2/27/2025,Sandeepa De Silva,Colombo,Colombo,Western,4088,7386,11474,163520,295440,458960
2/28/2025,Sandeepa De Silva,Colombo,Colombo,Western,5956,6572,12528,238240,262880,501120
3/1/2025,Sandeepa De Silva,Colombo,Colombo,Western,7917,6647,14564,316680,265880,582560
3/2/2025,Sandeepa De Silva,Colombo,Colombo,Western,191,1425,1616,7640,57000,64640
3/3/2025,Sandeepa De Silva,Colombo,Colombo,Western,5458,2209,7667,218320,88360,306680
3/4/2025,Sandeepa De Silva,Colombo,Colombo,Western,5105,5552,10657,204200,222080,426280
3/5/2025,Sandeepa De Silva,Colombo,Colombo,Western,6307,7709,14016,252280,308360,560640
3/6/2025,Sandeepa De Silva,Colombo,Colombo,Western,8960,37,8997,358400,1480,359880
3/7/2025,Sandeepa De Silva,Colombo,Colombo,Western,8510,6377,14887,340400,255080,595480
3/8/2025,Sandeepa De Silva,Colombo,Colombo,Western,8108,7156,15264,324320,286240,610560
3/9/2025,Sandeepa De Silva,Colombo,Colombo,Western,5503,3963,9466,220120,158520,378640
3/10/2025,Sandeepa De Silva,Colombo,Colombo,Western,7820,3178,10998,312800,127120,439920
3/11/2025,Sandeepa De Silva,Colombo,Colombo,Western,3740,5690,9430,149600,227600,377200
3/12/2025,Sandeepa De Silva,Colombo,Colombo,Western,6596,4345,10941,263840,173800,437640
3/13/2025,Sandeepa De Silva,Colombo,Colombo,Western,3249,7982,11231,129960,319280,449240
3/14/2025,Sandeepa De Silva,Colombo,Colombo,Western,1635,6772,8407,65400,270880,336280
3/15/2025,Sandeepa De Silva,Colombo,Colombo,Western,2939,9764,12703,117560,390560,508120
3/16/2025,Sandeepa De Silva,Colombo,Colombo,Western,9599,5652,15251,383960,226080,610040
3/17/2025,Sandeepa De Silva,Colombo,Colombo,Western,7225,6879,14104,289000,275160,564160
3/18/2025,Sandeepa De Silva,Colombo,Colombo,Western,2096,8691,10787,83840,347640,431480
3/19/2025,Sandeepa De Silva,Colombo,Colombo,Western,9468,1649,11117,378720,65960,444680
3/20/2025,Sandeepa De Silva,Colombo,Colombo,Western,3882,8343,12225,155280,333720,489000
3/21/2025,Sandeepa De Silva,Colombo,Colombo,Western,2157,2031,4188,86280,81240,167520
3/22/2025,Sandeepa De Silva,Colombo,Colombo,Western,1685,26,1711,67400,1040,68440
3/23/2025,Sandeepa De Silva,Colombo,Colombo,Western,8874,9233,18107,354960,369320,724280
3/25/2024,Siriwardena Dissanayake,Ratnapura,Rakwana,Sabaragamuwa,3328,429,3757,133120,17160,150280
3/26/2024,Siriwardena Dissanayake,Ratnapura,Rakwana,Sabaragamuwa,6051,2179,8230,242040,87160,329200
3/27/2024,Siriwardena Dissanayake,Ratnapura,Rakwana,Sabaragamuwa,4731,9441,14172,189240,377640,566880
3/28/2024,Siriwardena Dissanayake,Ratnapura,Rakwana,Sabaragamuwa,4699,6230,10929,187960,249200,437160
3/29/2024,Siriwardena Dissanayake,Ratnapura,Rakwana,Sabaragamuwa,2411,1090,3501,96440,43600,140040
3/30/2024,Siriwardena Dissanayake,Ratnapura,Rakwana,Sabaragamuwa,4228,7798,12026,169120,311920,481040
3/31/2024,Siriwardena Dissanayake,Ratnapura,Rakwana,Sabaragamuwa,4213,3764,7977,168520,150560,319080
4/1/2024,Siriwardena Dissanayake,Ratnapura,Rakwana,Sabaragamuwa,9841,8565,18406,393640,342600,736240
4/2/2024,Siriwardena Dissanayake,Ratnapura,Rakwana,Sabaragamuwa,9175,8776,17951,367000,351040,718040
4/3/2024,Siriwardena Dissanayake,Ratnapura,Rakwana,Sabaragamuwa,4250,4817,9067,170000,192680,362680
4/4/2024,Siriwardena Dissanayake,Ratnapura,Rakwana,Sabaragamuwa,3923,2326,6249,156920,93040,249960
4/5/2024,Siriwardena Dissanayake,Ratnapura,Rakwana,Sabaragamuwa,5569,6636,12205,222760,265440,488200
4/6/2024,Siriwardena Dissanayake,Ratnapura,Rakwana,Sabaragamuwa,4932,2371,7303,197280,94840,292120
4/7/2024,Siriwardena Dissanayake,Ratnapura,Rakwana,Sabaragamuwa,8082,4170,12252,323280,166800,490080
4/8/2024,Siriwardena Dissanayake,Ratnapura,Rakwana,Sabaragamuwa,2289,4367,6656,91560,174680,266240
4/9/2024,Siriwardena Dissanayake,Ratnapura,Rakwana,Sabaragamuwa,9116,2321,11437,364640,92840,457480
4/10/2024,Siriwardena Dissanayake,Ratnapura,Rakwana,Sabaragamuwa,917,4151,5068,36680,166040,202720
4/11/2024,Siriwardena Dissanayake,Ratnapura,Rakwana,Sabaragamuwa,273,5893,6166,10920,235720,246640
4/19/2024,Siriwardena Dissanayake,Ratnapura,Rakwana,Sabaragamuwa,858,7086,7944,34320,283440,317760
4/20/2024,Siriwardena Dissanayake,Ratnapura,Rakwana,Sabaragamuwa,4277,7950,12227,171080,318000,489080
4/21/2024,Siriwardena Dissanayake,Ratnapura,Rakwana,Sabaragamuwa,6977,4701,11678,279080,188040,467120
4/22/2024,Siriwardena Dissanayake,Ratnapura,Rakwana,Sabaragamuwa,6899,6062,12961,275960,242480,518440
4/23/2024,Siriwardena Dissanayake,Ratnapura,Rakwana,Sabaragamuwa,6215,3842,10057,248600,153680,402280
4/24/2024,Siriwardena Dissanayake,Ratnapura,Rakwana,Sabaragamuwa,4812,2008,6820,192480,80320,272800
4/25/2024,Siriwardena Dissanayake,Ratnapura,Rakwana,Sabaragamuwa,3857,8034,11891,154280,321360,475640
4/26/2024,Siriwardena Dissanayake,Ratnapura,Rakwana,Sabaragamuwa,2160,3339,5499,86400,133560,219960
4/27/2024,Siriwardena Dissanayake,Ratnapura,Rakwana,Sabaragamuwa,7624,4418,12042,304960,176720,481680
4/28/2024,Siriwardena Dissanayake,Ratnapura,Rakwana,Sabaragamuwa,9315,9990,19305,372600,399600,772200
4/29/2024,Siriwardena Dissanayake,Ratnapura,Rakwana,Sabaragamuwa,5444,6934,12378,217760,277360,495120
4/30/2024,Siriwardena Dissanayake,Ratnapura,Rakwana,Sabaragamuwa,3043,4428,7471,121720,177120,298840
5/1/2024,Siriwardena Dissanayake,Ratnapura,Rakwana,Sabaragamuwa,1029,8352,9381,41160,334080,375240
5/2/2024,Siriwardena Dissanayake,Ratnapura,Rakwana,Sabaragamuwa,6079,8836,14915,243160,353440,596600
5/3/2024,Siriwardena Dissanayake,Ratnapura,Rakwana,Sabaragamuwa,5463,7680,13143,218520,307200,525720
5/4/2024,Siriwardena Dissanayake,Ratnapura,Rakwana,Sabaragamuwa,2359,4431,6790,94360,177240,271600
5/5/2024,Siriwardena Dissanayake,Ratnapura,Rakwana,Sabaragamuwa,9550,9873,19423,382000,394920,776920
5/6/2024,Siriwardena Dissanayake,Ratnapura,Rakwana,Sabaragamuwa,167,1259,1426,6680,50360,57040
5/7/2024,Siriwardena Dissanayake,Ratnapura,Rakwana,Sabaragamuwa,7268,6537,13805,290720,261480,552200
5/8/2024,Siriwardena Dissanayake,Ratnapura,Rakwana,Sabaragamuwa,4869,5045,9914,194760,201800,396560
5/9/2024,Siriwardena Dissanayake,Ratnapura,Rakwana,Sabaragamuwa,215,9658,9873,8600,386320,394920
5/10/2024,Siriwardena Dissanayake,Ratnapura,Rakwana,Sabaragamuwa,7719,4660,12379,308760,186400,495160
5/11/2024,Siriwardena Dissanayake,Ratnapura,Rakwana,Sabaragamuwa,6750,1049,7799,270000,41960,311960
5/12/2024,Siriwardena Dissanayake,Ratnapura,Rakwana,Sabaragamuwa,1505,4381,5886,60200,175240,235440
5/13/2024,Siriwardena Dissanayake,Ratnapura,Rakwana,Sabaragamuwa,2493,2789,5282,99720,111560,211280
5/14/2024,Siriwardena Dissanayake,Ratnapura,Rakwana,Sabaragamuwa,9690,7026,16716,387600,281040,668640
5/15/2024,Siriwardena Dissanayake,Ratnapura,Rakwana,Sabaragamuwa,8001,3899,11900,320040,155960,476000
5/16/2024,Siriwardena Dissanayake,Ratnapura,Rakwana,Sabaragamuwa,5779,8226,14005,231160,329040,560200
5/17/2024,Siriwardena Dissanayake,Ratnapura,Rakwana,Sabaragamuwa,8450,1760,10210,338000,70400,408400
5/18/2024,Siriwardena Dissanayake,Ratnapura,Rakwana,Sabaragamuwa,97,3173,3270,3880,126920,130800
5/19/2024,Siriwardena Dissanayake,Ratnapura,Rakwana,Sabaragamuwa,2605,809,3414,104200,32360,136560
5/20/2024,Siriwardena Dissanayake,Ratnapura,Rakwana,Sabaragamuwa,7904,9356,17260,316160,374240,690400
5/21/2024,Siriwardena Dissanayake,Ratnapura,Rakwana,Sabaragamuwa,9487,6234,15721,379480,249360,628840
5/22/2024,Siriwardena Dissanayake,Ratnapura,Rakwana,Sabaragamuwa,9997,6205,16202,399880,248200,648080
5/24/2024,Siriwardena Dissanayake,Ratnapura,Rakwana,Sabaragamuwa,5117,9683,14800,204680,387320,592000
5/25/2024,Siriwardena Dissanayake,Ratnapura,Rakwana,Sabaragamuwa,3719,3763,7482,148760,150520,299280
5/26/2024,Siriwardena Dissanayake,Ratnapura,Rakwana,Sabaragamuwa,9761,492,10253,390440,19680,410120
5/27/2024,Siriwardena Dissanayake,Ratnapura,Rakwana,Sabaragamuwa,8978,1912,10890,359120,76480,435600
5/28/2024,Siriwardena Dissanayake,Ratnapura,Rakwana,Sabaragamuwa,9617,9653,19270,384680,386120,770800
5/29/2024,Siriwardena Dissanayake,Ratnapura,Rakwana,Sabaragamuwa,6599,4614,11213,263960,184560,448520
5/30/2024,Siriwardena Dissanayake,Ratnapura,Rakwana,Sabaragamuwa,7929,5505,13434,317160,220200,537360
5/31/2024,Siriwardena Dissanayake,Ratnapura,Rakwana,Sabaragamuwa,5362,5840,11202,214480,233600,448080
6/1/2024,Siriwardena Dissanayake,Ratnapura,Rakwana,Sabaragamuwa,3375,9012,12387,135000,360480,495480
6/2/2024,Siriwardena Dissanayake,Ratnapura,Rakwana,Sabaragamuwa,3548,3317,6865,141920,132680,274600
6/3/2024,Siriwardena Dissanayake,Ratnapura,Rakwana,Sabaragamuwa,7060,1504,8564,282400,60160,342560
6/4/2024,Siriwardena Dissanayake,Ratnapura,Rakwana,Sabaragamuwa,954,3516,4470,38160,140640,178800
6/5/2024,Siriwardena Dissanayake,Ratnapura,Rakwana,Sabaragamuwa,8973,7327,16300,358920,293080,652000
6/6/2024,Siriwardena Dissanayake,Ratnapura,Rakwana,Sabaragamuwa,964,6080,7044,38560,243200,281760
6/7/2024,Siriwardena Dissanayake,Ratnapura,Rakwana,Sabaragamuwa,3453,5937,9390,138120,237480,375600
6/8/2024,Siriwardena Dissanayake,Ratnapura,Rakwana,Sabaragamuwa,8145,2050,10195,325800,82000,407800
6/9/2024,Siriwardena Dissanayake,Ratnapura,Rakwana,Sabaragamuwa,6607,8514,15121,264280,340560,604840
6/10/2024,Siriwardena Dissanayake,Ratnapura,Rakwana,Sabaragamuwa,595,5122,5717,23800,204880,228680
6/11/2024,Siriwardena Dissanayake,Ratnapura,Rakwana,Sabaragamuwa,8154,1057,9211,326160,42280,368440
6/12/2024,Siriwardena Dissanayake,Ratnapura,Rakwana,Sabaragamuwa,4687,7505,12192,187480,300200,487680
6/13/2024,Siriwardena Dissanayake,Ratnapura,Rakwana,Sabaragamuwa,3185,9274,12459,127400,370960,498360
6/14/2024,Siriwardena Dissanayake,Ratnapura,Rakwana,Sabaragamuwa,6398,8002,14400,255920,320080,576000
6/15/2024,Siriwardena Dissanayake,Ratnapura,Rakwana,Sabaragamuwa,6178,4064,10242,247120,162560,409680
6/16/2024,Siriwardena Dissanayake,Ratnapura,Rakwana,Sabaragamuwa,1891,4578,6469,75640,183120,258760
6/17/2024,Siriwardena Dissanayake,Ratnapura,Rakwana,Sabaragamuwa,9423,760,10183,376920,30400,407320
6/18/2024,Siriwardena Dissanayake,Ratnapura,Rakwana,Sabaragamuwa,1988,2243,4231,79520,89720,169240
6/19/2024,Siriwardena Dissanayake,Ratnapura,Rakwana,Sabaragamuwa,253,8708,8961,10120,348320,358440
6/20/2024,Siriwardena Dissanayake,Ratnapura,Rakwana,Sabaragamuwa,8364,4988,13352,334560,199520,534080
6/21/2024,Siriwardena Dissanayake,Ratnapura,Rakwana,Sabaragamuwa,2455,2512,4967,98200,100480,198680
6/22/2024,Siriwardena Dissanayake,Ratnapura,Rakwana,Sabaragamuwa,6782,3467,10249,271280,138680,409960
6/23/2024,Siriwardena Dissanayake,Ratnapura,Rakwana,Sabaragamuwa,4436,5592,10028,177440,223680,401120
6/24/2024,Siriwardena Dissanayake,Ratnapura,Rakwana,Sabaragamuwa,9334,5537,14871,373360,221480,594840
6/25/2024,Siriwardena Dissanayake,Ratnapura,Rakwana,Sabaragamuwa,3868,3407,7275,154720,136280,291000
6/26/2024,Siriwardena Dissanayake,Ratnapura,Rakwana,Sabaragamuwa,7850,9241,17091,314000,369640,683640
6/27/2024,Siriwardena Dissanayake,Ratnapura,Rakwana,Sabaragamuwa,7525,9493,17018,301000,379720,680720
6/28/2024,Siriwardena Dissanayake,Ratnapura,Rakwana,Sabaragamuwa,3002,8878,11880,120080,355120,475200
6/29/2024,Siriwardena Dissanayake,Ratnapura,Rakwana,Sabaragamuwa,4943,5078,10021,197720,203120,400840
6/30/2024,Siriwardena Dissanayake,Ratnapura,Rakwana,Sabaragamuwa,3459,1067,4526,138360,42680,181040
7/1/2024,Siriwardena Dissanayake,Ratnapura,Rakwana,Sabaragamuwa,9930,7453,17383,397200,298120,695320
7/2/2024,Siriwardena Dissanayake,Ratnapura,Rakwana,Sabaragamuwa,7059,5881,12940,282360,235240,517600
7/3/2024,Siriwardena Dissanayake,Ratnapura,Rakwana,Sabaragamuwa,1875,2878,4753,75000,115120,190120
7/4/2024,Siriwardena Dissanayake,Ratnapura,Rakwana,Sabaragamuwa,7690,1819,9509,307600,72760,380360
7/5/2024,Siriwardena Dissanayake,Ratnapura,Rakwana,Sabaragamuwa,4741,7950,12691,189640,318000,507640
7/6/2024,Siriwardena Dissanayake,Ratnapura,Rakwana,Sabaragamuwa,8406,7268,15674,336240,290720,626960
7/7/2024,Siriwardena Dissanayake,Ratnapura,Rakwana,Sabaragamuwa,9275,4227,13502,371000,169080,540080
7/8/2024,Siriwardena Dissanayake,Ratnapura,Rakwana,Sabaragamuwa,1627,4380,6007,65080,175200,240280
7/9/2024,Siriwardena Dissanayake,Ratnapura,Rakwana,Sabaragamuwa,3725,4960,8685,149000,198400,347400
7/10/2024,Siriwardena Dissanayake,Ratnapura,Rakwana,Sabaragamuwa,1968,7068,9036,78720,282720,361440
7/11/2024,Siriwardena Dissanayake,Ratnapura,Rakwana,Sabaragamuwa,686,3111,3797,27440,124440,151880
7/12/2024,Siriwardena Dissanayake,Ratnapura,Rakwana,Sabaragamuwa,834,6805,7639,33360,272200,305560
7/13/2024,Siriwardena Dissanayake,Ratnapura,Rakwana,Sabaragamuwa,5054,4448,9502,202160,177920,380080
7/14/2024,Siriwardena Dissanayake,Ratnapura,Rakwana,Sabaragamuwa,4617,3693,8310,184680,147720,332400
7/15/2024,Siriwardena Dissanayake,Ratnapura,Rakwana,Sabaragamuwa,9340,3376,12716,373600,135040,508640
7/16/2024,Siriwardena Dissanayake,Ratnapura,Rakwana,Sabaragamuwa,9774,846,10620,390960,33840,424800
7/17/2024,Siriwardena Dissanayake,Ratnapura,Rakwana,Sabaragamuwa,4265,5950,10215,170600,238000,408600
7/18/2024,Siriwardena Dissanayake,Ratnapura,Rakwana,Sabaragamuwa,5355,3602,8957,214200,144080,358280
7/19/2024,Siriwardena Dissanayake,Ratnapura,Rakwana,Sabaragamuwa,6475,7583,14058,259000,303320,562320
7/20/2024,Siriwardena Dissanayake,Ratnapura,Rakwana,Sabaragamuwa,8160,787,8947,326400,31480,357880
7/21/2024,Siriwardena Dissanayake,Ratnapura,Rakwana,Sabaragamuwa,4491,4537,9028,179640,181480,361120
7/22/2024,Siriwardena Dissanayake,Ratnapura,Rakwana,Sabaragamuwa,7165,2467,9632,286600,98680,385280
7/23/2024,Siriwardena Dissanayake,Ratnapura,Rakwana,Sabaragamuwa,9914,342,10256,396560,13680,410240
7/24/2024,Siriwardena Dissanayake,Ratnapura,Rakwana,Sabaragamuwa,7354,313,7667,294160,12520,306680
7/25/2024,Siriwardena Dissanayake,Ratnapura,Rakwana,Sabaragamuwa,4472,6651,11123,178880,266040,444920
7/26/2024,Siriwardena Dissanayake,Ratnapura,Rakwana,Sabaragamuwa,4211,7723,11934,168440,308920,477360
7/27/2024,Siriwardena Dissanayake,Ratnapura,Rakwana,Sabaragamuwa,6423,8563,14986,256920,342520,599440
7/28/2024,Siriwardena Dissanayake,Ratnapura,Rakwana,Sabaragamuwa,2225,7455,9680,89000,298200,387200
7/29/2024,Siriwardena Dissanayake,Ratnapura,Rakwana,Sabaragamuwa,6165,1398,7563,246600,55920,302520
7/30/2024,Siriwardena Dissanayake,Ratnapura,Rakwana,Sabaragamuwa,7529,1996,9525,301160,79840,381000
7/31/2024,Siriwardena Dissanayake,Ratnapura,Rakwana,Sabaragamuwa,4060,9747,13807,162400,389880,552280
8/1/2024,Siriwardena Dissanayake,Ratnapura,Rakwana,Sabaragamuwa,7765,1078,8843,310600,43120,353720
8/2/2024,Siriwardena Dissanayake,Ratnapura,Rakwana,Sabaragamuwa,9660,10,9670,386400,400,386800
8/3/2024,Siriwardena Dissanayake,Ratnapura,Rakwana,Sabaragamuwa,9957,2407,12364,398280,96280,494560
8/4/2024,Siriwardena Dissanayake,Ratnapura,Rakwana,Sabaragamuwa,2183,5942,8125,87320,237680,325000
8/5/2024,Siriwardena Dissanayake,Ratnapura,Rakwana,Sabaragamuwa,9467,5938,15405,378680,237520,616200
8/6/2024,Siriwardena Dissanayake,Ratnapura,Rakwana,Sabaragamuwa,2393,9287,11680,95720,371480,467200
8/7/2024,Siriwardena Dissanayake,Ratnapura,Rakwana,Sabaragamuwa,9094,1834,10928,363760,73360,437120
8/8/2024,Siriwardena Dissanayake,Ratnapura,Rakwana,Sabaragamuwa,9303,1529,10832,372120,61160,433280
8/9/2024,Siriwardena Dissanayake,Ratnapura,Rakwana,Sabaragamuwa,1409,5840,7249,56360,233600,289960
8/10/2024,Siriwardena Dissanayake,Ratnapura,Rakwana,Sabaragamuwa,5159,1764,6923,206360,70560,276920
8/11/2024,Siriwardena Dissanayake,Ratnapura,Rakwana,Sabaragamuwa,6354,8115,14469,254160,324600,578760
8/12/2024,Siriwardena Dissanayake,Ratnapura,Rakwana,Sabaragamuwa,6138,191,6329,245520,7640,253160
8/13/2024,Siriwardena Dissanayake,Ratnapura,Rakwana,Sabaragamuwa,631,9790,10421,25240,391600,416840
8/14/2024,Siriwardena Dissanayake,Ratnapura,Rakwana,Sabaragamuwa,5053,2793,7846,202120,111720,313840
8/15/2024,Siriwardena Dissanayake,Ratnapura,Rakwana,Sabaragamuwa,2679,5998,8677,107160,239920,347080
8/16/2024,Siriwardena Dissanayake,Ratnapura,Rakwana,Sabaragamuwa,23,6411,6434,920,256440,257360
8/17/2024,Siriwardena Dissanayake,Ratnapura,Rakwana,Sabaragamuwa,4946,3299,8245,197840,131960,329800
8/18/2024,Siriwardena Dissanayake,Ratnapura,Rakwana,Sabaragamuwa,2082,6325,8407,83280,253000,336280
8/19/2024,Siriwardena Dissanayake,Ratnapura,Rakwana,Sabaragamuwa,4694,7972,12666,187760,318880,506640
8/20/2024,Siriwardena Dissanayake,Ratnapura,Rakwana,Sabaragamuwa,125,5369,5494,5000,214760,219760
8/21/2024,Siriwardena Dissanayake,Ratnapura,Rakwana,Sabaragamuwa,7177,1989,9166,287080,79560,366640
8/22/2024,Siriwardena Dissanayake,Ratnapura,Rakwana,Sabaragamuwa,3349,9456,12805,133960,378240,512200
8/23/2024,Siriwardena Dissanayake,Ratnapura,Rakwana,Sabaragamuwa,1504,4698,6202,60160,187920,248080
8/24/2024,Siriwardena Dissanayake,Ratnapura,Rakwana,Sabaragamuwa,2438,3021,5459,97520,120840,218360
8/25/2024,Siriwardena Dissanayake,Ratnapura,Rakwana,Sabaragamuwa,12,8393,8405,480,335720,336200
8/26/2024,Siriwardena Dissanayake,Ratnapura,Rakwana,Sabaragamuwa,6026,9058,15084,241040,362320,603360
8/27/2024,Siriwardena Dissanayake,Ratnapura,Rakwana,Sabaragamuwa,6860,934,7794,274400,37360,311760
8/28/2024,Siriwardena Dissanayake,Ratnapura,Rakwana,Sabaragamuwa,73,2756,2829,2920,110240,113160
8/29/2024,Siriwardena Dissanayake,Ratnapura,Rakwana,Sabaragamuwa,5824,8201,14025,232960,328040,561000
8/30/2024,Siriwardena Dissanayake,Ratnapura,Rakwana,Sabaragamuwa,9393,362,9755,375720,14480,390200
8/31/2024,Siriwardena Dissanayake,Ratnapura,Rakwana,Sabaragamuwa,6889,1092,7981,275560,43680,319240
9/1/2024,Siriwardena Dissanayake,Ratnapura,Rakwana,Sabaragamuwa,8702,4099,12801,348080,163960,512040
9/2/2024,Siriwardena Dissanayake,Ratnapura,Rakwana,Sabaragamuwa,737,7415,8152,29480,296600,326080
9/3/2024,Siriwardena Dissanayake,Ratnapura,Rakwana,Sabaragamuwa,6160,6117,12277,246400,244680,491080
9/4/2024,Siriwardena Dissanayake,Ratnapura,Rakwana,Sabaragamuwa,8774,5609,14383,350960,224360,575320
9/5/2024,Siriwardena Dissanayake,Ratnapura,Rakwana,Sabaragamuwa,9860,3984,13844,394400,159360,553760
9/6/2024,Siriwardena Dissanayake,Ratnapura,Rakwana,Sabaragamuwa,9418,4712,14130,376720,188480,565200
9/7/2024,Siriwardena Dissanayake,Ratnapura,Rakwana,Sabaragamuwa,2284,1875,4159,91360,75000,166360
9/8/2024,Siriwardena Dissanayake,Ratnapura,Rakwana,Sabaragamuwa,74,3530,3604,2960,141200,144160
9/9/2024,Siriwardena Dissanayake,Ratnapura,Rakwana,Sabaragamuwa,3856,7592,11448,154240,303680,457920
9/10/2024,Siriwardena Dissanayake,Ratnapura,Rakwana,Sabaragamuwa,1860,9538,11398,74400,381520,455920
9/11/2024,Siriwardena Dissanayake,Ratnapura,Rakwana,Sabaragamuwa,602,5980,6582,24080,239200,263280
9/12/2024,Siriwardena Dissanayake,Ratnapura,Rakwana,Sabaragamuwa,8613,2666,11279,344520,106640,451160
9/13/2024,Siriwardena Dissanayake,Ratnapura,Rakwana,Sabaragamuwa,4166,6410,10576,166640,256400,423040
9/14/2024,Siriwardena Dissanayake,Ratnapura,Rakwana,Sabaragamuwa,4653,3255,7908,186120,130200,316320
9/15/2024,Siriwardena Dissanayake,Ratnapura,Rakwana,Sabaragamuwa,7834,7637,15471,313360,305480,618840
9/16/2024,Siriwardena Dissanayake,Ratnapura,Rakwana,Sabaragamuwa,3578,5143,8721,143120,205720,348840
9/17/2024,Siriwardena Dissanayake,Ratnapura,Rakwana,Sabaragamuwa,9456,889,10345,378240,35560,413800
9/18/2024,Siriwardena Dissanayake,Ratnapura,Rakwana,Sabaragamuwa,1295,9466,10761,51800,378640,430440
9/19/2024,Siriwardena Dissanayake,Ratnapura,Rakwana,Sabaragamuwa,3670,2988,6658,146800,119520,266320
9/20/2024,Siriwardena Dissanayake,Ratnapura,Rakwana,Sabaragamuwa,7491,3944,11435,299640,157760,457400
9/21/2024,Siriwardena Dissanayake,Ratnapura,Rakwana,Sabaragamuwa,376,9946,10322,15040,397840,412880
9/22/2024,Siriwardena Dissanayake,Ratnapura,Rakwana,Sabaragamuwa,6454,6768,13222,258160,270720,528880
9/23/2024,Siriwardena Dissanayake,Ratnapura,Rakwana,Sabaragamuwa,3975,5463,9438,159000,218520,377520
9/24/2024,Siriwardena Dissanayake,Ratnapura,Rakwana,Sabaragamuwa,7813,6068,13881,312520,242720,555240
9/25/2024,Siriwardena Dissanayake,Ratnapura,Rakwana,Sabaragamuwa,2584,7347,9931,103360,293880,397240
9/26/2024,Siriwardena Dissanayake,Ratnapura,Rakwana,Sabaragamuwa,2474,9472,11946,98960,378880,477840
9/27/2024,Siriwardena Dissanayake,Ratnapura,Rakwana,Sabaragamuwa,8332,5679,14011,333280,227160,560440
9/28/2024,Siriwardena Dissanayake,Ratnapura,Rakwana,Sabaragamuwa,7671,9399,17070,306840,375960,682800
9/29/2024,Siriwardena Dissanayake,Ratnapura,Rakwana,Sabaragamuwa,6135,5936,12071,245400,237440,482840
9/30/2024,Siriwardena Dissanayake,Ratnapura,Rakwana,Sabaragamuwa,8653,6723,15376,346120,268920,615040
10/1/2024,Siriwardena Dissanayake,Ratnapura,Rakwana,Sabaragamuwa,1602,8799,10401,64080,351960,416040
10/2/2024,Siriwardena Dissanayake,Ratnapura,Rakwana,Sabaragamuwa,259,6097,6356,10360,243880,254240
10/3/2024,Siriwardena Dissanayake,Ratnapura,Rakwana,Sabaragamuwa,4122,6952,11074,164880,278080,442960
10/4/2024,Siriwardena Dissanayake,Ratnapura,Rakwana,Sabaragamuwa,8708,6378,15086,348320,255120,603440
10/5/2024,Siriwardena Dissanayake,Ratnapura,Rakwana,Sabaragamuwa,7831,4421,12252,313240,176840,490080
10/6/2024,Siriwardena Dissanayake,Ratnapura,Rakwana,Sabaragamuwa,3710,354,4064,148400,14160,162560
10/7/2024,Siriwardena Dissanayake,Ratnapura,Rakwana,Sabaragamuwa,2428,1986,4414,97120,79440,176560
10/8/2024,Siriwardena Dissanayake,Ratnapura,Rakwana,Sabaragamuwa,5338,4612,9950,213520,184480,398000
10/9/2024,Siriwardena Dissanayake,Ratnapura,Rakwana,Sabaragamuwa,2400,5565,7965,96000,222600,318600
10/10/2024,Siriwardena Dissanayake,Ratnapura,Rakwana,Sabaragamuwa,420,4019,4439,16800,160760,177560
10/11/2024,Siriwardena Dissanayake,Ratnapura,Rakwana,Sabaragamuwa,8390,4915,13305,335600,196600,532200
10/12/2024,Siriwardena Dissanayake,Ratnapura,Rakwana,Sabaragamuwa,5751,9883,15634,230040,395320,625360
10/13/2024,Siriwardena Dissanayake,Ratnapura,Rakwana,Sabaragamuwa,534,1849,2383,21360,73960,95320
10/14/2024,Siriwardena Dissanayake,Ratnapura,Rakwana,Sabaragamuwa,9203,9312,18515,368120,372480,740600
10/15/2024,Siriwardena Dissanayake,Ratnapura,Rakwana,Sabaragamuwa,3952,6710,10662,158080,268400,426480
10/16/2024,Siriwardena Dissanayake,Ratnapura,Rakwana,Sabaragamuwa,3296,8997,12293,131840,359880,491720
10/17/2024,Siriwardena Dissanayake,Ratnapura,Rakwana,Sabaragamuwa,113,7918,8031,4520,316720,321240
10/18/2024,Siriwardena Dissanayake,Ratnapura,Rakwana,Sabaragamuwa,33,5925,5958,1320,237000,238320
10/19/2024,Siriwardena Dissanayake,Ratnapura,Rakwana,Sabaragamuwa,2364,6103,8467,94560,244120,338680
10/20/2024,Siriwardena Dissanayake,Ratnapura,Rakwana,Sabaragamuwa,6524,995,7519,260960,39800,300760
10/21/2024,Siriwardena Dissanayake,Ratnapura,Rakwana,Sabaragamuwa,9787,5956,15743,391480,238240,629720
10/22/2024,Siriwardena Dissanayake,Ratnapura,Rakwana,Sabaragamuwa,6993,2516,9509,279720,100640,380360
10/23/2024,Siriwardena Dissanayake,Ratnapura,Rakwana,Sabaragamuwa,1053,4997,6050,42120,199880,242000
10/24/2024,Siriwardena Dissanayake,Ratnapura,Rakwana,Sabaragamuwa,6668,7382,14050,266720,295280,562000
10/25/2024,Siriwardena Dissanayake,Ratnapura,Rakwana,Sabaragamuwa,3202,6655,9857,128080,266200,394280
10/26/2024,Siriwardena Dissanayake,Ratnapura,Rakwana,Sabaragamuwa,4599,7373,11972,183960,294920,478880
10/27/2024,Siriwardena Dissanayake,Ratnapura,Rakwana,Sabaragamuwa,690,8063,8753,27600,322520,350120
10/28/2024,Siriwardena Dissanayake,Ratnapura,Rakwana,Sabaragamuwa,1681,2201,3882,67240,88040,155280
10/29/2024,Siriwardena Dissanayake,Ratnapura,Rakwana,Sabaragamuwa,1032,4838,5870,41280,193520,234800
10/30/2024,Siriwardena Dissanayake,Ratnapura,Rakwana,Sabaragamuwa,7723,5774,13497,308920,230960,539880
10/31/2024,Siriwardena Dissanayake,Ratnapura,Rakwana,Sabaragamuwa,9090,6849,15939,363600,273960,637560
11/1/2024,Siriwardena Dissanayake,Ratnapura,Rakwana,Sabaragamuwa,2871,2958,5829,114840,118320,233160
11/2/2024,Siriwardena Dissanayake,Ratnapura,Rakwana,Sabaragamuwa,7895,5724,13619,315800,228960,544760
11/3/2024,Siriwardena Dissanayake,Ratnapura,Rakwana,Sabaragamuwa,7457,9290,16747,298280,371600,669880
11/4/2024,Siriwardena Dissanayake,Ratnapura,Rakwana,Sabaragamuwa,3780,1405,5185,151200,56200,207400
11/5/2024,Siriwardena Dissanayake,Ratnapura,Rakwana,Sabaragamuwa,7890,4640,12530,315600,185600,501200
11/6/2024,Siriwardena Dissanayake,Ratnapura,Rakwana,Sabaragamuwa,6764,4328,11092,270560,173120,443680
11/7/2024,Siriwardena Dissanayake,Ratnapura,Rakwana,Sabaragamuwa,7034,8897,15931,281360,355880,637240
11/8/2024,Siriwardena Dissanayake,Ratnapura,Rakwana,Sabaragamuwa,954,7648,8602,38160,305920,344080
11/9/2024,Siriwardena Dissanayake,Ratnapura,Rakwana,Sabaragamuwa,4018,1796,5814,160720,71840,232560
11/10/2024,Siriwardena Dissanayake,Ratnapura,Rakwana,Sabaragamuwa,4003,4276,8279,160120,171040,331160
11/11/2024,Siriwardena Dissanayake,Ratnapura,Rakwana,Sabaragamuwa,2464,4646,7110,98560,185840,284400
11/12/2024,Siriwardena Dissanayake,Ratnapura,Rakwana,Sabaragamuwa,4789,6922,11711,191560,276880,468440
11/13/2024,Siriwardena Dissanayake,Ratnapura,Rakwana,Sabaragamuwa,7110,7427,14537,284400,297080,581480
11/14/2024,Siriwardena Dissanayake,Ratnapura,Rakwana,Sabaragamuwa,4815,1975,6790,192600,79000,271600
11/15/2024,Siriwardena Dissanayake,Ratnapura,Rakwana,Sabaragamuwa,4449,8569,13018,177960,342760,520720
11/16/2024,Siriwardena Dissanayake,Ratnapura,Rakwana,Sabaragamuwa,5700,4314,10014,228000,172560,400560
11/17/2024,Siriwardena Dissanayake,Ratnapura,Rakwana,Sabaragamuwa,7290,6864,14154,291600,274560,566160
11/18/2024,Siriwardena Dissanayake,Ratnapura,Rakwana,Sabaragamuwa,6715,2294,9009,268600,91760,360360
11/19/2024,Siriwardena Dissanayake,Ratnapura,Rakwana,Sabaragamuwa,1528,5113,6641,61120,204520,265640
11/20/2024,Siriwardena Dissanayake,Ratnapura,Rakwana,Sabaragamuwa,716,5672,6388,28640,226880,255520
11/21/2024,Siriwardena Dissanayake,Ratnapura,Rakwana,Sabaragamuwa,9143,7721,16864,365720,308840,674560
11/22/2024,Siriwardena Dissanayake,Ratnapura,Rakwana,Sabaragamuwa,2286,9374,11660,91440,374960,466400
11/23/2024,Siriwardena Dissanayake,Ratnapura,Rakwana,Sabaragamuwa,2273,8677,10950,90920,347080,438000
11/24/2024,Siriwardena Dissanayake,Ratnapura,Rakwana,Sabaragamuwa,3069,4162,7231,122760,166480,289240
11/25/2024,Siriwardena Dissanayake,Ratnapura,Rakwana,Sabaragamuwa,4287,298,4585,171480,11920,183400
11/26/2024,Siriwardena Dissanayake,Ratnapura,Rakwana,Sabaragamuwa,5937,5337,11274,237480,213480,450960
11/27/2024,Siriwardena Dissanayake,Ratnapura,Rakwana,Sabaragamuwa,3309,4409,7718,132360,176360,308720
11/28/2024,Siriwardena Dissanayake,Ratnapura,Rakwana,Sabaragamuwa,8061,3679,11740,322440,147160,469600
11/29/2024,Siriwardena Dissanayake,Ratnapura,Rakwana,Sabaragamuwa,1255,6626,7881,50200,265040,315240
11/30/2024,Siriwardena Dissanayake,Ratnapura,Rakwana,Sabaragamuwa,9862,3588,13450,394480,143520,538000
12/1/2024,Siriwardena Dissanayake,Ratnapura,Rakwana,Sabaragamuwa,6612,7481,14093,264480,299240,563720
12/2/2024,Siriwardena Dissanayake,Ratnapura,Rakwana,Sabaragamuwa,8103,6988,15091,324120,279520,603640
12/3/2024,Siriwardena Dissanayake,Ratnapura,Rakwana,Sabaragamuwa,6946,1116,8062,277840,44640,322480
12/4/2024,Siriwardena Dissanayake,Ratnapura,Rakwana,Sabaragamuwa,1351,9870,11221,54040,394800,448840
12/5/2024,Siriwardena Dissanayake,Ratnapura,Rakwana,Sabaragamuwa,5545,7041,12586,221800,281640,503440
12/6/2024,Siriwardena Dissanayake,Ratnapura,Rakwana,Sabaragamuwa,4999,4895,9894,199960,195800,395760
12/7/2024,Siriwardena Dissanayake,Ratnapura,Rakwana,Sabaragamuwa,7187,8191,15378,287480,327640,615120
12/8/2024,Siriwardena Dissanayake,Ratnapura,Rakwana,Sabaragamuwa,1211,7999,9210,48440,319960,368400
12/9/2024,Siriwardena Dissanayake,Ratnapura,Rakwana,Sabaragamuwa,5635,6508,12143,225400,260320,485720
12/10/2024,Siriwardena Dissanayake,Ratnapura,Rakwana,Sabaragamuwa,9527,8448,17975,381080,337920,719000
12/11/2024,Siriwardena Dissanayake,Ratnapura,Rakwana,Sabaragamuwa,4426,8155,12581,177040,326200,503240
12/12/2024,Siriwardena Dissanayake,Ratnapura,Rakwana,Sabaragamuwa,8078,6397,14475,323120,255880,579000
12/13/2024,Siriwardena Dissanayake,Ratnapura,Rakwana,Sabaragamuwa,1332,7032,8364,53280,281280,334560
12/14/2024,Siriwardena Dissanayake,Ratnapura,Rakwana,Sabaragamuwa,9524,7543,17067,380960,301720,682680
12/15/2024,Siriwardena Dissanayake,Ratnapura,Rakwana,Sabaragamuwa,1681,9513,11194,67240,380520,447760
12/16/2024,Siriwardena Dissanayake,Ratnapura,Rakwana,Sabaragamuwa,3736,1107,4843,149440,44280,193720
12/17/2024,Siriwardena Dissanayake,Ratnapura,Rakwana,Sabaragamuwa,1261,9334,10595,50440,373360,423800
12/18/2024,Siriwardena Dissanayake,Ratnapura,Rakwana,Sabaragamuwa,1626,6219,7845,65040,248760,313800
12/19/2024,Siriwardena Dissanayake,Ratnapura,Rakwana,Sabaragamuwa,6116,1208,7324,244640,48320,292960
12/20/2024,Siriwardena Dissanayake,Ratnapura,Rakwana,Sabaragamuwa,9871,700,10571,394840,28000,422840
12/21/2024,Siriwardena Dissanayake,Ratnapura,Rakwana,Sabaragamuwa,4374,8530,12904,174960,341200,516160
12/22/2024,Siriwardena Dissanayake,Ratnapura,Rakwana,Sabaragamuwa,3607,6512,10119,144280,260480,404760
12/23/2024,Siriwardena Dissanayake,Ratnapura,Rakwana,Sabaragamuwa,7380,3435,10815,295200,137400,432600
12/24/2024,Siriwardena Dissanayake,Ratnapura,Rakwana,Sabaragamuwa,6272,1446,7718,250880,57840,308720
12/25/2024,Siriwardena Dissanayake,Ratnapura,Rakwana,Sabaragamuwa,7214,6443,13657,288560,257720,546280
12/26/2024,Siriwardena Dissanayake,Ratnapura,Rakwana,Sabaragamuwa,2913,8532,11445,116520,341280,457800
12/27/2024,Siriwardena Dissanayake,Ratnapura,Rakwana,Sabaragamuwa,832,8252,9084,33280,330080,363360
12/28/2024,Siriwardena Dissanayake,Ratnapura,Rakwana,Sabaragamuwa,9096,2338,11434,363840,93520,457360
12/29/2024,Siriwardena Dissanayake,Ratnapura,Rakwana,Sabaragamuwa,2904,8267,11171,116160,330680,446840
12/30/2024,Siriwardena Dissanayake,Ratnapura,Rakwana,Sabaragamuwa,9816,5978,15794,392640,239120,631760
12/31/2024,Siriwardena Dissanayake,Ratnapura,Rakwana,Sabaragamuwa,8406,4599,13005,336240,183960,520200
1/1/2025,Siriwardena Dissanayake,Ratnapura,Rakwana,Sabaragamuwa,7314,9621,16935,292560,384840,677400
1/2/2025,Siriwardena Dissanayake,Ratnapura,Rakwana,Sabaragamuwa,6188,6467,12655,247520,258680,506200
1/3/2025,Siriwardena Dissanayake,Ratnapura,Rakwana,Sabaragamuwa,5676,1211,6887,227040,48440,275480
1/4/2025,Siriwardena Dissanayake,Ratnapura,Rakwana,Sabaragamuwa,3113,6410,9523,124520,256400,380920
1/5/2025,Siriwardena Dissanayake,Ratnapura,Rakwana,Sabaragamuwa,2240,437,2677,89600,17480,107080
1/6/2025,Siriwardena Dissanayake,Ratnapura,Rakwana,Sabaragamuwa,8324,2263,10587,332960,90520,423480
1/7/2025,Siriwardena Dissanayake,Ratnapura,Rakwana,Sabaragamuwa,4948,8353,13301,197920,334120,532040
1/8/2025,Siriwardena Dissanayake,Ratnapura,Rakwana,Sabaragamuwa,7946,7545,15491,317840,301800,619640
1/9/2025,Siriwardena Dissanayake,Ratnapura,Rakwana,Sabaragamuwa,1622,3524,5146,64880,140960,205840
1/10/2025,Siriwardena Dissanayake,Ratnapura,Rakwana,Sabaragamuwa,9937,8103,18040,397480,324120,721600
1/11/2025,Siriwardena Dissanayake,Ratnapura,Rakwana,Sabaragamuwa,2402,5199,7601,96080,207960,304040
1/12/2025,Siriwardena Dissanayake,Ratnapura,Rakwana,Sabaragamuwa,8947,4623,13570,357880,184920,542800
1/13/2025,Siriwardena Dissanayake,Ratnapura,Rakwana,Sabaragamuwa,3034,7789,10823,121360,311560,432920
1/14/2025,Siriwardena Dissanayake,Ratnapura,Rakwana,Sabaragamuwa,1382,4956,6338,55280,198240,253520
1/15/2025,Siriwardena Dissanayake,Ratnapura,Rakwana,Sabaragamuwa,9061,7569,16630,362440,302760,665200
1/16/2025,Siriwardena Dissanayake,Ratnapura,Rakwana,Sabaragamuwa,1443,185,1628,57720,7400,65120
1/17/2025,Siriwardena Dissanayake,Ratnapura,Rakwana,Sabaragamuwa,7119,6361,13480,284760,254440,539200
1/18/2025,Siriwardena Dissanayake,Ratnapura,Rakwana,Sabaragamuwa,8276,4883,13159,331040,195320,526360
1/19/2025,Siriwardena Dissanayake,Ratnapura,Rakwana,Sabaragamuwa,7934,6861,14795,317360,274440,591800
1/20/2025,Siriwardena Dissanayake,Ratnapura,Rakwana,Sabaragamuwa,9648,2523,12171,385920,100920,486840
1/21/2025,Siriwardena Dissanayake,Ratnapura,Rakwana,Sabaragamuwa,3856,3242,7098,154240,129680,283920
1/22/2025,Siriwardena Dissanayake,Ratnapura,Rakwana,Sabaragamuwa,7921,295,8216,316840,11800,328640
1/23/2025,Siriwardena Dissanayake,Ratnapura,Rakwana,Sabaragamuwa,9622,4519,14141,384880,180760,565640
1/24/2025,Siriwardena Dissanayake,Ratnapura,Rakwana,Sabaragamuwa,3746,2102,5848,149840,84080,233920
1/25/2025,Siriwardena Dissanayake,Ratnapura,Rakwana,Sabaragamuwa,3995,5635,9630,159800,225400,385200
1/26/2025,Siriwardena Dissanayake,Ratnapura,Rakwana,Sabaragamuwa,2990,5113,8103,119600,204520,324120
1/27/2025,Siriwardena Dissanayake,Ratnapura,Rakwana,Sabaragamuwa,5624,3462,9086,224960,138480,363440
1/28/2025,Siriwardena Dissanayake,Ratnapura,Rakwana,Sabaragamuwa,9234,4650,13884,369360,186000,555360
1/29/2025,Siriwardena Dissanayake,Ratnapura,Rakwana,Sabaragamuwa,8465,7106,15571,338600,284240,622840
1/30/2025,Siriwardena Dissanayake,Ratnapura,Rakwana,Sabaragamuwa,4283,9421,13704,171320,376840,548160
1/31/2025,Siriwardena Dissanayake,Ratnapura,Rakwana,Sabaragamuwa,6768,9320,16088,270720,372800,643520
2/1/2025,Siriwardena Dissanayake,Ratnapura,Rakwana,Sabaragamuwa,2675,7214,9889,107000,288560,395560
2/2/2025,Siriwardena Dissanayake,Ratnapura,Rakwana,Sabaragamuwa,8082,7118,15200,323280,284720,608000
2/3/2025,Siriwardena Dissanayake,Ratnapura,Rakwana,Sabaragamuwa,7018,3118,10136,280720,124720,405440
2/4/2025,Siriwardena Dissanayake,Ratnapura,Rakwana,Sabaragamuwa,877,7660,8537,35080,306400,341480
2/5/2025,Siriwardena Dissanayake,Ratnapura,Rakwana,Sabaragamuwa,7544,2501,10045,301760,100040,401800
2/6/2025,Siriwardena Dissanayake,Ratnapura,Rakwana,Sabaragamuwa,9427,4555,13982,377080,182200,559280
2/7/2025,Siriwardena Dissanayake,Ratnapura,Rakwana,Sabaragamuwa,841,4805,5646,33640,192200,225840
2/8/2025,Siriwardena Dissanayake,Ratnapura,Rakwana,Sabaragamuwa,348,57,405,13920,2280,16200
2/9/2025,Siriwardena Dissanayake,Ratnapura,Rakwana,Sabaragamuwa,8869,3091,11960,354760,123640,478400
2/10/2025,Siriwardena Dissanayake,Ratnapura,Rakwana,Sabaragamuwa,7937,119,8056,317480,4760,322240
2/11/2025,Siriwardena Dissanayake,Ratnapura,Rakwana,Sabaragamuwa,6505,94,6599,260200,3760,263960
2/12/2025,Siriwardena Dissanayake,Ratnapura,Rakwana,Sabaragamuwa,8364,988,9352,334560,39520,374080
2/13/2025,Siriwardena Dissanayake,Ratnapura,Rakwana,Sabaragamuwa,7779,8156,15935,311160,326240,637400
2/14/2025,Siriwardena Dissanayake,Ratnapura,Rakwana,Sabaragamuwa,4219,2342,6561,168760,93680,262440
2/15/2025,Siriwardena Dissanayake,Ratnapura,Rakwana,Sabaragamuwa,8045,5190,13235,321800,207600,529400
2/16/2025,Siriwardena Dissanayake,Ratnapura,Rakwana,Sabaragamuwa,1551,317,1868,62040,12680,74720
2/17/2025,Siriwardena Dissanayake,Ratnapura,Rakwana,Sabaragamuwa,2141,9114,11255,85640,364560,450200
2/18/2025,Siriwardena Dissanayake,Ratnapura,Rakwana,Sabaragamuwa,7266,7560,14826,290640,302400,593040
2/19/2025,Siriwardena Dissanayake,Ratnapura,Rakwana,Sabaragamuwa,3422,9908,13330,136880,396320,533200
2/20/2025,Siriwardena Dissanayake,Ratnapura,Rakwana,Sabaragamuwa,3356,7039,10395,134240,281560,415800
2/21/2025,Siriwardena Dissanayake,Ratnapura,Rakwana,Sabaragamuwa,5268,3564,8832,210720,142560,353280
2/22/2025,Siriwardena Dissanayake,Ratnapura,Rakwana,Sabaragamuwa,2828,6482,9310,113120,259280,372400
2/23/2025,Siriwardena Dissanayake,Ratnapura,Rakwana,Sabaragamuwa,397,8649,9046,15880,345960,361840
2/24/2025,Siriwardena Dissanayake,Ratnapura,Rakwana,Sabaragamuwa,1298,3709,5007,51920,148360,200280
2/25/2025,Siriwardena Dissanayake,Ratnapura,Rakwana,Sabaragamuwa,5974,7753,13727,238960,310120,549080
2/26/2025,Siriwardena Dissanayake,Ratnapura,Rakwana,Sabaragamuwa,5601,6932,12533,224040,277280,501320
2/27/2025,Siriwardena Dissanayake,Ratnapura,Rakwana,Sabaragamuwa,486,986,1472,19440,39440,58880
2/28/2025,Siriwardena Dissanayake,Ratnapura,Rakwana,Sabaragamuwa,8981,2417,11398,359240,96680,455920
3/1/2025,Siriwardena Dissanayake,Ratnapura,Rakwana,Sabaragamuwa,2490,9933,12423,99600,397320,496920
3/2/2025,Siriwardena Dissanayake,Ratnapura,Rakwana,Sabaragamuwa,7627,3847,11474,305080,153880,458960
3/3/2025,Siriwardena Dissanayake,Ratnapura,Rakwana,Sabaragamuwa,2761,9288,12049,110440,371520,481960
3/4/2025,Siriwardena Dissanayake,Ratnapura,Rakwana,Sabaragamuwa,5827,2880,8707,233080,115200,348280
3/5/2025,Siriwardena Dissanayake,Ratnapura,Rakwana,Sabaragamuwa,8981,8615,17596,359240,344600,703840
3/6/2025,Siriwardena Dissanayake,Ratnapura,Rakwana,Sabaragamuwa,3905,7567,11472,156200,302680,458880
3/7/2025,Siriwardena Dissanayake,Ratnapura,Rakwana,Sabaragamuwa,2514,5645,8159,100560,225800,326360
3/8/2025,Siriwardena Dissanayake,Ratnapura,Rakwana,Sabaragamuwa,6867,1948,8815,274680,77920,352600
3/9/2025,Siriwardena Dissanayake,Ratnapura,Rakwana,Sabaragamuwa,9214,1726,10940,368560,69040,437600
3/10/2025,Siriwardena Dissanayake,Ratnapura,Rakwana,Sabaragamuwa,9322,57,9379,372880,2280,375160
3/11/2025,Siriwardena Dissanayake,Ratnapura,Rakwana,Sabaragamuwa,8126,6239,14365,325040,249560,574600
3/12/2025,Siriwardena Dissanayake,Ratnapura,Rakwana,Sabaragamuwa,2697,6245,8942,107880,249800,357680
3/13/2025,Siriwardena Dissanayake,Ratnapura,Rakwana,Sabaragamuwa,1207,9573,10780,48280,382920,431200
3/14/2025,Siriwardena Dissanayake,Ratnapura,Rakwana,Sabaragamuwa,126,5828,5954,5040,233120,238160
3/15/2025,Siriwardena Dissanayake,Ratnapura,Rakwana,Sabaragamuwa,7765,2726,10491,310600,109040,419640
3/16/2025,Siriwardena Dissanayake,Ratnapura,Rakwana,Sabaragamuwa,5639,5778,11417,225560,231120,456680
3/17/2025,Siriwardena Dissanayake,Ratnapura,Rakwana,Sabaragamuwa,242,583,825,9680,23320,33000
3/18/2025,Siriwardena Dissanayake,Ratnapura,Rakwana,Sabaragamuwa,5512,6475,11987,220480,259000,479480
3/19/2025,Siriwardena Dissanayake,Ratnapura,Rakwana,Sabaragamuwa,1061,965,2026,42440,38600,81040
3/20/2025,Siriwardena Dissanayake,Ratnapura,Rakwana,Sabaragamuwa,9549,9850,19399,381960,394000,775960
3/21/2025,Siriwardena Dissanayake,Ratnapura,Rakwana,Sabaragamuwa,7706,311,8017,308240,12440,320680
3/22/2025,Siriwardena Dissanayake,Ratnapura,Rakwana,Sabaragamuwa,1319,3903,5222,52760,156120,208880
3/23/2025,Siriwardena Dissanayake,Ratnapura,Rakwana,Sabaragamuwa,3011,2509,5520,120440,100360,220800
3/25/2024,Ajith Kumarasinghe,Kandy,Teldeniya,Central,3853,2123,5976,154120,84920,239040
3/26/2024,Ajith Kumarasinghe,Kandy,Teldeniya,Central,9993,6,9999,399720,240,399960
3/27/2024,Ajith Kumarasinghe,Kandy,Teldeniya,Central,9407,8692,18099,376280,347680,723960
3/28/2024,Ajith Kumarasinghe,Kandy,Teldeniya,Central,6325,8227,14552,253000,329080,582080
3/29/2024,Ajith Kumarasinghe,Kandy,Teldeniya,Central,3625,4704,8329,145000,188160,333160
3/30/2024,Ajith Kumarasinghe,Kandy,Teldeniya,Central,4849,7832,12681,193960,313280,507240
3/31/2024,Ajith Kumarasinghe,Kandy,Teldeniya,Central,2656,1842,4498,106240,73680,179920
4/1/2024,Ajith Kumarasinghe,Kandy,Teldeniya,Central,3992,1513,5505,159680,60520,220200
4/2/2024,Ajith Kumarasinghe,Kandy,Teldeniya,Central,321,4601,4922,12840,184040,196880
4/3/2024,Ajith Kumarasinghe,Kandy,Teldeniya,Central,3257,660,3917,130280,26400,156680
4/4/2024,Ajith Kumarasinghe,Kandy,Teldeniya,Central,7743,1207,8950,309720,48280,358000
4/5/2024,Ajith Kumarasinghe,Kandy,Teldeniya,Central,8193,8201,16394,327720,328040,655760
4/6/2024,Ajith Kumarasinghe,Kandy,Teldeniya,Central,4731,3785,8516,189240,151400,340640
4/7/2024,Ajith Kumarasinghe,Kandy,Teldeniya,Central,8558,6745,15303,342320,269800,612120
4/8/2024,Ajith Kumarasinghe,Kandy,Teldeniya,Central,3379,5803,9182,135160,232120,367280
4/9/2024,Ajith Kumarasinghe,Kandy,Teldeniya,Central,579,1744,2323,23160,69760,92920
4/10/2024,Ajith Kumarasinghe,Kandy,Teldeniya,Central,8459,8534,16993,338360,341360,679720
4/11/2024,Ajith Kumarasinghe,Kandy,Teldeniya,Central,7497,7900,15397,299880,316000,615880
4/19/2024,Ajith Kumarasinghe,Kandy,Teldeniya,Central,9175,601,9776,367000,24040,391040
4/20/2024,Ajith Kumarasinghe,Kandy,Teldeniya,Central,7971,1835,9806,318840,73400,392240
4/21/2024,Ajith Kumarasinghe,Kandy,Teldeniya,Central,1546,213,1759,61840,8520,70360
4/22/2024,Ajith Kumarasinghe,Kandy,Teldeniya,Central,7219,1059,8278,288760,42360,331120
4/23/2024,Ajith Kumarasinghe,Kandy,Teldeniya,Central,1758,4318,6076,70320,172720,243040
4/24/2024,Ajith Kumarasinghe,Kandy,Teldeniya,Central,3265,598,3863,130600,23920,154520
4/25/2024,Ajith Kumarasinghe,Kandy,Teldeniya,Central,9309,2715,12024,372360,108600,480960
4/26/2024,Ajith Kumarasinghe,Kandy,Teldeniya,Central,9821,4074,13895,392840,162960,555800
4/27/2024,Ajith Kumarasinghe,Kandy,Teldeniya,Central,5353,3252,8605,214120,130080,344200
4/28/2024,Ajith Kumarasinghe,Kandy,Teldeniya,Central,8870,6924,15794,354800,276960,631760
4/29/2024,Ajith Kumarasinghe,Kandy,Teldeniya,Central,6230,3651,9881,249200,146040,395240
4/30/2024,Ajith Kumarasinghe,Kandy,Teldeniya,Central,9182,7996,17178,367280,319840,687120
5/1/2024,Ajith Kumarasinghe,Kandy,Teldeniya,Central,48,3293,3341,1920,131720,133640
5/2/2024,Ajith Kumarasinghe,Kandy,Teldeniya,Central,5746,7009,12755,229840,280360,510200
5/3/2024,Ajith Kumarasinghe,Kandy,Teldeniya,Central,9961,21,9982,398440,840,399280
5/4/2024,Ajith Kumarasinghe,Kandy,Teldeniya,Central,7147,4508,11655,285880,180320,466200
5/5/2024,Ajith Kumarasinghe,Kandy,Teldeniya,Central,4990,9986,14976,199600,399440,599040
5/6/2024,Ajith Kumarasinghe,Kandy,Teldeniya,Central,4160,2955,7115,166400,118200,284600
5/7/2024,Ajith Kumarasinghe,Kandy,Teldeniya,Central,1415,9719,11134,56600,388760,445360
5/8/2024,Ajith Kumarasinghe,Kandy,Teldeniya,Central,8688,7318,16006,347520,292720,640240
5/9/2024,Ajith Kumarasinghe,Kandy,Teldeniya,Central,4270,1887,6157,170800,75480,246280
5/10/2024,Ajith Kumarasinghe,Kandy,Teldeniya,Central,6441,2938,9379,257640,117520,375160
5/11/2024,Ajith Kumarasinghe,Kandy,Teldeniya,Central,7892,6754,14646,315680,270160,585840
5/12/2024,Ajith Kumarasinghe,Kandy,Teldeniya,Central,1089,9448,10537,43560,377920,421480
5/13/2024,Ajith Kumarasinghe,Kandy,Teldeniya,Central,7833,7873,15706,313320,314920,628240
5/14/2024,Ajith Kumarasinghe,Kandy,Teldeniya,Central,1087,3111,4198,43480,124440,167920
5/15/2024,Ajith Kumarasinghe,Kandy,Teldeniya,Central,4866,2787,7653,194640,111480,306120
5/16/2024,Ajith Kumarasinghe,Kandy,Teldeniya,Central,4278,85,4363,171120,3400,174520
5/17/2024,Ajith Kumarasinghe,Kandy,Teldeniya,Central,261,1238,1499,10440,49520,59960
5/18/2024,Ajith Kumarasinghe,Kandy,Teldeniya,Central,4487,7775,12262,179480,311000,490480
5/19/2024,Ajith Kumarasinghe,Kandy,Teldeniya,Central,4996,4672,9668,199840,186880,386720
5/20/2024,Ajith Kumarasinghe,Kandy,Teldeniya,Central,9618,7560,17178,384720,302400,687120
5/21/2024,Ajith Kumarasinghe,Kandy,Teldeniya,Central,6505,1410,7915,260200,56400,316600
5/22/2024,Ajith Kumarasinghe,Kandy,Teldeniya,Central,3617,3144,6761,144680,125760,270440
5/24/2024,Ajith Kumarasinghe,Kandy,Teldeniya,Central,1079,6422,7501,43160,256880,300040
5/25/2024,Ajith Kumarasinghe,Kandy,Teldeniya,Central,94,7398,7492,3760,295920,299680
5/26/2024,Ajith Kumarasinghe,Kandy,Teldeniya,Central,5164,6389,11553,206560,255560,462120
5/27/2024,Ajith Kumarasinghe,Kandy,Teldeniya,Central,1480,6316,7796,59200,252640,311840
5/28/2024,Ajith Kumarasinghe,Kandy,Teldeniya,Central,4009,5859,9868,160360,234360,394720
5/29/2024,Ajith Kumarasinghe,Kandy,Teldeniya,Central,8883,7140,16023,355320,285600,640920
5/30/2024,Ajith Kumarasinghe,Kandy,Teldeniya,Central,942,9205,10147,37680,368200,405880
5/31/2024,Ajith Kumarasinghe,Kandy,Teldeniya,Central,5806,621,6427,232240,24840,257080
6/1/2024,Ajith Kumarasinghe,Kandy,Teldeniya,Central,968,1649,2617,38720,65960,104680
6/2/2024,Ajith Kumarasinghe,Kandy,Teldeniya,Central,1846,4186,6032,73840,167440,241280
6/3/2024,Ajith Kumarasinghe,Kandy,Teldeniya,Central,2726,2084,4810,109040,83360,192400
6/4/2024,Ajith Kumarasinghe,Kandy,Teldeniya,Central,3055,3861,6916,122200,154440,276640
6/5/2024,Ajith Kumarasinghe,Kandy,Teldeniya,Central,8969,7209,16178,358760,288360,647120
6/6/2024,Ajith Kumarasinghe,Kandy,Teldeniya,Central,2863,162,3025,114520,6480,121000
6/7/2024,Ajith Kumarasinghe,Kandy,Teldeniya,Central,6349,4871,11220,253960,194840,448800
6/8/2024,Ajith Kumarasinghe,Kandy,Teldeniya,Central,4157,641,4798,166280,25640,191920
6/9/2024,Ajith Kumarasinghe,Kandy,Teldeniya,Central,724,7877,8601,28960,315080,344040
6/10/2024,Ajith Kumarasinghe,Kandy,Teldeniya,Central,337,7067,7404,13480,282680,296160
6/11/2024,Ajith Kumarasinghe,Kandy,Teldeniya,Central,3957,1988,5945,158280,79520,237800
6/12/2024,Ajith Kumarasinghe,Kandy,Teldeniya,Central,4365,1867,6232,174600,74680,249280
6/13/2024,Ajith Kumarasinghe,Kandy,Teldeniya,Central,8011,9579,17590,320440,383160,703600
6/14/2024,Ajith Kumarasinghe,Kandy,Teldeniya,Central,6315,6566,12881,252600,262640,515240
6/15/2024,Ajith Kumarasinghe,Kandy,Teldeniya,Central,774,1157,1931,30960,46280,77240
6/16/2024,Ajith Kumarasinghe,Kandy,Teldeniya,Central,143,3594,3737,5720,143760,149480
6/17/2024,Ajith Kumarasinghe,Kandy,Teldeniya,Central,3371,7460,10831,134840,298400,433240
6/18/2024,Ajith Kumarasinghe,Kandy,Teldeniya,Central,3178,8231,11409,127120,329240,456360
6/19/2024,Ajith Kumarasinghe,Kandy,Teldeniya,Central,8345,1326,9671,333800,53040,386840
6/20/2024,Ajith Kumarasinghe,Kandy,Teldeniya,Central,9384,6768,16152,375360,270720,646080
6/21/2024,Ajith Kumarasinghe,Kandy,Teldeniya,Central,2523,988,3511,100920,39520,140440
6/22/2024,Ajith Kumarasinghe,Kandy,Teldeniya,Central,8985,1578,10563,359400,63120,422520
6/23/2024,Ajith Kumarasinghe,Kandy,Teldeniya,Central,412,1707,2119,16480,68280,84760
6/24/2024,Ajith Kumarasinghe,Kandy,Teldeniya,Central,8761,9841,18602,350440,393640,744080
6/25/2024,Ajith Kumarasinghe,Kandy,Teldeniya,Central,6611,9006,15617,264440,360240,624680
6/26/2024,Ajith Kumarasinghe,Kandy,Teldeniya,Central,5915,8577,14492,236600,343080,579680
6/27/2024,Ajith Kumarasinghe,Kandy,Teldeniya,Central,9809,7320,17129,392360,292800,685160
6/28/2024,Ajith Kumarasinghe,Kandy,Teldeniya,Central,7631,6512,14143,305240,260480,565720
6/29/2024,Ajith Kumarasinghe,Kandy,Teldeniya,Central,6913,2417,9330,276520,96680,373200
6/30/2024,Ajith Kumarasinghe,Kandy,Teldeniya,Central,2829,1283,4112,113160,51320,164480
7/1/2024,Ajith Kumarasinghe,Kandy,Teldeniya,Central,4019,6900,10919,160760,276000,436760
7/2/2024,Ajith Kumarasinghe,Kandy,Teldeniya,Central,3607,9096,12703,144280,363840,508120
7/3/2024,Ajith Kumarasinghe,Kandy,Teldeniya,Central,1805,1250,3055,72200,50000,122200
7/4/2024,Ajith Kumarasinghe,Kandy,Teldeniya,Central,6598,8432,15030,263920,337280,601200
7/5/2024,Ajith Kumarasinghe,Kandy,Teldeniya,Central,9840,3007,12847,393600,120280,513880
7/6/2024,Ajith Kumarasinghe,Kandy,Teldeniya,Central,8456,4128,12584,338240,165120,503360
7/7/2024,Ajith Kumarasinghe,Kandy,Teldeniya,Central,5528,6334,11862,221120,253360,474480
7/8/2024,Ajith Kumarasinghe,Kandy,Teldeniya,Central,9178,6902,16080,367120,276080,643200
7/9/2024,Ajith Kumarasinghe,Kandy,Teldeniya,Central,3671,5104,8775,146840,204160,351000
7/10/2024,Ajith Kumarasinghe,Kandy,Teldeniya,Central,1755,6055,7810,70200,242200,312400
7/11/2024,Ajith Kumarasinghe,Kandy,Teldeniya,Central,6696,4489,11185,267840,179560,447400
7/12/2024,Ajith Kumarasinghe,Kandy,Teldeniya,Central,704,1388,2092,28160,55520,83680
7/13/2024,Ajith Kumarasinghe,Kandy,Teldeniya,Central,4971,3303,8274,198840,132120,330960
7/14/2024,Ajith Kumarasinghe,Kandy,Teldeniya,Central,8299,2841,11140,331960,113640,445600
7/15/2024,Ajith Kumarasinghe,Kandy,Teldeniya,Central,651,7,658,26040,280,26320
7/16/2024,Ajith Kumarasinghe,Kandy,Teldeniya,Central,4,9534,9538,160,381360,381520
7/17/2024,Ajith Kumarasinghe,Kandy,Teldeniya,Central,1322,3419,4741,52880,136760,189640
7/18/2024,Ajith Kumarasinghe,Kandy,Teldeniya,Central,417,5879,6296,16680,235160,251840
7/19/2024,Ajith Kumarasinghe,Kandy,Teldeniya,Central,5079,5190,10269,203160,207600,410760
7/20/2024,Ajith Kumarasinghe,Kandy,Teldeniya,Central,970,1084,2054,38800,43360,82160
7/21/2024,Ajith Kumarasinghe,Kandy,Teldeniya,Central,737,5705,6442,29480,228200,257680
7/22/2024,Ajith Kumarasinghe,Kandy,Teldeniya,Central,5103,2298,7401,204120,91920,296040
7/23/2024,Ajith Kumarasinghe,Kandy,Teldeniya,Central,6013,1342,7355,240520,53680,294200
7/24/2024,Ajith Kumarasinghe,Kandy,Teldeniya,Central,5091,5209,10300,203640,208360,412000
7/25/2024,Ajith Kumarasinghe,Kandy,Teldeniya,Central,6669,4759,11428,266760,190360,457120
7/26/2024,Ajith Kumarasinghe,Kandy,Teldeniya,Central,8249,6161,14410,329960,246440,576400
7/27/2024,Ajith Kumarasinghe,Kandy,Teldeniya,Central,8688,4118,12806,347520,164720,512240
7/28/2024,Ajith Kumarasinghe,Kandy,Teldeniya,Central,2823,6032,8855,112920,241280,354200
7/29/2024,Ajith Kumarasinghe,Kandy,Teldeniya,Central,1379,8283,9662,55160,331320,386480
7/30/2024,Ajith Kumarasinghe,Kandy,Teldeniya,Central,86,7956,8042,3440,318240,321680
7/31/2024,Ajith Kumarasinghe,Kandy,Teldeniya,Central,7761,6696,14457,310440,267840,578280
8/1/2024,Ajith Kumarasinghe,Kandy,Teldeniya,Central,6206,9636,15842,248240,385440,633680
8/2/2024,Ajith Kumarasinghe,Kandy,Teldeniya,Central,7455,8177,15632,298200,327080,625280
8/3/2024,Ajith Kumarasinghe,Kandy,Teldeniya,Central,5715,2053,7768,228600,82120,310720
8/4/2024,Ajith Kumarasinghe,Kandy,Teldeniya,Central,30,8219,8249,1200,328760,329960
8/5/2024,Ajith Kumarasinghe,Kandy,Teldeniya,Central,7756,6792,14548,310240,271680,581920
8/6/2024,Ajith Kumarasinghe,Kandy,Teldeniya,Central,9553,2532,12085,382120,101280,483400
8/7/2024,Ajith Kumarasinghe,Kandy,Teldeniya,Central,8250,6999,15249,330000,279960,609960
8/8/2024,Ajith Kumarasinghe,Kandy,Teldeniya,Central,2394,5064,7458,95760,202560,298320
8/9/2024,Ajith Kumarasinghe,Kandy,Teldeniya,Central,5270,469,5739,210800,18760,229560
8/10/2024,Ajith Kumarasinghe,Kandy,Teldeniya,Central,7235,3413,10648,289400,136520,425920
8/11/2024,Ajith Kumarasinghe,Kandy,Teldeniya,Central,4984,6858,11842,199360,274320,473680
8/12/2024,Ajith Kumarasinghe,Kandy,Teldeniya,Central,3317,575,3892,132680,23000,155680
8/13/2024,Ajith Kumarasinghe,Kandy,Teldeniya,Central,7329,9410,16739,293160,376400,669560
8/14/2024,Ajith Kumarasinghe,Kandy,Teldeniya,Central,9528,3023,12551,381120,120920,502040
8/15/2024,Ajith Kumarasinghe,Kandy,Teldeniya,Central,4991,3121,8112,199640,124840,324480
8/16/2024,Ajith Kumarasinghe,Kandy,Teldeniya,Central,7696,432,8128,307840,17280,325120
8/17/2024,Ajith Kumarasinghe,Kandy,Teldeniya,Central,2543,6923,9466,101720,276920,378640
8/18/2024,Ajith Kumarasinghe,Kandy,Teldeniya,Central,5327,488,5815,213080,19520,232600
8/19/2024,Ajith Kumarasinghe,Kandy,Teldeniya,Central,2362,2272,4634,94480,90880,185360
8/20/2024,Ajith Kumarasinghe,Kandy,Teldeniya,Central,851,8178,9029,34040,327120,361160
8/21/2024,Ajith Kumarasinghe,Kandy,Teldeniya,Central,1209,894,2103,48360,35760,84120
8/22/2024,Ajith Kumarasinghe,Kandy,Teldeniya,Central,3272,3741,7013,130880,149640,280520
8/23/2024,Ajith Kumarasinghe,Kandy,Teldeniya,Central,9934,9975,19909,397360,399000,796360
8/24/2024,Ajith Kumarasinghe,Kandy,Teldeniya,Central,8514,2598,11112,340560,103920,444480
8/25/2024,Ajith Kumarasinghe,Kandy,Teldeniya,Central,3962,3,3965,158480,120,158600
8/26/2024,Ajith Kumarasinghe,Kandy,Teldeniya,Central,9382,1183,10565,375280,47320,422600
8/27/2024,Ajith Kumarasinghe,Kandy,Teldeniya,Central,4936,3028,7964,197440,121120,318560
8/28/2024,Ajith Kumarasinghe,Kandy,Teldeniya,Central,1569,5392,6961,62760,215680,278440
8/29/2024,Ajith Kumarasinghe,Kandy,Teldeniya,Central,8286,609,8895,331440,24360,355800
8/30/2024,Ajith Kumarasinghe,Kandy,Teldeniya,Central,201,7704,7905,8040,308160,316200
8/31/2024,Ajith Kumarasinghe,Kandy,Teldeniya,Central,2185,1971,4156,87400,78840,166240
9/1/2024,Ajith Kumarasinghe,Kandy,Teldeniya,Central,2960,9946,12906,118400,397840,516240
9/2/2024,Ajith Kumarasinghe,Kandy,Teldeniya,Central,1277,4861,6138,51080,194440,245520
9/3/2024,Ajith Kumarasinghe,Kandy,Teldeniya,Central,2793,244,3037,111720,9760,121480
9/4/2024,Ajith Kumarasinghe,Kandy,Teldeniya,Central,3657,2931,6588,146280,117240,263520
9/5/2024,Ajith Kumarasinghe,Kandy,Teldeniya,Central,1272,3671,4943,50880,146840,197720
9/6/2024,Ajith Kumarasinghe,Kandy,Teldeniya,Central,3288,4543,7831,131520,181720,313240
9/7/2024,Ajith Kumarasinghe,Kandy,Teldeniya,Central,8208,8564,16772,328320,342560,670880
9/8/2024,Ajith Kumarasinghe,Kandy,Teldeniya,Central,8275,9597,17872,331000,383880,714880
9/9/2024,Ajith Kumarasinghe,Kandy,Teldeniya,Central,9957,4142,14099,398280,165680,563960
9/10/2024,Ajith Kumarasinghe,Kandy,Teldeniya,Central,9873,1251,11124,394920,50040,444960
9/11/2024,Ajith Kumarasinghe,Kandy,Teldeniya,Central,6119,3535,9654,244760,141400,386160
9/12/2024,Ajith Kumarasinghe,Kandy,Teldeniya,Central,1634,8264,9898,65360,330560,395920
9/13/2024,Ajith Kumarasinghe,Kandy,Teldeniya,Central,4995,9096,14091,199800,363840,563640
9/14/2024,Ajith Kumarasinghe,Kandy,Teldeniya,Central,6590,1454,8044,263600,58160,321760
9/15/2024,Ajith Kumarasinghe,Kandy,Teldeniya,Central,8744,5344,14088,349760,213760,563520
9/16/2024,Ajith Kumarasinghe,Kandy,Teldeniya,Central,5935,5303,11238,237400,212120,449520
9/17/2024,Ajith Kumarasinghe,Kandy,Teldeniya,Central,559,255,814,22360,10200,32560
9/18/2024,Ajith Kumarasinghe,Kandy,Teldeniya,Central,8005,7364,15369,320200,294560,614760
9/19/2024,Ajith Kumarasinghe,Kandy,Teldeniya,Central,70,5354,5424,2800,214160,216960
9/20/2024,Ajith Kumarasinghe,Kandy,Teldeniya,Central,2990,5271,8261,119600,210840,330440
9/21/2024,Ajith Kumarasinghe,Kandy,Teldeniya,Central,8265,8409,16674,330600,336360,666960
9/22/2024,Ajith Kumarasinghe,Kandy,Teldeniya,Central,8537,305,8842,341480,12200,353680
9/23/2024,Ajith Kumarasinghe,Kandy,Teldeniya,Central,9385,9623,19008,375400,384920,760320
9/24/2024,Ajith Kumarasinghe,Kandy,Teldeniya,Central,9569,469,10038,382760,18760,401520
9/25/2024,Ajith Kumarasinghe,Kandy,Teldeniya,Central,7225,3969,11194,289000,158760,447760
9/26/2024,Ajith Kumarasinghe,Kandy,Teldeniya,Central,8781,3511,12292,351240,140440,491680
9/27/2024,Ajith Kumarasinghe,Kandy,Teldeniya,Central,3954,5195,9149,158160,207800,365960
9/28/2024,Ajith Kumarasinghe,Kandy,Teldeniya,Central,551,5207,5758,22040,208280,230320
9/29/2024,Ajith Kumarasinghe,Kandy,Teldeniya,Central,1937,1099,3036,77480,43960,121440
9/30/2024,Ajith Kumarasinghe,Kandy,Teldeniya,Central,8955,1251,10206,358200,50040,408240
10/1/2024,Ajith Kumarasinghe,Kandy,Teldeniya,Central,2396,2402,4798,95840,96080,191920
10/2/2024,Ajith Kumarasinghe,Kandy,Teldeniya,Central,1088,7198,8286,43520,287920,331440
10/3/2024,Ajith Kumarasinghe,Kandy,Teldeniya,Central,6149,4525,10674,245960,181000,426960
10/4/2024,Ajith Kumarasinghe,Kandy,Teldeniya,Central,4598,5434,10032,183920,217360,401280
10/5/2024,Ajith Kumarasinghe,Kandy,Teldeniya,Central,5085,7041,12126,203400,281640,485040
10/6/2024,Ajith Kumarasinghe,Kandy,Teldeniya,Central,214,7381,7595,8560,295240,303800
10/7/2024,Ajith Kumarasinghe,Kandy,Teldeniya,Central,8608,961,9569,344320,38440,382760
10/8/2024,Ajith Kumarasinghe,Kandy,Teldeniya,Central,4690,9924,14614,187600,396960,584560
10/9/2024,Ajith Kumarasinghe,Kandy,Teldeniya,Central,33,8315,8348,1320,332600,333920
10/10/2024,Ajith Kumarasinghe,Kandy,Teldeniya,Central,3980,8656,12636,159200,346240,505440
10/11/2024,Ajith Kumarasinghe,Kandy,Teldeniya,Central,537,6845,7382,21480,273800,295280
10/12/2024,Ajith Kumarasinghe,Kandy,Teldeniya,Central,2652,6719,9371,106080,268760,374840
10/13/2024,Ajith Kumarasinghe,Kandy,Teldeniya,Central,4600,4637,9237,184000,185480,369480
10/14/2024,Ajith Kumarasinghe,Kandy,Teldeniya,Central,4284,5472,9756,171360,218880,390240
10/15/2024,Ajith Kumarasinghe,Kandy,Teldeniya,Central,1286,3073,4359,51440,122920,174360
10/16/2024,Ajith Kumarasinghe,Kandy,Teldeniya,Central,389,7162,7551,15560,286480,302040
10/17/2024,Ajith Kumarasinghe,Kandy,Teldeniya,Central,6299,5011,11310,251960,200440,452400
10/18/2024,Ajith Kumarasinghe,Kandy,Teldeniya,Central,1073,489,1562,42920,19560,62480
10/19/2024,Ajith Kumarasinghe,Kandy,Teldeniya,Central,766,8666,9432,30640,346640,377280
10/20/2024,Ajith Kumarasinghe,Kandy,Teldeniya,Central,9910,9506,19416,396400,380240,776640
10/21/2024,Ajith Kumarasinghe,Kandy,Teldeniya,Central,9203,2990,12193,368120,119600,487720
10/22/2024,Ajith Kumarasinghe,Kandy,Teldeniya,Central,1836,5376,7212,73440,215040,288480
10/23/2024,Ajith Kumarasinghe,Kandy,Teldeniya,Central,9273,6118,15391,370920,244720,615640
10/24/2024,Ajith Kumarasinghe,Kandy,Teldeniya,Central,2358,8670,11028,94320,346800,441120
10/25/2024,Ajith Kumarasinghe,Kandy,Teldeniya,Central,3321,7366,10687,132840,294640,427480
10/26/2024,Ajith Kumarasinghe,Kandy,Teldeniya,Central,3523,2743,6266,140920,109720,250640
10/27/2024,Ajith Kumarasinghe,Kandy,Teldeniya,Central,5312,421,5733,212480,16840,229320
10/28/2024,Ajith Kumarasinghe,Kandy,Teldeniya,Central,8117,215,8332,324680,8600,333280
10/29/2024,Ajith Kumarasinghe,Kandy,Teldeniya,Central,1529,2075,3604,61160,83000,144160
10/30/2024,Ajith Kumarasinghe,Kandy,Teldeniya,Central,4649,291,4940,185960,11640,197600
10/31/2024,Ajith Kumarasinghe,Kandy,Teldeniya,Central,5258,6534,11792,210320,261360,471680
11/1/2024,Ajith Kumarasinghe,Kandy,Teldeniya,Central,5442,8778,14220,217680,351120,568800
11/2/2024,Ajith Kumarasinghe,Kandy,Teldeniya,Central,5297,2684,7981,211880,107360,319240
11/3/2024,Ajith Kumarasinghe,Kandy,Teldeniya,Central,4057,6880,10937,162280,275200,437480
11/4/2024,Ajith Kumarasinghe,Kandy,Teldeniya,Central,3574,4713,8287,142960,188520,331480
11/5/2024,Ajith Kumarasinghe,Kandy,Teldeniya,Central,6441,1814,8255,257640,72560,330200
11/6/2024,Ajith Kumarasinghe,Kandy,Teldeniya,Central,9255,4150,13405,370200,166000,536200
11/7/2024,Ajith Kumarasinghe,Kandy,Teldeniya,Central,1845,4859,6704,73800,194360,268160
11/8/2024,Ajith Kumarasinghe,Kandy,Teldeniya,Central,3378,856,4234,135120,34240,169360
11/9/2024,Ajith Kumarasinghe,Kandy,Teldeniya,Central,4990,659,5649,199600,26360,225960
11/10/2024,Ajith Kumarasinghe,Kandy,Teldeniya,Central,1208,1146,2354,48320,45840,94160
11/11/2024,Ajith Kumarasinghe,Kandy,Teldeniya,Central,7679,9239,16918,307160,369560,676720
11/12/2024,Ajith Kumarasinghe,Kandy,Teldeniya,Central,4633,7948,12581,185320,317920,503240
11/13/2024,Ajith Kumarasinghe,Kandy,Teldeniya,Central,9306,6074,15380,372240,242960,615200
11/14/2024,Ajith Kumarasinghe,Kandy,Teldeniya,Central,1678,7487,9165,67120,299480,366600
11/15/2024,Ajith Kumarasinghe,Kandy,Teldeniya,Central,8110,6189,14299,324400,247560,571960
11/16/2024,Ajith Kumarasinghe,Kandy,Teldeniya,Central,5034,1105,6139,201360,44200,245560
11/17/2024,Ajith Kumarasinghe,Kandy,Teldeniya,Central,4967,2829,7796,198680,113160,311840
11/18/2024,Ajith Kumarasinghe,Kandy,Teldeniya,Central,7309,4966,12275,292360,198640,491000
11/19/2024,Ajith Kumarasinghe,Kandy,Teldeniya,Central,6019,2572,8591,240760,102880,343640
11/20/2024,Ajith Kumarasinghe,Kandy,Teldeniya,Central,8300,3807,12107,332000,152280,484280
11/21/2024,Ajith Kumarasinghe,Kandy,Teldeniya,Central,471,2657,3128,18840,106280,125120
11/22/2024,Ajith Kumarasinghe,Kandy,Teldeniya,Central,4722,6339,11061,188880,253560,442440
11/23/2024,Ajith Kumarasinghe,Kandy,Teldeniya,Central,7325,284,7609,293000,11360,304360
11/24/2024,Ajith Kumarasinghe,Kandy,Teldeniya,Central,49,1184,1233,1960,47360,49320
11/25/2024,Ajith Kumarasinghe,Kandy,Teldeniya,Central,1894,2300,4194,75760,92000,167760
11/26/2024,Ajith Kumarasinghe,Kandy,Teldeniya,Central,2745,8514,11259,109800,340560,450360
11/27/2024,Ajith Kumarasinghe,Kandy,Teldeniya,Central,9726,8588,18314,389040,343520,732560
11/28/2024,Ajith Kumarasinghe,Kandy,Teldeniya,Central,3848,6861,10709,153920,274440,428360
11/29/2024,Ajith Kumarasinghe,Kandy,Teldeniya,Central,1090,1554,2644,43600,62160,105760
11/30/2024,Ajith Kumarasinghe,Kandy,Teldeniya,Central,7562,3021,10583,302480,120840,423320
12/1/2024,Ajith Kumarasinghe,Kandy,Teldeniya,Central,8185,3597,11782,327400,143880,471280
12/2/2024,Ajith Kumarasinghe,Kandy,Teldeniya,Central,8396,4783,13179,335840,191320,527160
12/3/2024,Ajith Kumarasinghe,Kandy,Teldeniya,Central,1952,3855,5807,78080,154200,232280
12/4/2024,Ajith Kumarasinghe,Kandy,Teldeniya,Central,6925,9356,16281,277000,374240,651240
12/5/2024,Ajith Kumarasinghe,Kandy,Teldeniya,Central,8118,3143,11261,324720,125720,450440
12/6/2024,Ajith Kumarasinghe,Kandy,Teldeniya,Central,6665,9668,16333,266600,386720,653320
12/7/2024,Ajith Kumarasinghe,Kandy,Teldeniya,Central,3795,8932,12727,151800,357280,509080
12/8/2024,Ajith Kumarasinghe,Kandy,Teldeniya,Central,7102,8961,16063,284080,358440,642520
12/9/2024,Ajith Kumarasinghe,Kandy,Teldeniya,Central,1662,8474,10136,66480,338960,405440
12/10/2024,Ajith Kumarasinghe,Kandy,Teldeniya,Central,2775,8011,10786,111000,320440,431440
12/11/2024,Ajith Kumarasinghe,Kandy,Teldeniya,Central,2608,4489,7097,104320,179560,283880
12/12/2024,Ajith Kumarasinghe,Kandy,Teldeniya,Central,5104,4635,9739,204160,185400,389560
12/13/2024,Ajith Kumarasinghe,Kandy,Teldeniya,Central,3855,9828,13683,154200,393120,547320
12/14/2024,Ajith Kumarasinghe,Kandy,Teldeniya,Central,4082,585,4667,163280,23400,186680
12/15/2024,Ajith Kumarasinghe,Kandy,Teldeniya,Central,9090,3331,12421,363600,133240,496840
12/16/2024,Ajith Kumarasinghe,Kandy,Teldeniya,Central,1759,7529,9288,70360,301160,371520
12/17/2024,Ajith Kumarasinghe,Kandy,Teldeniya,Central,1800,1160,2960,72000,46400,118400
12/18/2024,Ajith Kumarasinghe,Kandy,Teldeniya,Central,63,4840,4903,2520,193600,196120
12/19/2024,Ajith Kumarasinghe,Kandy,Teldeniya,Central,3899,5452,9351,155960,218080,374040
12/20/2024,Ajith Kumarasinghe,Kandy,Teldeniya,Central,4287,5149,9436,171480,205960,377440
12/21/2024,Ajith Kumarasinghe,Kandy,Teldeniya,Central,8752,1207,9959,350080,48280,398360
12/22/2024,Ajith Kumarasinghe,Kandy,Teldeniya,Central,4347,8000,12347,173880,320000,493880
12/23/2024,Ajith Kumarasinghe,Kandy,Teldeniya,Central,1355,6915,8270,54200,276600,330800
12/24/2024,Ajith Kumarasinghe,Kandy,Teldeniya,Central,4186,5285,9471,167440,211400,378840
12/25/2024,Ajith Kumarasinghe,Kandy,Teldeniya,Central,9362,5549,14911,374480,221960,596440
12/26/2024,Ajith Kumarasinghe,Kandy,Teldeniya,Central,4149,6003,10152,165960,240120,406080
12/27/2024,Ajith Kumarasinghe,Kandy,Teldeniya,Central,784,794,1578,31360,31760,63120
12/28/2024,Ajith Kumarasinghe,Kandy,Teldeniya,Central,3642,2085,5727,145680,83400,229080
12/29/2024,Ajith Kumarasinghe,Kandy,Teldeniya,Central,7649,6016,13665,305960,240640,546600
12/30/2024,Ajith Kumarasinghe,Kandy,Teldeniya,Central,9711,2735,12446,388440,109400,497840
12/31/2024,Ajith Kumarasinghe,Kandy,Teldeniya,Central,1567,4997,6564,62680,199880,262560
1/1/2025,Ajith Kumarasinghe,Kandy,Teldeniya,Central,7831,3054,10885,313240,122160,435400
1/2/2025,Ajith Kumarasinghe,Kandy,Teldeniya,Central,7179,7147,14326,287160,285880,573040
1/3/2025,Ajith Kumarasinghe,Kandy,Teldeniya,Central,3436,7084,10520,137440,283360,420800
1/4/2025,Ajith Kumarasinghe,Kandy,Teldeniya,Central,9185,4352,13537,367400,174080,541480
1/5/2025,Ajith Kumarasinghe,Kandy,Teldeniya,Central,5189,6513,11702,207560,260520,468080
1/6/2025,Ajith Kumarasinghe,Kandy,Teldeniya,Central,3121,2214,5335,124840,88560,213400
1/7/2025,Ajith Kumarasinghe,Kandy,Teldeniya,Central,6695,7084,13779,267800,283360,551160
1/8/2025,Ajith Kumarasinghe,Kandy,Teldeniya,Central,3534,4685,8219,141360,187400,328760
1/9/2025,Ajith Kumarasinghe,Kandy,Teldeniya,Central,820,3069,3889,32800,122760,155560
1/10/2025,Ajith Kumarasinghe,Kandy,Teldeniya,Central,304,5545,5849,12160,221800,233960
1/11/2025,Ajith Kumarasinghe,Kandy,Teldeniya,Central,1125,7935,9060,45000,317400,362400
1/12/2025,Ajith Kumarasinghe,Kandy,Teldeniya,Central,6719,4196,10915,268760,167840,436600
1/13/2025,Ajith Kumarasinghe,Kandy,Teldeniya,Central,7479,8739,16218,299160,349560,648720
1/14/2025,Ajith Kumarasinghe,Kandy,Teldeniya,Central,5927,1581,7508,237080,63240,300320
1/15/2025,Ajith Kumarasinghe,Kandy,Teldeniya,Central,5809,2729,8538,232360,109160,341520
1/16/2025,Ajith Kumarasinghe,Kandy,Teldeniya,Central,5122,1655,6777,204880,66200,271080
1/17/2025,Ajith Kumarasinghe,Kandy,Teldeniya,Central,8535,2609,11144,341400,104360,445760
1/18/2025,Ajith Kumarasinghe,Kandy,Teldeniya,Central,8246,1587,9833,329840,63480,393320
1/19/2025,Ajith Kumarasinghe,Kandy,Teldeniya,Central,4452,3783,8235,178080,151320,329400
1/20/2025,Ajith Kumarasinghe,Kandy,Teldeniya,Central,3354,7113,10467,134160,284520,418680
1/21/2025,Ajith Kumarasinghe,Kandy,Teldeniya,Central,6461,8094,14555,258440,323760,582200
1/22/2025,Ajith Kumarasinghe,Kandy,Teldeniya,Central,313,4587,4900,12520,183480,196000
1/23/2025,Ajith Kumarasinghe,Kandy,Teldeniya,Central,7983,390,8373,319320,15600,334920
1/24/2025,Ajith Kumarasinghe,Kandy,Teldeniya,Central,4168,1411,5579,166720,56440,223160
1/25/2025,Ajith Kumarasinghe,Kandy,Teldeniya,Central,8230,7182,15412,329200,287280,616480
1/26/2025,Ajith Kumarasinghe,Kandy,Teldeniya,Central,7017,7407,14424,280680,296280,576960
1/27/2025,Ajith Kumarasinghe,Kandy,Teldeniya,Central,8,5567,5575,320,222680,223000
1/28/2025,Ajith Kumarasinghe,Kandy,Teldeniya,Central,2113,8487,10600,84520,339480,424000
1/29/2025,Ajith Kumarasinghe,Kandy,Teldeniya,Central,281,6340,6621,11240,253600,264840
1/30/2025,Ajith Kumarasinghe,Kandy,Teldeniya,Central,2388,7684,10072,95520,307360,402880
1/31/2025,Ajith Kumarasinghe,Kandy,Teldeniya,Central,5670,8445,14115,226800,337800,564600
2/1/2025,Ajith Kumarasinghe,Kandy,Teldeniya,Central,9043,3097,12140,361720,123880,485600
2/2/2025,Ajith Kumarasinghe,Kandy,Teldeniya,Central,1322,3820,5142,52880,152800,205680
2/3/2025,Ajith Kumarasinghe,Kandy,Teldeniya,Central,2613,2067,4680,104520,82680,187200
2/4/2025,Ajith Kumarasinghe,Kandy,Teldeniya,Central,3430,7008,10438,137200,280320,417520
2/5/2025,Ajith Kumarasinghe,Kandy,Teldeniya,Central,2874,8172,11046,114960,326880,441840
2/6/2025,Ajith Kumarasinghe,Kandy,Teldeniya,Central,2274,7535,9809,90960,301400,392360
2/7/2025,Ajith Kumarasinghe,Kandy,Teldeniya,Central,5705,6611,12316,228200,264440,492640
2/8/2025,Ajith Kumarasinghe,Kandy,Teldeniya,Central,693,6673,7366,27720,266920,294640
2/9/2025,Ajith Kumarasinghe,Kandy,Teldeniya,Central,9513,2011,11524,380520,80440,460960
2/10/2025,Ajith Kumarasinghe,Kandy,Teldeniya,Central,4397,2044,6441,175880,81760,257640
2/11/2025,Ajith Kumarasinghe,Kandy,Teldeniya,Central,1585,3047,4632,63400,121880,185280
2/12/2025,Ajith Kumarasinghe,Kandy,Teldeniya,Central,701,4172,4873,28040,166880,194920
2/13/2025,Ajith Kumarasinghe,Kandy,Teldeniya,Central,3383,6424,9807,135320,256960,392280
2/14/2025,Ajith Kumarasinghe,Kandy,Teldeniya,Central,7246,5624,12870,289840,224960,514800
2/15/2025,Ajith Kumarasinghe,Kandy,Teldeniya,Central,1658,8740,10398,66320,349600,415920
2/16/2025,Ajith Kumarasinghe,Kandy,Teldeniya,Central,3966,336,4302,158640,13440,172080
2/17/2025,Ajith Kumarasinghe,Kandy,Teldeniya,Central,9077,1692,10769,363080,67680,430760
2/18/2025,Ajith Kumarasinghe,Kandy,Teldeniya,Central,7229,3345,10574,289160,133800,422960
2/19/2025,Ajith Kumarasinghe,Kandy,Teldeniya,Central,6518,5016,11534,260720,200640,461360
2/20/2025,Ajith Kumarasinghe,Kandy,Teldeniya,Central,1477,2728,4205,59080,109120,168200
2/21/2025,Ajith Kumarasinghe,Kandy,Teldeniya,Central,6070,5292,11362,242800,211680,454480
2/22/2025,Ajith Kumarasinghe,Kandy,Teldeniya,Central,8421,1312,9733,336840,52480,389320
2/23/2025,Ajith Kumarasinghe,Kandy,Teldeniya,Central,4929,1789,6718,197160,71560,268720
2/24/2025,Ajith Kumarasinghe,Kandy,Teldeniya,Central,8259,3466,11725,330360,138640,469000
2/25/2025,Ajith Kumarasinghe,Kandy,Teldeniya,Central,6414,7096,13510,256560,283840,540400
2/26/2025,Ajith Kumarasinghe,Kandy,Teldeniya,Central,9494,1895,11389,379760,75800,455560
2/27/2025,Ajith Kumarasinghe,Kandy,Teldeniya,Central,2793,954,3747,111720,38160,149880
2/28/2025,Ajith Kumarasinghe,Kandy,Teldeniya,Central,9172,5393,14565,366880,215720,582600
3/1/2025,Ajith Kumarasinghe,Kandy,Teldeniya,Central,6040,8613,14653,241600,344520,586120
3/2/2025,Ajith Kumarasinghe,Kandy,Teldeniya,Central,6435,6997,13432,257400,279880,537280
3/3/2025,Ajith Kumarasinghe,Kandy,Teldeniya,Central,7858,5574,13432,314320,222960,537280
3/4/2025,Ajith Kumarasinghe,Kandy,Teldeniya,Central,2884,2925,5809,115360,117000,232360
3/5/2025,Ajith Kumarasinghe,Kandy,Teldeniya,Central,1564,9239,10803,62560,369560,432120
3/6/2025,Ajith Kumarasinghe,Kandy,Teldeniya,Central,5298,8437,13735,211920,337480,549400
3/7/2025,Ajith Kumarasinghe,Kandy,Teldeniya,Central,137,6810,6947,5480,272400,277880
3/8/2025,Ajith Kumarasinghe,Kandy,Teldeniya,Central,6706,5202,11908,268240,208080,476320
3/9/2025,Ajith Kumarasinghe,Kandy,Teldeniya,Central,4215,9019,13234,168600,360760,529360
3/10/2025,Ajith Kumarasinghe,Kandy,Teldeniya,Central,2491,6504,8995,99640,260160,359800
3/11/2025,Ajith Kumarasinghe,Kandy,Teldeniya,Central,9241,6294,15535,369640,251760,621400
3/12/2025,Ajith Kumarasinghe,Kandy,Teldeniya,Central,2945,2306,5251,117800,92240,210040
3/13/2025,Ajith Kumarasinghe,Kandy,Teldeniya,Central,1795,109,1904,71800,4360,76160
3/14/2025,Ajith Kumarasinghe,Kandy,Teldeniya,Central,2101,2014,4115,84040,80560,164600
3/15/2025,Ajith Kumarasinghe,Kandy,Teldeniya,Central,1648,9411,11059,65920,376440,442360
3/16/2025,Ajith Kumarasinghe,Kandy,Teldeniya,Central,6873,9623,16496,274920,384920,659840
3/17/2025,Ajith Kumarasinghe,Kandy,Teldeniya,Central,6699,3401,10100,267960,136040,404000
3/18/2025,Ajith Kumarasinghe,Kandy,Teldeniya,Central,4904,9321,14225,196160,372840,569000
3/19/2025,Ajith Kumarasinghe,Kandy,Teldeniya,Central,9935,8886,18821,397400,355440,752840
3/20/2025,Ajith Kumarasinghe,Kandy,Teldeniya,Central,1759,5718,7477,70360,228720,299080
3/21/2025,Ajith Kumarasinghe,Kandy,Teldeniya,Central,6296,8001,14297,251840,320040,571880
3/22/2025,Ajith Kumarasinghe,Kandy,Teldeniya,Central,8165,5851,14016,326600,234040,560640
3/23/2025,Ajith Kumarasinghe,Kandy,Teldeniya,Central,7792,8217,16009,311680,328680,640360
3/25/2024,Buddhi Perera,Badulla,Badulla,Uva,6029,3588,9617,241160,143520,384680
3/26/2024,Buddhi Perera,Badulla,Badulla,Uva,8236,929,9165,329440,37160,366600
3/27/2024,Buddhi Perera,Badulla,Badulla,Uva,5495,2739,8234,219800,109560,329360
3/28/2024,Buddhi Perera,Badulla,Badulla,Uva,4128,7102,11230,165120,284080,449200
3/29/2024,Buddhi Perera,Badulla,Badulla,Uva,1567,7067,8634,62680,282680,345360
3/30/2024,Buddhi Perera,Badulla,Badulla,Uva,3782,2967,6749,151280,118680,269960
3/31/2024,Buddhi Perera,Badulla,Badulla,Uva,2659,4007,6666,106360,160280,266640
4/1/2024,Buddhi Perera,Badulla,Badulla,Uva,5951,3524,9475,238040,140960,379000
4/2/2024,Buddhi Perera,Badulla,Badulla,Uva,5600,9053,14653,224000,362120,586120
4/3/2024,Buddhi Perera,Badulla,Badulla,Uva,9484,2070,11554,379360,82800,462160
4/4/2024,Buddhi Perera,Badulla,Badulla,Uva,1233,5525,6758,49320,221000,270320
4/5/2024,Buddhi Perera,Badulla,Badulla,Uva,3803,9348,13151,152120,373920,526040
4/6/2024,Buddhi Perera,Badulla,Badulla,Uva,380,2342,2722,15200,93680,108880
4/7/2024,Buddhi Perera,Badulla,Badulla,Uva,5952,545,6497,238080,21800,259880
4/8/2024,Buddhi Perera,Badulla,Badulla,Uva,9087,7668,16755,363480,306720,670200
4/9/2024,Buddhi Perera,Badulla,Badulla,Uva,955,7028,7983,38200,281120,319320
4/10/2024,Buddhi Perera,Badulla,Badulla,Uva,7351,303,7654,294040,12120,306160
4/11/2024,Buddhi Perera,Badulla,Badulla,Uva,8307,1731,10038,332280,69240,401520
4/19/2024,Buddhi Perera,Badulla,Badulla,Uva,8223,6657,14880,328920,266280,595200
4/20/2024,Buddhi Perera,Badulla,Badulla,Uva,5850,3004,8854,234000,120160,354160
4/21/2024,Buddhi Perera,Badulla,Badulla,Uva,5573,5562,11135,222920,222480,445400
4/22/2024,Buddhi Perera,Badulla,Badulla,Uva,970,7138,8108,38800,285520,324320
4/23/2024,Buddhi Perera,Badulla,Badulla,Uva,4323,6356,10679,172920,254240,427160
4/24/2024,Buddhi Perera,Badulla,Badulla,Uva,7832,5835,13667,313280,233400,546680
4/25/2024,Buddhi Perera,Badulla,Badulla,Uva,5416,8884,14300,216640,355360,572000
4/26/2024,Buddhi Perera,Badulla,Badulla,Uva,3408,9095,12503,136320,363800,500120
4/27/2024,Buddhi Perera,Badulla,Badulla,Uva,5484,5002,10486,219360,200080,419440
4/28/2024,Buddhi Perera,Badulla,Badulla,Uva,4798,7045,11843,191920,281800,473720
4/29/2024,Buddhi Perera,Badulla,Badulla,Uva,4320,7333,11653,172800,293320,466120
4/30/2024,Buddhi Perera,Badulla,Badulla,Uva,4284,5876,10160,171360,235040,406400
5/1/2024,Buddhi Perera,Badulla,Badulla,Uva,6795,5492,12287,271800,219680,491480
5/2/2024,Buddhi Perera,Badulla,Badulla,Uva,5029,3453,8482,201160,138120,339280
5/3/2024,Buddhi Perera,Badulla,Badulla,Uva,6855,6641,13496,274200,265640,539840
5/4/2024,Buddhi Perera,Badulla,Badulla,Uva,652,5649,6301,26080,225960,252040
5/5/2024,Buddhi Perera,Badulla,Badulla,Uva,81,2069,2150,3240,82760,86000
5/6/2024,Buddhi Perera,Badulla,Badulla,Uva,1571,6471,8042,62840,258840,321680
5/7/2024,Buddhi Perera,Badulla,Badulla,Uva,1283,696,1979,51320,27840,79160
5/8/2024,Buddhi Perera,Badulla,Badulla,Uva,1712,6966,8678,68480,278640,347120
5/9/2024,Buddhi Perera,Badulla,Badulla,Uva,2580,3546,6126,103200,141840,245040
5/10/2024,Buddhi Perera,Badulla,Badulla,Uva,8980,9580,18560,359200,383200,742400
5/11/2024,Buddhi Perera,Badulla,Badulla,Uva,3081,7249,10330,123240,289960,413200
5/12/2024,Buddhi Perera,Badulla,Badulla,Uva,7013,9042,16055,280520,361680,642200
5/13/2024,Buddhi Perera,Badulla,Badulla,Uva,1354,1189,2543,54160,47560,101720
5/14/2024,Buddhi Perera,Badulla,Badulla,Uva,5820,8907,14727,232800,356280,589080
5/15/2024,Buddhi Perera,Badulla,Badulla,Uva,7758,4076,11834,310320,163040,473360
5/16/2024,Buddhi Perera,Badulla,Badulla,Uva,9968,5898,15866,398720,235920,634640
5/17/2024,Buddhi Perera,Badulla,Badulla,Uva,6615,2629,9244,264600,105160,369760
5/18/2024,Buddhi Perera,Badulla,Badulla,Uva,6184,887,7071,247360,35480,282840
5/19/2024,Buddhi Perera,Badulla,Badulla,Uva,9334,3135,12469,373360,125400,498760
5/20/2024,Buddhi Perera,Badulla,Badulla,Uva,2663,3108,5771,106520,124320,230840
5/21/2024,Buddhi Perera,Badulla,Badulla,Uva,5198,817,6015,207920,32680,240600
5/22/2024,Buddhi Perera,Badulla,Badulla,Uva,6126,7809,13935,245040,312360,557400
5/24/2024,Buddhi Perera,Badulla,Badulla,Uva,5906,913,6819,236240,36520,272760
5/25/2024,Buddhi Perera,Badulla,Badulla,Uva,4164,7848,12012,166560,313920,480480
5/26/2024,Buddhi Perera,Badulla,Badulla,Uva,3428,4826,8254,137120,193040,330160
5/27/2024,Buddhi Perera,Badulla,Badulla,Uva,7107,770,7877,284280,30800,315080
5/28/2024,Buddhi Perera,Badulla,Badulla,Uva,260,2376,2636,10400,95040,105440
5/29/2024,Buddhi Perera,Badulla,Badulla,Uva,793,1060,1853,31720,42400,74120
5/30/2024,Buddhi Perera,Badulla,Badulla,Uva,2,3694,3696,80,147760,147840
5/31/2024,Buddhi Perera,Badulla,Badulla,Uva,376,7491,7867,15040,299640,314680
6/1/2024,Buddhi Perera,Badulla,Badulla,Uva,2568,6142,8710,102720,245680,348400
6/2/2024,Buddhi Perera,Badulla,Badulla,Uva,475,2197,2672,19000,87880,106880
6/3/2024,Buddhi Perera,Badulla,Badulla,Uva,8324,6662,14986,332960,266480,599440
6/4/2024,Buddhi Perera,Badulla,Badulla,Uva,9207,8023,17230,368280,320920,689200
6/5/2024,Buddhi Perera,Badulla,Badulla,Uva,5759,9220,14979,230360,368800,599160
6/6/2024,Buddhi Perera,Badulla,Badulla,Uva,7384,7631,15015,295360,305240,600600
6/7/2024,Buddhi Perera,Badulla,Badulla,Uva,7037,379,7416,281480,15160,296640
6/8/2024,Buddhi Perera,Badulla,Badulla,Uva,8958,7451,16409,358320,298040,656360
6/9/2024,Buddhi Perera,Badulla,Badulla,Uva,1016,5810,6826,40640,232400,273040
6/10/2024,Buddhi Perera,Badulla,Badulla,Uva,3854,4016,7870,154160,160640,314800
6/11/2024,Buddhi Perera,Badulla,Badulla,Uva,7491,7386,14877,299640,295440,595080
6/12/2024,Buddhi Perera,Badulla,Badulla,Uva,7488,1192,8680,299520,47680,347200
6/13/2024,Buddhi Perera,Badulla,Badulla,Uva,6814,6955,13769,272560,278200,550760
6/14/2024,Buddhi Perera,Badulla,Badulla,Uva,7371,2601,9972,294840,104040,398880
6/15/2024,Buddhi Perera,Badulla,Badulla,Uva,5916,4853,10769,236640,194120,430760
6/16/2024,Buddhi Perera,Badulla,Badulla,Uva,4074,5217,9291,162960,208680,371640
6/17/2024,Buddhi Perera,Badulla,Badulla,Uva,2193,958,3151,87720,38320,126040
6/18/2024,Buddhi Perera,Badulla,Badulla,Uva,4565,735,5300,182600,29400,212000
6/19/2024,Buddhi Perera,Badulla,Badulla,Uva,6224,2146,8370,248960,85840,334800
6/20/2024,Buddhi Perera,Badulla,Badulla,Uva,1901,6427,8328,76040,257080,333120
6/21/2024,Buddhi Perera,Badulla,Badulla,Uva,5841,5023,10864,233640,200920,434560
6/22/2024,Buddhi Perera,Badulla,Badulla,Uva,4526,5924,10450,181040,236960,418000
6/23/2024,Buddhi Perera,Badulla,Badulla,Uva,7132,9808,16940,285280,392320,677600
6/24/2024,Buddhi Perera,Badulla,Badulla,Uva,5930,6664,12594,237200,266560,503760
6/25/2024,Buddhi Perera,Badulla,Badulla,Uva,5075,8575,13650,203000,343000,546000
6/26/2024,Buddhi Perera,Badulla,Badulla,Uva,5133,3412,8545,205320,136480,341800
6/27/2024,Buddhi Perera,Badulla,Badulla,Uva,2383,4180,6563,95320,167200,262520
6/28/2024,Buddhi Perera,Badulla,Badulla,Uva,8026,5463,13489,321040,218520,539560
6/29/2024,Buddhi Perera,Badulla,Badulla,Uva,4672,5490,10162,186880,219600,406480
6/30/2024,Buddhi Perera,Badulla,Badulla,Uva,5319,1125,6444,212760,45000,257760
7/1/2024,Buddhi Perera,Badulla,Badulla,Uva,1362,5320,6682,54480,212800,267280
7/2/2024,Buddhi Perera,Badulla,Badulla,Uva,6243,8811,15054,249720,352440,602160
7/3/2024,Buddhi Perera,Badulla,Badulla,Uva,9748,3374,13122,389920,134960,524880
7/4/2024,Buddhi Perera,Badulla,Badulla,Uva,7795,3201,10996,311800,128040,439840
7/5/2024,Buddhi Perera,Badulla,Badulla,Uva,1647,8982,10629,65880,359280,425160
7/6/2024,Buddhi Perera,Badulla,Badulla,Uva,7756,6188,13944,310240,247520,557760
7/7/2024,Buddhi Perera,Badulla,Badulla,Uva,9050,2739,11789,362000,109560,471560
7/8/2024,Buddhi Perera,Badulla,Badulla,Uva,6811,563,7374,272440,22520,294960
7/9/2024,Buddhi Perera,Badulla,Badulla,Uva,8894,6850,15744,355760,274000,629760
7/10/2024,Buddhi Perera,Badulla,Badulla,Uva,3126,3706,6832,125040,148240,273280
7/11/2024,Buddhi Perera,Badulla,Badulla,Uva,8301,9845,18146,332040,393800,725840
7/12/2024,Buddhi Perera,Badulla,Badulla,Uva,3755,9239,12994,150200,369560,519760
7/13/2024,Buddhi Perera,Badulla,Badulla,Uva,7488,5260,12748,299520,210400,509920
7/14/2024,Buddhi Perera,Badulla,Badulla,Uva,9793,7966,17759,391720,318640,710360
7/15/2024,Buddhi Perera,Badulla,Badulla,Uva,1847,211,2058,73880,8440,82320
7/16/2024,Buddhi Perera,Badulla,Badulla,Uva,8938,3002,11940,357520,120080,477600
7/17/2024,Buddhi Perera,Badulla,Badulla,Uva,9006,4729,13735,360240,189160,549400
7/18/2024,Buddhi Perera,Badulla,Badulla,Uva,9093,2899,11992,363720,115960,479680
7/19/2024,Buddhi Perera,Badulla,Badulla,Uva,4332,2510,6842,173280,100400,273680
7/20/2024,Buddhi Perera,Badulla,Badulla,Uva,9447,4020,13467,377880,160800,538680
7/21/2024,Buddhi Perera,Badulla,Badulla,Uva,7935,853,8788,317400,34120,351520
7/22/2024,Buddhi Perera,Badulla,Badulla,Uva,1531,7527,9058,61240,301080,362320
7/23/2024,Buddhi Perera,Badulla,Badulla,Uva,556,4064,4620,22240,162560,184800
7/24/2024,Buddhi Perera,Badulla,Badulla,Uva,9420,5244,14664,376800,209760,586560
7/25/2024,Buddhi Perera,Badulla,Badulla,Uva,3446,7691,11137,137840,307640,445480
7/26/2024,Buddhi Perera,Badulla,Badulla,Uva,4211,791,5002,168440,31640,200080
7/27/2024,Buddhi Perera,Badulla,Badulla,Uva,8684,8832,17516,347360,353280,700640
7/28/2024,Buddhi Perera,Badulla,Badulla,Uva,7120,5314,12434,284800,212560,497360
7/29/2024,Buddhi Perera,Badulla,Badulla,Uva,5867,2906,8773,234680,116240,350920
7/30/2024,Buddhi Perera,Badulla,Badulla,Uva,5194,5082,10276,207760,203280,411040
7/31/2024,Buddhi Perera,Badulla,Badulla,Uva,7087,8596,15683,283480,343840,627320
8/1/2024,Buddhi Perera,Badulla,Badulla,Uva,7946,6202,14148,317840,248080,565920
8/2/2024,Buddhi Perera,Badulla,Badulla,Uva,8508,9785,18293,340320,391400,731720
8/3/2024,Buddhi Perera,Badulla,Badulla,Uva,3888,4944,8832,155520,197760,353280
8/4/2024,Buddhi Perera,Badulla,Badulla,Uva,1134,288,1422,45360,11520,56880
8/5/2024,Buddhi Perera,Badulla,Badulla,Uva,8642,3486,12128,345680,139440,485120
8/6/2024,Buddhi Perera,Badulla,Badulla,Uva,1302,1778,3080,52080,71120,123200
8/7/2024,Buddhi Perera,Badulla,Badulla,Uva,3908,2212,6120,156320,88480,244800
8/8/2024,Buddhi Perera,Badulla,Badulla,Uva,6726,9334,16060,269040,373360,642400
8/9/2024,Buddhi Perera,Badulla,Badulla,Uva,1666,1272,2938,66640,50880,117520
8/10/2024,Buddhi Perera,Badulla,Badulla,Uva,8434,2920,11354,337360,116800,454160
8/11/2024,Buddhi Perera,Badulla,Badulla,Uva,8657,4041,12698,346280,161640,507920
8/12/2024,Buddhi Perera,Badulla,Badulla,Uva,1938,6383,8321,77520,255320,332840
8/13/2024,Buddhi Perera,Badulla,Badulla,Uva,7941,6473,14414,317640,258920,576560
8/14/2024,Buddhi Perera,Badulla,Badulla,Uva,6449,5424,11873,257960,216960,474920
8/15/2024,Buddhi Perera,Badulla,Badulla,Uva,420,9229,9649,16800,369160,385960
8/16/2024,Buddhi Perera,Badulla,Badulla,Uva,2957,5937,8894,118280,237480,355760
8/17/2024,Buddhi Perera,Badulla,Badulla,Uva,6329,1008,7337,253160,40320,293480
8/18/2024,Buddhi Perera,Badulla,Badulla,Uva,3813,2887,6700,152520,115480,268000
8/19/2024,Buddhi Perera,Badulla,Badulla,Uva,9143,6620,15763,365720,264800,630520
8/20/2024,Buddhi Perera,Badulla,Badulla,Uva,1047,8842,9889,41880,353680,395560
8/21/2024,Buddhi Perera,Badulla,Badulla,Uva,8993,8636,17629,359720,345440,705160
8/22/2024,Buddhi Perera,Badulla,Badulla,Uva,8488,203,8691,339520,8120,347640
8/23/2024,Buddhi Perera,Badulla,Badulla,Uva,5152,5018,10170,206080,200720,406800
8/24/2024,Buddhi Perera,Badulla,Badulla,Uva,7235,1651,8886,289400,66040,355440
8/25/2024,Buddhi Perera,Badulla,Badulla,Uva,6715,2253,8968,268600,90120,358720
8/26/2024,Buddhi Perera,Badulla,Badulla,Uva,7712,3839,11551,308480,153560,462040
8/27/2024,Buddhi Perera,Badulla,Badulla,Uva,3436,6969,10405,137440,278760,416200
8/28/2024,Buddhi Perera,Badulla,Badulla,Uva,6404,7896,14300,256160,315840,572000
8/29/2024,Buddhi Perera,Badulla,Badulla,Uva,984,5552,6536,39360,222080,261440
8/30/2024,Buddhi Perera,Badulla,Badulla,Uva,9529,2688,12217,381160,107520,488680
8/31/2024,Buddhi Perera,Badulla,Badulla,Uva,6866,2575,9441,274640,103000,377640
9/1/2024,Buddhi Perera,Badulla,Badulla,Uva,1934,330,2264,77360,13200,90560
9/2/2024,Buddhi Perera,Badulla,Badulla,Uva,9732,9713,19445,389280,388520,777800
9/3/2024,Buddhi Perera,Badulla,Badulla,Uva,3311,3289,6600,132440,131560,264000
9/4/2024,Buddhi Perera,Badulla,Badulla,Uva,1453,1840,3293,58120,73600,131720
9/5/2024,Buddhi Perera,Badulla,Badulla,Uva,8240,2998,11238,329600,119920,449520
9/6/2024,Buddhi Perera,Badulla,Badulla,Uva,3211,9565,12776,128440,382600,511040
9/7/2024,Buddhi Perera,Badulla,Badulla,Uva,9175,4582,13757,367000,183280,550280
9/8/2024,Buddhi Perera,Badulla,Badulla,Uva,6415,1251,7666,256600,50040,306640
9/9/2024,Buddhi Perera,Badulla,Badulla,Uva,1252,42,1294,50080,1680,51760
9/10/2024,Buddhi Perera,Badulla,Badulla,Uva,339,3009,3348,13560,120360,133920
9/11/2024,Buddhi Perera,Badulla,Badulla,Uva,3884,2562,6446,155360,102480,257840
9/12/2024,Buddhi Perera,Badulla,Badulla,Uva,5462,4476,9938,218480,179040,397520
9/13/2024,Buddhi Perera,Badulla,Badulla,Uva,2029,8627,10656,81160,345080,426240
9/14/2024,Buddhi Perera,Badulla,Badulla,Uva,9836,4011,13847,393440,160440,553880
9/15/2024,Buddhi Perera,Badulla,Badulla,Uva,98,3874,3972,3920,154960,158880
9/16/2024,Buddhi Perera,Badulla,Badulla,Uva,1001,8278,9279,40040,331120,371160
9/17/2024,Buddhi Perera,Badulla,Badulla,Uva,6192,4476,10668,247680,179040,426720
9/18/2024,Buddhi Perera,Badulla,Badulla,Uva,9842,2451,12293,393680,98040,491720
9/19/2024,Buddhi Perera,Badulla,Badulla,Uva,5231,9903,15134,209240,396120,605360
9/20/2024,Buddhi Perera,Badulla,Badulla,Uva,7740,302,8042,309600,12080,321680
9/21/2024,Buddhi Perera,Badulla,Badulla,Uva,6475,6375,12850,259000,255000,514000
9/22/2024,Buddhi Perera,Badulla,Badulla,Uva,4421,7559,11980,176840,302360,479200
9/23/2024,Buddhi Perera,Badulla,Badulla,Uva,4514,3753,8267,180560,150120,330680
9/24/2024,Buddhi Perera,Badulla,Badulla,Uva,2762,648,3410,110480,25920,136400
9/25/2024,Buddhi Perera,Badulla,Badulla,Uva,9547,4193,13740,381880,167720,549600
9/26/2024,Buddhi Perera,Badulla,Badulla,Uva,3595,2430,6025,143800,97200,241000
9/27/2024,Buddhi Perera,Badulla,Badulla,Uva,2358,4426,6784,94320,177040,271360
9/28/2024,Buddhi Perera,Badulla,Badulla,Uva,9932,9565,19497,397280,382600,779880
9/29/2024,Buddhi Perera,Badulla,Badulla,Uva,6815,3980,10795,272600,159200,431800
9/30/2024,Buddhi Perera,Badulla,Badulla,Uva,7880,3967,11847,315200,158680,473880
10/1/2024,Buddhi Perera,Badulla,Badulla,Uva,3285,7442,10727,131400,297680,429080
10/2/2024,Buddhi Perera,Badulla,Badulla,Uva,2437,4986,7423,97480,199440,296920
10/3/2024,Buddhi Perera,Badulla,Badulla,Uva,7178,2366,9544,287120,94640,381760
10/4/2024,Buddhi Perera,Badulla,Badulla,Uva,3533,9006,12539,141320,360240,501560
10/5/2024,Buddhi Perera,Badulla,Badulla,Uva,5362,9127,14489,214480,365080,579560
10/6/2024,Buddhi Perera,Badulla,Badulla,Uva,2743,5755,8498,109720,230200,339920
10/7/2024,Buddhi Perera,Badulla,Badulla,Uva,9931,1594,11525,397240,63760,461000
10/8/2024,Buddhi Perera,Badulla,Badulla,Uva,9268,6137,15405,370720,245480,616200
10/9/2024,Buddhi Perera,Badulla,Badulla,Uva,2939,1132,4071,117560,45280,162840
10/10/2024,Buddhi Perera,Badulla,Badulla,Uva,530,8243,8773,21200,329720,350920
10/11/2024,Buddhi Perera,Badulla,Badulla,Uva,2590,2097,4687,103600,83880,187480
10/12/2024,Buddhi Perera,Badulla,Badulla,Uva,2516,7791,10307,100640,311640,412280
10/13/2024,Buddhi Perera,Badulla,Badulla,Uva,5773,3468,9241,230920,138720,369640
10/14/2024,Buddhi Perera,Badulla,Badulla,Uva,2861,672,3533,114440,26880,141320
10/15/2024,Buddhi Perera,Badulla,Badulla,Uva,831,9059,9890,33240,362360,395600
10/16/2024,Buddhi Perera,Badulla,Badulla,Uva,4836,2186,7022,193440,87440,280880
10/17/2024,Buddhi Perera,Badulla,Badulla,Uva,8596,6329,14925,343840,253160,597000
10/18/2024,Buddhi Perera,Badulla,Badulla,Uva,3474,1549,5023,138960,61960,200920
10/19/2024,Buddhi Perera,Badulla,Badulla,Uva,5704,8976,14680,228160,359040,587200
10/20/2024,Buddhi Perera,Badulla,Badulla,Uva,9130,1111,10241,365200,44440,409640
10/21/2024,Buddhi Perera,Badulla,Badulla,Uva,1163,6992,8155,46520,279680,326200
10/22/2024,Buddhi Perera,Badulla,Badulla,Uva,429,43,472,17160,1720,18880
10/23/2024,Buddhi Perera,Badulla,Badulla,Uva,1475,4837,6312,59000,193480,252480
10/24/2024,Buddhi Perera,Badulla,Badulla,Uva,7331,812,8143,293240,32480,325720
10/25/2024,Buddhi Perera,Badulla,Badulla,Uva,435,8940,9375,17400,357600,375000
10/26/2024,Buddhi Perera,Badulla,Badulla,Uva,196,5930,6126,7840,237200,245040
10/27/2024,Buddhi Perera,Badulla,Badulla,Uva,6176,5384,11560,247040,215360,462400
10/28/2024,Buddhi Perera,Badulla,Badulla,Uva,8155,1235,9390,326200,49400,375600
10/29/2024,Buddhi Perera,Badulla,Badulla,Uva,348,9107,9455,13920,364280,378200
10/30/2024,Buddhi Perera,Badulla,Badulla,Uva,6987,4092,11079,279480,163680,443160
10/31/2024,Buddhi Perera,Badulla,Badulla,Uva,4190,9658,13848,167600,386320,553920
11/1/2024,Buddhi Perera,Badulla,Badulla,Uva,6987,6671,13658,279480,266840,546320
11/2/2024,Buddhi Perera,Badulla,Badulla,Uva,2488,1441,3929,99520,57640,157160
11/3/2024,Buddhi Perera,Badulla,Badulla,Uva,631,6072,6703,25240,242880,268120
11/4/2024,Buddhi Perera,Badulla,Badulla,Uva,3742,694,4436,149680,27760,177440
11/5/2024,Buddhi Perera,Badulla,Badulla,Uva,7789,6736,14525,311560,269440,581000
11/6/2024,Buddhi Perera,Badulla,Badulla,Uva,4791,8861,13652,191640,354440,546080
11/7/2024,Buddhi Perera,Badulla,Badulla,Uva,8382,3530,11912,335280,141200,476480
11/8/2024,Buddhi Perera,Badulla,Badulla,Uva,4598,4950,9548,183920,198000,381920
11/9/2024,Buddhi Perera,Badulla,Badulla,Uva,9068,3405,12473,362720,136200,498920
11/10/2024,Buddhi Perera,Badulla,Badulla,Uva,921,6963,7884,36840,278520,315360
11/11/2024,Buddhi Perera,Badulla,Badulla,Uva,3245,39,3284,129800,1560,131360
11/12/2024,Buddhi Perera,Badulla,Badulla,Uva,5353,6463,11816,214120,258520,472640
11/13/2024,Buddhi Perera,Badulla,Badulla,Uva,9696,4099,13795,387840,163960,551800
11/14/2024,Buddhi Perera,Badulla,Badulla,Uva,3649,23,3672,145960,920,146880
11/15/2024,Buddhi Perera,Badulla,Badulla,Uva,1256,9903,11159,50240,396120,446360
11/16/2024,Buddhi Perera,Badulla,Badulla,Uva,467,3210,3677,18680,128400,147080
11/17/2024,Buddhi Perera,Badulla,Badulla,Uva,7308,665,7973,292320,26600,318920
11/18/2024,Buddhi Perera,Badulla,Badulla,Uva,5829,4212,10041,233160,168480,401640
11/19/2024,Buddhi Perera,Badulla,Badulla,Uva,1249,6316,7565,49960,252640,302600
11/20/2024,Buddhi Perera,Badulla,Badulla,Uva,1180,4513,5693,47200,180520,227720
11/21/2024,Buddhi Perera,Badulla,Badulla,Uva,2562,8113,10675,102480,324520,427000
11/22/2024,Buddhi Perera,Badulla,Badulla,Uva,5684,497,6181,227360,19880,247240
11/23/2024,Buddhi Perera,Badulla,Badulla,Uva,4230,8580,12810,169200,343200,512400
11/24/2024,Buddhi Perera,Badulla,Badulla,Uva,2035,6423,8458,81400,256920,338320
11/25/2024,Buddhi Perera,Badulla,Badulla,Uva,1788,8582,10370,71520,343280,414800
11/26/2024,Buddhi Perera,Badulla,Badulla,Uva,2276,4869,7145,91040,194760,285800
11/27/2024,Buddhi Perera,Badulla,Badulla,Uva,6750,448,7198,270000,17920,287920
11/28/2024,Buddhi Perera,Badulla,Badulla,Uva,8141,8268,16409,325640,330720,656360
11/29/2024,Buddhi Perera,Badulla,Badulla,Uva,4531,9224,13755,181240,368960,550200
11/30/2024,Buddhi Perera,Badulla,Badulla,Uva,5701,1517,7218,228040,60680,288720
12/1/2024,Buddhi Perera,Badulla,Badulla,Uva,5618,6981,12599,224720,279240,503960
12/2/2024,Buddhi Perera,Badulla,Badulla,Uva,2208,6038,8246,88320,241520,329840
12/3/2024,Buddhi Perera,Badulla,Badulla,Uva,816,5334,6150,32640,213360,246000
12/4/2024,Buddhi Perera,Badulla,Badulla,Uva,7702,4211,11913,308080,168440,476520
12/5/2024,Buddhi Perera,Badulla,Badulla,Uva,1918,7570,9488,76720,302800,379520
12/6/2024,Buddhi Perera,Badulla,Badulla,Uva,1448,3388,4836,57920,135520,193440
12/7/2024,Buddhi Perera,Badulla,Badulla,Uva,2782,8649,11431,111280,345960,457240
12/8/2024,Buddhi Perera,Badulla,Badulla,Uva,2862,4471,7333,114480,178840,293320
12/9/2024,Buddhi Perera,Badulla,Badulla,Uva,1190,4856,6046,47600,194240,241840
12/10/2024,Buddhi Perera,Badulla,Badulla,Uva,8540,1938,10478,341600,77520,419120
12/11/2024,Buddhi Perera,Badulla,Badulla,Uva,850,4706,5556,34000,188240,222240
12/12/2024,Buddhi Perera,Badulla,Badulla,Uva,7668,2464,10132,306720,98560,405280
12/13/2024,Buddhi Perera,Badulla,Badulla,Uva,475,1089,1564,19000,43560,62560
12/14/2024,Buddhi Perera,Badulla,Badulla,Uva,1889,7166,9055,75560,286640,362200
12/15/2024,Buddhi Perera,Badulla,Badulla,Uva,9077,6631,15708,363080,265240,628320
12/16/2024,Buddhi Perera,Badulla,Badulla,Uva,1332,7744,9076,53280,309760,363040
12/17/2024,Buddhi Perera,Badulla,Badulla,Uva,8945,621,9566,357800,24840,382640
12/18/2024,Buddhi Perera,Badulla,Badulla,Uva,4231,8319,12550,169240,332760,502000
12/19/2024,Buddhi Perera,Badulla,Badulla,Uva,6577,2408,8985,263080,96320,359400
12/20/2024,Buddhi Perera,Badulla,Badulla,Uva,596,717,1313,23840,28680,52520
12/21/2024,Buddhi Perera,Badulla,Badulla,Uva,82,7739,7821,3280,309560,312840
12/22/2024,Buddhi Perera,Badulla,Badulla,Uva,4564,9633,14197,182560,385320,567880
12/23/2024,Buddhi Perera,Badulla,Badulla,Uva,3317,7278,10595,132680,291120,423800
12/24/2024,Buddhi Perera,Badulla,Badulla,Uva,4979,654,5633,199160,26160,225320
12/25/2024,Buddhi Perera,Badulla,Badulla,Uva,772,2326,3098,30880,93040,123920
12/26/2024,Buddhi Perera,Badulla,Badulla,Uva,422,6694,7116,16880,267760,284640
12/27/2024,Buddhi Perera,Badulla,Badulla,Uva,2382,1106,3488,95280,44240,139520
12/28/2024,Buddhi Perera,Badulla,Badulla,Uva,5599,4762,10361,223960,190480,414440
12/29/2024,Buddhi Perera,Badulla,Badulla,Uva,2980,1790,4770,119200,71600,190800
12/30/2024,Buddhi Perera,Badulla,Badulla,Uva,1669,9709,11378,66760,388360,455120
12/31/2024,Buddhi Perera,Badulla,Badulla,Uva,7196,1998,9194,287840,79920,367760
1/1/2025,Buddhi Perera,Badulla,Badulla,Uva,9279,8762,18041,371160,350480,721640
1/2/2025,Buddhi Perera,Badulla,Badulla,Uva,9838,4536,14374,393520,181440,574960
1/3/2025,Buddhi Perera,Badulla,Badulla,Uva,8734,1453,10187,349360,58120,407480
1/4/2025,Buddhi Perera,Badulla,Badulla,Uva,7050,9040,16090,282000,361600,643600
1/5/2025,Buddhi Perera,Badulla,Badulla,Uva,5526,2261,7787,221040,90440,311480
1/6/2025,Buddhi Perera,Badulla,Badulla,Uva,9123,4671,13794,364920,186840,551760
1/7/2025,Buddhi Perera,Badulla,Badulla,Uva,998,8424,9422,39920,336960,376880
1/8/2025,Buddhi Perera,Badulla,Badulla,Uva,7135,8283,15418,285400,331320,616720
1/9/2025,Buddhi Perera,Badulla,Badulla,Uva,9746,4997,14743,389840,199880,589720
1/10/2025,Buddhi Perera,Badulla,Badulla,Uva,6571,442,7013,262840,17680,280520
1/11/2025,Buddhi Perera,Badulla,Badulla,Uva,4767,9173,13940,190680,366920,557600
1/12/2025,Buddhi Perera,Badulla,Badulla,Uva,2242,915,3157,89680,36600,126280
1/13/2025,Buddhi Perera,Badulla,Badulla,Uva,9628,2872,12500,385120,114880,500000
1/14/2025,Buddhi Perera,Badulla,Badulla,Uva,5003,3107,8110,200120,124280,324400
1/15/2025,Buddhi Perera,Badulla,Badulla,Uva,4438,9628,14066,177520,385120,562640
1/16/2025,Buddhi Perera,Badulla,Badulla,Uva,808,8801,9609,32320,352040,384360
1/17/2025,Buddhi Perera,Badulla,Badulla,Uva,6460,7078,13538,258400,283120,541520
1/18/2025,Buddhi Perera,Badulla,Badulla,Uva,5631,4647,10278,225240,185880,411120
1/19/2025,Buddhi Perera,Badulla,Badulla,Uva,5696,6419,12115,227840,256760,484600
1/20/2025,Buddhi Perera,Badulla,Badulla,Uva,2751,9368,12119,110040,374720,484760
1/21/2025,Buddhi Perera,Badulla,Badulla,Uva,260,5916,6176,10400,236640,247040
1/22/2025,Buddhi Perera,Badulla,Badulla,Uva,6964,5197,12161,278560,207880,486440
1/23/2025,Buddhi Perera,Badulla,Badulla,Uva,2744,8983,11727,109760,359320,469080
1/24/2025,Buddhi Perera,Badulla,Badulla,Uva,3053,9940,12993,122120,397600,519720
1/25/2025,Buddhi Perera,Badulla,Badulla,Uva,1267,5172,6439,50680,206880,257560
1/26/2025,Buddhi Perera,Badulla,Badulla,Uva,2884,3899,6783,115360,155960,271320
1/27/2025,Buddhi Perera,Badulla,Badulla,Uva,1583,2134,3717,63320,85360,148680
1/28/2025,Buddhi Perera,Badulla,Badulla,Uva,1367,8371,9738,54680,334840,389520
1/29/2025,Buddhi Perera,Badulla,Badulla,Uva,606,7042,7648,24240,281680,305920
1/30/2025,Buddhi Perera,Badulla,Badulla,Uva,183,9999,10182,7320,399960,407280
1/31/2025,Buddhi Perera,Badulla,Badulla,Uva,9621,918,10539,384840,36720,421560
2/1/2025,Buddhi Perera,Badulla,Badulla,Uva,7679,6056,13735,307160,242240,549400
2/2/2025,Buddhi Perera,Badulla,Badulla,Uva,5591,7711,13302,223640,308440,532080
2/3/2025,Buddhi Perera,Badulla,Badulla,Uva,8684,9364,18048,347360,374560,721920
2/4/2025,Buddhi Perera,Badulla,Badulla,Uva,9400,9818,19218,376000,392720,768720
2/5/2025,Buddhi Perera,Badulla,Badulla,Uva,683,3062,3745,27320,122480,149800
2/6/2025,Buddhi Perera,Badulla,Badulla,Uva,2287,6839,9126,91480,273560,365040
2/7/2025,Buddhi Perera,Badulla,Badulla,Uva,9342,212,9554,373680,8480,382160
2/8/2025,Buddhi Perera,Badulla,Badulla,Uva,9413,6641,16054,376520,265640,642160
2/9/2025,Buddhi Perera,Badulla,Badulla,Uva,837,6308,7145,33480,252320,285800
2/10/2025,Buddhi Perera,Badulla,Badulla,Uva,8752,4029,12781,350080,161160,511240
2/11/2025,Buddhi Perera,Badulla,Badulla,Uva,8905,266,9171,356200,10640,366840
2/12/2025,Buddhi Perera,Badulla,Badulla,Uva,8113,3698,11811,324520,147920,472440
2/13/2025,Buddhi Perera,Badulla,Badulla,Uva,5643,3754,9397,225720,150160,375880
2/14/2025,Buddhi Perera,Badulla,Badulla,Uva,44,7346,7390,1760,293840,295600
2/15/2025,Buddhi Perera,Badulla,Badulla,Uva,348,7599,7947,13920,303960,317880
2/16/2025,Buddhi Perera,Badulla,Badulla,Uva,2059,1908,3967,82360,76320,158680
2/17/2025,Buddhi Perera,Badulla,Badulla,Uva,7270,4601,11871,290800,184040,474840
2/18/2025,Buddhi Perera,Badulla,Badulla,Uva,5597,3625,9222,223880,145000,368880
2/19/2025,Buddhi Perera,Badulla,Badulla,Uva,6626,5441,12067,265040,217640,482680
2/20/2025,Buddhi Perera,Badulla,Badulla,Uva,8409,956,9365,336360,38240,374600
2/21/2025,Buddhi Perera,Badulla,Badulla,Uva,8767,8050,16817,350680,322000,672680
2/22/2025,Buddhi Perera,Badulla,Badulla,Uva,4605,8917,13522,184200,356680,540880
2/23/2025,Buddhi Perera,Badulla,Badulla,Uva,2364,1041,3405,94560,41640,136200
2/24/2025,Buddhi Perera,Badulla,Badulla,Uva,8718,4372,13090,348720,174880,523600
2/25/2025,Buddhi Perera,Badulla,Badulla,Uva,4228,2086,6314,169120,83440,252560
2/26/2025,Buddhi Perera,Badulla,Badulla,Uva,9296,2400,11696,371840,96000,467840
2/27/2025,Buddhi Perera,Badulla,Badulla,Uva,3118,6774,9892,124720,270960,395680
2/28/2025,Buddhi Perera,Badulla,Badulla,Uva,5700,6522,12222,228000,260880,488880
3/1/2025,Buddhi Perera,Badulla,Badulla,Uva,8007,5187,13194,320280,207480,527760
3/2/2025,Buddhi Perera,Badulla,Badulla,Uva,728,2744,3472,29120,109760,138880
3/3/2025,Buddhi Perera,Badulla,Badulla,Uva,4153,5967,10120,166120,238680,404800
3/4/2025,Buddhi Perera,Badulla,Badulla,Uva,2380,5635,8015,95200,225400,320600
3/5/2025,Buddhi Perera,Badulla,Badulla,Uva,9568,9208,18776,382720,368320,751040
3/6/2025,Buddhi Perera,Badulla,Badulla,Uva,8555,8050,16605,342200,322000,664200
3/7/2025,Buddhi Perera,Badulla,Badulla,Uva,5880,4648,10528,235200,185920,421120
3/8/2025,Buddhi Perera,Badulla,Badulla,Uva,6876,1186,8062,275040,47440,322480
3/9/2025,Buddhi Perera,Badulla,Badulla,Uva,8267,2196,10463,330680,87840,418520
3/10/2025,Buddhi Perera,Badulla,Badulla,Uva,6217,5068,11285,248680,202720,451400
3/11/2025,Buddhi Perera,Badulla,Badulla,Uva,3884,5164,9048,155360,206560,361920
3/12/2025,Buddhi Perera,Badulla,Badulla,Uva,2258,9855,12113,90320,394200,484520
3/13/2025,Buddhi Perera,Badulla,Badulla,Uva,661,8277,8938,26440,331080,357520
3/14/2025,Buddhi Perera,Badulla,Badulla,Uva,9817,2309,12126,392680,92360,485040
3/15/2025,Buddhi Perera,Badulla,Badulla,Uva,4611,2200,6811,184440,88000,272440
3/16/2025,Buddhi Perera,Badulla,Badulla,Uva,5288,1522,6810,211520,60880,272400
3/17/2025,Buddhi Perera,Badulla,Badulla,Uva,7235,5031,12266,289400,201240,490640
3/18/2025,Buddhi Perera,Badulla,Badulla,Uva,4871,2798,7669,194840,111920,306760
3/19/2025,Buddhi Perera,Badulla,Badulla,Uva,5961,7903,13864,238440,316120,554560
3/20/2025,Buddhi Perera,Badulla,Badulla,Uva,1041,2356,3397,41640,94240,135880
3/21/2025,Buddhi Perera,Badulla,Badulla,Uva,4304,3120,7424,172160,124800,296960
3/22/2025,Buddhi Perera,Badulla,Badulla,Uva,548,601,1149,21920,24040,45960
3/23/2025,Buddhi Perera,Badulla,Badulla,Uva,7129,6170,13299,285160,246800,531960
3/25/2024,Chatura Perera,Moneragala,Siyambalanduwa,Uva,4974,1834,6808,198960,73360,272320
3/26/2024,Chatura Perera,Moneragala,Siyambalanduwa,Uva,8594,4378,12972,343760,175120,518880
3/27/2024,Chatura Perera,Moneragala,Siyambalanduwa,Uva,2350,5473,7823,94000,218920,312920
3/28/2024,Chatura Perera,Moneragala,Siyambalanduwa,Uva,265,3919,4184,10600,156760,167360
3/29/2024,Chatura Perera,Moneragala,Siyambalanduwa,Uva,7203,8454,15657,288120,338160,626280
3/30/2024,Chatura Perera,Moneragala,Siyambalanduwa,Uva,2505,5515,8020,100200,220600,320800
3/31/2024,Chatura Perera,Moneragala,Siyambalanduwa,Uva,3462,6425,9887,138480,257000,395480
4/1/2024,Chatura Perera,Moneragala,Siyambalanduwa,Uva,7189,8992,16181,287560,359680,647240
4/2/2024,Chatura Perera,Moneragala,Siyambalanduwa,Uva,1688,8655,10343,67520,346200,413720
4/3/2024,Chatura Perera,Moneragala,Siyambalanduwa,Uva,3839,9764,13603,153560,390560,544120
4/4/2024,Chatura Perera,Moneragala,Siyambalanduwa,Uva,6446,3814,10260,257840,152560,410400
4/5/2024,Chatura Perera,Moneragala,Siyambalanduwa,Uva,4477,6910,11387,179080,276400,455480
4/6/2024,Chatura Perera,Moneragala,Siyambalanduwa,Uva,9551,8803,18354,382040,352120,734160
4/7/2024,Chatura Perera,Moneragala,Siyambalanduwa,Uva,190,2424,2614,7600,96960,104560
4/8/2024,Chatura Perera,Moneragala,Siyambalanduwa,Uva,9374,3879,13253,374960,155160,530120
4/9/2024,Chatura Perera,Moneragala,Siyambalanduwa,Uva,7508,9760,17268,300320,390400,690720
4/10/2024,Chatura Perera,Moneragala,Siyambalanduwa,Uva,2100,4076,6176,84000,163040,247040
4/11/2024,Chatura Perera,Moneragala,Siyambalanduwa,Uva,1217,4522,5739,48680,180880,229560
4/19/2024,Chatura Perera,Moneragala,Siyambalanduwa,Uva,7998,7099,15097,319920,283960,603880
4/20/2024,Chatura Perera,Moneragala,Siyambalanduwa,Uva,1608,6489,8097,64320,259560,323880
4/21/2024,Chatura Perera,Moneragala,Siyambalanduwa,Uva,7450,8554,16004,298000,342160,640160
4/22/2024,Chatura Perera,Moneragala,Siyambalanduwa,Uva,3205,6173,9378,128200,246920,375120
4/23/2024,Chatura Perera,Moneragala,Siyambalanduwa,Uva,3248,1262,4510,129920,50480,180400
4/24/2024,Chatura Perera,Moneragala,Siyambalanduwa,Uva,9011,7366,16377,360440,294640,655080
4/25/2024,Chatura Perera,Moneragala,Siyambalanduwa,Uva,2187,9957,12144,87480,398280,485760
4/26/2024,Chatura Perera,Moneragala,Siyambalanduwa,Uva,7399,8047,15446,295960,321880,617840
4/27/2024,Chatura Perera,Moneragala,Siyambalanduwa,Uva,3330,8748,12078,133200,349920,483120
4/28/2024,Chatura Perera,Moneragala,Siyambalanduwa,Uva,8525,7802,16327,341000,312080,653080
4/29/2024,Chatura Perera,Moneragala,Siyambalanduwa,Uva,5885,9882,15767,235400,395280,630680
4/30/2024,Chatura Perera,Moneragala,Siyambalanduwa,Uva,4855,9113,13968,194200,364520,558720
5/1/2024,Chatura Perera,Moneragala,Siyambalanduwa,Uva,2072,7668,9740,82880,306720,389600
5/2/2024,Chatura Perera,Moneragala,Siyambalanduwa,Uva,9458,6112,15570,378320,244480,622800
5/3/2024,Chatura Perera,Moneragala,Siyambalanduwa,Uva,9954,4757,14711,398160,190280,588440
5/4/2024,Chatura Perera,Moneragala,Siyambalanduwa,Uva,1613,6612,8225,64520,264480,329000
5/5/2024,Chatura Perera,Moneragala,Siyambalanduwa,Uva,311,2577,2888,12440,103080,115520
5/6/2024,Chatura Perera,Moneragala,Siyambalanduwa,Uva,8173,1253,9426,326920,50120,377040
5/7/2024,Chatura Perera,Moneragala,Siyambalanduwa,Uva,3531,4890,8421,141240,195600,336840
5/8/2024,Chatura Perera,Moneragala,Siyambalanduwa,Uva,626,12,638,25040,480,25520
5/9/2024,Chatura Perera,Moneragala,Siyambalanduwa,Uva,3237,5927,9164,129480,237080,366560
5/10/2024,Chatura Perera,Moneragala,Siyambalanduwa,Uva,6935,6049,12984,277400,241960,519360
5/11/2024,Chatura Perera,Moneragala,Siyambalanduwa,Uva,170,751,921,6800,30040,36840
5/12/2024,Chatura Perera,Moneragala,Siyambalanduwa,Uva,426,4661,5087,17040,186440,203480
5/13/2024,Chatura Perera,Moneragala,Siyambalanduwa,Uva,658,5237,5895,26320,209480,235800
5/14/2024,Chatura Perera,Moneragala,Siyambalanduwa,Uva,1982,9803,11785,79280,392120,471400
5/15/2024,Chatura Perera,Moneragala,Siyambalanduwa,Uva,1440,9704,11144,57600,388160,445760
5/16/2024,Chatura Perera,Moneragala,Siyambalanduwa,Uva,6149,9036,15185,245960,361440,607400
5/17/2024,Chatura Perera,Moneragala,Siyambalanduwa,Uva,8633,6888,15521,345320,275520,620840
5/18/2024,Chatura Perera,Moneragala,Siyambalanduwa,Uva,2815,7855,10670,112600,314200,426800
5/19/2024,Chatura Perera,Moneragala,Siyambalanduwa,Uva,7929,2238,10167,317160,89520,406680
5/20/2024,Chatura Perera,Moneragala,Siyambalanduwa,Uva,8360,1534,9894,334400,61360,395760
5/21/2024,Chatura Perera,Moneragala,Siyambalanduwa,Uva,2217,8325,10542,88680,333000,421680
5/22/2024,Chatura Perera,Moneragala,Siyambalanduwa,Uva,2026,193,2219,81040,7720,88760
5/24/2024,Chatura Perera,Moneragala,Siyambalanduwa,Uva,962,4596,5558,38480,183840,222320
5/25/2024,Chatura Perera,Moneragala,Siyambalanduwa,Uva,7189,2404,9593,287560,96160,383720
5/26/2024,Chatura Perera,Moneragala,Siyambalanduwa,Uva,6150,8314,14464,246000,332560,578560
5/27/2024,Chatura Perera,Moneragala,Siyambalanduwa,Uva,9286,9648,18934,371440,385920,757360
5/28/2024,Chatura Perera,Moneragala,Siyambalanduwa,Uva,9520,6336,15856,380800,253440,634240
5/29/2024,Chatura Perera,Moneragala,Siyambalanduwa,Uva,448,9393,9841,17920,375720,393640
5/30/2024,Chatura Perera,Moneragala,Siyambalanduwa,Uva,582,8625,9207,23280,345000,368280
5/31/2024,Chatura Perera,Moneragala,Siyambalanduwa,Uva,2913,7954,10867,116520,318160,434680
6/1/2024,Chatura Perera,Moneragala,Siyambalanduwa,Uva,7806,8541,16347,312240,341640,653880
6/2/2024,Chatura Perera,Moneragala,Siyambalanduwa,Uva,3171,3670,6841,126840,146800,273640
6/3/2024,Chatura Perera,Moneragala,Siyambalanduwa,Uva,5681,3457,9138,227240,138280,365520
6/4/2024,Chatura Perera,Moneragala,Siyambalanduwa,Uva,4559,7860,12419,182360,314400,496760
6/5/2024,Chatura Perera,Moneragala,Siyambalanduwa,Uva,9207,37,9244,368280,1480,369760
6/6/2024,Chatura Perera,Moneragala,Siyambalanduwa,Uva,8732,1356,10088,349280,54240,403520
6/7/2024,Chatura Perera,Moneragala,Siyambalanduwa,Uva,4659,4246,8905,186360,169840,356200
6/8/2024,Chatura Perera,Moneragala,Siyambalanduwa,Uva,2389,2566,4955,95560,102640,198200
6/9/2024,Chatura Perera,Moneragala,Siyambalanduwa,Uva,735,6732,7467,29400,269280,298680
6/10/2024,Chatura Perera,Moneragala,Siyambalanduwa,Uva,1010,5152,6162,40400,206080,246480
6/11/2024,Chatura Perera,Moneragala,Siyambalanduwa,Uva,2812,7884,10696,112480,315360,427840
6/12/2024,Chatura Perera,Moneragala,Siyambalanduwa,Uva,2290,1016,3306,91600,40640,132240
6/13/2024,Chatura Perera,Moneragala,Siyambalanduwa,Uva,8853,3807,12660,354120,152280,506400
6/14/2024,Chatura Perera,Moneragala,Siyambalanduwa,Uva,2307,3440,5747,92280,137600,229880
6/15/2024,Chatura Perera,Moneragala,Siyambalanduwa,Uva,559,585,1144,22360,23400,45760
6/16/2024,Chatura Perera,Moneragala,Siyambalanduwa,Uva,1123,9348,10471,44920,373920,418840
6/17/2024,Chatura Perera,Moneragala,Siyambalanduwa,Uva,567,795,1362,22680,31800,54480
6/18/2024,Chatura Perera,Moneragala,Siyambalanduwa,Uva,3587,3158,6745,143480,126320,269800
6/19/2024,Chatura Perera,Moneragala,Siyambalanduwa,Uva,9529,3627,13156,381160,145080,526240
6/20/2024,Chatura Perera,Moneragala,Siyambalanduwa,Uva,9079,5872,14951,363160,234880,598040
6/21/2024,Chatura Perera,Moneragala,Siyambalanduwa,Uva,7350,8573,15923,294000,342920,636920
6/22/2024,Chatura Perera,Moneragala,Siyambalanduwa,Uva,3927,6804,10731,157080,272160,429240
6/23/2024,Chatura Perera,Moneragala,Siyambalanduwa,Uva,6208,376,6584,248320,15040,263360
6/24/2024,Chatura Perera,Moneragala,Siyambalanduwa,Uva,8688,40,8728,347520,1600,349120
6/25/2024,Chatura Perera,Moneragala,Siyambalanduwa,Uva,3885,3516,7401,155400,140640,296040
6/26/2024,Chatura Perera,Moneragala,Siyambalanduwa,Uva,5901,6461,12362,236040,258440,494480
6/27/2024,Chatura Perera,Moneragala,Siyambalanduwa,Uva,5095,496,5591,203800,19840,223640
6/28/2024,Chatura Perera,Moneragala,Siyambalanduwa,Uva,9368,5316,14684,374720,212640,587360
6/29/2024,Chatura Perera,Moneragala,Siyambalanduwa,Uva,2756,7858,10614,110240,314320,424560
6/30/2024,Chatura Perera,Moneragala,Siyambalanduwa,Uva,7704,9314,17018,308160,372560,680720
7/1/2024,Chatura Perera,Moneragala,Siyambalanduwa,Uva,6431,8116,14547,257240,324640,581880
7/2/2024,Chatura Perera,Moneragala,Siyambalanduwa,Uva,3337,6604,9941,133480,264160,397640
7/3/2024,Chatura Perera,Moneragala,Siyambalanduwa,Uva,5302,1221,6523,212080,48840,260920
7/4/2024,Chatura Perera,Moneragala,Siyambalanduwa,Uva,2767,2981,5748,110680,119240,229920
7/5/2024,Chatura Perera,Moneragala,Siyambalanduwa,Uva,6741,7741,14482,269640,309640,579280
7/6/2024,Chatura Perera,Moneragala,Siyambalanduwa,Uva,2058,5432,7490,82320,217280,299600
7/7/2024,Chatura Perera,Moneragala,Siyambalanduwa,Uva,4172,9336,13508,166880,373440,540320
7/8/2024,Chatura Perera,Moneragala,Siyambalanduwa,Uva,2214,8425,10639,88560,337000,425560
7/9/2024,Chatura Perera,Moneragala,Siyambalanduwa,Uva,2636,7662,10298,105440,306480,411920
7/10/2024,Chatura Perera,Moneragala,Siyambalanduwa,Uva,9295,5123,14418,371800,204920,576720
7/11/2024,Chatura Perera,Moneragala,Siyambalanduwa,Uva,6553,2572,9125,262120,102880,365000
7/12/2024,Chatura Perera,Moneragala,Siyambalanduwa,Uva,7324,9492,16816,292960,379680,672640
7/13/2024,Chatura Perera,Moneragala,Siyambalanduwa,Uva,9248,7025,16273,369920,281000,650920
7/14/2024,Chatura Perera,Moneragala,Siyambalanduwa,Uva,3088,8761,11849,123520,350440,473960
7/15/2024,Chatura Perera,Moneragala,Siyambalanduwa,Uva,1288,6837,8125,51520,273480,325000
7/16/2024,Chatura Perera,Moneragala,Siyambalanduwa,Uva,6780,8586,15366,271200,343440,614640
7/17/2024,Chatura Perera,Moneragala,Siyambalanduwa,Uva,7440,1421,8861,297600,56840,354440
7/18/2024,Chatura Perera,Moneragala,Siyambalanduwa,Uva,4119,3336,7455,164760,133440,298200
7/19/2024,Chatura Perera,Moneragala,Siyambalanduwa,Uva,6167,5778,11945,246680,231120,477800
7/20/2024,Chatura Perera,Moneragala,Siyambalanduwa,Uva,2409,5146,7555,96360,205840,302200
7/21/2024,Chatura Perera,Moneragala,Siyambalanduwa,Uva,7540,5495,13035,301600,219800,521400
7/22/2024,Chatura Perera,Moneragala,Siyambalanduwa,Uva,7432,3724,11156,297280,148960,446240
7/23/2024,Chatura Perera,Moneragala,Siyambalanduwa,Uva,4497,2123,6620,179880,84920,264800
7/24/2024,Chatura Perera,Moneragala,Siyambalanduwa,Uva,3895,4785,8680,155800,191400,347200
7/25/2024,Chatura Perera,Moneragala,Siyambalanduwa,Uva,9512,2433,11945,380480,97320,477800
7/26/2024,Chatura Perera,Moneragala,Siyambalanduwa,Uva,5126,9909,15035,205040,396360,601400
7/27/2024,Chatura Perera,Moneragala,Siyambalanduwa,Uva,8075,4995,13070,323000,199800,522800
7/28/2024,Chatura Perera,Moneragala,Siyambalanduwa,Uva,5628,5012,10640,225120,200480,425600
7/29/2024,Chatura Perera,Moneragala,Siyambalanduwa,Uva,7319,6846,14165,292760,273840,566600
7/30/2024,Chatura Perera,Moneragala,Siyambalanduwa,Uva,6481,5271,11752,259240,210840,470080
7/31/2024,Chatura Perera,Moneragala,Siyambalanduwa,Uva,4231,8029,12260,169240,321160,490400
8/1/2024,Chatura Perera,Moneragala,Siyambalanduwa,Uva,2734,2033,4767,109360,81320,190680
8/2/2024,Chatura Perera,Moneragala,Siyambalanduwa,Uva,8694,8457,17151,347760,338280,686040
8/3/2024,Chatura Perera,Moneragala,Siyambalanduwa,Uva,6694,1856,8550,267760,74240,342000
8/4/2024,Chatura Perera,Moneragala,Siyambalanduwa,Uva,5196,4930,10126,207840,197200,405040
8/5/2024,Chatura Perera,Moneragala,Siyambalanduwa,Uva,2506,6202,8708,100240,248080,348320
8/6/2024,Chatura Perera,Moneragala,Siyambalanduwa,Uva,4314,4868,9182,172560,194720,367280
8/7/2024,Chatura Perera,Moneragala,Siyambalanduwa,Uva,6248,7421,13669,249920,296840,546760
8/8/2024,Chatura Perera,Moneragala,Siyambalanduwa,Uva,3652,8890,12542,146080,355600,501680
8/9/2024,Chatura Perera,Moneragala,Siyambalanduwa,Uva,8459,7707,16166,338360,308280,646640
8/10/2024,Chatura Perera,Moneragala,Siyambalanduwa,Uva,1852,8184,10036,74080,327360,401440
8/11/2024,Chatura Perera,Moneragala,Siyambalanduwa,Uva,7598,6317,13915,303920,252680,556600
8/12/2024,Chatura Perera,Moneragala,Siyambalanduwa,Uva,687,111,798,27480,4440,31920
8/13/2024,Chatura Perera,Moneragala,Siyambalanduwa,Uva,9682,2377,12059,387280,95080,482360
8/14/2024,Chatura Perera,Moneragala,Siyambalanduwa,Uva,3841,2920,6761,153640,116800,270440
8/15/2024,Chatura Perera,Moneragala,Siyambalanduwa,Uva,6766,2176,8942,270640,87040,357680
8/16/2024,Chatura Perera,Moneragala,Siyambalanduwa,Uva,2377,8968,11345,95080,358720,453800
8/17/2024,Chatura Perera,Moneragala,Siyambalanduwa,Uva,4107,6247,10354,164280,249880,414160
8/18/2024,Chatura Perera,Moneragala,Siyambalanduwa,Uva,8628,3516,12144,345120,140640,485760
8/19/2024,Chatura Perera,Moneragala,Siyambalanduwa,Uva,4129,6217,10346,165160,248680,413840
8/20/2024,Chatura Perera,Moneragala,Siyambalanduwa,Uva,5278,9795,15073,211120,391800,602920
8/21/2024,Chatura Perera,Moneragala,Siyambalanduwa,Uva,5651,3909,9560,226040,156360,382400
8/22/2024,Chatura Perera,Moneragala,Siyambalanduwa,Uva,3612,1971,5583,144480,78840,223320
8/23/2024,Chatura Perera,Moneragala,Siyambalanduwa,Uva,9724,9864,19588,388960,394560,783520
8/24/2024,Chatura Perera,Moneragala,Siyambalanduwa,Uva,8623,262,8885,344920,10480,355400
8/25/2024,Chatura Perera,Moneragala,Siyambalanduwa,Uva,8907,9872,18779,356280,394880,751160
8/26/2024,Chatura Perera,Moneragala,Siyambalanduwa,Uva,6753,945,7698,270120,37800,307920
8/27/2024,Chatura Perera,Moneragala,Siyambalanduwa,Uva,2974,9027,12001,118960,361080,480040
8/28/2024,Chatura Perera,Moneragala,Siyambalanduwa,Uva,8405,6570,14975,336200,262800,599000
8/29/2024,Chatura Perera,Moneragala,Siyambalanduwa,Uva,9726,4776,14502,389040,191040,580080
8/30/2024,Chatura Perera,Moneragala,Siyambalanduwa,Uva,3036,4359,7395,121440,174360,295800
8/31/2024,Chatura Perera,Moneragala,Siyambalanduwa,Uva,4883,1204,6087,195320,48160,243480
9/1/2024,Chatura Perera,Moneragala,Siyambalanduwa,Uva,3357,1331,4688,134280,53240,187520
9/2/2024,Chatura Perera,Moneragala,Siyambalanduwa,Uva,469,3852,4321,18760,154080,172840
9/3/2024,Chatura Perera,Moneragala,Siyambalanduwa,Uva,211,2418,2629,8440,96720,105160
9/4/2024,Chatura Perera,Moneragala,Siyambalanduwa,Uva,5137,9880,15017,205480,395200,600680
9/5/2024,Chatura Perera,Moneragala,Siyambalanduwa,Uva,7996,9559,17555,319840,382360,702200
9/6/2024,Chatura Perera,Moneragala,Siyambalanduwa,Uva,1166,8967,10133,46640,358680,405320
9/7/2024,Chatura Perera,Moneragala,Siyambalanduwa,Uva,5933,1257,7190,237320,50280,287600
9/8/2024,Chatura Perera,Moneragala,Siyambalanduwa,Uva,3749,22,3771,149960,880,150840
9/9/2024,Chatura Perera,Moneragala,Siyambalanduwa,Uva,3663,2558,6221,146520,102320,248840
9/10/2024,Chatura Perera,Moneragala,Siyambalanduwa,Uva,2024,7237,9261,80960,289480,370440
9/11/2024,Chatura Perera,Moneragala,Siyambalanduwa,Uva,282,3052,3334,11280,122080,133360
9/12/2024,Chatura Perera,Moneragala,Siyambalanduwa,Uva,5728,7021,12749,229120,280840,509960
9/13/2024,Chatura Perera,Moneragala,Siyambalanduwa,Uva,7888,1822,9710,315520,72880,388400
9/14/2024,Chatura Perera,Moneragala,Siyambalanduwa,Uva,5826,1213,7039,233040,48520,281560
9/15/2024,Chatura Perera,Moneragala,Siyambalanduwa,Uva,6158,140,6298,246320,5600,251920
9/16/2024,Chatura Perera,Moneragala,Siyambalanduwa,Uva,5035,6729,11764,201400,269160,470560
9/17/2024,Chatura Perera,Moneragala,Siyambalanduwa,Uva,3090,691,3781,123600,27640,151240
9/18/2024,Chatura Perera,Moneragala,Siyambalanduwa,Uva,7807,7490,15297,312280,299600,611880
9/19/2024,Chatura Perera,Moneragala,Siyambalanduwa,Uva,7907,483,8390,316280,19320,335600
9/20/2024,Chatura Perera,Moneragala,Siyambalanduwa,Uva,4,2876,2880,160,115040,115200
9/21/2024,Chatura Perera,Moneragala,Siyambalanduwa,Uva,6902,9963,16865,276080,398520,674600
9/22/2024,Chatura Perera,Moneragala,Siyambalanduwa,Uva,1322,2651,3973,52880,106040,158920
9/23/2024,Chatura Perera,Moneragala,Siyambalanduwa,Uva,7969,796,8765,318760,31840,350600
9/24/2024,Chatura Perera,Moneragala,Siyambalanduwa,Uva,6795,3991,10786,271800,159640,431440
9/25/2024,Chatura Perera,Moneragala,Siyambalanduwa,Uva,8785,1977,10762,351400,79080,430480
9/26/2024,Chatura Perera,Moneragala,Siyambalanduwa,Uva,7290,2011,9301,291600,80440,372040
9/27/2024,Chatura Perera,Moneragala,Siyambalanduwa,Uva,2269,4982,7251,90760,199280,290040
9/28/2024,Chatura Perera,Moneragala,Siyambalanduwa,Uva,3287,9355,12642,131480,374200,505680
9/29/2024,Chatura Perera,Moneragala,Siyambalanduwa,Uva,4295,1878,6173,171800,75120,246920
9/30/2024,Chatura Perera,Moneragala,Siyambalanduwa,Uva,8543,2216,10759,341720,88640,430360
10/1/2024,Chatura Perera,Moneragala,Siyambalanduwa,Uva,2133,5010,7143,85320,200400,285720
10/2/2024,Chatura Perera,Moneragala,Siyambalanduwa,Uva,7616,8528,16144,304640,341120,645760
10/3/2024,Chatura Perera,Moneragala,Siyambalanduwa,Uva,4190,3988,8178,167600,159520,327120
10/4/2024,Chatura Perera,Moneragala,Siyambalanduwa,Uva,3034,3484,6518,121360,139360,260720
10/5/2024,Chatura Perera,Moneragala,Siyambalanduwa,Uva,4858,5536,10394,194320,221440,415760
10/6/2024,Chatura Perera,Moneragala,Siyambalanduwa,Uva,7018,9905,16923,280720,396200,676920
10/7/2024,Chatura Perera,Moneragala,Siyambalanduwa,Uva,9218,8990,18208,368720,359600,728320
10/8/2024,Chatura Perera,Moneragala,Siyambalanduwa,Uva,3840,6378,10218,153600,255120,408720
10/9/2024,Chatura Perera,Moneragala,Siyambalanduwa,Uva,7384,6459,13843,295360,258360,553720
10/10/2024,Chatura Perera,Moneragala,Siyambalanduwa,Uva,5339,2881,8220,213560,115240,328800
10/11/2024,Chatura Perera,Moneragala,Siyambalanduwa,Uva,2524,494,3018,100960,19760,120720
10/12/2024,Chatura Perera,Moneragala,Siyambalanduwa,Uva,6337,1440,7777,253480,57600,311080
10/13/2024,Chatura Perera,Moneragala,Siyambalanduwa,Uva,9520,269,9789,380800,10760,391560
10/14/2024,Chatura Perera,Moneragala,Siyambalanduwa,Uva,4759,7547,12306,190360,301880,492240
10/15/2024,Chatura Perera,Moneragala,Siyambalanduwa,Uva,9765,7840,17605,390600,313600,704200
10/16/2024,Chatura Perera,Moneragala,Siyambalanduwa,Uva,2907,703,3610,116280,28120,144400
10/17/2024,Chatura Perera,Moneragala,Siyambalanduwa,Uva,933,2152,3085,37320,86080,123400
10/18/2024,Chatura Perera,Moneragala,Siyambalanduwa,Uva,6876,3889,10765,275040,155560,430600
10/19/2024,Chatura Perera,Moneragala,Siyambalanduwa,Uva,778,6339,7117,31120,253560,284680
10/20/2024,Chatura Perera,Moneragala,Siyambalanduwa,Uva,7581,41,7622,303240,1640,304880
10/21/2024,Chatura Perera,Moneragala,Siyambalanduwa,Uva,9384,1841,11225,375360,73640,449000
10/22/2024,Chatura Perera,Moneragala,Siyambalanduwa,Uva,4371,2434,6805,174840,97360,272200
10/23/2024,Chatura Perera,Moneragala,Siyambalanduwa,Uva,4489,8947,13436,179560,357880,537440
10/24/2024,Chatura Perera,Moneragala,Siyambalanduwa,Uva,3309,5004,8313,132360,200160,332520
10/25/2024,Chatura Perera,Moneragala,Siyambalanduwa,Uva,1086,7906,8992,43440,316240,359680
10/26/2024,Chatura Perera,Moneragala,Siyambalanduwa,Uva,3133,8213,11346,125320,328520,453840
10/27/2024,Chatura Perera,Moneragala,Siyambalanduwa,Uva,2674,3234,5908,106960,129360,236320
10/28/2024,Chatura Perera,Moneragala,Siyambalanduwa,Uva,3503,8148,11651,140120,325920,466040
10/29/2024,Chatura Perera,Moneragala,Siyambalanduwa,Uva,9257,870,10127,370280,34800,405080
10/30/2024,Chatura Perera,Moneragala,Siyambalanduwa,Uva,7627,5728,13355,305080,229120,534200
10/31/2024,Chatura Perera,Moneragala,Siyambalanduwa,Uva,2321,2707,5028,92840,108280,201120
11/1/2024,Chatura Perera,Moneragala,Siyambalanduwa,Uva,8147,5829,13976,325880,233160,559040
11/2/2024,Chatura Perera,Moneragala,Siyambalanduwa,Uva,9114,5995,15109,364560,239800,604360
11/3/2024,Chatura Perera,Moneragala,Siyambalanduwa,Uva,616,5044,5660,24640,201760,226400
11/4/2024,Chatura Perera,Moneragala,Siyambalanduwa,Uva,2569,4190,6759,102760,167600,270360
11/5/2024,Chatura Perera,Moneragala,Siyambalanduwa,Uva,4788,9940,14728,191520,397600,589120
11/6/2024,Chatura Perera,Moneragala,Siyambalanduwa,Uva,9595,4780,14375,383800,191200,575000
11/7/2024,Chatura Perera,Moneragala,Siyambalanduwa,Uva,1706,1622,3328,68240,64880,133120
11/8/2024,Chatura Perera,Moneragala,Siyambalanduwa,Uva,6364,143,6507,254560,5720,260280
11/9/2024,Chatura Perera,Moneragala,Siyambalanduwa,Uva,20,8083,8103,800,323320,324120
11/10/2024,Chatura Perera,Moneragala,Siyambalanduwa,Uva,4465,6668,11133,178600,266720,445320
11/11/2024,Chatura Perera,Moneragala,Siyambalanduwa,Uva,9396,3515,12911,375840,140600,516440
11/12/2024,Chatura Perera,Moneragala,Siyambalanduwa,Uva,9608,7233,16841,384320,289320,673640
11/13/2024,Chatura Perera,Moneragala,Siyambalanduwa,Uva,2568,1224,3792,102720,48960,151680
11/14/2024,Chatura Perera,Moneragala,Siyambalanduwa,Uva,8176,8383,16559,327040,335320,662360
11/15/2024,Chatura Perera,Moneragala,Siyambalanduwa,Uva,2267,7689,9956,90680,307560,398240
11/16/2024,Chatura Perera,Moneragala,Siyambalanduwa,Uva,2796,9760,12556,111840,390400,502240
11/17/2024,Chatura Perera,Moneragala,Siyambalanduwa,Uva,1090,379,1469,43600,15160,58760
11/18/2024,Chatura Perera,Moneragala,Siyambalanduwa,Uva,9328,86,9414,373120,3440,376560
11/19/2024,Chatura Perera,Moneragala,Siyambalanduwa,Uva,5285,2432,7717,211400,97280,308680
11/20/2024,Chatura Perera,Moneragala,Siyambalanduwa,Uva,1763,7606,9369,70520,304240,374760
11/21/2024,Chatura Perera,Moneragala,Siyambalanduwa,Uva,6229,4607,10836,249160,184280,433440
11/22/2024,Chatura Perera,Moneragala,Siyambalanduwa,Uva,1937,7727,9664,77480,309080,386560
11/23/2024,Chatura Perera,Moneragala,Siyambalanduwa,Uva,2121,2220,4341,84840,88800,173640
11/24/2024,Chatura Perera,Moneragala,Siyambalanduwa,Uva,108,7178,7286,4320,287120,291440
11/25/2024,Chatura Perera,Moneragala,Siyambalanduwa,Uva,5804,8563,14367,232160,342520,574680
11/26/2024,Chatura Perera,Moneragala,Siyambalanduwa,Uva,6099,1394,7493,243960,55760,299720
11/27/2024,Chatura Perera,Moneragala,Siyambalanduwa,Uva,8271,4528,12799,330840,181120,511960
11/28/2024,Chatura Perera,Moneragala,Siyambalanduwa,Uva,1657,5580,7237,66280,223200,289480
11/29/2024,Chatura Perera,Moneragala,Siyambalanduwa,Uva,2244,9849,12093,89760,393960,483720
11/30/2024,Chatura Perera,Moneragala,Siyambalanduwa,Uva,8942,2762,11704,357680,110480,468160
12/1/2024,Chatura Perera,Moneragala,Siyambalanduwa,Uva,3356,1752,5108,134240,70080,204320
12/2/2024,Chatura Perera,Moneragala,Siyambalanduwa,Uva,6107,8248,14355,244280,329920,574200
12/3/2024,Chatura Perera,Moneragala,Siyambalanduwa,Uva,2565,2819,5384,102600,112760,215360
12/4/2024,Chatura Perera,Moneragala,Siyambalanduwa,Uva,8253,6319,14572,330120,252760,582880
12/5/2024,Chatura Perera,Moneragala,Siyambalanduwa,Uva,222,6765,6987,8880,270600,279480
12/6/2024,Chatura Perera,Moneragala,Siyambalanduwa,Uva,2766,1012,3778,110640,40480,151120
12/7/2024,Chatura Perera,Moneragala,Siyambalanduwa,Uva,9265,238,9503,370600,9520,380120
12/8/2024,Chatura Perera,Moneragala,Siyambalanduwa,Uva,6544,8655,15199,261760,346200,607960
12/9/2024,Chatura Perera,Moneragala,Siyambalanduwa,Uva,9951,9302,19253,398040,372080,770120
12/10/2024,Chatura Perera,Moneragala,Siyambalanduwa,Uva,7173,2780,9953,286920,111200,398120
12/11/2024,Chatura Perera,Moneragala,Siyambalanduwa,Uva,848,5170,6018,33920,206800,240720
12/12/2024,Chatura Perera,Moneragala,Siyambalanduwa,Uva,3176,7365,10541,127040,294600,421640
12/13/2024,Chatura Perera,Moneragala,Siyambalanduwa,Uva,7734,6848,14582,309360,273920,583280
12/14/2024,Chatura Perera,Moneragala,Siyambalanduwa,Uva,9767,9438,19205,390680,377520,768200
12/15/2024,Chatura Perera,Moneragala,Siyambalanduwa,Uva,4609,1610,6219,184360,64400,248760
12/16/2024,Chatura Perera,Moneragala,Siyambalanduwa,Uva,5475,8953,14428,219000,358120,577120
12/17/2024,Chatura Perera,Moneragala,Siyambalanduwa,Uva,3089,6426,9515,123560,257040,380600
12/18/2024,Chatura Perera,Moneragala,Siyambalanduwa,Uva,975,6084,7059,39000,243360,282360
12/19/2024,Chatura Perera,Moneragala,Siyambalanduwa,Uva,1537,2955,4492,61480,118200,179680
12/20/2024,Chatura Perera,Moneragala,Siyambalanduwa,Uva,4706,9082,13788,188240,363280,551520
12/21/2024,Chatura Perera,Moneragala,Siyambalanduwa,Uva,3499,1987,5486,139960,79480,219440
12/22/2024,Chatura Perera,Moneragala,Siyambalanduwa,Uva,1984,38,2022,79360,1520,80880
12/23/2024,Chatura Perera,Moneragala,Siyambalanduwa,Uva,8505,949,9454,340200,37960,378160
12/24/2024,Chatura Perera,Moneragala,Siyambalanduwa,Uva,2227,3655,5882,89080,146200,235280
12/25/2024,Chatura Perera,Moneragala,Siyambalanduwa,Uva,891,6108,6999,35640,244320,279960
12/26/2024,Chatura Perera,Moneragala,Siyambalanduwa,Uva,7363,2512,9875,294520,100480,395000
12/27/2024,Chatura Perera,Moneragala,Siyambalanduwa,Uva,5731,798,6529,229240,31920,261160
12/28/2024,Chatura Perera,Moneragala,Siyambalanduwa,Uva,2407,1405,3812,96280,56200,152480
12/29/2024,Chatura Perera,Moneragala,Siyambalanduwa,Uva,7323,7334,14657,292920,293360,586280
12/30/2024,Chatura Perera,Moneragala,Siyambalanduwa,Uva,5077,2048,7125,203080,81920,285000
12/31/2024,Chatura Perera,Moneragala,Siyambalanduwa,Uva,1325,7625,8950,53000,305000,358000
1/1/2025,Chatura Perera,Moneragala,Siyambalanduwa,Uva,1298,6860,8158,51920,274400,326320
1/2/2025,Chatura Perera,Moneragala,Siyambalanduwa,Uva,6230,3054,9284,249200,122160,371360
1/3/2025,Chatura Perera,Moneragala,Siyambalanduwa,Uva,4399,8331,12730,175960,333240,509200
1/4/2025,Chatura Perera,Moneragala,Siyambalanduwa,Uva,4663,9788,14451,186520,391520,578040
1/5/2025,Chatura Perera,Moneragala,Siyambalanduwa,Uva,6632,9587,16219,265280,383480,648760
1/6/2025,Chatura Perera,Moneragala,Siyambalanduwa,Uva,4983,3548,8531,199320,141920,341240
1/7/2025,Chatura Perera,Moneragala,Siyambalanduwa,Uva,7449,8800,16249,297960,352000,649960
1/8/2025,Chatura Perera,Moneragala,Siyambalanduwa,Uva,1972,5109,7081,78880,204360,283240
1/9/2025,Chatura Perera,Moneragala,Siyambalanduwa,Uva,5157,8664,13821,206280,346560,552840
1/10/2025,Chatura Perera,Moneragala,Siyambalanduwa,Uva,9837,9288,19125,393480,371520,765000
1/11/2025,Chatura Perera,Moneragala,Siyambalanduwa,Uva,732,870,1602,29280,34800,64080
1/12/2025,Chatura Perera,Moneragala,Siyambalanduwa,Uva,8253,469,8722,330120,18760,348880
1/13/2025,Chatura Perera,Moneragala,Siyambalanduwa,Uva,7923,5239,13162,316920,209560,526480
1/14/2025,Chatura Perera,Moneragala,Siyambalanduwa,Uva,4971,1573,6544,198840,62920,261760
1/15/2025,Chatura Perera,Moneragala,Siyambalanduwa,Uva,9179,8764,17943,367160,350560,717720
1/16/2025,Chatura Perera,Moneragala,Siyambalanduwa,Uva,2948,3549,6497,117920,141960,259880
1/17/2025,Chatura Perera,Moneragala,Siyambalanduwa,Uva,796,7003,7799,31840,280120,311960
1/18/2025,Chatura Perera,Moneragala,Siyambalanduwa,Uva,3630,9193,12823,145200,367720,512920
1/19/2025,Chatura Perera,Moneragala,Siyambalanduwa,Uva,9822,2788,12610,392880,111520,504400
1/20/2025,Chatura Perera,Moneragala,Siyambalanduwa,Uva,956,2179,3135,38240,87160,125400
1/21/2025,Chatura Perera,Moneragala,Siyambalanduwa,Uva,1096,4702,5798,43840,188080,231920
1/22/2025,Chatura Perera,Moneragala,Siyambalanduwa,Uva,8792,8389,17181,351680,335560,687240
1/23/2025,Chatura Perera,Moneragala,Siyambalanduwa,Uva,735,5055,5790,29400,202200,231600
1/24/2025,Chatura Perera,Moneragala,Siyambalanduwa,Uva,3248,9528,12776,129920,381120,511040
1/25/2025,Chatura Perera,Moneragala,Siyambalanduwa,Uva,3478,2187,5665,139120,87480,226600
1/26/2025,Chatura Perera,Moneragala,Siyambalanduwa,Uva,212,2834,3046,8480,113360,121840
1/27/2025,Chatura Perera,Moneragala,Siyambalanduwa,Uva,6055,3869,9924,242200,154760,396960
1/28/2025,Chatura Perera,Moneragala,Siyambalanduwa,Uva,8469,875,9344,338760,35000,373760
1/29/2025,Chatura Perera,Moneragala,Siyambalanduwa,Uva,3728,1159,4887,149120,46360,195480
1/30/2025,Chatura Perera,Moneragala,Siyambalanduwa,Uva,1609,3611,5220,64360,144440,208800
1/31/2025,Chatura Perera,Moneragala,Siyambalanduwa,Uva,718,9301,10019,28720,372040,400760
2/1/2025,Chatura Perera,Moneragala,Siyambalanduwa,Uva,9690,9928,19618,387600,397120,784720
2/2/2025,Chatura Perera,Moneragala,Siyambalanduwa,Uva,8346,6434,14780,333840,257360,591200
2/3/2025,Chatura Perera,Moneragala,Siyambalanduwa,Uva,6529,4916,11445,261160,196640,457800
2/4/2025,Chatura Perera,Moneragala,Siyambalanduwa,Uva,1703,1523,3226,68120,60920,129040
2/5/2025,Chatura Perera,Moneragala,Siyambalanduwa,Uva,4510,8541,13051,180400,341640,522040
2/6/2025,Chatura Perera,Moneragala,Siyambalanduwa,Uva,837,3705,4542,33480,148200,181680
2/7/2025,Chatura Perera,Moneragala,Siyambalanduwa,Uva,4649,1873,6522,185960,74920,260880
2/8/2025,Chatura Perera,Moneragala,Siyambalanduwa,Uva,1133,4625,5758,45320,185000,230320
2/9/2025,Chatura Perera,Moneragala,Siyambalanduwa,Uva,9036,2879,11915,361440,115160,476600
2/10/2025,Chatura Perera,Moneragala,Siyambalanduwa,Uva,9797,9525,19322,391880,381000,772880
2/11/2025,Chatura Perera,Moneragala,Siyambalanduwa,Uva,1159,9383,10542,46360,375320,421680
2/12/2025,Chatura Perera,Moneragala,Siyambalanduwa,Uva,4440,883,5323,177600,35320,212920
2/13/2025,Chatura Perera,Moneragala,Siyambalanduwa,Uva,7726,3969,11695,309040,158760,467800
2/14/2025,Chatura Perera,Moneragala,Siyambalanduwa,Uva,8698,5884,14582,347920,235360,583280
2/15/2025,Chatura Perera,Moneragala,Siyambalanduwa,Uva,9082,9187,18269,363280,367480,730760
2/16/2025,Chatura Perera,Moneragala,Siyambalanduwa,Uva,4714,6971,11685,188560,278840,467400
2/17/2025,Chatura Perera,Moneragala,Siyambalanduwa,Uva,3108,2624,5732,124320,104960,229280
2/18/2025,Chatura Perera,Moneragala,Siyambalanduwa,Uva,7212,9653,16865,288480,386120,674600
2/19/2025,Chatura Perera,Moneragala,Siyambalanduwa,Uva,8692,5084,13776,347680,203360,551040
2/20/2025,Chatura Perera,Moneragala,Siyambalanduwa,Uva,6307,9649,15956,252280,385960,638240
2/21/2025,Chatura Perera,Moneragala,Siyambalanduwa,Uva,7638,6578,14216,305520,263120,568640
2/22/2025,Chatura Perera,Moneragala,Siyambalanduwa,Uva,13,786,799,520,31440,31960
2/23/2025,Chatura Perera,Moneragala,Siyambalanduwa,Uva,6759,8431,15190,270360,337240,607600
2/24/2025,Chatura Perera,Moneragala,Siyambalanduwa,Uva,4034,4117,8151,161360,164680,326040
2/25/2025,Chatura Perera,Moneragala,Siyambalanduwa,Uva,267,4018,4285,10680,160720,171400
2/26/2025,Chatura Perera,Moneragala,Siyambalanduwa,Uva,7679,2956,10635,307160,118240,425400
2/27/2025,Chatura Perera,Moneragala,Siyambalanduwa,Uva,1501,1900,3401,60040,76000,136040
2/28/2025,Chatura Perera,Moneragala,Siyambalanduwa,Uva,5292,1840,7132,211680,73600,285280
3/1/2025,Chatura Perera,Moneragala,Siyambalanduwa,Uva,8179,7307,15486,327160,292280,619440
3/2/2025,Chatura Perera,Moneragala,Siyambalanduwa,Uva,1426,3182,4608,57040,127280,184320
3/3/2025,Chatura Perera,Moneragala,Siyambalanduwa,Uva,534,8105,8639,21360,324200,345560
3/4/2025,Chatura Perera,Moneragala,Siyambalanduwa,Uva,2950,6060,9010,118000,242400,360400
3/5/2025,Chatura Perera,Moneragala,Siyambalanduwa,Uva,8679,6324,15003,347160,252960,600120
3/6/2025,Chatura Perera,Moneragala,Siyambalanduwa,Uva,99,803,902,3960,32120,36080
3/7/2025,Chatura Perera,Moneragala,Siyambalanduwa,Uva,2017,9194,11211,80680,367760,448440
3/8/2025,Chatura Perera,Moneragala,Siyambalanduwa,Uva,736,7381,8117,29440,295240,324680
3/9/2025,Chatura Perera,Moneragala,Siyambalanduwa,Uva,9473,7233,16706,378920,289320,668240
3/10/2025,Chatura Perera,Moneragala,Siyambalanduwa,Uva,2463,8398,10861,98520,335920,434440
3/11/2025,Chatura Perera,Moneragala,Siyambalanduwa,Uva,6153,6532,12685,246120,261280,507400
3/12/2025,Chatura Perera,Moneragala,Siyambalanduwa,Uva,1403,6131,7534,56120,245240,301360
3/13/2025,Chatura Perera,Moneragala,Siyambalanduwa,Uva,7093,404,7497,283720,16160,299880
3/14/2025,Chatura Perera,Moneragala,Siyambalanduwa,Uva,5914,5250,11164,236560,210000,446560
3/15/2025,Chatura Perera,Moneragala,Siyambalanduwa,Uva,1526,39,1565,61040,1560,62600
3/16/2025,Chatura Perera,Moneragala,Siyambalanduwa,Uva,8574,7721,16295,342960,308840,651800
3/17/2025,Chatura Perera,Moneragala,Siyambalanduwa,Uva,1117,9131,10248,44680,365240,409920
3/18/2025,Chatura Perera,Moneragala,Siyambalanduwa,Uva,8918,3644,12562,356720,145760,502480
3/19/2025,Chatura Perera,Moneragala,Siyambalanduwa,Uva,9998,7663,17661,399920,306520,706440
3/20/2025,Chatura Perera,Moneragala,Siyambalanduwa,Uva,6470,5732,12202,258800,229280,488080
3/21/2025,Chatura Perera,Moneragala,Siyambalanduwa,Uva,906,3747,4653,36240,149880,186120
3/22/2025,Chatura Perera,Moneragala,Siyambalanduwa,Uva,76,9204,9280,3040,368160,371200
3/23/2025,Chatura Perera,Moneragala,Siyambalanduwa,Uva,8397,2382,10779,335880,95280,431160
3/25/2024,Mihira Fernando,Badulla,Dambatenne,Uva,3555,3025,6580,142200,121000,263200
3/26/2024,Mihira Fernando,Badulla,Dambatenne,Uva,4404,6869,11273,176160,274760,450920
3/27/2024,Mihira Fernando,Badulla,Dambatenne,Uva,5083,8092,13175,203320,323680,527000
3/28/2024,Mihira Fernando,Badulla,Dambatenne,Uva,8349,2677,11026,333960,107080,441040
3/29/2024,Mihira Fernando,Badulla,Dambatenne,Uva,8661,4701,13362,346440,188040,534480
3/30/2024,Mihira Fernando,Badulla,Dambatenne,Uva,924,939,1863,36960,37560,74520
3/31/2024,Mihira Fernando,Badulla,Dambatenne,Uva,8193,1008,9201,327720,40320,368040
4/1/2024,Mihira Fernando,Badulla,Dambatenne,Uva,5200,6147,11347,208000,245880,453880
4/2/2024,Mihira Fernando,Badulla,Dambatenne,Uva,9810,5311,15121,392400,212440,604840
4/3/2024,Mihira Fernando,Badulla,Dambatenne,Uva,5886,1046,6932,235440,41840,277280
4/4/2024,Mihira Fernando,Badulla,Dambatenne,Uva,7318,370,7688,292720,14800,307520
4/5/2024,Mihira Fernando,Badulla,Dambatenne,Uva,6055,7200,13255,242200,288000,530200
4/6/2024,Mihira Fernando,Badulla,Dambatenne,Uva,9490,8544,18034,379600,341760,721360
4/7/2024,Mihira Fernando,Badulla,Dambatenne,Uva,6981,8571,15552,279240,342840,622080
4/8/2024,Mihira Fernando,Badulla,Dambatenne,Uva,1957,8724,10681,78280,348960,427240
4/9/2024,Mihira Fernando,Badulla,Dambatenne,Uva,3360,2404,5764,134400,96160,230560
4/10/2024,Mihira Fernando,Badulla,Dambatenne,Uva,4148,103,4251,165920,4120,170040
4/11/2024,Mihira Fernando,Badulla,Dambatenne,Uva,6072,757,6829,242880,30280,273160
4/19/2024,Mihira Fernando,Badulla,Dambatenne,Uva,7457,8188,15645,298280,327520,625800
4/20/2024,Mihira Fernando,Badulla,Dambatenne,Uva,6062,6973,13035,242480,278920,521400
4/21/2024,Mihira Fernando,Badulla,Dambatenne,Uva,2129,9204,11333,85160,368160,453320
4/22/2024,Mihira Fernando,Badulla,Dambatenne,Uva,8672,8849,17521,346880,353960,700840
4/23/2024,Mihira Fernando,Badulla,Dambatenne,Uva,5512,5996,11508,220480,239840,460320
4/24/2024,Mihira Fernando,Badulla,Dambatenne,Uva,4213,9644,13857,168520,385760,554280
4/25/2024,Mihira Fernando,Badulla,Dambatenne,Uva,5371,5635,11006,214840,225400,440240
4/26/2024,Mihira Fernando,Badulla,Dambatenne,Uva,431,4705,5136,17240,188200,205440
4/27/2024,Mihira Fernando,Badulla,Dambatenne,Uva,5281,233,5514,211240,9320,220560
4/28/2024,Mihira Fernando,Badulla,Dambatenne,Uva,1311,163,1474,52440,6520,58960
4/29/2024,Mihira Fernando,Badulla,Dambatenne,Uva,9069,932,10001,362760,37280,400040
4/30/2024,Mihira Fernando,Badulla,Dambatenne,Uva,1050,3053,4103,42000,122120,164120
5/1/2024,Mihira Fernando,Badulla,Dambatenne,Uva,4076,4071,8147,163040,162840,325880
5/2/2024,Mihira Fernando,Badulla,Dambatenne,Uva,6243,1466,7709,249720,58640,308360
5/3/2024,Mihira Fernando,Badulla,Dambatenne,Uva,3740,5334,9074,149600,213360,362960
5/4/2024,Mihira Fernando,Badulla,Dambatenne,Uva,6696,6398,13094,267840,255920,523760
5/5/2024,Mihira Fernando,Badulla,Dambatenne,Uva,5979,5788,11767,239160,231520,470680
5/6/2024,Mihira Fernando,Badulla,Dambatenne,Uva,744,8244,8988,29760,329760,359520
5/7/2024,Mihira Fernando,Badulla,Dambatenne,Uva,65,1496,1561,2600,59840,62440
5/8/2024,Mihira Fernando,Badulla,Dambatenne,Uva,5428,3500,8928,217120,140000,357120
5/9/2024,Mihira Fernando,Badulla,Dambatenne,Uva,7799,6308,14107,311960,252320,564280
5/10/2024,Mihira Fernando,Badulla,Dambatenne,Uva,3408,6107,9515,136320,244280,380600
5/11/2024,Mihira Fernando,Badulla,Dambatenne,Uva,8327,9038,17365,333080,361520,694600
5/12/2024,Mihira Fernando,Badulla,Dambatenne,Uva,1434,5702,7136,57360,228080,285440
5/13/2024,Mihira Fernando,Badulla,Dambatenne,Uva,4641,8261,12902,185640,330440,516080
5/14/2024,Mihira Fernando,Badulla,Dambatenne,Uva,2648,4386,7034,105920,175440,281360
5/15/2024,Mihira Fernando,Badulla,Dambatenne,Uva,1743,4721,6464,69720,188840,258560
5/16/2024,Mihira Fernando,Badulla,Dambatenne,Uva,6108,9053,15161,244320,362120,606440
5/17/2024,Mihira Fernando,Badulla,Dambatenne,Uva,7012,6997,14009,280480,279880,560360
5/18/2024,Mihira Fernando,Badulla,Dambatenne,Uva,3200,151,3351,128000,6040,134040
5/19/2024,Mihira Fernando,Badulla,Dambatenne,Uva,4619,8358,12977,184760,334320,519080
5/20/2024,Mihira Fernando,Badulla,Dambatenne,Uva,2875,7415,10290,115000,296600,411600
5/21/2024,Mihira Fernando,Badulla,Dambatenne,Uva,6525,3243,9768,261000,129720,390720
5/22/2024,Mihira Fernando,Badulla,Dambatenne,Uva,6422,7455,13877,256880,298200,555080
5/24/2024,Mihira Fernando,Badulla,Dambatenne,Uva,9851,6657,16508,394040,266280,660320
5/25/2024,Mihira Fernando,Badulla,Dambatenne,Uva,6159,4410,10569,246360,176400,422760
5/26/2024,Mihira Fernando,Badulla,Dambatenne,Uva,9382,1838,11220,375280,73520,448800
5/27/2024,Mihira Fernando,Badulla,Dambatenne,Uva,440,6784,7224,17600,271360,288960
5/28/2024,Mihira Fernando,Badulla,Dambatenne,Uva,5888,5438,11326,235520,217520,453040
5/29/2024,Mihira Fernando,Badulla,Dambatenne,Uva,5212,202,5414,208480,8080,216560
5/30/2024,Mihira Fernando,Badulla,Dambatenne,Uva,1240,5296,6536,49600,211840,261440
5/31/2024,Mihira Fernando,Badulla,Dambatenne,Uva,3078,5884,8962,123120,235360,358480
6/1/2024,Mihira Fernando,Badulla,Dambatenne,Uva,649,6505,7154,25960,260200,286160
6/2/2024,Mihira Fernando,Badulla,Dambatenne,Uva,6292,8406,14698,251680,336240,587920
6/3/2024,Mihira Fernando,Badulla,Dambatenne,Uva,6142,583,6725,245680,23320,269000
6/4/2024,Mihira Fernando,Badulla,Dambatenne,Uva,3025,9007,12032,121000,360280,481280
6/5/2024,Mihira Fernando,Badulla,Dambatenne,Uva,3578,1001,4579,143120,40040,183160
6/6/2024,Mihira Fernando,Badulla,Dambatenne,Uva,8062,7420,15482,322480,296800,619280
6/7/2024,Mihira Fernando,Badulla,Dambatenne,Uva,7336,964,8300,293440,38560,332000
6/8/2024,Mihira Fernando,Badulla,Dambatenne,Uva,7023,1728,8751,280920,69120,350040
6/9/2024,Mihira Fernando,Badulla,Dambatenne,Uva,8484,2974,11458,339360,118960,458320
6/10/2024,Mihira Fernando,Badulla,Dambatenne,Uva,9782,4950,14732,391280,198000,589280
6/11/2024,Mihira Fernando,Badulla,Dambatenne,Uva,7447,9861,17308,297880,394440,692320
6/12/2024,Mihira Fernando,Badulla,Dambatenne,Uva,16,2297,2313,640,91880,92520
6/13/2024,Mihira Fernando,Badulla,Dambatenne,Uva,8993,6342,15335,359720,253680,613400
6/14/2024,Mihira Fernando,Badulla,Dambatenne,Uva,3287,4169,7456,131480,166760,298240
6/15/2024,Mihira Fernando,Badulla,Dambatenne,Uva,3093,5524,8617,123720,220960,344680
6/16/2024,Mihira Fernando,Badulla,Dambatenne,Uva,9095,4649,13744,363800,185960,549760
6/17/2024,Mihira Fernando,Badulla,Dambatenne,Uva,242,2385,2627,9680,95400,105080
6/18/2024,Mihira Fernando,Badulla,Dambatenne,Uva,9985,1506,11491,399400,60240,459640
6/19/2024,Mihira Fernando,Badulla,Dambatenne,Uva,561,5210,5771,22440,208400,230840
6/20/2024,Mihira Fernando,Badulla,Dambatenne,Uva,2570,6555,9125,102800,262200,365000
6/21/2024,Mihira Fernando,Badulla,Dambatenne,Uva,1192,5528,6720,47680,221120,268800
6/22/2024,Mihira Fernando,Badulla,Dambatenne,Uva,3209,5540,8749,128360,221600,349960
6/23/2024,Mihira Fernando,Badulla,Dambatenne,Uva,4815,9751,14566,192600,390040,582640
6/24/2024,Mihira Fernando,Badulla,Dambatenne,Uva,5486,8688,14174,219440,347520,566960
6/25/2024,Mihira Fernando,Badulla,Dambatenne,Uva,3763,3093,6856,150520,123720,274240
6/26/2024,Mihira Fernando,Badulla,Dambatenne,Uva,2548,387,2935,101920,15480,117400
6/27/2024,Mihira Fernando,Badulla,Dambatenne,Uva,3463,1383,4846,138520,55320,193840
6/28/2024,Mihira Fernando,Badulla,Dambatenne,Uva,7626,5554,13180,305040,222160,527200
6/29/2024,Mihira Fernando,Badulla,Dambatenne,Uva,2430,3704,6134,97200,148160,245360
6/30/2024,Mihira Fernando,Badulla,Dambatenne,Uva,5597,4519,10116,223880,180760,404640
7/1/2024,Mihira Fernando,Badulla,Dambatenne,Uva,8757,4061,12818,350280,162440,512720
7/2/2024,Mihira Fernando,Badulla,Dambatenne,Uva,3351,8382,11733,134040,335280,469320
7/3/2024,Mihira Fernando,Badulla,Dambatenne,Uva,5085,3600,8685,203400,144000,347400
7/4/2024,Mihira Fernando,Badulla,Dambatenne,Uva,7629,2412,10041,305160,96480,401640
7/5/2024,Mihira Fernando,Badulla,Dambatenne,Uva,3818,3781,7599,152720,151240,303960
7/6/2024,Mihira Fernando,Badulla,Dambatenne,Uva,9887,9350,19237,395480,374000,769480
7/7/2024,Mihira Fernando,Badulla,Dambatenne,Uva,6303,2497,8800,252120,99880,352000
7/8/2024,Mihira Fernando,Badulla,Dambatenne,Uva,1217,2350,3567,48680,94000,142680
7/9/2024,Mihira Fernando,Badulla,Dambatenne,Uva,5124,2211,7335,204960,88440,293400
7/10/2024,Mihira Fernando,Badulla,Dambatenne,Uva,9528,805,10333,381120,32200,413320
7/11/2024,Mihira Fernando,Badulla,Dambatenne,Uva,2656,7338,9994,106240,293520,399760
7/12/2024,Mihira Fernando,Badulla,Dambatenne,Uva,7073,108,7181,282920,4320,287240
7/13/2024,Mihira Fernando,Badulla,Dambatenne,Uva,1255,3993,5248,50200,159720,209920
7/14/2024,Mihira Fernando,Badulla,Dambatenne,Uva,6170,9880,16050,246800,395200,642000
7/15/2024,Mihira Fernando,Badulla,Dambatenne,Uva,6921,160,7081,276840,6400,283240
7/16/2024,Mihira Fernando,Badulla,Dambatenne,Uva,5442,2032,7474,217680,81280,298960
7/17/2024,Mihira Fernando,Badulla,Dambatenne,Uva,6164,3222,9386,246560,128880,375440
7/18/2024,Mihira Fernando,Badulla,Dambatenne,Uva,5806,362,6168,232240,14480,246720
7/19/2024,Mihira Fernando,Badulla,Dambatenne,Uva,3426,820,4246,137040,32800,169840
7/20/2024,Mihira Fernando,Badulla,Dambatenne,Uva,2474,6481,8955,98960,259240,358200
7/21/2024,Mihira Fernando,Badulla,Dambatenne,Uva,819,1741,2560,32760,69640,102400
7/22/2024,Mihira Fernando,Badulla,Dambatenne,Uva,9192,8744,17936,367680,349760,717440
7/23/2024,Mihira Fernando,Badulla,Dambatenne,Uva,2901,5906,8807,116040,236240,352280
7/24/2024,Mihira Fernando,Badulla,Dambatenne,Uva,1246,5222,6468,49840,208880,258720
7/25/2024,Mihira Fernando,Badulla,Dambatenne,Uva,5292,7294,12586,211680,291760,503440
7/26/2024,Mihira Fernando,Badulla,Dambatenne,Uva,7953,8342,16295,318120,333680,651800
7/27/2024,Mihira Fernando,Badulla,Dambatenne,Uva,1700,4612,6312,68000,184480,252480
7/28/2024,Mihira Fernando,Badulla,Dambatenne,Uva,4878,6912,11790,195120,276480,471600
7/29/2024,Mihira Fernando,Badulla,Dambatenne,Uva,9671,2248,11919,386840,89920,476760
7/30/2024,Mihira Fernando,Badulla,Dambatenne,Uva,314,5266,5580,12560,210640,223200
7/31/2024,Mihira Fernando,Badulla,Dambatenne,Uva,33,6205,6238,1320,248200,249520
8/1/2024,Mihira Fernando,Badulla,Dambatenne,Uva,1045,7862,8907,41800,314480,356280
8/2/2024,Mihira Fernando,Badulla,Dambatenne,Uva,2243,2152,4395,89720,86080,175800
8/3/2024,Mihira Fernando,Badulla,Dambatenne,Uva,5394,4373,9767,215760,174920,390680
8/4/2024,Mihira Fernando,Badulla,Dambatenne,Uva,1889,423,2312,75560,16920,92480
8/5/2024,Mihira Fernando,Badulla,Dambatenne,Uva,521,3558,4079,20840,142320,163160
8/6/2024,Mihira Fernando,Badulla,Dambatenne,Uva,1295,6790,8085,51800,271600,323400
8/7/2024,Mihira Fernando,Badulla,Dambatenne,Uva,5763,5698,11461,230520,227920,458440
8/8/2024,Mihira Fernando,Badulla,Dambatenne,Uva,7947,7504,15451,317880,300160,618040
8/9/2024,Mihira Fernando,Badulla,Dambatenne,Uva,4037,3227,7264,161480,129080,290560
8/10/2024,Mihira Fernando,Badulla,Dambatenne,Uva,633,4271,4904,25320,170840,196160
8/11/2024,Mihira Fernando,Badulla,Dambatenne,Uva,4153,8705,12858,166120,348200,514320
8/12/2024,Mihira Fernando,Badulla,Dambatenne,Uva,2820,5283,8103,112800,211320,324120
8/13/2024,Mihira Fernando,Badulla,Dambatenne,Uva,3830,8272,12102,153200,330880,484080
8/14/2024,Mihira Fernando,Badulla,Dambatenne,Uva,4669,196,4865,186760,7840,194600
8/15/2024,Mihira Fernando,Badulla,Dambatenne,Uva,1241,7888,9129,49640,315520,365160
8/16/2024,Mihira Fernando,Badulla,Dambatenne,Uva,2346,7451,9797,93840,298040,391880
8/17/2024,Mihira Fernando,Badulla,Dambatenne,Uva,808,471,1279,32320,18840,51160
8/18/2024,Mihira Fernando,Badulla,Dambatenne,Uva,7574,7623,15197,302960,304920,607880
8/19/2024,Mihira Fernando,Badulla,Dambatenne,Uva,562,1268,1830,22480,50720,73200
8/20/2024,Mihira Fernando,Badulla,Dambatenne,Uva,209,2742,2951,8360,109680,118040
8/21/2024,Mihira Fernando,Badulla,Dambatenne,Uva,6365,4206,10571,254600,168240,422840
8/22/2024,Mihira Fernando,Badulla,Dambatenne,Uva,9447,9000,18447,377880,360000,737880
8/23/2024,Mihira Fernando,Badulla,Dambatenne,Uva,3489,9743,13232,139560,389720,529280
8/24/2024,Mihira Fernando,Badulla,Dambatenne,Uva,286,2037,2323,11440,81480,92920
8/25/2024,Mihira Fernando,Badulla,Dambatenne,Uva,6804,8310,15114,272160,332400,604560
8/26/2024,Mihira Fernando,Badulla,Dambatenne,Uva,3203,1380,4583,128120,55200,183320
8/27/2024,Mihira Fernando,Badulla,Dambatenne,Uva,3520,89,3609,140800,3560,144360
8/28/2024,Mihira Fernando,Badulla,Dambatenne,Uva,2401,5975,8376,96040,239000,335040
8/29/2024,Mihira Fernando,Badulla,Dambatenne,Uva,3782,8536,12318,151280,341440,492720
8/30/2024,Mihira Fernando,Badulla,Dambatenne,Uva,1454,9523,10977,58160,380920,439080
8/31/2024,Mihira Fernando,Badulla,Dambatenne,Uva,8468,6815,15283,338720,272600,611320
9/1/2024,Mihira Fernando,Badulla,Dambatenne,Uva,7213,1211,8424,288520,48440,336960
9/2/2024,Mihira Fernando,Badulla,Dambatenne,Uva,7142,4987,12129,285680,199480,485160
9/3/2024,Mihira Fernando,Badulla,Dambatenne,Uva,3568,3,3571,142720,120,142840
9/4/2024,Mihira Fernando,Badulla,Dambatenne,Uva,1763,3566,5329,70520,142640,213160
9/5/2024,Mihira Fernando,Badulla,Dambatenne,Uva,3488,8480,11968,139520,339200,478720
9/6/2024,Mihira Fernando,Badulla,Dambatenne,Uva,3138,8191,11329,125520,327640,453160
9/7/2024,Mihira Fernando,Badulla,Dambatenne,Uva,8982,9940,18922,359280,397600,756880
9/8/2024,Mihira Fernando,Badulla,Dambatenne,Uva,1819,8786,10605,72760,351440,424200
9/9/2024,Mihira Fernando,Badulla,Dambatenne,Uva,2578,4347,6925,103120,173880,277000
9/10/2024,Mihira Fernando,Badulla,Dambatenne,Uva,2963,7481,10444,118520,299240,417760
9/11/2024,Mihira Fernando,Badulla,Dambatenne,Uva,6396,2249,8645,255840,89960,345800
9/12/2024,Mihira Fernando,Badulla,Dambatenne,Uva,3052,902,3954,122080,36080,158160
9/13/2024,Mihira Fernando,Badulla,Dambatenne,Uva,2730,8460,11190,109200,338400,447600
9/14/2024,Mihira Fernando,Badulla,Dambatenne,Uva,1769,4243,6012,70760,169720,240480
9/15/2024,Mihira Fernando,Badulla,Dambatenne,Uva,8450,2647,11097,338000,105880,443880
9/16/2024,Mihira Fernando,Badulla,Dambatenne,Uva,3860,7743,11603,154400,309720,464120
9/17/2024,Mihira Fernando,Badulla,Dambatenne,Uva,4253,4251,8504,170120,170040,340160
9/18/2024,Mihira Fernando,Badulla,Dambatenne,Uva,973,534,1507,38920,21360,60280
9/19/2024,Mihira Fernando,Badulla,Dambatenne,Uva,6938,5614,12552,277520,224560,502080
9/20/2024,Mihira Fernando,Badulla,Dambatenne,Uva,9085,5390,14475,363400,215600,579000
9/21/2024,Mihira Fernando,Badulla,Dambatenne,Uva,4526,2516,7042,181040,100640,281680
9/22/2024,Mihira Fernando,Badulla,Dambatenne,Uva,9974,7178,17152,398960,287120,686080
9/23/2024,Mihira Fernando,Badulla,Dambatenne,Uva,5916,705,6621,236640,28200,264840
9/24/2024,Mihira Fernando,Badulla,Dambatenne,Uva,140,7639,7779,5600,305560,311160
9/25/2024,Mihira Fernando,Badulla,Dambatenne,Uva,860,5777,6637,34400,231080,265480
9/26/2024,Mihira Fernando,Badulla,Dambatenne,Uva,5834,1937,7771,233360,77480,310840
9/27/2024,Mihira Fernando,Badulla,Dambatenne,Uva,2055,4955,7010,82200,198200,280400
9/28/2024,Mihira Fernando,Badulla,Dambatenne,Uva,4052,9967,14019,162080,398680,560760
9/29/2024,Mihira Fernando,Badulla,Dambatenne,Uva,3657,91,3748,146280,3640,149920
9/30/2024,Mihira Fernando,Badulla,Dambatenne,Uva,3379,9488,12867,135160,379520,514680
10/1/2024,Mihira Fernando,Badulla,Dambatenne,Uva,3953,993,4946,158120,39720,197840
10/2/2024,Mihira Fernando,Badulla,Dambatenne,Uva,1635,6384,8019,65400,255360,320760
10/3/2024,Mihira Fernando,Badulla,Dambatenne,Uva,1732,174,1906,69280,6960,76240
10/4/2024,Mihira Fernando,Badulla,Dambatenne,Uva,4476,3363,7839,179040,134520,313560
10/5/2024,Mihira Fernando,Badulla,Dambatenne,Uva,743,8671,9414,29720,346840,376560
10/6/2024,Mihira Fernando,Badulla,Dambatenne,Uva,7069,70,7139,282760,2800,285560
10/7/2024,Mihira Fernando,Badulla,Dambatenne,Uva,3268,7869,11137,130720,314760,445480
10/8/2024,Mihira Fernando,Badulla,Dambatenne,Uva,6525,197,6722,261000,7880,268880
10/9/2024,Mihira Fernando,Badulla,Dambatenne,Uva,4124,7980,12104,164960,319200,484160
10/10/2024,Mihira Fernando,Badulla,Dambatenne,Uva,604,3164,3768,24160,126560,150720
10/11/2024,Mihira Fernando,Badulla,Dambatenne,Uva,9214,4051,13265,368560,162040,530600
10/12/2024,Mihira Fernando,Badulla,Dambatenne,Uva,5481,4159,9640,219240,166360,385600
10/13/2024,Mihira Fernando,Badulla,Dambatenne,Uva,264,5059,5323,10560,202360,212920
10/14/2024,Mihira Fernando,Badulla,Dambatenne,Uva,9518,8770,18288,380720,350800,731520
10/15/2024,Mihira Fernando,Badulla,Dambatenne,Uva,3484,9603,13087,139360,384120,523480
10/16/2024,Mihira Fernando,Badulla,Dambatenne,Uva,7601,2548,10149,304040,101920,405960
10/17/2024,Mihira Fernando,Badulla,Dambatenne,Uva,4942,6988,11930,197680,279520,477200
10/18/2024,Mihira Fernando,Badulla,Dambatenne,Uva,5659,8417,14076,226360,336680,563040
10/19/2024,Mihira Fernando,Badulla,Dambatenne,Uva,1882,3716,5598,75280,148640,223920
10/20/2024,Mihira Fernando,Badulla,Dambatenne,Uva,411,7843,8254,16440,313720,330160
10/21/2024,Mihira Fernando,Badulla,Dambatenne,Uva,1411,3087,4498,56440,123480,179920
10/22/2024,Mihira Fernando,Badulla,Dambatenne,Uva,9667,122,9789,386680,4880,391560
10/23/2024,Mihira Fernando,Badulla,Dambatenne,Uva,6524,468,6992,260960,18720,279680
10/24/2024,Mihira Fernando,Badulla,Dambatenne,Uva,7782,6631,14413,311280,265240,576520
10/25/2024,Mihira Fernando,Badulla,Dambatenne,Uva,8891,8332,17223,355640,333280,688920
10/26/2024,Mihira Fernando,Badulla,Dambatenne,Uva,7689,2827,10516,307560,113080,420640
10/27/2024,Mihira Fernando,Badulla,Dambatenne,Uva,6052,8724,14776,242080,348960,591040
10/28/2024,Mihira Fernando,Badulla,Dambatenne,Uva,6337,3417,9754,253480,136680,390160
10/29/2024,Mihira Fernando,Badulla,Dambatenne,Uva,9919,8062,17981,396760,322480,719240
10/30/2024,Mihira Fernando,Badulla,Dambatenne,Uva,9544,5580,15124,381760,223200,604960
10/31/2024,Mihira Fernando,Badulla,Dambatenne,Uva,675,7750,8425,27000,310000,337000
11/1/2024,Mihira Fernando,Badulla,Dambatenne,Uva,6431,6885,13316,257240,275400,532640
11/2/2024,Mihira Fernando,Badulla,Dambatenne,Uva,9712,3712,13424,388480,148480,536960
11/3/2024,Mihira Fernando,Badulla,Dambatenne,Uva,8684,4350,13034,347360,174000,521360
11/4/2024,Mihira Fernando,Badulla,Dambatenne,Uva,5280,1702,6982,211200,68080,279280
11/5/2024,Mihira Fernando,Badulla,Dambatenne,Uva,5600,7834,13434,224000,313360,537360
11/6/2024,Mihira Fernando,Badulla,Dambatenne,Uva,9713,4990,14703,388520,199600,588120
11/7/2024,Mihira Fernando,Badulla,Dambatenne,Uva,5533,1336,6869,221320,53440,274760
11/8/2024,Mihira Fernando,Badulla,Dambatenne,Uva,5867,6992,12859,234680,279680,514360
11/9/2024,Mihira Fernando,Badulla,Dambatenne,Uva,7658,7297,14955,306320,291880,598200
11/10/2024,Mihira Fernando,Badulla,Dambatenne,Uva,2561,1415,3976,102440,56600,159040
11/11/2024,Mihira Fernando,Badulla,Dambatenne,Uva,8333,5773,14106,333320,230920,564240
11/12/2024,Mihira Fernando,Badulla,Dambatenne,Uva,9984,2471,12455,399360,98840,498200
11/13/2024,Mihira Fernando,Badulla,Dambatenne,Uva,4766,9848,14614,190640,393920,584560
11/14/2024,Mihira Fernando,Badulla,Dambatenne,Uva,9620,5705,15325,384800,228200,613000
11/15/2024,Mihira Fernando,Badulla,Dambatenne,Uva,3216,5130,8346,128640,205200,333840
11/16/2024,Mihira Fernando,Badulla,Dambatenne,Uva,4058,4003,8061,162320,160120,322440
11/17/2024,Mihira Fernando,Badulla,Dambatenne,Uva,2292,8837,11129,91680,353480,445160
11/18/2024,Mihira Fernando,Badulla,Dambatenne,Uva,1057,4672,5729,42280,186880,229160
11/19/2024,Mihira Fernando,Badulla,Dambatenne,Uva,8888,3971,12859,355520,158840,514360
11/20/2024,Mihira Fernando,Badulla,Dambatenne,Uva,4615,8924,13539,184600,356960,541560
11/21/2024,Mihira Fernando,Badulla,Dambatenne,Uva,5533,7499,13032,221320,299960,521280
11/22/2024,Mihira Fernando,Badulla,Dambatenne,Uva,7596,1579,9175,303840,63160,367000
11/23/2024,Mihira Fernando,Badulla,Dambatenne,Uva,8955,7418,16373,358200,296720,654920
11/24/2024,Mihira Fernando,Badulla,Dambatenne,Uva,1640,1527,3167,65600,61080,126680
11/25/2024,Mihira Fernando,Badulla,Dambatenne,Uva,427,5064,5491,17080,202560,219640
11/26/2024,Mihira Fernando,Badulla,Dambatenne,Uva,1824,3291,5115,72960,131640,204600
11/27/2024,Mihira Fernando,Badulla,Dambatenne,Uva,5007,8568,13575,200280,342720,543000
11/28/2024,Mihira Fernando,Badulla,Dambatenne,Uva,6939,2895,9834,277560,115800,393360
11/29/2024,Mihira Fernando,Badulla,Dambatenne,Uva,4261,5246,9507,170440,209840,380280
11/30/2024,Mihira Fernando,Badulla,Dambatenne,Uva,8748,8144,16892,349920,325760,675680
12/1/2024,Mihira Fernando,Badulla,Dambatenne,Uva,2475,7969,10444,99000,318760,417760
12/2/2024,Mihira Fernando,Badulla,Dambatenne,Uva,956,2851,3807,38240,114040,152280
12/3/2024,Mihira Fernando,Badulla,Dambatenne,Uva,2442,8296,10738,97680,331840,429520
12/4/2024,Mihira Fernando,Badulla,Dambatenne,Uva,7360,5586,12946,294400,223440,517840
12/5/2024,Mihira Fernando,Badulla,Dambatenne,Uva,72,2601,2673,2880,104040,106920
12/6/2024,Mihira Fernando,Badulla,Dambatenne,Uva,86,6393,6479,3440,255720,259160
12/7/2024,Mihira Fernando,Badulla,Dambatenne,Uva,7366,8117,15483,294640,324680,619320
12/8/2024,Mihira Fernando,Badulla,Dambatenne,Uva,5937,4012,9949,237480,160480,397960
12/9/2024,Mihira Fernando,Badulla,Dambatenne,Uva,4102,5698,9800,164080,227920,392000
12/10/2024,Mihira Fernando,Badulla,Dambatenne,Uva,6724,6943,13667,268960,277720,546680
12/11/2024,Mihira Fernando,Badulla,Dambatenne,Uva,9685,370,10055,387400,14800,402200
12/12/2024,Mihira Fernando,Badulla,Dambatenne,Uva,7042,1354,8396,281680,54160,335840
12/13/2024,Mihira Fernando,Badulla,Dambatenne,Uva,4054,6062,10116,162160,242480,404640
12/14/2024,Mihira Fernando,Badulla,Dambatenne,Uva,5872,1398,7270,234880,55920,290800
12/15/2024,Mihira Fernando,Badulla,Dambatenne,Uva,7860,5180,13040,314400,207200,521600
12/16/2024,Mihira Fernando,Badulla,Dambatenne,Uva,4141,9937,14078,165640,397480,563120
12/17/2024,Mihira Fernando,Badulla,Dambatenne,Uva,2407,655,3062,96280,26200,122480
12/18/2024,Mihira Fernando,Badulla,Dambatenne,Uva,9087,6664,15751,363480,266560,630040
12/19/2024,Mihira Fernando,Badulla,Dambatenne,Uva,4608,31,4639,184320,1240,185560
12/20/2024,Mihira Fernando,Badulla,Dambatenne,Uva,731,9282,10013,29240,371280,400520
12/21/2024,Mihira Fernando,Badulla,Dambatenne,Uva,4509,3068,7577,180360,122720,303080
12/22/2024,Mihira Fernando,Badulla,Dambatenne,Uva,5308,6713,12021,212320,268520,480840
12/23/2024,Mihira Fernando,Badulla,Dambatenne,Uva,7632,601,8233,305280,24040,329320
12/24/2024,Mihira Fernando,Badulla,Dambatenne,Uva,6399,8454,14853,255960,338160,594120
12/25/2024,Mihira Fernando,Badulla,Dambatenne,Uva,8829,3737,12566,353160,149480,502640
12/26/2024,Mihira Fernando,Badulla,Dambatenne,Uva,8946,2945,11891,357840,117800,475640
12/27/2024,Mihira Fernando,Badulla,Dambatenne,Uva,1712,7232,8944,68480,289280,357760
12/28/2024,Mihira Fernando,Badulla,Dambatenne,Uva,8192,5405,13597,327680,216200,543880
12/29/2024,Mihira Fernando,Badulla,Dambatenne,Uva,3986,3427,7413,159440,137080,296520
12/30/2024,Mihira Fernando,Badulla,Dambatenne,Uva,572,1093,1665,22880,43720,66600
12/31/2024,Mihira Fernando,Badulla,Dambatenne,Uva,164,6623,6787,6560,264920,271480
1/1/2025,Mihira Fernando,Badulla,Dambatenne,Uva,3385,8231,11616,135400,329240,464640
1/2/2025,Mihira Fernando,Badulla,Dambatenne,Uva,5611,8054,13665,224440,322160,546600
1/3/2025,Mihira Fernando,Badulla,Dambatenne,Uva,936,3426,4362,37440,137040,174480
1/4/2025,Mihira Fernando,Badulla,Dambatenne,Uva,2049,4136,6185,81960,165440,247400
1/5/2025,Mihira Fernando,Badulla,Dambatenne,Uva,376,1117,1493,15040,44680,59720
1/6/2025,Mihira Fernando,Badulla,Dambatenne,Uva,1792,5884,7676,71680,235360,307040
1/7/2025,Mihira Fernando,Badulla,Dambatenne,Uva,3561,3657,7218,142440,146280,288720
1/8/2025,Mihira Fernando,Badulla,Dambatenne,Uva,2903,1161,4064,116120,46440,162560
1/9/2025,Mihira Fernando,Badulla,Dambatenne,Uva,5621,4683,10304,224840,187320,412160
1/10/2025,Mihira Fernando,Badulla,Dambatenne,Uva,1604,9305,10909,64160,372200,436360
1/11/2025,Mihira Fernando,Badulla,Dambatenne,Uva,5496,6750,12246,219840,270000,489840
1/12/2025,Mihira Fernando,Badulla,Dambatenne,Uva,7593,585,8178,303720,23400,327120
1/13/2025,Mihira Fernando,Badulla,Dambatenne,Uva,6823,2913,9736,272920,116520,389440
1/14/2025,Mihira Fernando,Badulla,Dambatenne,Uva,2857,2921,5778,114280,116840,231120
1/15/2025,Mihira Fernando,Badulla,Dambatenne,Uva,8055,1529,9584,322200,61160,383360
1/16/2025,Mihira Fernando,Badulla,Dambatenne,Uva,1424,233,1657,56960,9320,66280
1/17/2025,Mihira Fernando,Badulla,Dambatenne,Uva,5130,7843,12973,205200,313720,518920
1/18/2025,Mihira Fernando,Badulla,Dambatenne,Uva,7286,3646,10932,291440,145840,437280
1/19/2025,Mihira Fernando,Badulla,Dambatenne,Uva,4083,8254,12337,163320,330160,493480
1/20/2025,Mihira Fernando,Badulla,Dambatenne,Uva,6168,4094,10262,246720,163760,410480
1/21/2025,Mihira Fernando,Badulla,Dambatenne,Uva,804,2871,3675,32160,114840,147000
1/22/2025,Mihira Fernando,Badulla,Dambatenne,Uva,8447,8149,16596,337880,325960,663840
1/23/2025,Mihira Fernando,Badulla,Dambatenne,Uva,4347,6951,11298,173880,278040,451920
1/24/2025,Mihira Fernando,Badulla,Dambatenne,Uva,2189,9816,12005,87560,392640,480200
1/25/2025,Mihira Fernando,Badulla,Dambatenne,Uva,9553,1287,10840,382120,51480,433600
1/26/2025,Mihira Fernando,Badulla,Dambatenne,Uva,6742,8646,15388,269680,345840,615520
1/27/2025,Mihira Fernando,Badulla,Dambatenne,Uva,1513,1775,3288,60520,71000,131520
1/28/2025,Mihira Fernando,Badulla,Dambatenne,Uva,3733,568,4301,149320,22720,172040
1/29/2025,Mihira Fernando,Badulla,Dambatenne,Uva,6660,2719,9379,266400,108760,375160
1/30/2025,Mihira Fernando,Badulla,Dambatenne,Uva,2147,8133,10280,85880,325320,411200
1/31/2025,Mihira Fernando,Badulla,Dambatenne,Uva,450,594,1044,18000,23760,41760
2/1/2025,Mihira Fernando,Badulla,Dambatenne,Uva,8719,9947,18666,348760,397880,746640
2/2/2025,Mihira Fernando,Badulla,Dambatenne,Uva,8188,4000,12188,327520,160000,487520
2/3/2025,Mihira Fernando,Badulla,Dambatenne,Uva,2220,8801,11021,88800,352040,440840
2/4/2025,Mihira Fernando,Badulla,Dambatenne,Uva,4685,6903,11588,187400,276120,463520
2/5/2025,Mihira Fernando,Badulla,Dambatenne,Uva,5646,2121,7767,225840,84840,310680
2/6/2025,Mihira Fernando,Badulla,Dambatenne,Uva,558,7258,7816,22320,290320,312640
2/7/2025,Mihira Fernando,Badulla,Dambatenne,Uva,3705,8420,12125,148200,336800,485000
2/8/2025,Mihira Fernando,Badulla,Dambatenne,Uva,4674,7021,11695,186960,280840,467800
2/9/2025,Mihira Fernando,Badulla,Dambatenne,Uva,3897,4439,8336,155880,177560,333440
2/10/2025,Mihira Fernando,Badulla,Dambatenne,Uva,106,4014,4120,4240,160560,164800
2/11/2025,Mihira Fernando,Badulla,Dambatenne,Uva,6107,4853,10960,244280,194120,438400
2/12/2025,Mihira Fernando,Badulla,Dambatenne,Uva,9808,2073,11881,392320,82920,475240
2/13/2025,Mihira Fernando,Badulla,Dambatenne,Uva,5744,4979,10723,229760,199160,428920
2/14/2025,Mihira Fernando,Badulla,Dambatenne,Uva,2221,9124,11345,88840,364960,453800
2/15/2025,Mihira Fernando,Badulla,Dambatenne,Uva,4005,5523,9528,160200,220920,381120
2/16/2025,Mihira Fernando,Badulla,Dambatenne,Uva,4480,7098,11578,179200,283920,463120
2/17/2025,Mihira Fernando,Badulla,Dambatenne,Uva,3470,195,3665,138800,7800,146600
2/18/2025,Mihira Fernando,Badulla,Dambatenne,Uva,2477,9685,12162,99080,387400,486480
2/19/2025,Mihira Fernando,Badulla,Dambatenne,Uva,5527,1603,7130,221080,64120,285200
2/20/2025,Mihira Fernando,Badulla,Dambatenne,Uva,3290,8233,11523,131600,329320,460920
2/21/2025,Mihira Fernando,Badulla,Dambatenne,Uva,2408,7797,10205,96320,311880,408200
2/22/2025,Mihira Fernando,Badulla,Dambatenne,Uva,6506,870,7376,260240,34800,295040
2/23/2025,Mihira Fernando,Badulla,Dambatenne,Uva,7795,4108,11903,311800,164320,476120
2/24/2025,Mihira Fernando,Badulla,Dambatenne,Uva,5755,1324,7079,230200,52960,283160
2/25/2025,Mihira Fernando,Badulla,Dambatenne,Uva,6113,2482,8595,244520,99280,343800
2/26/2025,Mihira Fernando,Badulla,Dambatenne,Uva,8872,7010,15882,354880,280400,635280
2/27/2025,Mihira Fernando,Badulla,Dambatenne,Uva,8006,9951,17957,320240,398040,718280
2/28/2025,Mihira Fernando,Badulla,Dambatenne,Uva,6797,1652,8449,271880,66080,337960
3/1/2025,Mihira Fernando,Badulla,Dambatenne,Uva,5395,1432,6827,215800,57280,273080
3/2/2025,Mihira Fernando,Badulla,Dambatenne,Uva,5170,2177,7347,206800,87080,293880
3/3/2025,Mihira Fernando,Badulla,Dambatenne,Uva,5151,771,5922,206040,30840,236880
3/4/2025,Mihira Fernando,Badulla,Dambatenne,Uva,6805,3847,10652,272200,153880,426080
3/5/2025,Mihira Fernando,Badulla,Dambatenne,Uva,3561,8151,11712,142440,326040,468480
3/6/2025,Mihira Fernando,Badulla,Dambatenne,Uva,7357,8335,15692,294280,333400,627680
3/7/2025,Mihira Fernando,Badulla,Dambatenne,Uva,4150,9030,13180,166000,361200,527200
3/8/2025,Mihira Fernando,Badulla,Dambatenne,Uva,5392,5177,10569,215680,207080,422760
3/9/2025,Mihira Fernando,Badulla,Dambatenne,Uva,7414,1005,8419,296560,40200,336760
3/10/2025,Mihira Fernando,Badulla,Dambatenne,Uva,3697,2431,6128,147880,97240,245120
3/11/2025,Mihira Fernando,Badulla,Dambatenne,Uva,4690,5700,10390,187600,228000,415600
3/12/2025,Mihira Fernando,Badulla,Dambatenne,Uva,5746,2120,7866,229840,84800,314640
3/13/2025,Mihira Fernando,Badulla,Dambatenne,Uva,4494,8103,12597,179760,324120,503880
3/14/2025,Mihira Fernando,Badulla,Dambatenne,Uva,9207,3473,12680,368280,138920,507200
3/15/2025,Mihira Fernando,Badulla,Dambatenne,Uva,147,6594,6741,5880,263760,269640
3/16/2025,Mihira Fernando,Badulla,Dambatenne,Uva,5246,2247,7493,209840,89880,299720
3/17/2025,Mihira Fernando,Badulla,Dambatenne,Uva,49,7654,7703,1960,306160,308120
3/18/2025,Mihira Fernando,Badulla,Dambatenne,Uva,7768,6486,14254,310720,259440,570160
3/19/2025,Mihira Fernando,Badulla,Dambatenne,Uva,1153,335,1488,46120,13400,59520
3/20/2025,Mihira Fernando,Badulla,Dambatenne,Uva,4063,1702,5765,162520,68080,230600
3/21/2025,Mihira Fernando,Badulla,Dambatenne,Uva,7361,1592,8953,294440,63680,358120
3/22/2025,Mihira Fernando,Badulla,Dambatenne,Uva,4666,5867,10533,186640,234680,421320
3/23/2025,Mihira Fernando,Badulla,Dambatenne,Uva,3499,3640,7139,139960,145600,285560
3/25/2024,Gayani Priyadarshani,Ampara,Kalmunai,Eastern,1379,6477,7856,55160,259080,314240
3/26/2024,Gayani Priyadarshani,Ampara,Kalmunai,Eastern,2163,4701,6864,86520,188040,274560
3/27/2024,Gayani Priyadarshani,Ampara,Kalmunai,Eastern,6295,1055,7350,251800,42200,294000
3/28/2024,Gayani Priyadarshani,Ampara,Kalmunai,Eastern,523,4761,5284,20920,190440,211360
3/29/2024,Gayani Priyadarshani,Ampara,Kalmunai,Eastern,4651,7198,11849,186040,287920,473960
3/30/2024,Gayani Priyadarshani,Ampara,Kalmunai,Eastern,3015,2271,5286,120600,90840,211440
3/31/2024,Gayani Priyadarshani,Ampara,Kalmunai,Eastern,4970,3663,8633,198800,146520,345320
4/1/2024,Gayani Priyadarshani,Ampara,Kalmunai,Eastern,3544,3567,7111,141760,142680,284440
4/2/2024,Gayani Priyadarshani,Ampara,Kalmunai,Eastern,9363,3194,12557,374520,127760,502280
4/3/2024,Gayani Priyadarshani,Ampara,Kalmunai,Eastern,8460,5518,13978,338400,220720,559120
4/4/2024,Gayani Priyadarshani,Ampara,Kalmunai,Eastern,7854,7508,15362,314160,300320,614480
4/5/2024,Gayani Priyadarshani,Ampara,Kalmunai,Eastern,5219,2113,7332,208760,84520,293280
4/6/2024,Gayani Priyadarshani,Ampara,Kalmunai,Eastern,745,163,908,29800,6520,36320
4/7/2024,Gayani Priyadarshani,Ampara,Kalmunai,Eastern,9185,4977,14162,367400,199080,566480
4/8/2024,Gayani Priyadarshani,Ampara,Kalmunai,Eastern,7951,2513,10464,318040,100520,418560
4/9/2024,Gayani Priyadarshani,Ampara,Kalmunai,Eastern,4326,4055,8381,173040,162200,335240
4/10/2024,Gayani Priyadarshani,Ampara,Kalmunai,Eastern,2107,7672,9779,84280,306880,391160
4/11/2024,Gayani Priyadarshani,Ampara,Kalmunai,Eastern,3932,2968,6900,157280,118720,276000
4/19/2024,Gayani Priyadarshani,Ampara,Kalmunai,Eastern,8298,4890,13188,331920,195600,527520
4/20/2024,Gayani Priyadarshani,Ampara,Kalmunai,Eastern,9909,6260,16169,396360,250400,646760
4/21/2024,Gayani Priyadarshani,Ampara,Kalmunai,Eastern,2785,8693,11478,111400,347720,459120
4/22/2024,Gayani Priyadarshani,Ampara,Kalmunai,Eastern,1223,5995,7218,48920,239800,288720
4/23/2024,Gayani Priyadarshani,Ampara,Kalmunai,Eastern,6434,3921,10355,257360,156840,414200
4/24/2024,Gayani Priyadarshani,Ampara,Kalmunai,Eastern,7287,7259,14546,291480,290360,581840
4/25/2024,Gayani Priyadarshani,Ampara,Kalmunai,Eastern,7952,3676,11628,318080,147040,465120
4/26/2024,Gayani Priyadarshani,Ampara,Kalmunai,Eastern,4539,3596,8135,181560,143840,325400
4/27/2024,Gayani Priyadarshani,Ampara,Kalmunai,Eastern,3612,1449,5061,144480,57960,202440
4/28/2024,Gayani Priyadarshani,Ampara,Kalmunai,Eastern,9623,4742,14365,384920,189680,574600
4/29/2024,Gayani Priyadarshani,Ampara,Kalmunai,Eastern,1963,958,2921,78520,38320,116840
4/30/2024,Gayani Priyadarshani,Ampara,Kalmunai,Eastern,9225,5652,14877,369000,226080,595080
5/1/2024,Gayani Priyadarshani,Ampara,Kalmunai,Eastern,7208,1135,8343,288320,45400,333720
5/2/2024,Gayani Priyadarshani,Ampara,Kalmunai,Eastern,769,5775,6544,30760,231000,261760
5/3/2024,Gayani Priyadarshani,Ampara,Kalmunai,Eastern,9818,620,10438,392720,24800,417520
5/4/2024,Gayani Priyadarshani,Ampara,Kalmunai,Eastern,6806,9465,16271,272240,378600,650840
5/5/2024,Gayani Priyadarshani,Ampara,Kalmunai,Eastern,6571,5227,11798,262840,209080,471920
5/6/2024,Gayani Priyadarshani,Ampara,Kalmunai,Eastern,9342,9092,18434,373680,363680,737360
5/7/2024,Gayani Priyadarshani,Ampara,Kalmunai,Eastern,3841,6770,10611,153640,270800,424440
5/8/2024,Gayani Priyadarshani,Ampara,Kalmunai,Eastern,2852,2404,5256,114080,96160,210240
5/9/2024,Gayani Priyadarshani,Ampara,Kalmunai,Eastern,647,3513,4160,25880,140520,166400
5/10/2024,Gayani Priyadarshani,Ampara,Kalmunai,Eastern,8437,8403,16840,337480,336120,673600
5/11/2024,Gayani Priyadarshani,Ampara,Kalmunai,Eastern,5701,1966,7667,228040,78640,306680
5/12/2024,Gayani Priyadarshani,Ampara,Kalmunai,Eastern,129,7420,7549,5160,296800,301960
5/13/2024,Gayani Priyadarshani,Ampara,Kalmunai,Eastern,1775,8510,10285,71000,340400,411400
5/14/2024,Gayani Priyadarshani,Ampara,Kalmunai,Eastern,5285,7907,13192,211400,316280,527680
5/15/2024,Gayani Priyadarshani,Ampara,Kalmunai,Eastern,3115,3912,7027,124600,156480,281080
5/16/2024,Gayani Priyadarshani,Ampara,Kalmunai,Eastern,9824,2580,12404,392960,103200,496160
5/17/2024,Gayani Priyadarshani,Ampara,Kalmunai,Eastern,2163,2755,4918,86520,110200,196720
5/18/2024,Gayani Priyadarshani,Ampara,Kalmunai,Eastern,6662,214,6876,266480,8560,275040
5/19/2024,Gayani Priyadarshani,Ampara,Kalmunai,Eastern,6958,449,7407,278320,17960,296280
5/20/2024,Gayani Priyadarshani,Ampara,Kalmunai,Eastern,4120,8416,12536,164800,336640,501440
5/21/2024,Gayani Priyadarshani,Ampara,Kalmunai,Eastern,3252,2270,5522,130080,90800,220880
5/22/2024,Gayani Priyadarshani,Ampara,Kalmunai,Eastern,7791,4933,12724,311640,197320,508960
5/24/2024,Gayani Priyadarshani,Ampara,Kalmunai,Eastern,2381,5956,8337,95240,238240,333480
5/25/2024,Gayani Priyadarshani,Ampara,Kalmunai,Eastern,888,1655,2543,35520,66200,101720
5/26/2024,Gayani Priyadarshani,Ampara,Kalmunai,Eastern,2533,4424,6957,101320,176960,278280
5/27/2024,Gayani Priyadarshani,Ampara,Kalmunai,Eastern,4713,8386,13099,188520,335440,523960
5/28/2024,Gayani Priyadarshani,Ampara,Kalmunai,Eastern,9374,2862,12236,374960,114480,489440
5/29/2024,Gayani Priyadarshani,Ampara,Kalmunai,Eastern,9912,2449,12361,396480,97960,494440
5/30/2024,Gayani Priyadarshani,Ampara,Kalmunai,Eastern,1093,7459,8552,43720,298360,342080
5/31/2024,Gayani Priyadarshani,Ampara,Kalmunai,Eastern,1871,8245,10116,74840,329800,404640
6/1/2024,Gayani Priyadarshani,Ampara,Kalmunai,Eastern,1389,5987,7376,55560,239480,295040
6/2/2024,Gayani Priyadarshani,Ampara,Kalmunai,Eastern,1040,5943,6983,41600,237720,279320
6/3/2024,Gayani Priyadarshani,Ampara,Kalmunai,Eastern,8412,6553,14965,336480,262120,598600
6/4/2024,Gayani Priyadarshani,Ampara,Kalmunai,Eastern,236,5742,5978,9440,229680,239120
6/5/2024,Gayani Priyadarshani,Ampara,Kalmunai,Eastern,5484,1281,6765,219360,51240,270600
6/6/2024,Gayani Priyadarshani,Ampara,Kalmunai,Eastern,2802,9678,12480,112080,387120,499200
6/7/2024,Gayani Priyadarshani,Ampara,Kalmunai,Eastern,2041,7097,9138,81640,283880,365520
6/8/2024,Gayani Priyadarshani,Ampara,Kalmunai,Eastern,8903,9242,18145,356120,369680,725800
6/9/2024,Gayani Priyadarshani,Ampara,Kalmunai,Eastern,3764,6585,10349,150560,263400,413960
6/10/2024,Gayani Priyadarshani,Ampara,Kalmunai,Eastern,3856,3441,7297,154240,137640,291880
6/11/2024,Gayani Priyadarshani,Ampara,Kalmunai,Eastern,6434,9953,16387,257360,398120,655480
6/12/2024,Gayani Priyadarshani,Ampara,Kalmunai,Eastern,269,3755,4024,10760,150200,160960
6/13/2024,Gayani Priyadarshani,Ampara,Kalmunai,Eastern,2337,7412,9749,93480,296480,389960
6/14/2024,Gayani Priyadarshani,Ampara,Kalmunai,Eastern,4161,4803,8964,166440,192120,358560
6/15/2024,Gayani Priyadarshani,Ampara,Kalmunai,Eastern,5263,7676,12939,210520,307040,517560
6/16/2024,Gayani Priyadarshani,Ampara,Kalmunai,Eastern,2200,9254,11454,88000,370160,458160
6/17/2024,Gayani Priyadarshani,Ampara,Kalmunai,Eastern,6644,6217,12861,265760,248680,514440
6/18/2024,Gayani Priyadarshani,Ampara,Kalmunai,Eastern,3213,6311,9524,128520,252440,380960
6/19/2024,Gayani Priyadarshani,Ampara,Kalmunai,Eastern,6088,8754,14842,243520,350160,593680
6/20/2024,Gayani Priyadarshani,Ampara,Kalmunai,Eastern,1558,6111,7669,62320,244440,306760
6/21/2024,Gayani Priyadarshani,Ampara,Kalmunai,Eastern,6332,6119,12451,253280,244760,498040
6/22/2024,Gayani Priyadarshani,Ampara,Kalmunai,Eastern,2108,2485,4593,84320,99400,183720
6/23/2024,Gayani Priyadarshani,Ampara,Kalmunai,Eastern,9658,4396,14054,386320,175840,562160
6/24/2024,Gayani Priyadarshani,Ampara,Kalmunai,Eastern,8384,1752,10136,335360,70080,405440
6/25/2024,Gayani Priyadarshani,Ampara,Kalmunai,Eastern,5974,6636,12610,238960,265440,504400
6/26/2024,Gayani Priyadarshani,Ampara,Kalmunai,Eastern,3244,9814,13058,129760,392560,522320
6/27/2024,Gayani Priyadarshani,Ampara,Kalmunai,Eastern,2029,9734,11763,81160,389360,470520
6/28/2024,Gayani Priyadarshani,Ampara,Kalmunai,Eastern,711,9963,10674,28440,398520,426960
6/29/2024,Gayani Priyadarshani,Ampara,Kalmunai,Eastern,1371,6543,7914,54840,261720,316560
6/30/2024,Gayani Priyadarshani,Ampara,Kalmunai,Eastern,9912,6751,16663,396480,270040,666520
7/1/2024,Gayani Priyadarshani,Ampara,Kalmunai,Eastern,5481,1772,7253,219240,70880,290120
7/2/2024,Gayani Priyadarshani,Ampara,Kalmunai,Eastern,6359,9195,15554,254360,367800,622160
7/3/2024,Gayani Priyadarshani,Ampara,Kalmunai,Eastern,7701,415,8116,308040,16600,324640
7/4/2024,Gayani Priyadarshani,Ampara,Kalmunai,Eastern,3196,2448,5644,127840,97920,225760
7/5/2024,Gayani Priyadarshani,Ampara,Kalmunai,Eastern,5184,7914,13098,207360,316560,523920
7/6/2024,Gayani Priyadarshani,Ampara,Kalmunai,Eastern,9327,5622,14949,373080,224880,597960
7/7/2024,Gayani Priyadarshani,Ampara,Kalmunai,Eastern,4587,4006,8593,183480,160240,343720
7/8/2024,Gayani Priyadarshani,Ampara,Kalmunai,Eastern,8733,2674,11407,349320,106960,456280
7/9/2024,Gayani Priyadarshani,Ampara,Kalmunai,Eastern,1463,6110,7573,58520,244400,302920
7/10/2024,Gayani Priyadarshani,Ampara,Kalmunai,Eastern,4003,7318,11321,160120,292720,452840
7/11/2024,Gayani Priyadarshani,Ampara,Kalmunai,Eastern,4943,3929,8872,197720,157160,354880
7/12/2024,Gayani Priyadarshani,Ampara,Kalmunai,Eastern,9924,2573,12497,396960,102920,499880
7/13/2024,Gayani Priyadarshani,Ampara,Kalmunai,Eastern,6269,4268,10537,250760,170720,421480
7/14/2024,Gayani Priyadarshani,Ampara,Kalmunai,Eastern,4522,7963,12485,180880,318520,499400
7/15/2024,Gayani Priyadarshani,Ampara,Kalmunai,Eastern,4960,3464,8424,198400,138560,336960
7/16/2024,Gayani Priyadarshani,Ampara,Kalmunai,Eastern,4248,6580,10828,169920,263200,433120
7/17/2024,Gayani Priyadarshani,Ampara,Kalmunai,Eastern,1112,4281,5393,44480,171240,215720
7/18/2024,Gayani Priyadarshani,Ampara,Kalmunai,Eastern,6694,2429,9123,267760,97160,364920
7/19/2024,Gayani Priyadarshani,Ampara,Kalmunai,Eastern,8979,4508,13487,359160,180320,539480
7/20/2024,Gayani Priyadarshani,Ampara,Kalmunai,Eastern,6649,7673,14322,265960,306920,572880
7/21/2024,Gayani Priyadarshani,Ampara,Kalmunai,Eastern,7520,9508,17028,300800,380320,681120
7/22/2024,Gayani Priyadarshani,Ampara,Kalmunai,Eastern,3795,4029,7824,151800,161160,312960
7/23/2024,Gayani Priyadarshani,Ampara,Kalmunai,Eastern,6244,9533,15777,249760,381320,631080
7/24/2024,Gayani Priyadarshani,Ampara,Kalmunai,Eastern,1887,7928,9815,75480,317120,392600
7/25/2024,Gayani Priyadarshani,Ampara,Kalmunai,Eastern,9354,9937,19291,374160,397480,771640
7/26/2024,Gayani Priyadarshani,Ampara,Kalmunai,Eastern,6521,6143,12664,260840,245720,506560
7/27/2024,Gayani Priyadarshani,Ampara,Kalmunai,Eastern,2240,4916,7156,89600,196640,286240
7/28/2024,Gayani Priyadarshani,Ampara,Kalmunai,Eastern,3369,2419,5788,134760,96760,231520
7/29/2024,Gayani Priyadarshani,Ampara,Kalmunai,Eastern,4542,2577,7119,181680,103080,284760
7/30/2024,Gayani Priyadarshani,Ampara,Kalmunai,Eastern,5299,7060,12359,211960,282400,494360
7/31/2024,Gayani Priyadarshani,Ampara,Kalmunai,Eastern,732,6934,7666,29280,277360,306640
8/1/2024,Gayani Priyadarshani,Ampara,Kalmunai,Eastern,4457,9862,14319,178280,394480,572760
8/2/2024,Gayani Priyadarshani,Ampara,Kalmunai,Eastern,7920,5773,13693,316800,230920,547720
8/3/2024,Gayani Priyadarshani,Ampara,Kalmunai,Eastern,9374,1658,11032,374960,66320,441280
8/4/2024,Gayani Priyadarshani,Ampara,Kalmunai,Eastern,6479,8404,14883,259160,336160,595320
8/5/2024,Gayani Priyadarshani,Ampara,Kalmunai,Eastern,7356,9867,17223,294240,394680,688920
8/6/2024,Gayani Priyadarshani,Ampara,Kalmunai,Eastern,9619,4489,14108,384760,179560,564320
8/7/2024,Gayani Priyadarshani,Ampara,Kalmunai,Eastern,448,5030,5478,17920,201200,219120
8/8/2024,Gayani Priyadarshani,Ampara,Kalmunai,Eastern,515,4585,5100,20600,183400,204000
8/9/2024,Gayani Priyadarshani,Ampara,Kalmunai,Eastern,1944,9285,11229,77760,371400,449160
8/10/2024,Gayani Priyadarshani,Ampara,Kalmunai,Eastern,3715,999,4714,148600,39960,188560
8/11/2024,Gayani Priyadarshani,Ampara,Kalmunai,Eastern,2430,8908,11338,97200,356320,453520
8/12/2024,Gayani Priyadarshani,Ampara,Kalmunai,Eastern,3019,4571,7590,120760,182840,303600
8/13/2024,Gayani Priyadarshani,Ampara,Kalmunai,Eastern,9817,8754,18571,392680,350160,742840
8/14/2024,Gayani Priyadarshani,Ampara,Kalmunai,Eastern,7283,1237,8520,291320,49480,340800
8/15/2024,Gayani Priyadarshani,Ampara,Kalmunai,Eastern,8094,6790,14884,323760,271600,595360
8/16/2024,Gayani Priyadarshani,Ampara,Kalmunai,Eastern,6340,4748,11088,253600,189920,443520
8/17/2024,Gayani Priyadarshani,Ampara,Kalmunai,Eastern,5708,5486,11194,228320,219440,447760
8/18/2024,Gayani Priyadarshani,Ampara,Kalmunai,Eastern,555,6477,7032,22200,259080,281280
8/19/2024,Gayani Priyadarshani,Ampara,Kalmunai,Eastern,7156,9060,16216,286240,362400,648640
8/20/2024,Gayani Priyadarshani,Ampara,Kalmunai,Eastern,3973,6636,10609,158920,265440,424360
8/21/2024,Gayani Priyadarshani,Ampara,Kalmunai,Eastern,1194,99,1293,47760,3960,51720
8/22/2024,Gayani Priyadarshani,Ampara,Kalmunai,Eastern,9358,9090,18448,374320,363600,737920
8/23/2024,Gayani Priyadarshani,Ampara,Kalmunai,Eastern,1706,4558,6264,68240,182320,250560
8/24/2024,Gayani Priyadarshani,Ampara,Kalmunai,Eastern,1590,373,1963,63600,14920,78520
8/25/2024,Gayani Priyadarshani,Ampara,Kalmunai,Eastern,410,4309,4719,16400,172360,188760
8/26/2024,Gayani Priyadarshani,Ampara,Kalmunai,Eastern,7162,627,7789,286480,25080,311560
8/27/2024,Gayani Priyadarshani,Ampara,Kalmunai,Eastern,3367,5204,8571,134680,208160,342840
8/28/2024,Gayani Priyadarshani,Ampara,Kalmunai,Eastern,8846,7411,16257,353840,296440,650280
8/29/2024,Gayani Priyadarshani,Ampara,Kalmunai,Eastern,4435,4241,8676,177400,169640,347040
8/30/2024,Gayani Priyadarshani,Ampara,Kalmunai,Eastern,5245,6046,11291,209800,241840,451640
8/31/2024,Gayani Priyadarshani,Ampara,Kalmunai,Eastern,4078,7867,11945,163120,314680,477800
9/1/2024,Gayani Priyadarshani,Ampara,Kalmunai,Eastern,3840,1062,4902,153600,42480,196080
9/2/2024,Gayani Priyadarshani,Ampara,Kalmunai,Eastern,6565,152,6717,262600,6080,268680
9/3/2024,Gayani Priyadarshani,Ampara,Kalmunai,Eastern,4643,7344,11987,185720,293760,479480
9/4/2024,Gayani Priyadarshani,Ampara,Kalmunai,Eastern,4745,7245,11990,189800,289800,479600
9/5/2024,Gayani Priyadarshani,Ampara,Kalmunai,Eastern,9127,9163,18290,365080,366520,731600
9/6/2024,Gayani Priyadarshani,Ampara,Kalmunai,Eastern,6940,1673,8613,277600,66920,344520
9/7/2024,Gayani Priyadarshani,Ampara,Kalmunai,Eastern,1490,2861,4351,59600,114440,174040
9/8/2024,Gayani Priyadarshani,Ampara,Kalmunai,Eastern,8586,890,9476,343440,35600,379040
9/9/2024,Gayani Priyadarshani,Ampara,Kalmunai,Eastern,927,3423,4350,37080,136920,174000
9/10/2024,Gayani Priyadarshani,Ampara,Kalmunai,Eastern,1966,9445,11411,78640,377800,456440
9/11/2024,Gayani Priyadarshani,Ampara,Kalmunai,Eastern,9857,3584,13441,394280,143360,537640
9/12/2024,Gayani Priyadarshani,Ampara,Kalmunai,Eastern,1181,5431,6612,47240,217240,264480
9/13/2024,Gayani Priyadarshani,Ampara,Kalmunai,Eastern,2711,6264,8975,108440,250560,359000
9/14/2024,Gayani Priyadarshani,Ampara,Kalmunai,Eastern,5222,9262,14484,208880,370480,579360
9/15/2024,Gayani Priyadarshani,Ampara,Kalmunai,Eastern,5578,9121,14699,223120,364840,587960
9/16/2024,Gayani Priyadarshani,Ampara,Kalmunai,Eastern,1936,8245,10181,77440,329800,407240
9/17/2024,Gayani Priyadarshani,Ampara,Kalmunai,Eastern,7040,9311,16351,281600,372440,654040
9/18/2024,Gayani Priyadarshani,Ampara,Kalmunai,Eastern,5710,6707,12417,228400,268280,496680
9/19/2024,Gayani Priyadarshani,Ampara,Kalmunai,Eastern,203,5767,5970,8120,230680,238800
9/20/2024,Gayani Priyadarshani,Ampara,Kalmunai,Eastern,8555,5918,14473,342200,236720,578920
9/21/2024,Gayani Priyadarshani,Ampara,Kalmunai,Eastern,7666,3079,10745,306640,123160,429800
9/22/2024,Gayani Priyadarshani,Ampara,Kalmunai,Eastern,9107,2115,11222,364280,84600,448880
9/23/2024,Gayani Priyadarshani,Ampara,Kalmunai,Eastern,6984,2050,9034,279360,82000,361360
9/24/2024,Gayani Priyadarshani,Ampara,Kalmunai,Eastern,1347,8754,10101,53880,350160,404040
9/25/2024,Gayani Priyadarshani,Ampara,Kalmunai,Eastern,1834,6623,8457,73360,264920,338280
9/26/2024,Gayani Priyadarshani,Ampara,Kalmunai,Eastern,4410,2313,6723,176400,92520,268920
9/27/2024,Gayani Priyadarshani,Ampara,Kalmunai,Eastern,5629,9170,14799,225160,366800,591960
9/28/2024,Gayani Priyadarshani,Ampara,Kalmunai,Eastern,5343,1416,6759,213720,56640,270360
9/29/2024,Gayani Priyadarshani,Ampara,Kalmunai,Eastern,4254,7052,11306,170160,282080,452240
9/30/2024,Gayani Priyadarshani,Ampara,Kalmunai,Eastern,6746,2556,9302,269840,102240,372080
10/1/2024,Gayani Priyadarshani,Ampara,Kalmunai,Eastern,7997,5705,13702,319880,228200,548080
10/2/2024,Gayani Priyadarshani,Ampara,Kalmunai,Eastern,1625,8128,9753,65000,325120,390120
10/3/2024,Gayani Priyadarshani,Ampara,Kalmunai,Eastern,2882,7015,9897,115280,280600,395880
10/4/2024,Gayani Priyadarshani,Ampara,Kalmunai,Eastern,8138,8826,16964,325520,353040,678560
10/5/2024,Gayani Priyadarshani,Ampara,Kalmunai,Eastern,3444,1143,4587,137760,45720,183480
10/6/2024,Gayani Priyadarshani,Ampara,Kalmunai,Eastern,3265,3943,7208,130600,157720,288320
10/7/2024,Gayani Priyadarshani,Ampara,Kalmunai,Eastern,4443,1236,5679,177720,49440,227160
10/8/2024,Gayani Priyadarshani,Ampara,Kalmunai,Eastern,554,6546,7100,22160,261840,284000
10/9/2024,Gayani Priyadarshani,Ampara,Kalmunai,Eastern,9590,5359,14949,383600,214360,597960
10/10/2024,Gayani Priyadarshani,Ampara,Kalmunai,Eastern,1537,4026,5563,61480,161040,222520
10/11/2024,Gayani Priyadarshani,Ampara,Kalmunai,Eastern,1022,976,1998,40880,39040,79920
10/12/2024,Gayani Priyadarshani,Ampara,Kalmunai,Eastern,8470,9984,18454,338800,399360,738160
10/13/2024,Gayani Priyadarshani,Ampara,Kalmunai,Eastern,109,9071,9180,4360,362840,367200
10/14/2024,Gayani Priyadarshani,Ampara,Kalmunai,Eastern,2234,9631,11865,89360,385240,474600
10/15/2024,Gayani Priyadarshani,Ampara,Kalmunai,Eastern,2067,2569,4636,82680,102760,185440
10/16/2024,Gayani Priyadarshani,Ampara,Kalmunai,Eastern,5916,4331,10247,236640,173240,409880
10/17/2024,Gayani Priyadarshani,Ampara,Kalmunai,Eastern,1592,1615,3207,63680,64600,128280
10/18/2024,Gayani Priyadarshani,Ampara,Kalmunai,Eastern,826,6898,7724,33040,275920,308960
10/19/2024,Gayani Priyadarshani,Ampara,Kalmunai,Eastern,5688,4674,10362,227520,186960,414480
10/20/2024,Gayani Priyadarshani,Ampara,Kalmunai,Eastern,3305,6694,9999,132200,267760,399960
10/21/2024,Gayani Priyadarshani,Ampara,Kalmunai,Eastern,1961,5124,7085,78440,204960,283400
10/22/2024,Gayani Priyadarshani,Ampara,Kalmunai,Eastern,220,3367,3587,8800,134680,143480
10/23/2024,Gayani Priyadarshani,Ampara,Kalmunai,Eastern,9816,4502,14318,392640,180080,572720
10/24/2024,Gayani Priyadarshani,Ampara,Kalmunai,Eastern,7834,7114,14948,313360,284560,597920
10/25/2024,Gayani Priyadarshani,Ampara,Kalmunai,Eastern,1235,1466,2701,49400,58640,108040
10/26/2024,Gayani Priyadarshani,Ampara,Kalmunai,Eastern,9567,4735,14302,382680,189400,572080
10/27/2024,Gayani Priyadarshani,Ampara,Kalmunai,Eastern,296,8978,9274,11840,359120,370960
10/28/2024,Gayani Priyadarshani,Ampara,Kalmunai,Eastern,4935,8725,13660,197400,349000,546400
10/29/2024,Gayani Priyadarshani,Ampara,Kalmunai,Eastern,7001,7192,14193,280040,287680,567720
10/30/2024,Gayani Priyadarshani,Ampara,Kalmunai,Eastern,6471,9748,16219,258840,389920,648760
10/31/2024,Gayani Priyadarshani,Ampara,Kalmunai,Eastern,9518,958,10476,380720,38320,419040
11/1/2024,Gayani Priyadarshani,Ampara,Kalmunai,Eastern,1511,7883,9394,60440,315320,375760
11/2/2024,Gayani Priyadarshani,Ampara,Kalmunai,Eastern,5180,714,5894,207200,28560,235760
11/3/2024,Gayani Priyadarshani,Ampara,Kalmunai,Eastern,3607,251,3858,144280,10040,154320
11/4/2024,Gayani Priyadarshani,Ampara,Kalmunai,Eastern,3472,2283,5755,138880,91320,230200
11/5/2024,Gayani Priyadarshani,Ampara,Kalmunai,Eastern,8111,9788,17899,324440,391520,715960
11/6/2024,Gayani Priyadarshani,Ampara,Kalmunai,Eastern,403,3504,3907,16120,140160,156280
11/7/2024,Gayani Priyadarshani,Ampara,Kalmunai,Eastern,6156,4260,10416,246240,170400,416640
11/8/2024,Gayani Priyadarshani,Ampara,Kalmunai,Eastern,3727,7836,11563,149080,313440,462520
11/9/2024,Gayani Priyadarshani,Ampara,Kalmunai,Eastern,1505,5827,7332,60200,233080,293280
11/10/2024,Gayani Priyadarshani,Ampara,Kalmunai,Eastern,484,3771,4255,19360,150840,170200
11/11/2024,Gayani Priyadarshani,Ampara,Kalmunai,Eastern,870,882,1752,34800,35280,70080
11/12/2024,Gayani Priyadarshani,Ampara,Kalmunai,Eastern,1237,7657,8894,49480,306280,355760
11/13/2024,Gayani Priyadarshani,Ampara,Kalmunai,Eastern,7911,4267,12178,316440,170680,487120
11/14/2024,Gayani Priyadarshani,Ampara,Kalmunai,Eastern,5330,9245,14575,213200,369800,583000
11/15/2024,Gayani Priyadarshani,Ampara,Kalmunai,Eastern,3300,4402,7702,132000,176080,308080
11/16/2024,Gayani Priyadarshani,Ampara,Kalmunai,Eastern,8429,2196,10625,337160,87840,425000
11/17/2024,Gayani Priyadarshani,Ampara,Kalmunai,Eastern,8929,6889,15818,357160,275560,632720
11/18/2024,Gayani Priyadarshani,Ampara,Kalmunai,Eastern,3827,6924,10751,153080,276960,430040
11/19/2024,Gayani Priyadarshani,Ampara,Kalmunai,Eastern,3574,5473,9047,142960,218920,361880
11/20/2024,Gayani Priyadarshani,Ampara,Kalmunai,Eastern,9811,2436,12247,392440,97440,489880
11/21/2024,Gayani Priyadarshani,Ampara,Kalmunai,Eastern,7310,6327,13637,292400,253080,545480
11/22/2024,Gayani Priyadarshani,Ampara,Kalmunai,Eastern,2475,6343,8818,99000,253720,352720
11/23/2024,Gayani Priyadarshani,Ampara,Kalmunai,Eastern,1433,2699,4132,57320,107960,165280
11/24/2024,Gayani Priyadarshani,Ampara,Kalmunai,Eastern,3281,7557,10838,131240,302280,433520
11/25/2024,Gayani Priyadarshani,Ampara,Kalmunai,Eastern,5176,3132,8308,207040,125280,332320
11/26/2024,Gayani Priyadarshani,Ampara,Kalmunai,Eastern,1403,6250,7653,56120,250000,306120
11/27/2024,Gayani Priyadarshani,Ampara,Kalmunai,Eastern,8652,7523,16175,346080,300920,647000
11/28/2024,Gayani Priyadarshani,Ampara,Kalmunai,Eastern,8521,2342,10863,340840,93680,434520
11/29/2024,Gayani Priyadarshani,Ampara,Kalmunai,Eastern,3197,6344,9541,127880,253760,381640
11/30/2024,Gayani Priyadarshani,Ampara,Kalmunai,Eastern,8575,1350,9925,343000,54000,397000
12/1/2024,Gayani Priyadarshani,Ampara,Kalmunai,Eastern,3469,814,4283,138760,32560,171320
12/2/2024,Gayani Priyadarshani,Ampara,Kalmunai,Eastern,3951,924,4875,158040,36960,195000
12/3/2024,Gayani Priyadarshani,Ampara,Kalmunai,Eastern,2336,4009,6345,93440,160360,253800
12/4/2024,Gayani Priyadarshani,Ampara,Kalmunai,Eastern,890,4736,5626,35600,189440,225040
12/5/2024,Gayani Priyadarshani,Ampara,Kalmunai,Eastern,2792,1230,4022,111680,49200,160880
12/6/2024,Gayani Priyadarshani,Ampara,Kalmunai,Eastern,8657,4597,13254,346280,183880,530160
12/7/2024,Gayani Priyadarshani,Ampara,Kalmunai,Eastern,1481,7278,8759,59240,291120,350360
12/8/2024,Gayani Priyadarshani,Ampara,Kalmunai,Eastern,8574,7855,16429,342960,314200,657160
12/9/2024,Gayani Priyadarshani,Ampara,Kalmunai,Eastern,2508,3059,5567,100320,122360,222680
12/10/2024,Gayani Priyadarshani,Ampara,Kalmunai,Eastern,3086,2843,5929,123440,113720,237160
12/11/2024,Gayani Priyadarshani,Ampara,Kalmunai,Eastern,2038,1185,3223,81520,47400,128920
12/12/2024,Gayani Priyadarshani,Ampara,Kalmunai,Eastern,7505,9608,17113,300200,384320,684520
12/13/2024,Gayani Priyadarshani,Ampara,Kalmunai,Eastern,1040,3691,4731,41600,147640,189240
12/14/2024,Gayani Priyadarshani,Ampara,Kalmunai,Eastern,6630,6109,12739,265200,244360,509560
12/15/2024,Gayani Priyadarshani,Ampara,Kalmunai,Eastern,4559,6543,11102,182360,261720,444080
12/16/2024,Gayani Priyadarshani,Ampara,Kalmunai,Eastern,4985,5925,10910,199400,237000,436400
12/17/2024,Gayani Priyadarshani,Ampara,Kalmunai,Eastern,2233,3064,5297,89320,122560,211880
12/18/2024,Gayani Priyadarshani,Ampara,Kalmunai,Eastern,7212,4341,11553,288480,173640,462120
12/19/2024,Gayani Priyadarshani,Ampara,Kalmunai,Eastern,5304,5080,10384,212160,203200,415360
12/20/2024,Gayani Priyadarshani,Ampara,Kalmunai,Eastern,3554,9049,12603,142160,361960,504120
12/21/2024,Gayani Priyadarshani,Ampara,Kalmunai,Eastern,4641,290,4931,185640,11600,197240
12/22/2024,Gayani Priyadarshani,Ampara,Kalmunai,Eastern,4320,5705,10025,172800,228200,401000
12/23/2024,Gayani Priyadarshani,Ampara,Kalmunai,Eastern,2891,3896,6787,115640,155840,271480
12/24/2024,Gayani Priyadarshani,Ampara,Kalmunai,Eastern,9099,1385,10484,363960,55400,419360
12/25/2024,Gayani Priyadarshani,Ampara,Kalmunai,Eastern,1642,3452,5094,65680,138080,203760
12/26/2024,Gayani Priyadarshani,Ampara,Kalmunai,Eastern,6047,5686,11733,241880,227440,469320
12/27/2024,Gayani Priyadarshani,Ampara,Kalmunai,Eastern,4620,4663,9283,184800,186520,371320
12/28/2024,Gayani Priyadarshani,Ampara,Kalmunai,Eastern,5858,8675,14533,234320,347000,581320
12/29/2024,Gayani Priyadarshani,Ampara,Kalmunai,Eastern,7242,1114,8356,289680,44560,334240
12/30/2024,Gayani Priyadarshani,Ampara,Kalmunai,Eastern,5350,6294,11644,214000,251760,465760
12/31/2024,Gayani Priyadarshani,Ampara,Kalmunai,Eastern,7813,6965,14778,312520,278600,591120
1/1/2025,Gayani Priyadarshani,Ampara,Kalmunai,Eastern,9211,416,9627,368440,16640,385080
1/2/2025,Gayani Priyadarshani,Ampara,Kalmunai,Eastern,8492,1101,9593,339680,44040,383720
1/3/2025,Gayani Priyadarshani,Ampara,Kalmunai,Eastern,9170,6493,15663,366800,259720,626520
1/4/2025,Gayani Priyadarshani,Ampara,Kalmunai,Eastern,8849,3556,12405,353960,142240,496200
1/5/2025,Gayani Priyadarshani,Ampara,Kalmunai,Eastern,2713,8115,10828,108520,324600,433120
1/6/2025,Gayani Priyadarshani,Ampara,Kalmunai,Eastern,8174,3806,11980,326960,152240,479200
1/7/2025,Gayani Priyadarshani,Ampara,Kalmunai,Eastern,9721,2611,12332,388840,104440,493280
1/8/2025,Gayani Priyadarshani,Ampara,Kalmunai,Eastern,4234,7474,11708,169360,298960,468320
1/9/2025,Gayani Priyadarshani,Ampara,Kalmunai,Eastern,912,1705,2617,36480,68200,104680
1/10/2025,Gayani Priyadarshani,Ampara,Kalmunai,Eastern,6236,4054,10290,249440,162160,411600
1/11/2025,Gayani Priyadarshani,Ampara,Kalmunai,Eastern,8659,8374,17033,346360,334960,681320
1/12/2025,Gayani Priyadarshani,Ampara,Kalmunai,Eastern,4331,4276,8607,173240,171040,344280
1/13/2025,Gayani Priyadarshani,Ampara,Kalmunai,Eastern,3186,4704,7890,127440,188160,315600
1/14/2025,Gayani Priyadarshani,Ampara,Kalmunai,Eastern,8384,1432,9816,335360,57280,392640
1/15/2025,Gayani Priyadarshani,Ampara,Kalmunai,Eastern,2606,157,2763,104240,6280,110520
1/16/2025,Gayani Priyadarshani,Ampara,Kalmunai,Eastern,7811,3814,11625,312440,152560,465000
1/17/2025,Gayani Priyadarshani,Ampara,Kalmunai,Eastern,105,4679,4784,4200,187160,191360
1/18/2025,Gayani Priyadarshani,Ampara,Kalmunai,Eastern,3224,3709,6933,128960,148360,277320
1/19/2025,Gayani Priyadarshani,Ampara,Kalmunai,Eastern,2212,938,3150,88480,37520,126000
1/20/2025,Gayani Priyadarshani,Ampara,Kalmunai,Eastern,7518,8022,15540,300720,320880,621600
1/21/2025,Gayani Priyadarshani,Ampara,Kalmunai,Eastern,7907,853,8760,316280,34120,350400
1/22/2025,Gayani Priyadarshani,Ampara,Kalmunai,Eastern,4137,5898,10035,165480,235920,401400
1/23/2025,Gayani Priyadarshani,Ampara,Kalmunai,Eastern,9258,5741,14999,370320,229640,599960
1/24/2025,Gayani Priyadarshani,Ampara,Kalmunai,Eastern,8156,1545,9701,326240,61800,388040
1/25/2025,Gayani Priyadarshani,Ampara,Kalmunai,Eastern,4563,2187,6750,182520,87480,270000
1/26/2025,Gayani Priyadarshani,Ampara,Kalmunai,Eastern,3353,9025,12378,134120,361000,495120
1/27/2025,Gayani Priyadarshani,Ampara,Kalmunai,Eastern,6028,6727,12755,241120,269080,510200
1/28/2025,Gayani Priyadarshani,Ampara,Kalmunai,Eastern,328,3704,4032,13120,148160,161280
1/29/2025,Gayani Priyadarshani,Ampara,Kalmunai,Eastern,7720,3186,10906,308800,127440,436240
1/30/2025,Gayani Priyadarshani,Ampara,Kalmunai,Eastern,3856,8714,12570,154240,348560,502800
1/31/2025,Gayani Priyadarshani,Ampara,Kalmunai,Eastern,1726,8248,9974,69040,329920,398960
2/1/2025,Gayani Priyadarshani,Ampara,Kalmunai,Eastern,2918,9350,12268,116720,374000,490720
2/2/2025,Gayani Priyadarshani,Ampara,Kalmunai,Eastern,6199,4801,11000,247960,192040,440000
2/3/2025,Gayani Priyadarshani,Ampara,Kalmunai,Eastern,9347,5316,14663,373880,212640,586520
2/4/2025,Gayani Priyadarshani,Ampara,Kalmunai,Eastern,6351,1237,7588,254040,49480,303520
2/5/2025,Gayani Priyadarshani,Ampara,Kalmunai,Eastern,8381,2887,11268,335240,115480,450720
2/6/2025,Gayani Priyadarshani,Ampara,Kalmunai,Eastern,254,7091,7345,10160,283640,293800
2/7/2025,Gayani Priyadarshani,Ampara,Kalmunai,Eastern,2046,5616,7662,81840,224640,306480
2/8/2025,Gayani Priyadarshani,Ampara,Kalmunai,Eastern,726,8287,9013,29040,331480,360520
2/9/2025,Gayani Priyadarshani,Ampara,Kalmunai,Eastern,6747,3529,10276,269880,141160,411040
2/10/2025,Gayani Priyadarshani,Ampara,Kalmunai,Eastern,5308,927,6235,212320,37080,249400
2/11/2025,Gayani Priyadarshani,Ampara,Kalmunai,Eastern,1840,610,2450,73600,24400,98000
2/12/2025,Gayani Priyadarshani,Ampara,Kalmunai,Eastern,3965,1068,5033,158600,42720,201320
2/13/2025,Gayani Priyadarshani,Ampara,Kalmunai,Eastern,3797,9459,13256,151880,378360,530240
2/14/2025,Gayani Priyadarshani,Ampara,Kalmunai,Eastern,9628,2160,11788,385120,86400,471520
2/15/2025,Gayani Priyadarshani,Ampara,Kalmunai,Eastern,5081,8908,13989,203240,356320,559560
2/16/2025,Gayani Priyadarshani,Ampara,Kalmunai,Eastern,2817,1348,4165,112680,53920,166600
2/17/2025,Gayani Priyadarshani,Ampara,Kalmunai,Eastern,1764,2199,3963,70560,87960,158520
2/18/2025,Gayani Priyadarshani,Ampara,Kalmunai,Eastern,7675,7242,14917,307000,289680,596680
2/19/2025,Gayani Priyadarshani,Ampara,Kalmunai,Eastern,812,6520,7332,32480,260800,293280
2/20/2025,Gayani Priyadarshani,Ampara,Kalmunai,Eastern,5091,474,5565,203640,18960,222600
2/21/2025,Gayani Priyadarshani,Ampara,Kalmunai,Eastern,6143,9818,15961,245720,392720,638440
2/22/2025,Gayani Priyadarshani,Ampara,Kalmunai,Eastern,6242,8868,15110,249680,354720,604400
2/23/2025,Gayani Priyadarshani,Ampara,Kalmunai,Eastern,1032,4500,5532,41280,180000,221280
2/24/2025,Gayani Priyadarshani,Ampara,Kalmunai,Eastern,3384,6760,10144,135360,270400,405760
2/25/2025,Gayani Priyadarshani,Ampara,Kalmunai,Eastern,5107,5075,10182,204280,203000,407280
2/26/2025,Gayani Priyadarshani,Ampara,Kalmunai,Eastern,8353,9399,17752,334120,375960,710080
2/27/2025,Gayani Priyadarshani,Ampara,Kalmunai,Eastern,4863,706,5569,194520,28240,222760
2/28/2025,Gayani Priyadarshani,Ampara,Kalmunai,Eastern,7708,6964,14672,308320,278560,586880
3/1/2025,Gayani Priyadarshani,Ampara,Kalmunai,Eastern,4038,1649,5687,161520,65960,227480
3/2/2025,Gayani Priyadarshani,Ampara,Kalmunai,Eastern,7997,7788,15785,319880,311520,631400
3/3/2025,Gayani Priyadarshani,Ampara,Kalmunai,Eastern,4123,8033,12156,164920,321320,486240
3/4/2025,Gayani Priyadarshani,Ampara,Kalmunai,Eastern,3951,3415,7366,158040,136600,294640
3/5/2025,Gayani Priyadarshani,Ampara,Kalmunai,Eastern,5224,1709,6933,208960,68360,277320
3/6/2025,Gayani Priyadarshani,Ampara,Kalmunai,Eastern,3466,7275,10741,138640,291000,429640
3/7/2025,Gayani Priyadarshani,Ampara,Kalmunai,Eastern,5717,6178,11895,228680,247120,475800
3/8/2025,Gayani Priyadarshani,Ampara,Kalmunai,Eastern,6348,7792,14140,253920,311680,565600
3/9/2025,Gayani Priyadarshani,Ampara,Kalmunai,Eastern,2812,7444,10256,112480,297760,410240
3/10/2025,Gayani Priyadarshani,Ampara,Kalmunai,Eastern,3848,5931,9779,153920,237240,391160
3/11/2025,Gayani Priyadarshani,Ampara,Kalmunai,Eastern,8650,2902,11552,346000,116080,462080
3/12/2025,Gayani Priyadarshani,Ampara,Kalmunai,Eastern,1725,4869,6594,69000,194760,263760
3/13/2025,Gayani Priyadarshani,Ampara,Kalmunai,Eastern,493,9048,9541,19720,361920,381640
3/14/2025,Gayani Priyadarshani,Ampara,Kalmunai,Eastern,9413,6539,15952,376520,261560,638080
3/15/2025,Gayani Priyadarshani,Ampara,Kalmunai,Eastern,3813,9610,13423,152520,384400,536920
3/16/2025,Gayani Priyadarshani,Ampara,Kalmunai,Eastern,7550,8949,16499,302000,357960,659960
3/17/2025,Gayani Priyadarshani,Ampara,Kalmunai,Eastern,5181,9704,14885,207240,388160,595400
3/18/2025,Gayani Priyadarshani,Ampara,Kalmunai,Eastern,2897,4483,7380,115880,179320,295200
3/19/2025,Gayani Priyadarshani,Ampara,Kalmunai,Eastern,9628,2938,12566,385120,117520,502640
3/20/2025,Gayani Priyadarshani,Ampara,Kalmunai,Eastern,3755,8805,12560,150200,352200,502400
3/21/2025,Gayani Priyadarshani,Ampara,Kalmunai,Eastern,8090,1463,9553,323600,58520,382120
3/22/2025,Gayani Priyadarshani,Ampara,Kalmunai,Eastern,4334,1247,5581,173360,49880,223240
3/23/2025,Gayani Priyadarshani,Ampara,Kalmunai,Eastern,6469,8175,14644,258760,327000,585760
3/25/2024,Lakmal Samarasinghe,Mannar,Adampan,Northern,9271,9606,18877,370840,384240,755080
3/26/2024,Lakmal Samarasinghe,Mannar,Adampan,Northern,6201,3188,9389,248040,127520,375560
3/27/2024,Lakmal Samarasinghe,Mannar,Adampan,Northern,6791,4715,11506,271640,188600,460240
3/28/2024,Lakmal Samarasinghe,Mannar,Adampan,Northern,7006,5117,12123,280240,204680,484920
3/29/2024,Lakmal Samarasinghe,Mannar,Adampan,Northern,4597,8464,13061,183880,338560,522440
3/30/2024,Lakmal Samarasinghe,Mannar,Adampan,Northern,8622,613,9235,344880,24520,369400
3/31/2024,Lakmal Samarasinghe,Mannar,Adampan,Northern,9111,9049,18160,364440,361960,726400
4/1/2024,Lakmal Samarasinghe,Mannar,Adampan,Northern,5554,2296,7850,222160,91840,314000
4/2/2024,Lakmal Samarasinghe,Mannar,Adampan,Northern,59,7141,7200,2360,285640,288000
4/3/2024,Lakmal Samarasinghe,Mannar,Adampan,Northern,1903,7148,9051,76120,285920,362040
4/4/2024,Lakmal Samarasinghe,Mannar,Adampan,Northern,2766,9363,12129,110640,374520,485160
4/5/2024,Lakmal Samarasinghe,Mannar,Adampan,Northern,432,7286,7718,17280,291440,308720
4/6/2024,Lakmal Samarasinghe,Mannar,Adampan,Northern,3988,535,4523,159520,21400,180920
4/7/2024,Lakmal Samarasinghe,Mannar,Adampan,Northern,1675,1163,2838,67000,46520,113520
4/8/2024,Lakmal Samarasinghe,Mannar,Adampan,Northern,5113,1258,6371,204520,50320,254840
4/9/2024,Lakmal Samarasinghe,Mannar,Adampan,Northern,7431,8923,16354,297240,356920,654160
4/10/2024,Lakmal Samarasinghe,Mannar,Adampan,Northern,9958,5824,15782,398320,232960,631280
4/11/2024,Lakmal Samarasinghe,Mannar,Adampan,Northern,4260,5467,9727,170400,218680,389080
4/19/2024,Lakmal Samarasinghe,Mannar,Adampan,Northern,6657,6623,13280,266280,264920,531200
4/20/2024,Lakmal Samarasinghe,Mannar,Adampan,Northern,8833,3164,11997,353320,126560,479880
4/21/2024,Lakmal Samarasinghe,Mannar,Adampan,Northern,4007,935,4942,160280,37400,197680
4/22/2024,Lakmal Samarasinghe,Mannar,Adampan,Northern,8608,2007,10615,344320,80280,424600
4/23/2024,Lakmal Samarasinghe,Mannar,Adampan,Northern,9730,8318,18048,389200,332720,721920
4/24/2024,Lakmal Samarasinghe,Mannar,Adampan,Northern,3962,9112,13074,158480,364480,522960
4/25/2024,Lakmal Samarasinghe,Mannar,Adampan,Northern,296,2988,3284,11840,119520,131360
4/26/2024,Lakmal Samarasinghe,Mannar,Adampan,Northern,6510,8524,15034,260400,340960,601360
4/27/2024,Lakmal Samarasinghe,Mannar,Adampan,Northern,2194,3278,5472,87760,131120,218880
4/28/2024,Lakmal Samarasinghe,Mannar,Adampan,Northern,7285,4643,11928,291400,185720,477120
4/29/2024,Lakmal Samarasinghe,Mannar,Adampan,Northern,5621,2583,8204,224840,103320,328160
4/30/2024,Lakmal Samarasinghe,Mannar,Adampan,Northern,119,8694,8813,4760,347760,352520
5/1/2024,Lakmal Samarasinghe,Mannar,Adampan,Northern,4926,3483,8409,197040,139320,336360
5/2/2024,Lakmal Samarasinghe,Mannar,Adampan,Northern,7180,2574,9754,287200,102960,390160
5/3/2024,Lakmal Samarasinghe,Mannar,Adampan,Northern,8503,4780,13283,340120,191200,531320
5/4/2024,Lakmal Samarasinghe,Mannar,Adampan,Northern,1594,9769,11363,63760,390760,454520
5/5/2024,Lakmal Samarasinghe,Mannar,Adampan,Northern,5259,6005,11264,210360,240200,450560
5/6/2024,Lakmal Samarasinghe,Mannar,Adampan,Northern,4652,910,5562,186080,36400,222480
5/7/2024,Lakmal Samarasinghe,Mannar,Adampan,Northern,5153,2268,7421,206120,90720,296840
5/8/2024,Lakmal Samarasinghe,Mannar,Adampan,Northern,4966,6640,11606,198640,265600,464240
5/9/2024,Lakmal Samarasinghe,Mannar,Adampan,Northern,4105,6410,10515,164200,256400,420600
5/10/2024,Lakmal Samarasinghe,Mannar,Adampan,Northern,5394,2102,7496,215760,84080,299840
5/11/2024,Lakmal Samarasinghe,Mannar,Adampan,Northern,3847,4697,8544,153880,187880,341760
5/12/2024,Lakmal Samarasinghe,Mannar,Adampan,Northern,6739,1312,8051,269560,52480,322040
5/13/2024,Lakmal Samarasinghe,Mannar,Adampan,Northern,4865,6108,10973,194600,244320,438920
5/14/2024,Lakmal Samarasinghe,Mannar,Adampan,Northern,2427,4470,6897,97080,178800,275880
5/15/2024,Lakmal Samarasinghe,Mannar,Adampan,Northern,9971,8097,18068,398840,323880,722720
5/16/2024,Lakmal Samarasinghe,Mannar,Adampan,Northern,1554,9385,10939,62160,375400,437560
5/17/2024,Lakmal Samarasinghe,Mannar,Adampan,Northern,7567,4235,11802,302680,169400,472080
5/18/2024,Lakmal Samarasinghe,Mannar,Adampan,Northern,131,4543,4674,5240,181720,186960
5/19/2024,Lakmal Samarasinghe,Mannar,Adampan,Northern,918,286,1204,36720,11440,48160
5/20/2024,Lakmal Samarasinghe,Mannar,Adampan,Northern,2501,4331,6832,100040,173240,273280
5/21/2024,Lakmal Samarasinghe,Mannar,Adampan,Northern,4556,2667,7223,182240,106680,288920
5/22/2024,Lakmal Samarasinghe,Mannar,Adampan,Northern,2461,5316,7777,98440,212640,311080
5/24/2024,Lakmal Samarasinghe,Mannar,Adampan,Northern,7344,6954,14298,293760,278160,571920
5/25/2024,Lakmal Samarasinghe,Mannar,Adampan,Northern,2487,3685,6172,99480,147400,246880
5/26/2024,Lakmal Samarasinghe,Mannar,Adampan,Northern,4112,8122,12234,164480,324880,489360
5/27/2024,Lakmal Samarasinghe,Mannar,Adampan,Northern,7672,5759,13431,306880,230360,537240
5/28/2024,Lakmal Samarasinghe,Mannar,Adampan,Northern,9110,855,9965,364400,34200,398600
5/29/2024,Lakmal Samarasinghe,Mannar,Adampan,Northern,3080,5545,8625,123200,221800,345000
5/30/2024,Lakmal Samarasinghe,Mannar,Adampan,Northern,7317,1153,8470,292680,46120,338800
5/31/2024,Lakmal Samarasinghe,Mannar,Adampan,Northern,7950,1561,9511,318000,62440,380440
6/1/2024,Lakmal Samarasinghe,Mannar,Adampan,Northern,8840,5716,14556,353600,228640,582240
6/2/2024,Lakmal Samarasinghe,Mannar,Adampan,Northern,6092,4372,10464,243680,174880,418560
6/3/2024,Lakmal Samarasinghe,Mannar,Adampan,Northern,3209,880,4089,128360,35200,163560
6/4/2024,Lakmal Samarasinghe,Mannar,Adampan,Northern,1751,1620,3371,70040,64800,134840
6/5/2024,Lakmal Samarasinghe,Mannar,Adampan,Northern,5582,86,5668,223280,3440,226720
6/6/2024,Lakmal Samarasinghe,Mannar,Adampan,Northern,2459,4373,6832,98360,174920,273280
6/7/2024,Lakmal Samarasinghe,Mannar,Adampan,Northern,5703,1686,7389,228120,67440,295560
6/8/2024,Lakmal Samarasinghe,Mannar,Adampan,Northern,8733,5574,14307,349320,222960,572280
6/9/2024,Lakmal Samarasinghe,Mannar,Adampan,Northern,5048,5249,10297,201920,209960,411880
6/10/2024,Lakmal Samarasinghe,Mannar,Adampan,Northern,6887,99,6986,275480,3960,279440
6/11/2024,Lakmal Samarasinghe,Mannar,Adampan,Northern,8528,6766,15294,341120,270640,611760
6/12/2024,Lakmal Samarasinghe,Mannar,Adampan,Northern,1570,4160,5730,62800,166400,229200
6/13/2024,Lakmal Samarasinghe,Mannar,Adampan,Northern,7050,2987,10037,282000,119480,401480
6/14/2024,Lakmal Samarasinghe,Mannar,Adampan,Northern,8620,5903,14523,344800,236120,580920
6/15/2024,Lakmal Samarasinghe,Mannar,Adampan,Northern,5947,5092,11039,237880,203680,441560
6/16/2024,Lakmal Samarasinghe,Mannar,Adampan,Northern,1865,4862,6727,74600,194480,269080
6/17/2024,Lakmal Samarasinghe,Mannar,Adampan,Northern,4310,3694,8004,172400,147760,320160
6/18/2024,Lakmal Samarasinghe,Mannar,Adampan,Northern,564,9189,9753,22560,367560,390120
6/19/2024,Lakmal Samarasinghe,Mannar,Adampan,Northern,2099,3741,5840,83960,149640,233600
6/20/2024,Lakmal Samarasinghe,Mannar,Adampan,Northern,5790,791,6581,231600,31640,263240
6/21/2024,Lakmal Samarasinghe,Mannar,Adampan,Northern,5156,2171,7327,206240,86840,293080
6/22/2024,Lakmal Samarasinghe,Mannar,Adampan,Northern,7321,3005,10326,292840,120200,413040
6/23/2024,Lakmal Samarasinghe,Mannar,Adampan,Northern,2481,4733,7214,99240,189320,288560
6/24/2024,Lakmal Samarasinghe,Mannar,Adampan,Northern,2874,6040,8914,114960,241600,356560
6/25/2024,Lakmal Samarasinghe,Mannar,Adampan,Northern,4099,1655,5754,163960,66200,230160
6/26/2024,Lakmal Samarasinghe,Mannar,Adampan,Northern,2274,1444,3718,90960,57760,148720
6/27/2024,Lakmal Samarasinghe,Mannar,Adampan,Northern,7940,6861,14801,317600,274440,592040
6/28/2024,Lakmal Samarasinghe,Mannar,Adampan,Northern,3325,6216,9541,133000,248640,381640
6/29/2024,Lakmal Samarasinghe,Mannar,Adampan,Northern,1004,8048,9052,40160,321920,362080
6/30/2024,Lakmal Samarasinghe,Mannar,Adampan,Northern,423,9570,9993,16920,382800,399720
7/1/2024,Lakmal Samarasinghe,Mannar,Adampan,Northern,8471,8798,17269,338840,351920,690760
7/2/2024,Lakmal Samarasinghe,Mannar,Adampan,Northern,6325,2616,8941,253000,104640,357640
7/3/2024,Lakmal Samarasinghe,Mannar,Adampan,Northern,9227,7,9234,369080,280,369360
7/4/2024,Lakmal Samarasinghe,Mannar,Adampan,Northern,6847,4505,11352,273880,180200,454080
7/5/2024,Lakmal Samarasinghe,Mannar,Adampan,Northern,2583,8784,11367,103320,351360,454680
7/6/2024,Lakmal Samarasinghe,Mannar,Adampan,Northern,8772,8664,17436,350880,346560,697440
7/7/2024,Lakmal Samarasinghe,Mannar,Adampan,Northern,8196,9009,17205,327840,360360,688200
7/8/2024,Lakmal Samarasinghe,Mannar,Adampan,Northern,5660,6093,11753,226400,243720,470120
7/9/2024,Lakmal Samarasinghe,Mannar,Adampan,Northern,684,9430,10114,27360,377200,404560
7/10/2024,Lakmal Samarasinghe,Mannar,Adampan,Northern,3605,5865,9470,144200,234600,378800
7/11/2024,Lakmal Samarasinghe,Mannar,Adampan,Northern,9536,1439,10975,381440,57560,439000
7/12/2024,Lakmal Samarasinghe,Mannar,Adampan,Northern,9641,6243,15884,385640,249720,635360
7/13/2024,Lakmal Samarasinghe,Mannar,Adampan,Northern,1025,9056,10081,41000,362240,403240
7/14/2024,Lakmal Samarasinghe,Mannar,Adampan,Northern,5617,7050,12667,224680,282000,506680
7/15/2024,Lakmal Samarasinghe,Mannar,Adampan,Northern,5401,8141,13542,216040,325640,541680
7/16/2024,Lakmal Samarasinghe,Mannar,Adampan,Northern,1607,7853,9460,64280,314120,378400
7/17/2024,Lakmal Samarasinghe,Mannar,Adampan,Northern,9538,7560,17098,381520,302400,683920
7/18/2024,Lakmal Samarasinghe,Mannar,Adampan,Northern,9988,3706,13694,399520,148240,547760
7/19/2024,Lakmal Samarasinghe,Mannar,Adampan,Northern,5379,7566,12945,215160,302640,517800
7/20/2024,Lakmal Samarasinghe,Mannar,Adampan,Northern,598,2467,3065,23920,98680,122600
7/21/2024,Lakmal Samarasinghe,Mannar,Adampan,Northern,4857,3229,8086,194280,129160,323440
7/22/2024,Lakmal Samarasinghe,Mannar,Adampan,Northern,9538,6618,16156,381520,264720,646240
7/23/2024,Lakmal Samarasinghe,Mannar,Adampan,Northern,542,6418,6960,21680,256720,278400
7/24/2024,Lakmal Samarasinghe,Mannar,Adampan,Northern,1053,6574,7627,42120,262960,305080
7/25/2024,Lakmal Samarasinghe,Mannar,Adampan,Northern,6188,1472,7660,247520,58880,306400
7/26/2024,Lakmal Samarasinghe,Mannar,Adampan,Northern,1125,5717,6842,45000,228680,273680
7/27/2024,Lakmal Samarasinghe,Mannar,Adampan,Northern,7568,4791,12359,302720,191640,494360
7/28/2024,Lakmal Samarasinghe,Mannar,Adampan,Northern,8154,4439,12593,326160,177560,503720
7/29/2024,Lakmal Samarasinghe,Mannar,Adampan,Northern,9885,1859,11744,395400,74360,469760
7/30/2024,Lakmal Samarasinghe,Mannar,Adampan,Northern,663,1205,1868,26520,48200,74720
7/31/2024,Lakmal Samarasinghe,Mannar,Adampan,Northern,5686,7021,12707,227440,280840,508280
8/1/2024,Lakmal Samarasinghe,Mannar,Adampan,Northern,822,2161,2983,32880,86440,119320
8/2/2024,Lakmal Samarasinghe,Mannar,Adampan,Northern,8657,9849,18506,346280,393960,740240
8/3/2024,Lakmal Samarasinghe,Mannar,Adampan,Northern,9956,8318,18274,398240,332720,730960
8/4/2024,Lakmal Samarasinghe,Mannar,Adampan,Northern,4563,5354,9917,182520,214160,396680
8/5/2024,Lakmal Samarasinghe,Mannar,Adampan,Northern,2656,9529,12185,106240,381160,487400
8/6/2024,Lakmal Samarasinghe,Mannar,Adampan,Northern,7378,5637,13015,295120,225480,520600
8/7/2024,Lakmal Samarasinghe,Mannar,Adampan,Northern,5057,9003,14060,202280,360120,562400
8/8/2024,Lakmal Samarasinghe,Mannar,Adampan,Northern,7413,393,7806,296520,15720,312240
8/9/2024,Lakmal Samarasinghe,Mannar,Adampan,Northern,8674,7197,15871,346960,287880,634840
8/10/2024,Lakmal Samarasinghe,Mannar,Adampan,Northern,441,3061,3502,17640,122440,140080
8/11/2024,Lakmal Samarasinghe,Mannar,Adampan,Northern,5685,4928,10613,227400,197120,424520
8/12/2024,Lakmal Samarasinghe,Mannar,Adampan,Northern,8056,9339,17395,322240,373560,695800
8/13/2024,Lakmal Samarasinghe,Mannar,Adampan,Northern,6059,1954,8013,242360,78160,320520
8/14/2024,Lakmal Samarasinghe,Mannar,Adampan,Northern,3344,2151,5495,133760,86040,219800
8/15/2024,Lakmal Samarasinghe,Mannar,Adampan,Northern,3518,1288,4806,140720,51520,192240
8/16/2024,Lakmal Samarasinghe,Mannar,Adampan,Northern,4383,5422,9805,175320,216880,392200
8/17/2024,Lakmal Samarasinghe,Mannar,Adampan,Northern,139,2509,2648,5560,100360,105920
8/18/2024,Lakmal Samarasinghe,Mannar,Adampan,Northern,9153,5010,14163,366120,200400,566520
8/19/2024,Lakmal Samarasinghe,Mannar,Adampan,Northern,9592,2477,12069,383680,99080,482760
8/20/2024,Lakmal Samarasinghe,Mannar,Adampan,Northern,1348,2431,3779,53920,97240,151160
8/21/2024,Lakmal Samarasinghe,Mannar,Adampan,Northern,4997,7594,12591,199880,303760,503640
8/22/2024,Lakmal Samarasinghe,Mannar,Adampan,Northern,4718,8984,13702,188720,359360,548080
8/23/2024,Lakmal Samarasinghe,Mannar,Adampan,Northern,5831,4199,10030,233240,167960,401200
8/24/2024,Lakmal Samarasinghe,Mannar,Adampan,Northern,4505,9991,14496,180200,399640,579840
8/25/2024,Lakmal Samarasinghe,Mannar,Adampan,Northern,3904,1578,5482,156160,63120,219280
8/26/2024,Lakmal Samarasinghe,Mannar,Adampan,Northern,8454,4090,12544,338160,163600,501760
8/27/2024,Lakmal Samarasinghe,Mannar,Adampan,Northern,9110,9235,18345,364400,369400,733800
8/28/2024,Lakmal Samarasinghe,Mannar,Adampan,Northern,7879,4968,12847,315160,198720,513880
8/29/2024,Lakmal Samarasinghe,Mannar,Adampan,Northern,1463,2446,3909,58520,97840,156360
8/30/2024,Lakmal Samarasinghe,Mannar,Adampan,Northern,5855,8680,14535,234200,347200,581400
8/31/2024,Lakmal Samarasinghe,Mannar,Adampan,Northern,6280,1715,7995,251200,68600,319800
9/1/2024,Lakmal Samarasinghe,Mannar,Adampan,Northern,1346,8755,10101,53840,350200,404040
9/2/2024,Lakmal Samarasinghe,Mannar,Adampan,Northern,2968,2718,5686,118720,108720,227440
9/3/2024,Lakmal Samarasinghe,Mannar,Adampan,Northern,8085,7856,15941,323400,314240,637640
9/4/2024,Lakmal Samarasinghe,Mannar,Adampan,Northern,9755,5300,15055,390200,212000,602200
9/5/2024,Lakmal Samarasinghe,Mannar,Adampan,Northern,7115,6278,13393,284600,251120,535720
9/6/2024,Lakmal Samarasinghe,Mannar,Adampan,Northern,8925,8477,17402,357000,339080,696080
9/7/2024,Lakmal Samarasinghe,Mannar,Adampan,Northern,3100,4775,7875,124000,191000,315000
9/8/2024,Lakmal Samarasinghe,Mannar,Adampan,Northern,9519,5121,14640,380760,204840,585600
9/9/2024,Lakmal Samarasinghe,Mannar,Adampan,Northern,7540,5013,12553,301600,200520,502120
9/10/2024,Lakmal Samarasinghe,Mannar,Adampan,Northern,8073,4163,12236,322920,166520,489440
9/11/2024,Lakmal Samarasinghe,Mannar,Adampan,Northern,1684,6189,7873,67360,247560,314920
9/12/2024,Lakmal Samarasinghe,Mannar,Adampan,Northern,6436,9118,15554,257440,364720,622160
9/13/2024,Lakmal Samarasinghe,Mannar,Adampan,Northern,5774,4582,10356,230960,183280,414240
9/14/2024,Lakmal Samarasinghe,Mannar,Adampan,Northern,3106,4209,7315,124240,168360,292600
9/15/2024,Lakmal Samarasinghe,Mannar,Adampan,Northern,30,5738,5768,1200,229520,230720
9/16/2024,Lakmal Samarasinghe,Mannar,Adampan,Northern,4478,3076,7554,179120,123040,302160
9/17/2024,Lakmal Samarasinghe,Mannar,Adampan,Northern,4722,8294,13016,188880,331760,520640
9/18/2024,Lakmal Samarasinghe,Mannar,Adampan,Northern,6427,7218,13645,257080,288720,545800
9/19/2024,Lakmal Samarasinghe,Mannar,Adampan,Northern,5252,9250,14502,210080,370000,580080
9/20/2024,Lakmal Samarasinghe,Mannar,Adampan,Northern,3063,7737,10800,122520,309480,432000
9/21/2024,Lakmal Samarasinghe,Mannar,Adampan,Northern,8942,1574,10516,357680,62960,420640
9/22/2024,Lakmal Samarasinghe,Mannar,Adampan,Northern,3721,3348,7069,148840,133920,282760
9/23/2024,Lakmal Samarasinghe,Mannar,Adampan,Northern,7251,556,7807,290040,22240,312280
9/24/2024,Lakmal Samarasinghe,Mannar,Adampan,Northern,5632,7300,12932,225280,292000,517280
9/25/2024,Lakmal Samarasinghe,Mannar,Adampan,Northern,1666,3073,4739,66640,122920,189560
9/26/2024,Lakmal Samarasinghe,Mannar,Adampan,Northern,8832,5337,14169,353280,213480,566760
9/27/2024,Lakmal Samarasinghe,Mannar,Adampan,Northern,1604,2260,3864,64160,90400,154560
9/28/2024,Lakmal Samarasinghe,Mannar,Adampan,Northern,2440,6512,8952,97600,260480,358080
9/29/2024,Lakmal Samarasinghe,Mannar,Adampan,Northern,4391,9094,13485,175640,363760,539400
9/30/2024,Lakmal Samarasinghe,Mannar,Adampan,Northern,9782,4092,13874,391280,163680,554960
10/1/2024,Lakmal Samarasinghe,Mannar,Adampan,Northern,335,110,445,13400,4400,17800
10/2/2024,Lakmal Samarasinghe,Mannar,Adampan,Northern,550,8821,9371,22000,352840,374840
10/3/2024,Lakmal Samarasinghe,Mannar,Adampan,Northern,9070,1867,10937,362800,74680,437480
10/4/2024,Lakmal Samarasinghe,Mannar,Adampan,Northern,2805,482,3287,112200,19280,131480
10/5/2024,Lakmal Samarasinghe,Mannar,Adampan,Northern,7335,1232,8567,293400,49280,342680
10/6/2024,Lakmal Samarasinghe,Mannar,Adampan,Northern,9110,4253,13363,364400,170120,534520
10/7/2024,Lakmal Samarasinghe,Mannar,Adampan,Northern,6969,9956,16925,278760,398240,677000
10/8/2024,Lakmal Samarasinghe,Mannar,Adampan,Northern,6502,387,6889,260080,15480,275560
10/9/2024,Lakmal Samarasinghe,Mannar,Adampan,Northern,6461,7440,13901,258440,297600,556040
10/10/2024,Lakmal Samarasinghe,Mannar,Adampan,Northern,1774,9189,10963,70960,367560,438520
10/11/2024,Lakmal Samarasinghe,Mannar,Adampan,Northern,9008,141,9149,360320,5640,365960
10/12/2024,Lakmal Samarasinghe,Mannar,Adampan,Northern,2532,8330,10862,101280,333200,434480
10/13/2024,Lakmal Samarasinghe,Mannar,Adampan,Northern,9698,6674,16372,387920,266960,654880
10/14/2024,Lakmal Samarasinghe,Mannar,Adampan,Northern,1725,5119,6844,69000,204760,273760
10/15/2024,Lakmal Samarasinghe,Mannar,Adampan,Northern,6164,4628,10792,246560,185120,431680
10/16/2024,Lakmal Samarasinghe,Mannar,Adampan,Northern,7844,5688,13532,313760,227520,541280
10/17/2024,Lakmal Samarasinghe,Mannar,Adampan,Northern,7853,1552,9405,314120,62080,376200
10/18/2024,Lakmal Samarasinghe,Mannar,Adampan,Northern,366,4141,4507,14640,165640,180280
10/19/2024,Lakmal Samarasinghe,Mannar,Adampan,Northern,9324,7349,16673,372960,293960,666920
10/20/2024,Lakmal Samarasinghe,Mannar,Adampan,Northern,5545,5087,10632,221800,203480,425280
10/21/2024,Lakmal Samarasinghe,Mannar,Adampan,Northern,7248,9812,17060,289920,392480,682400
10/22/2024,Lakmal Samarasinghe,Mannar,Adampan,Northern,8620,4035,12655,344800,161400,506200
10/23/2024,Lakmal Samarasinghe,Mannar,Adampan,Northern,382,5891,6273,15280,235640,250920
10/24/2024,Lakmal Samarasinghe,Mannar,Adampan,Northern,7625,2944,10569,305000,117760,422760
10/25/2024,Lakmal Samarasinghe,Mannar,Adampan,Northern,1244,8918,10162,49760,356720,406480
10/26/2024,Lakmal Samarasinghe,Mannar,Adampan,Northern,5125,6246,11371,205000,249840,454840
10/27/2024,Lakmal Samarasinghe,Mannar,Adampan,Northern,4072,6884,10956,162880,275360,438240
10/28/2024,Lakmal Samarasinghe,Mannar,Adampan,Northern,2979,5855,8834,119160,234200,353360
10/29/2024,Lakmal Samarasinghe,Mannar,Adampan,Northern,3832,8887,12719,153280,355480,508760
10/30/2024,Lakmal Samarasinghe,Mannar,Adampan,Northern,5858,986,6844,234320,39440,273760
10/31/2024,Lakmal Samarasinghe,Mannar,Adampan,Northern,6371,6369,12740,254840,254760,509600
11/1/2024,Lakmal Samarasinghe,Mannar,Adampan,Northern,3149,2253,5402,125960,90120,216080
11/2/2024,Lakmal Samarasinghe,Mannar,Adampan,Northern,9268,3261,12529,370720,130440,501160
11/3/2024,Lakmal Samarasinghe,Mannar,Adampan,Northern,8531,8124,16655,341240,324960,666200
11/4/2024,Lakmal Samarasinghe,Mannar,Adampan,Northern,2648,5838,8486,105920,233520,339440
11/5/2024,Lakmal Samarasinghe,Mannar,Adampan,Northern,3274,4190,7464,130960,167600,298560
11/6/2024,Lakmal Samarasinghe,Mannar,Adampan,Northern,6112,363,6475,244480,14520,259000
11/7/2024,Lakmal Samarasinghe,Mannar,Adampan,Northern,6059,16,6075,242360,640,243000
11/8/2024,Lakmal Samarasinghe,Mannar,Adampan,Northern,434,5015,5449,17360,200600,217960
11/9/2024,Lakmal Samarasinghe,Mannar,Adampan,Northern,3379,5803,9182,135160,232120,367280
11/10/2024,Lakmal Samarasinghe,Mannar,Adampan,Northern,4675,8093,12768,187000,323720,510720
11/11/2024,Lakmal Samarasinghe,Mannar,Adampan,Northern,1483,463,1946,59320,18520,77840
11/12/2024,Lakmal Samarasinghe,Mannar,Adampan,Northern,7585,5458,13043,303400,218320,521720
11/13/2024,Lakmal Samarasinghe,Mannar,Adampan,Northern,419,3889,4308,16760,155560,172320
11/14/2024,Lakmal Samarasinghe,Mannar,Adampan,Northern,8979,4587,13566,359160,183480,542640
11/15/2024,Lakmal Samarasinghe,Mannar,Adampan,Northern,9290,8137,17427,371600,325480,697080
11/16/2024,Lakmal Samarasinghe,Mannar,Adampan,Northern,5730,1738,7468,229200,69520,298720
11/17/2024,Lakmal Samarasinghe,Mannar,Adampan,Northern,4754,6787,11541,190160,271480,461640
11/18/2024,Lakmal Samarasinghe,Mannar,Adampan,Northern,276,455,731,11040,18200,29240
11/19/2024,Lakmal Samarasinghe,Mannar,Adampan,Northern,766,770,1536,30640,30800,61440
11/20/2024,Lakmal Samarasinghe,Mannar,Adampan,Northern,4832,718,5550,193280,28720,222000
11/21/2024,Lakmal Samarasinghe,Mannar,Adampan,Northern,4540,5679,10219,181600,227160,408760
11/22/2024,Lakmal Samarasinghe,Mannar,Adampan,Northern,5384,9673,15057,215360,386920,602280
11/23/2024,Lakmal Samarasinghe,Mannar,Adampan,Northern,2365,8313,10678,94600,332520,427120
11/24/2024,Lakmal Samarasinghe,Mannar,Adampan,Northern,8315,5950,14265,332600,238000,570600
11/25/2024,Lakmal Samarasinghe,Mannar,Adampan,Northern,6696,2056,8752,267840,82240,350080
11/26/2024,Lakmal Samarasinghe,Mannar,Adampan,Northern,309,915,1224,12360,36600,48960
11/27/2024,Lakmal Samarasinghe,Mannar,Adampan,Northern,5810,3283,9093,232400,131320,363720
11/28/2024,Lakmal Samarasinghe,Mannar,Adampan,Northern,8629,6127,14756,345160,245080,590240
11/29/2024,Lakmal Samarasinghe,Mannar,Adampan,Northern,4144,7910,12054,165760,316400,482160
11/30/2024,Lakmal Samarasinghe,Mannar,Adampan,Northern,1932,6410,8342,77280,256400,333680
12/1/2024,Lakmal Samarasinghe,Mannar,Adampan,Northern,2074,2722,4796,82960,108880,191840
12/2/2024,Lakmal Samarasinghe,Mannar,Adampan,Northern,8071,4500,12571,322840,180000,502840
12/3/2024,Lakmal Samarasinghe,Mannar,Adampan,Northern,8034,6950,14984,321360,278000,599360
12/4/2024,Lakmal Samarasinghe,Mannar,Adampan,Northern,838,9308,10146,33520,372320,405840
12/5/2024,Lakmal Samarasinghe,Mannar,Adampan,Northern,811,6252,7063,32440,250080,282520
12/6/2024,Lakmal Samarasinghe,Mannar,Adampan,Northern,9871,3579,13450,394840,143160,538000
12/7/2024,Lakmal Samarasinghe,Mannar,Adampan,Northern,6696,2953,9649,267840,118120,385960
12/8/2024,Lakmal Samarasinghe,Mannar,Adampan,Northern,3356,5704,9060,134240,228160,362400
12/9/2024,Lakmal Samarasinghe,Mannar,Adampan,Northern,8353,5160,13513,334120,206400,540520
12/10/2024,Lakmal Samarasinghe,Mannar,Adampan,Northern,9954,3977,13931,398160,159080,557240
12/11/2024,Lakmal Samarasinghe,Mannar,Adampan,Northern,3027,9156,12183,121080,366240,487320
12/12/2024,Lakmal Samarasinghe,Mannar,Adampan,Northern,4061,2276,6337,162440,91040,253480
12/13/2024,Lakmal Samarasinghe,Mannar,Adampan,Northern,1546,8917,10463,61840,356680,418520
12/14/2024,Lakmal Samarasinghe,Mannar,Adampan,Northern,9144,4707,13851,365760,188280,554040
12/15/2024,Lakmal Samarasinghe,Mannar,Adampan,Northern,6839,4872,11711,273560,194880,468440
12/16/2024,Lakmal Samarasinghe,Mannar,Adampan,Northern,4665,5541,10206,186600,221640,408240
12/17/2024,Lakmal Samarasinghe,Mannar,Adampan,Northern,7552,8422,15974,302080,336880,638960
12/18/2024,Lakmal Samarasinghe,Mannar,Adampan,Northern,566,7678,8244,22640,307120,329760
12/19/2024,Lakmal Samarasinghe,Mannar,Adampan,Northern,1006,9417,10423,40240,376680,416920
12/20/2024,Lakmal Samarasinghe,Mannar,Adampan,Northern,466,1068,1534,18640,42720,61360
12/21/2024,Lakmal Samarasinghe,Mannar,Adampan,Northern,8435,7339,15774,337400,293560,630960
12/22/2024,Lakmal Samarasinghe,Mannar,Adampan,Northern,1303,5324,6627,52120,212960,265080
12/23/2024,Lakmal Samarasinghe,Mannar,Adampan,Northern,6337,121,6458,253480,4840,258320
12/24/2024,Lakmal Samarasinghe,Mannar,Adampan,Northern,9951,3097,13048,398040,123880,521920
12/25/2024,Lakmal Samarasinghe,Mannar,Adampan,Northern,7613,5526,13139,304520,221040,525560
12/26/2024,Lakmal Samarasinghe,Mannar,Adampan,Northern,5073,6882,11955,202920,275280,478200
12/27/2024,Lakmal Samarasinghe,Mannar,Adampan,Northern,1213,6250,7463,48520,250000,298520
12/28/2024,Lakmal Samarasinghe,Mannar,Adampan,Northern,7323,2385,9708,292920,95400,388320
12/29/2024,Lakmal Samarasinghe,Mannar,Adampan,Northern,3455,1007,4462,138200,40280,178480
12/30/2024,Lakmal Samarasinghe,Mannar,Adampan,Northern,644,187,831,25760,7480,33240
12/31/2024,Lakmal Samarasinghe,Mannar,Adampan,Northern,6967,8975,15942,278680,359000,637680
1/1/2025,Lakmal Samarasinghe,Mannar,Adampan,Northern,5987,588,6575,239480,23520,263000
1/2/2025,Lakmal Samarasinghe,Mannar,Adampan,Northern,8804,6056,14860,352160,242240,594400
1/3/2025,Lakmal Samarasinghe,Mannar,Adampan,Northern,3569,6333,9902,142760,253320,396080
1/4/2025,Lakmal Samarasinghe,Mannar,Adampan,Northern,9787,4202,13989,391480,168080,559560
1/5/2025,Lakmal Samarasinghe,Mannar,Adampan,Northern,9873,4968,14841,394920,198720,593640
1/6/2025,Lakmal Samarasinghe,Mannar,Adampan,Northern,1374,1040,2414,54960,41600,96560
1/7/2025,Lakmal Samarasinghe,Mannar,Adampan,Northern,2868,861,3729,114720,34440,149160
1/8/2025,Lakmal Samarasinghe,Mannar,Adampan,Northern,4160,3338,7498,166400,133520,299920
1/9/2025,Lakmal Samarasinghe,Mannar,Adampan,Northern,6647,8985,15632,265880,359400,625280
1/10/2025,Lakmal Samarasinghe,Mannar,Adampan,Northern,2730,1503,4233,109200,60120,169320
1/11/2025,Lakmal Samarasinghe,Mannar,Adampan,Northern,1683,8323,10006,67320,332920,400240
1/12/2025,Lakmal Samarasinghe,Mannar,Adampan,Northern,7609,361,7970,304360,14440,318800
1/13/2025,Lakmal Samarasinghe,Mannar,Adampan,Northern,500,2091,2591,20000,83640,103640
1/14/2025,Lakmal Samarasinghe,Mannar,Adampan,Northern,8093,5712,13805,323720,228480,552200
1/15/2025,Lakmal Samarasinghe,Mannar,Adampan,Northern,9402,4860,14262,376080,194400,570480
1/16/2025,Lakmal Samarasinghe,Mannar,Adampan,Northern,5073,1677,6750,202920,67080,270000
1/17/2025,Lakmal Samarasinghe,Mannar,Adampan,Northern,3847,5209,9056,153880,208360,362240
1/18/2025,Lakmal Samarasinghe,Mannar,Adampan,Northern,5876,4921,10797,235040,196840,431880
1/19/2025,Lakmal Samarasinghe,Mannar,Adampan,Northern,6356,3954,10310,254240,158160,412400
1/20/2025,Lakmal Samarasinghe,Mannar,Adampan,Northern,6567,8880,15447,262680,355200,617880
1/21/2025,Lakmal Samarasinghe,Mannar,Adampan,Northern,2821,6871,9692,112840,274840,387680
1/22/2025,Lakmal Samarasinghe,Mannar,Adampan,Northern,7487,3643,11130,299480,145720,445200
1/23/2025,Lakmal Samarasinghe,Mannar,Adampan,Northern,310,3273,3583,12400,130920,143320
1/24/2025,Lakmal Samarasinghe,Mannar,Adampan,Northern,1543,5320,6863,61720,212800,274520
1/25/2025,Lakmal Samarasinghe,Mannar,Adampan,Northern,3372,4884,8256,134880,195360,330240
1/26/2025,Lakmal Samarasinghe,Mannar,Adampan,Northern,8396,4087,12483,335840,163480,499320
1/27/2025,Lakmal Samarasinghe,Mannar,Adampan,Northern,7997,2678,10675,319880,107120,427000
1/28/2025,Lakmal Samarasinghe,Mannar,Adampan,Northern,752,1853,2605,30080,74120,104200
1/29/2025,Lakmal Samarasinghe,Mannar,Adampan,Northern,4678,5089,9767,187120,203560,390680
1/30/2025,Lakmal Samarasinghe,Mannar,Adampan,Northern,9792,9856,19648,391680,394240,785920
1/31/2025,Lakmal Samarasinghe,Mannar,Adampan,Northern,7951,3586,11537,318040,143440,461480
2/1/2025,Lakmal Samarasinghe,Mannar,Adampan,Northern,2110,7922,10032,84400,316880,401280
2/2/2025,Lakmal Samarasinghe,Mannar,Adampan,Northern,2202,4001,6203,88080,160040,248120
2/3/2025,Lakmal Samarasinghe,Mannar,Adampan,Northern,1656,2203,3859,66240,88120,154360
2/4/2025,Lakmal Samarasinghe,Mannar,Adampan,Northern,3576,7706,11282,143040,308240,451280
2/5/2025,Lakmal Samarasinghe,Mannar,Adampan,Northern,6811,9171,15982,272440,366840,639280
2/6/2025,Lakmal Samarasinghe,Mannar,Adampan,Northern,383,3645,4028,15320,145800,161120
2/7/2025,Lakmal Samarasinghe,Mannar,Adampan,Northern,5039,285,5324,201560,11400,212960
2/8/2025,Lakmal Samarasinghe,Mannar,Adampan,Northern,8955,9001,17956,358200,360040,718240
2/9/2025,Lakmal Samarasinghe,Mannar,Adampan,Northern,1678,7543,9221,67120,301720,368840
2/10/2025,Lakmal Samarasinghe,Mannar,Adampan,Northern,387,6097,6484,15480,243880,259360
2/11/2025,Lakmal Samarasinghe,Mannar,Adampan,Northern,9409,2194,11603,376360,87760,464120
2/12/2025,Lakmal Samarasinghe,Mannar,Adampan,Northern,7009,8539,15548,280360,341560,621920
2/13/2025,Lakmal Samarasinghe,Mannar,Adampan,Northern,3194,2973,6167,127760,118920,246680
2/14/2025,Lakmal Samarasinghe,Mannar,Adampan,Northern,4224,4552,8776,168960,182080,351040
2/15/2025,Lakmal Samarasinghe,Mannar,Adampan,Northern,3253,2802,6055,130120,112080,242200
2/16/2025,Lakmal Samarasinghe,Mannar,Adampan,Northern,7426,7882,15308,297040,315280,612320
2/17/2025,Lakmal Samarasinghe,Mannar,Adampan,Northern,2521,45,2566,100840,1800,102640
2/18/2025,Lakmal Samarasinghe,Mannar,Adampan,Northern,3876,976,4852,155040,39040,194080
2/19/2025,Lakmal Samarasinghe,Mannar,Adampan,Northern,8041,988,9029,321640,39520,361160
2/20/2025,Lakmal Samarasinghe,Mannar,Adampan,Northern,2476,9297,11773,99040,371880,470920
2/21/2025,Lakmal Samarasinghe,Mannar,Adampan,Northern,8130,601,8731,325200,24040,349240
2/22/2025,Lakmal Samarasinghe,Mannar,Adampan,Northern,4805,6859,11664,192200,274360,466560
2/23/2025,Lakmal Samarasinghe,Mannar,Adampan,Northern,6390,9422,15812,255600,376880,632480
2/24/2025,Lakmal Samarasinghe,Mannar,Adampan,Northern,5414,3436,8850,216560,137440,354000
2/25/2025,Lakmal Samarasinghe,Mannar,Adampan,Northern,9402,1176,10578,376080,47040,423120
2/26/2025,Lakmal Samarasinghe,Mannar,Adampan,Northern,9068,1031,10099,362720,41240,403960
2/27/2025,Lakmal Samarasinghe,Mannar,Adampan,Northern,3614,5929,9543,144560,237160,381720
2/28/2025,Lakmal Samarasinghe,Mannar,Adampan,Northern,1174,2646,3820,46960,105840,152800
3/1/2025,Lakmal Samarasinghe,Mannar,Adampan,Northern,6475,8217,14692,259000,328680,587680
3/2/2025,Lakmal Samarasinghe,Mannar,Adampan,Northern,4639,7976,12615,185560,319040,504600
3/3/2025,Lakmal Samarasinghe,Mannar,Adampan,Northern,5526,7416,12942,221040,296640,517680
3/4/2025,Lakmal Samarasinghe,Mannar,Adampan,Northern,1468,8397,9865,58720,335880,394600
3/5/2025,Lakmal Samarasinghe,Mannar,Adampan,Northern,7469,6315,13784,298760,252600,551360
3/6/2025,Lakmal Samarasinghe,Mannar,Adampan,Northern,2315,3316,5631,92600,132640,225240
3/7/2025,Lakmal Samarasinghe,Mannar,Adampan,Northern,3413,9994,13407,136520,399760,536280
3/8/2025,Lakmal Samarasinghe,Mannar,Adampan,Northern,9608,4473,14081,384320,178920,563240
3/9/2025,Lakmal Samarasinghe,Mannar,Adampan,Northern,9629,9365,18994,385160,374600,759760
3/10/2025,Lakmal Samarasinghe,Mannar,Adampan,Northern,2166,722,2888,86640,28880,115520
3/11/2025,Lakmal Samarasinghe,Mannar,Adampan,Northern,5521,5821,11342,220840,232840,453680
3/12/2025,Lakmal Samarasinghe,Mannar,Adampan,Northern,1492,7638,9130,59680,305520,365200
3/13/2025,Lakmal Samarasinghe,Mannar,Adampan,Northern,1597,3203,4800,63880,128120,192000
3/14/2025,Lakmal Samarasinghe,Mannar,Adampan,Northern,2162,5479,7641,86480,219160,305640
3/15/2025,Lakmal Samarasinghe,Mannar,Adampan,Northern,7751,3123,10874,310040,124920,434960
3/16/2025,Lakmal Samarasinghe,Mannar,Adampan,Northern,4762,5634,10396,190480,225360,415840
3/17/2025,Lakmal Samarasinghe,Mannar,Adampan,Northern,1707,55,1762,68280,2200,70480
3/18/2025,Lakmal Samarasinghe,Mannar,Adampan,Northern,2800,9127,11927,112000,365080,477080
3/19/2025,Lakmal Samarasinghe,Mannar,Adampan,Northern,5393,4885,10278,215720,195400,411120
3/20/2025,Lakmal Samarasinghe,Mannar,Adampan,Northern,1071,2611,3682,42840,104440,147280
3/21/2025,Lakmal Samarasinghe,Mannar,Adampan,Northern,3010,724,3734,120400,28960,149360
3/22/2025,Lakmal Samarasinghe,Mannar,Adampan,Northern,4886,998,5884,195440,39920,235360
3/23/2025,Lakmal Samarasinghe,Mannar,Adampan,Northern,8786,5275,14061,351440,211000,562440
3/25/2024,Piyumini Karunarathne,Polonnaruwa,Kahatagasdigiliya,North Central,7991,389,8380,319640,15560,335200
3/26/2024,Piyumini Karunarathne,Polonnaruwa,Kahatagasdigiliya,North Central,6474,8957,15431,258960,358280,617240
3/27/2024,Piyumini Karunarathne,Polonnaruwa,Kahatagasdigiliya,North Central,9541,2159,11700,381640,86360,468000
3/28/2024,Piyumini Karunarathne,Polonnaruwa,Kahatagasdigiliya,North Central,90,6753,6843,3600,270120,273720
3/29/2024,Piyumini Karunarathne,Polonnaruwa,Kahatagasdigiliya,North Central,7962,2838,10800,318480,113520,432000
3/30/2024,Piyumini Karunarathne,Polonnaruwa,Kahatagasdigiliya,North Central,4208,8812,13020,168320,352480,520800
3/31/2024,Piyumini Karunarathne,Polonnaruwa,Kahatagasdigiliya,North Central,5540,2481,8021,221600,99240,320840
4/1/2024,Piyumini Karunarathne,Polonnaruwa,Kahatagasdigiliya,North Central,1386,7538,8924,55440,301520,356960
4/2/2024,Piyumini Karunarathne,Polonnaruwa,Kahatagasdigiliya,North Central,9751,3975,13726,390040,159000,549040
4/3/2024,Piyumini Karunarathne,Polonnaruwa,Kahatagasdigiliya,North Central,259,4352,4611,10360,174080,184440
4/4/2024,Piyumini Karunarathne,Polonnaruwa,Kahatagasdigiliya,North Central,6657,5986,12643,266280,239440,505720
4/5/2024,Piyumini Karunarathne,Polonnaruwa,Kahatagasdigiliya,North Central,4493,3793,8286,179720,151720,331440
4/6/2024,Piyumini Karunarathne,Polonnaruwa,Kahatagasdigiliya,North Central,2460,142,2602,98400,5680,104080
4/7/2024,Piyumini Karunarathne,Polonnaruwa,Kahatagasdigiliya,North Central,7411,459,7870,296440,18360,314800
4/8/2024,Piyumini Karunarathne,Polonnaruwa,Kahatagasdigiliya,North Central,3579,1161,4740,143160,46440,189600
4/9/2024,Piyumini Karunarathne,Polonnaruwa,Kahatagasdigiliya,North Central,4301,4939,9240,172040,197560,369600
4/10/2024,Piyumini Karunarathne,Polonnaruwa,Kahatagasdigiliya,North Central,304,5046,5350,12160,201840,214000
4/11/2024,Piyumini Karunarathne,Polonnaruwa,Kahatagasdigiliya,North Central,2410,26,2436,96400,1040,97440
4/19/2024,Piyumini Karunarathne,Polonnaruwa,Kahatagasdigiliya,North Central,4661,1224,5885,186440,48960,235400
4/20/2024,Piyumini Karunarathne,Polonnaruwa,Kahatagasdigiliya,North Central,116,8736,8852,4640,349440,354080
4/21/2024,Piyumini Karunarathne,Polonnaruwa,Kahatagasdigiliya,North Central,9941,7835,17776,397640,313400,711040
4/22/2024,Piyumini Karunarathne,Polonnaruwa,Kahatagasdigiliya,North Central,4027,2892,6919,161080,115680,276760
4/23/2024,Piyumini Karunarathne,Polonnaruwa,Kahatagasdigiliya,North Central,5193,539,5732,207720,21560,229280
4/24/2024,Piyumini Karunarathne,Polonnaruwa,Kahatagasdigiliya,North Central,8938,3172,12110,357520,126880,484400
4/25/2024,Piyumini Karunarathne,Polonnaruwa,Kahatagasdigiliya,North Central,1897,5562,7459,75880,222480,298360
4/26/2024,Piyumini Karunarathne,Polonnaruwa,Kahatagasdigiliya,North Central,2432,9004,11436,97280,360160,457440
4/27/2024,Piyumini Karunarathne,Polonnaruwa,Kahatagasdigiliya,North Central,9239,6538,15777,369560,261520,631080
4/28/2024,Piyumini Karunarathne,Polonnaruwa,Kahatagasdigiliya,North Central,3579,1032,4611,143160,41280,184440
4/29/2024,Piyumini Karunarathne,Polonnaruwa,Kahatagasdigiliya,North Central,8649,9736,18385,345960,389440,735400
4/30/2024,Piyumini Karunarathne,Polonnaruwa,Kahatagasdigiliya,North Central,981,91,1072,39240,3640,42880
5/1/2024,Piyumini Karunarathne,Polonnaruwa,Kahatagasdigiliya,North Central,3030,6051,9081,121200,242040,363240
5/2/2024,Piyumini Karunarathne,Polonnaruwa,Kahatagasdigiliya,North Central,8110,6378,14488,324400,255120,579520
5/3/2024,Piyumini Karunarathne,Polonnaruwa,Kahatagasdigiliya,North Central,8044,2124,10168,321760,84960,406720
5/4/2024,Piyumini Karunarathne,Polonnaruwa,Kahatagasdigiliya,North Central,794,9556,10350,31760,382240,414000
5/5/2024,Piyumini Karunarathne,Polonnaruwa,Kahatagasdigiliya,North Central,5784,2804,8588,231360,112160,343520
5/6/2024,Piyumini Karunarathne,Polonnaruwa,Kahatagasdigiliya,North Central,1087,9345,10432,43480,373800,417280
5/7/2024,Piyumini Karunarathne,Polonnaruwa,Kahatagasdigiliya,North Central,8210,9347,17557,328400,373880,702280
5/8/2024,Piyumini Karunarathne,Polonnaruwa,Kahatagasdigiliya,North Central,8476,8768,17244,339040,350720,689760
5/9/2024,Piyumini Karunarathne,Polonnaruwa,Kahatagasdigiliya,North Central,5571,3647,9218,222840,145880,368720
5/10/2024,Piyumini Karunarathne,Polonnaruwa,Kahatagasdigiliya,North Central,295,1320,1615,11800,52800,64600
5/11/2024,Piyumini Karunarathne,Polonnaruwa,Kahatagasdigiliya,North Central,3459,5173,8632,138360,206920,345280
5/12/2024,Piyumini Karunarathne,Polonnaruwa,Kahatagasdigiliya,North Central,4618,5073,9691,184720,202920,387640
5/13/2024,Piyumini Karunarathne,Polonnaruwa,Kahatagasdigiliya,North Central,7529,3624,11153,301160,144960,446120
5/14/2024,Piyumini Karunarathne,Polonnaruwa,Kahatagasdigiliya,North Central,5405,5911,11316,216200,236440,452640
5/15/2024,Piyumini Karunarathne,Polonnaruwa,Kahatagasdigiliya,North Central,2208,7184,9392,88320,287360,375680
5/16/2024,Piyumini Karunarathne,Polonnaruwa,Kahatagasdigiliya,North Central,6650,2902,9552,266000,116080,382080
5/17/2024,Piyumini Karunarathne,Polonnaruwa,Kahatagasdigiliya,North Central,3805,1109,4914,152200,44360,196560
5/18/2024,Piyumini Karunarathne,Polonnaruwa,Kahatagasdigiliya,North Central,2324,1638,3962,92960,65520,158480
5/19/2024,Piyumini Karunarathne,Polonnaruwa,Kahatagasdigiliya,North Central,3045,7596,10641,121800,303840,425640
5/20/2024,Piyumini Karunarathne,Polonnaruwa,Kahatagasdigiliya,North Central,8773,7964,16737,350920,318560,669480
5/21/2024,Piyumini Karunarathne,Polonnaruwa,Kahatagasdigiliya,North Central,768,9665,10433,30720,386600,417320
5/22/2024,Piyumini Karunarathne,Polonnaruwa,Kahatagasdigiliya,North Central,624,418,1042,24960,16720,41680
5/24/2024,Piyumini Karunarathne,Polonnaruwa,Kahatagasdigiliya,North Central,6117,7717,13834,244680,308680,553360
5/25/2024,Piyumini Karunarathne,Polonnaruwa,Kahatagasdigiliya,North Central,3676,4188,7864,147040,167520,314560
5/26/2024,Piyumini Karunarathne,Polonnaruwa,Kahatagasdigiliya,North Central,2836,7939,10775,113440,317560,431000
5/27/2024,Piyumini Karunarathne,Polonnaruwa,Kahatagasdigiliya,North Central,1949,7167,9116,77960,286680,364640
5/28/2024,Piyumini Karunarathne,Polonnaruwa,Kahatagasdigiliya,North Central,9563,7463,17026,382520,298520,681040
5/29/2024,Piyumini Karunarathne,Polonnaruwa,Kahatagasdigiliya,North Central,9100,2813,11913,364000,112520,476520
5/30/2024,Piyumini Karunarathne,Polonnaruwa,Kahatagasdigiliya,North Central,3751,8557,12308,150040,342280,492320
5/31/2024,Piyumini Karunarathne,Polonnaruwa,Kahatagasdigiliya,North Central,3548,3834,7382,141920,153360,295280
6/1/2024,Piyumini Karunarathne,Polonnaruwa,Kahatagasdigiliya,North Central,7593,5036,12629,303720,201440,505160
6/2/2024,Piyumini Karunarathne,Polonnaruwa,Kahatagasdigiliya,North Central,4337,3518,7855,173480,140720,314200
6/3/2024,Piyumini Karunarathne,Polonnaruwa,Kahatagasdigiliya,North Central,3925,5562,9487,157000,222480,379480
6/4/2024,Piyumini Karunarathne,Polonnaruwa,Kahatagasdigiliya,North Central,3409,535,3944,136360,21400,157760
6/5/2024,Piyumini Karunarathne,Polonnaruwa,Kahatagasdigiliya,North Central,1902,7553,9455,76080,302120,378200
6/6/2024,Piyumini Karunarathne,Polonnaruwa,Kahatagasdigiliya,North Central,9768,3617,13385,390720,144680,535400
6/7/2024,Piyumini Karunarathne,Polonnaruwa,Kahatagasdigiliya,North Central,3538,4922,8460,141520,196880,338400
6/8/2024,Piyumini Karunarathne,Polonnaruwa,Kahatagasdigiliya,North Central,7643,5683,13326,305720,227320,533040
6/9/2024,Piyumini Karunarathne,Polonnaruwa,Kahatagasdigiliya,North Central,9427,6620,16047,377080,264800,641880
6/10/2024,Piyumini Karunarathne,Polonnaruwa,Kahatagasdigiliya,North Central,3409,3328,6737,136360,133120,269480
6/11/2024,Piyumini Karunarathne,Polonnaruwa,Kahatagasdigiliya,North Central,5954,7972,13926,238160,318880,557040
6/12/2024,Piyumini Karunarathne,Polonnaruwa,Kahatagasdigiliya,North Central,7213,2968,10181,288520,118720,407240
6/13/2024,Piyumini Karunarathne,Polonnaruwa,Kahatagasdigiliya,North Central,3030,8878,11908,121200,355120,476320
6/14/2024,Piyumini Karunarathne,Polonnaruwa,Kahatagasdigiliya,North Central,5570,5155,10725,222800,206200,429000
6/15/2024,Piyumini Karunarathne,Polonnaruwa,Kahatagasdigiliya,North Central,4478,2200,6678,179120,88000,267120
6/16/2024,Piyumini Karunarathne,Polonnaruwa,Kahatagasdigiliya,North Central,3099,6650,9749,123960,266000,389960
6/17/2024,Piyumini Karunarathne,Polonnaruwa,Kahatagasdigiliya,North Central,5418,9019,14437,216720,360760,577480
6/18/2024,Piyumini Karunarathne,Polonnaruwa,Kahatagasdigiliya,North Central,4226,8440,12666,169040,337600,506640
6/19/2024,Piyumini Karunarathne,Polonnaruwa,Kahatagasdigiliya,North Central,9837,1103,10940,393480,44120,437600
6/20/2024,Piyumini Karunarathne,Polonnaruwa,Kahatagasdigiliya,North Central,6331,7690,14021,253240,307600,560840
6/21/2024,Piyumini Karunarathne,Polonnaruwa,Kahatagasdigiliya,North Central,6070,5334,11404,242800,213360,456160
6/22/2024,Piyumini Karunarathne,Polonnaruwa,Kahatagasdigiliya,North Central,9928,6993,16921,397120,279720,676840
6/23/2024,Piyumini Karunarathne,Polonnaruwa,Kahatagasdigiliya,North Central,9503,3332,12835,380120,133280,513400
6/24/2024,Piyumini Karunarathne,Polonnaruwa,Kahatagasdigiliya,North Central,8853,6007,14860,354120,240280,594400
6/25/2024,Piyumini Karunarathne,Polonnaruwa,Kahatagasdigiliya,North Central,5947,911,6858,237880,36440,274320
6/26/2024,Piyumini Karunarathne,Polonnaruwa,Kahatagasdigiliya,North Central,3227,2247,5474,129080,89880,218960
6/27/2024,Piyumini Karunarathne,Polonnaruwa,Kahatagasdigiliya,North Central,9842,1315,11157,393680,52600,446280
6/28/2024,Piyumini Karunarathne,Polonnaruwa,Kahatagasdigiliya,North Central,4090,926,5016,163600,37040,200640
6/29/2024,Piyumini Karunarathne,Polonnaruwa,Kahatagasdigiliya,North Central,2970,3790,6760,118800,151600,270400
6/30/2024,Piyumini Karunarathne,Polonnaruwa,Kahatagasdigiliya,North Central,5496,8713,14209,219840,348520,568360
7/1/2024,Piyumini Karunarathne,Polonnaruwa,Kahatagasdigiliya,North Central,8989,4728,13717,359560,189120,548680
7/2/2024,Piyumini Karunarathne,Polonnaruwa,Kahatagasdigiliya,North Central,5225,5708,10933,209000,228320,437320
7/3/2024,Piyumini Karunarathne,Polonnaruwa,Kahatagasdigiliya,North Central,9524,3104,12628,380960,124160,505120
7/4/2024,Piyumini Karunarathne,Polonnaruwa,Kahatagasdigiliya,North Central,5665,2382,8047,226600,95280,321880
7/5/2024,Piyumini Karunarathne,Polonnaruwa,Kahatagasdigiliya,North Central,6506,6801,13307,260240,272040,532280
7/6/2024,Piyumini Karunarathne,Polonnaruwa,Kahatagasdigiliya,North Central,5786,9139,14925,231440,365560,597000
7/7/2024,Piyumini Karunarathne,Polonnaruwa,Kahatagasdigiliya,North Central,4565,896,5461,182600,35840,218440
7/8/2024,Piyumini Karunarathne,Polonnaruwa,Kahatagasdigiliya,North Central,8556,6654,15210,342240,266160,608400
7/9/2024,Piyumini Karunarathne,Polonnaruwa,Kahatagasdigiliya,North Central,9985,4889,14874,399400,195560,594960
7/10/2024,Piyumini Karunarathne,Polonnaruwa,Kahatagasdigiliya,North Central,2784,108,2892,111360,4320,115680
7/11/2024,Piyumini Karunarathne,Polonnaruwa,Kahatagasdigiliya,North Central,4196,7556,11752,167840,302240,470080
7/12/2024,Piyumini Karunarathne,Polonnaruwa,Kahatagasdigiliya,North Central,2904,5902,8806,116160,236080,352240
7/13/2024,Piyumini Karunarathne,Polonnaruwa,Kahatagasdigiliya,North Central,7968,7516,15484,318720,300640,619360
7/14/2024,Piyumini Karunarathne,Polonnaruwa,Kahatagasdigiliya,North Central,4917,3544,8461,196680,141760,338440
7/15/2024,Piyumini Karunarathne,Polonnaruwa,Kahatagasdigiliya,North Central,3098,5938,9036,123920,237520,361440
7/16/2024,Piyumini Karunarathne,Polonnaruwa,Kahatagasdigiliya,North Central,8801,8034,16835,352040,321360,673400
7/17/2024,Piyumini Karunarathne,Polonnaruwa,Kahatagasdigiliya,North Central,5144,3080,8224,205760,123200,328960
7/18/2024,Piyumini Karunarathne,Polonnaruwa,Kahatagasdigiliya,North Central,5866,5286,11152,234640,211440,446080
7/19/2024,Piyumini Karunarathne,Polonnaruwa,Kahatagasdigiliya,North Central,8605,1357,9962,344200,54280,398480
7/20/2024,Piyumini Karunarathne,Polonnaruwa,Kahatagasdigiliya,North Central,606,232,838,24240,9280,33520
7/21/2024,Piyumini Karunarathne,Polonnaruwa,Kahatagasdigiliya,North Central,366,2051,2417,14640,82040,96680
7/22/2024,Piyumini Karunarathne,Polonnaruwa,Kahatagasdigiliya,North Central,7654,4288,11942,306160,171520,477680
7/23/2024,Piyumini Karunarathne,Polonnaruwa,Kahatagasdigiliya,North Central,3072,9606,12678,122880,384240,507120
7/24/2024,Piyumini Karunarathne,Polonnaruwa,Kahatagasdigiliya,North Central,1348,5150,6498,53920,206000,259920
7/25/2024,Piyumini Karunarathne,Polonnaruwa,Kahatagasdigiliya,North Central,3977,3548,7525,159080,141920,301000
7/26/2024,Piyumini Karunarathne,Polonnaruwa,Kahatagasdigiliya,North Central,5626,8415,14041,225040,336600,561640
7/27/2024,Piyumini Karunarathne,Polonnaruwa,Kahatagasdigiliya,North Central,8964,7599,16563,358560,303960,662520
7/28/2024,Piyumini Karunarathne,Polonnaruwa,Kahatagasdigiliya,North Central,3887,7590,11477,155480,303600,459080
7/29/2024,Piyumini Karunarathne,Polonnaruwa,Kahatagasdigiliya,North Central,2346,5134,7480,93840,205360,299200
7/30/2024,Piyumini Karunarathne,Polonnaruwa,Kahatagasdigiliya,North Central,7885,1157,9042,315400,46280,361680
7/31/2024,Piyumini Karunarathne,Polonnaruwa,Kahatagasdigiliya,North Central,6760,8686,15446,270400,347440,617840
8/1/2024,Piyumini Karunarathne,Polonnaruwa,Kahatagasdigiliya,North Central,9231,3716,12947,369240,148640,517880
8/2/2024,Piyumini Karunarathne,Polonnaruwa,Kahatagasdigiliya,North Central,6010,7504,13514,240400,300160,540560
8/3/2024,Piyumini Karunarathne,Polonnaruwa,Kahatagasdigiliya,North Central,8331,5400,13731,333240,216000,549240
8/4/2024,Piyumini Karunarathne,Polonnaruwa,Kahatagasdigiliya,North Central,3015,5477,8492,120600,219080,339680
8/5/2024,Piyumini Karunarathne,Polonnaruwa,Kahatagasdigiliya,North Central,6770,2148,8918,270800,85920,356720
8/6/2024,Piyumini Karunarathne,Polonnaruwa,Kahatagasdigiliya,North Central,9875,5831,15706,395000,233240,628240
8/7/2024,Piyumini Karunarathne,Polonnaruwa,Kahatagasdigiliya,North Central,8010,8879,16889,320400,355160,675560
8/8/2024,Piyumini Karunarathne,Polonnaruwa,Kahatagasdigiliya,North Central,2866,9130,11996,114640,365200,479840
8/9/2024,Piyumini Karunarathne,Polonnaruwa,Kahatagasdigiliya,North Central,6305,8490,14795,252200,339600,591800
8/10/2024,Piyumini Karunarathne,Polonnaruwa,Kahatagasdigiliya,North Central,4441,4791,9232,177640,191640,369280
8/11/2024,Piyumini Karunarathne,Polonnaruwa,Kahatagasdigiliya,North Central,8360,1883,10243,334400,75320,409720
8/12/2024,Piyumini Karunarathne,Polonnaruwa,Kahatagasdigiliya,North Central,8105,7062,15167,324200,282480,606680
8/13/2024,Piyumini Karunarathne,Polonnaruwa,Kahatagasdigiliya,North Central,9414,718,10132,376560,28720,405280
8/14/2024,Piyumini Karunarathne,Polonnaruwa,Kahatagasdigiliya,North Central,1147,5116,6263,45880,204640,250520
8/15/2024,Piyumini Karunarathne,Polonnaruwa,Kahatagasdigiliya,North Central,8189,6068,14257,327560,242720,570280
8/16/2024,Piyumini Karunarathne,Polonnaruwa,Kahatagasdigiliya,North Central,2815,6507,9322,112600,260280,372880
8/17/2024,Piyumini Karunarathne,Polonnaruwa,Kahatagasdigiliya,North Central,3135,1310,4445,125400,52400,177800
8/18/2024,Piyumini Karunarathne,Polonnaruwa,Kahatagasdigiliya,North Central,8019,5289,13308,320760,211560,532320
8/19/2024,Piyumini Karunarathne,Polonnaruwa,Kahatagasdigiliya,North Central,1975,1999,3974,79000,79960,158960
8/20/2024,Piyumini Karunarathne,Polonnaruwa,Kahatagasdigiliya,North Central,6890,8854,15744,275600,354160,629760
8/21/2024,Piyumini Karunarathne,Polonnaruwa,Kahatagasdigiliya,North Central,2386,710,3096,95440,28400,123840
8/22/2024,Piyumini Karunarathne,Polonnaruwa,Kahatagasdigiliya,North Central,2472,3865,6337,98880,154600,253480
8/23/2024,Piyumini Karunarathne,Polonnaruwa,Kahatagasdigiliya,North Central,1392,5596,6988,55680,223840,279520
8/24/2024,Piyumini Karunarathne,Polonnaruwa,Kahatagasdigiliya,North Central,8886,1704,10590,355440,68160,423600
8/25/2024,Piyumini Karunarathne,Polonnaruwa,Kahatagasdigiliya,North Central,1953,4459,6412,78120,178360,256480
8/26/2024,Piyumini Karunarathne,Polonnaruwa,Kahatagasdigiliya,North Central,8934,7812,16746,357360,312480,669840
8/27/2024,Piyumini Karunarathne,Polonnaruwa,Kahatagasdigiliya,North Central,8828,27,8855,353120,1080,354200
8/28/2024,Piyumini Karunarathne,Polonnaruwa,Kahatagasdigiliya,North Central,2067,5656,7723,82680,226240,308920
8/29/2024,Piyumini Karunarathne,Polonnaruwa,Kahatagasdigiliya,North Central,4085,9324,13409,163400,372960,536360
8/30/2024,Piyumini Karunarathne,Polonnaruwa,Kahatagasdigiliya,North Central,884,9071,9955,35360,362840,398200
8/31/2024,Piyumini Karunarathne,Polonnaruwa,Kahatagasdigiliya,North Central,8546,2166,10712,341840,86640,428480
9/1/2024,Piyumini Karunarathne,Polonnaruwa,Kahatagasdigiliya,North Central,2376,8700,11076,95040,348000,443040
9/2/2024,Piyumini Karunarathne,Polonnaruwa,Kahatagasdigiliya,North Central,1162,9888,11050,46480,395520,442000
9/3/2024,Piyumini Karunarathne,Polonnaruwa,Kahatagasdigiliya,North Central,3659,4403,8062,146360,176120,322480
9/4/2024,Piyumini Karunarathne,Polonnaruwa,Kahatagasdigiliya,North Central,1021,9888,10909,40840,395520,436360
9/5/2024,Piyumini Karunarathne,Polonnaruwa,Kahatagasdigiliya,North Central,9759,4562,14321,390360,182480,572840
9/6/2024,Piyumini Karunarathne,Polonnaruwa,Kahatagasdigiliya,North Central,5422,5809,11231,216880,232360,449240
9/7/2024,Piyumini Karunarathne,Polonnaruwa,Kahatagasdigiliya,North Central,6532,6266,12798,261280,250640,511920
9/8/2024,Piyumini Karunarathne,Polonnaruwa,Kahatagasdigiliya,North Central,9679,8491,18170,387160,339640,726800
9/9/2024,Piyumini Karunarathne,Polonnaruwa,Kahatagasdigiliya,North Central,2988,8734,11722,119520,349360,468880
9/10/2024,Piyumini Karunarathne,Polonnaruwa,Kahatagasdigiliya,North Central,3166,4027,7193,126640,161080,287720
9/11/2024,Piyumini Karunarathne,Polonnaruwa,Kahatagasdigiliya,North Central,1634,196,1830,65360,7840,73200
9/12/2024,Piyumini Karunarathne,Polonnaruwa,Kahatagasdigiliya,North Central,5836,4297,10133,233440,171880,405320
9/13/2024,Piyumini Karunarathne,Polonnaruwa,Kahatagasdigiliya,North Central,4066,3954,8020,162640,158160,320800
9/14/2024,Piyumini Karunarathne,Polonnaruwa,Kahatagasdigiliya,North Central,9503,1187,10690,380120,47480,427600
9/15/2024,Piyumini Karunarathne,Polonnaruwa,Kahatagasdigiliya,North Central,9629,8869,18498,385160,354760,739920
9/16/2024,Piyumini Karunarathne,Polonnaruwa,Kahatagasdigiliya,North Central,84,6238,6322,3360,249520,252880
9/17/2024,Piyumini Karunarathne,Polonnaruwa,Kahatagasdigiliya,North Central,6707,9264,15971,268280,370560,638840
9/18/2024,Piyumini Karunarathne,Polonnaruwa,Kahatagasdigiliya,North Central,4443,8706,13149,177720,348240,525960
9/19/2024,Piyumini Karunarathne,Polonnaruwa,Kahatagasdigiliya,North Central,6904,747,7651,276160,29880,306040
9/20/2024,Piyumini Karunarathne,Polonnaruwa,Kahatagasdigiliya,North Central,5644,7446,13090,225760,297840,523600
9/21/2024,Piyumini Karunarathne,Polonnaruwa,Kahatagasdigiliya,North Central,8244,2776,11020,329760,111040,440800
9/22/2024,Piyumini Karunarathne,Polonnaruwa,Kahatagasdigiliya,North Central,1911,1126,3037,76440,45040,121480
9/23/2024,Piyumini Karunarathne,Polonnaruwa,Kahatagasdigiliya,North Central,2292,3190,5482,91680,127600,219280
9/24/2024,Piyumini Karunarathne,Polonnaruwa,Kahatagasdigiliya,North Central,235,9426,9661,9400,377040,386440
9/25/2024,Piyumini Karunarathne,Polonnaruwa,Kahatagasdigiliya,North Central,1117,3392,4509,44680,135680,180360
9/26/2024,Piyumini Karunarathne,Polonnaruwa,Kahatagasdigiliya,North Central,4128,1404,5532,165120,56160,221280
9/27/2024,Piyumini Karunarathne,Polonnaruwa,Kahatagasdigiliya,North Central,893,1960,2853,35720,78400,114120
9/28/2024,Piyumini Karunarathne,Polonnaruwa,Kahatagasdigiliya,North Central,3672,3499,7171,146880,139960,286840
9/29/2024,Piyumini Karunarathne,Polonnaruwa,Kahatagasdigiliya,North Central,7296,2079,9375,291840,83160,375000
9/30/2024,Piyumini Karunarathne,Polonnaruwa,Kahatagasdigiliya,North Central,2449,2249,4698,97960,89960,187920
10/1/2024,Piyumini Karunarathne,Polonnaruwa,Kahatagasdigiliya,North Central,4212,2427,6639,168480,97080,265560
10/2/2024,Piyumini Karunarathne,Polonnaruwa,Kahatagasdigiliya,North Central,9555,5487,15042,382200,219480,601680
10/3/2024,Piyumini Karunarathne,Polonnaruwa,Kahatagasdigiliya,North Central,2455,715,3170,98200,28600,126800
10/4/2024,Piyumini Karunarathne,Polonnaruwa,Kahatagasdigiliya,North Central,8940,9669,18609,357600,386760,744360
10/5/2024,Piyumini Karunarathne,Polonnaruwa,Kahatagasdigiliya,North Central,3381,1647,5028,135240,65880,201120
10/6/2024,Piyumini Karunarathne,Polonnaruwa,Kahatagasdigiliya,North Central,7780,2406,10186,311200,96240,407440
10/7/2024,Piyumini Karunarathne,Polonnaruwa,Kahatagasdigiliya,North Central,9830,4531,14361,393200,181240,574440
10/8/2024,Piyumini Karunarathne,Polonnaruwa,Kahatagasdigiliya,North Central,1685,6357,8042,67400,254280,321680
10/9/2024,Piyumini Karunarathne,Polonnaruwa,Kahatagasdigiliya,North Central,2858,5368,8226,114320,214720,329040
10/10/2024,Piyumini Karunarathne,Polonnaruwa,Kahatagasdigiliya,North Central,6960,19,6979,278400,760,279160
10/11/2024,Piyumini Karunarathne,Polonnaruwa,Kahatagasdigiliya,North Central,2844,3748,6592,113760,149920,263680
10/12/2024,Piyumini Karunarathne,Polonnaruwa,Kahatagasdigiliya,North Central,1795,9260,11055,71800,370400,442200
10/13/2024,Piyumini Karunarathne,Polonnaruwa,Kahatagasdigiliya,North Central,2355,1609,3964,94200,64360,158560
10/14/2024,Piyumini Karunarathne,Polonnaruwa,Kahatagasdigiliya,North Central,5432,7796,13228,217280,311840,529120
10/15/2024,Piyumini Karunarathne,Polonnaruwa,Kahatagasdigiliya,North Central,4614,6621,11235,184560,264840,449400
10/16/2024,Piyumini Karunarathne,Polonnaruwa,Kahatagasdigiliya,North Central,7485,2802,10287,299400,112080,411480
10/17/2024,Piyumini Karunarathne,Polonnaruwa,Kahatagasdigiliya,North Central,8933,9242,18175,357320,369680,727000
10/18/2024,Piyumini Karunarathne,Polonnaruwa,Kahatagasdigiliya,North Central,7976,3052,11028,319040,122080,441120
10/19/2024,Piyumini Karunarathne,Polonnaruwa,Kahatagasdigiliya,North Central,4601,7714,12315,184040,308560,492600
10/20/2024,Piyumini Karunarathne,Polonnaruwa,Kahatagasdigiliya,North Central,1558,2337,3895,62320,93480,155800
10/21/2024,Piyumini Karunarathne,Polonnaruwa,Kahatagasdigiliya,North Central,8178,1509,9687,327120,60360,387480
10/22/2024,Piyumini Karunarathne,Polonnaruwa,Kahatagasdigiliya,North Central,1830,3733,5563,73200,149320,222520
10/23/2024,Piyumini Karunarathne,Polonnaruwa,Kahatagasdigiliya,North Central,1306,3464,4770,52240,138560,190800
10/24/2024,Piyumini Karunarathne,Polonnaruwa,Kahatagasdigiliya,North Central,2140,2500,4640,85600,100000,185600
10/25/2024,Piyumini Karunarathne,Polonnaruwa,Kahatagasdigiliya,North Central,4470,5464,9934,178800,218560,397360
10/26/2024,Piyumini Karunarathne,Polonnaruwa,Kahatagasdigiliya,North Central,9543,4920,14463,381720,196800,578520
10/27/2024,Piyumini Karunarathne,Polonnaruwa,Kahatagasdigiliya,North Central,4139,7643,11782,165560,305720,471280
10/28/2024,Piyumini Karunarathne,Polonnaruwa,Kahatagasdigiliya,North Central,2437,8247,10684,97480,329880,427360
10/29/2024,Piyumini Karunarathne,Polonnaruwa,Kahatagasdigiliya,North Central,770,7343,8113,30800,293720,324520
10/30/2024,Piyumini Karunarathne,Polonnaruwa,Kahatagasdigiliya,North Central,2269,6439,8708,90760,257560,348320
10/31/2024,Piyumini Karunarathne,Polonnaruwa,Kahatagasdigiliya,North Central,9393,8582,17975,375720,343280,719000
11/1/2024,Piyumini Karunarathne,Polonnaruwa,Kahatagasdigiliya,North Central,9866,3291,13157,394640,131640,526280
11/2/2024,Piyumini Karunarathne,Polonnaruwa,Kahatagasdigiliya,North Central,2544,9993,12537,101760,399720,501480
11/3/2024,Piyumini Karunarathne,Polonnaruwa,Kahatagasdigiliya,North Central,3340,637,3977,133600,25480,159080
11/4/2024,Piyumini Karunarathne,Polonnaruwa,Kahatagasdigiliya,North Central,1488,8510,9998,59520,340400,399920
11/5/2024,Piyumini Karunarathne,Polonnaruwa,Kahatagasdigiliya,North Central,7366,4529,11895,294640,181160,475800
11/6/2024,Piyumini Karunarathne,Polonnaruwa,Kahatagasdigiliya,North Central,4805,5302,10107,192200,212080,404280
11/7/2024,Piyumini Karunarathne,Polonnaruwa,Kahatagasdigiliya,North Central,9200,472,9672,368000,18880,386880
11/8/2024,Piyumini Karunarathne,Polonnaruwa,Kahatagasdigiliya,North Central,5996,4608,10604,239840,184320,424160
11/9/2024,Piyumini Karunarathne,Polonnaruwa,Kahatagasdigiliya,North Central,9037,3846,12883,361480,153840,515320
11/10/2024,Piyumini Karunarathne,Polonnaruwa,Kahatagasdigiliya,North Central,5278,8513,13791,211120,340520,551640
11/11/2024,Piyumini Karunarathne,Polonnaruwa,Kahatagasdigiliya,North Central,1750,2753,4503,70000,110120,180120
11/12/2024,Piyumini Karunarathne,Polonnaruwa,Kahatagasdigiliya,North Central,136,8666,8802,5440,346640,352080
11/13/2024,Piyumini Karunarathne,Polonnaruwa,Kahatagasdigiliya,North Central,7352,4535,11887,294080,181400,475480
11/14/2024,Piyumini Karunarathne,Polonnaruwa,Kahatagasdigiliya,North Central,7378,4466,11844,295120,178640,473760
11/15/2024,Piyumini Karunarathne,Polonnaruwa,Kahatagasdigiliya,North Central,8894,5751,14645,355760,230040,585800
11/16/2024,Piyumini Karunarathne,Polonnaruwa,Kahatagasdigiliya,North Central,4321,3081,7402,172840,123240,296080
11/17/2024,Piyumini Karunarathne,Polonnaruwa,Kahatagasdigiliya,North Central,368,5580,5948,14720,223200,237920
11/18/2024,Piyumini Karunarathne,Polonnaruwa,Kahatagasdigiliya,North Central,8677,9623,18300,347080,384920,732000
11/19/2024,Piyumini Karunarathne,Polonnaruwa,Kahatagasdigiliya,North Central,6064,7167,13231,242560,286680,529240
11/20/2024,Piyumini Karunarathne,Polonnaruwa,Kahatagasdigiliya,North Central,2587,234,2821,103480,9360,112840
11/21/2024,Piyumini Karunarathne,Polonnaruwa,Kahatagasdigiliya,North Central,4847,4095,8942,193880,163800,357680
11/22/2024,Piyumini Karunarathne,Polonnaruwa,Kahatagasdigiliya,North Central,3273,7376,10649,130920,295040,425960
11/23/2024,Piyumini Karunarathne,Polonnaruwa,Kahatagasdigiliya,North Central,8144,6365,14509,325760,254600,580360
11/24/2024,Piyumini Karunarathne,Polonnaruwa,Kahatagasdigiliya,North Central,5249,1232,6481,209960,49280,259240
11/25/2024,Piyumini Karunarathne,Polonnaruwa,Kahatagasdigiliya,North Central,5189,2756,7945,207560,110240,317800
11/26/2024,Piyumini Karunarathne,Polonnaruwa,Kahatagasdigiliya,North Central,5486,9813,15299,219440,392520,611960
11/27/2024,Piyumini Karunarathne,Polonnaruwa,Kahatagasdigiliya,North Central,1486,3851,5337,59440,154040,213480
11/28/2024,Piyumini Karunarathne,Polonnaruwa,Kahatagasdigiliya,North Central,777,5392,6169,31080,215680,246760
11/29/2024,Piyumini Karunarathne,Polonnaruwa,Kahatagasdigiliya,North Central,4763,6924,11687,190520,276960,467480
11/30/2024,Piyumini Karunarathne,Polonnaruwa,Kahatagasdigiliya,North Central,3677,4908,8585,147080,196320,343400
12/1/2024,Piyumini Karunarathne,Polonnaruwa,Kahatagasdigiliya,North Central,2415,4046,6461,96600,161840,258440
12/2/2024,Piyumini Karunarathne,Polonnaruwa,Kahatagasdigiliya,North Central,8644,8734,17378,345760,349360,695120
12/3/2024,Piyumini Karunarathne,Polonnaruwa,Kahatagasdigiliya,North Central,6062,7392,13454,242480,295680,538160
12/4/2024,Piyumini Karunarathne,Polonnaruwa,Kahatagasdigiliya,North Central,1538,8781,10319,61520,351240,412760
12/5/2024,Piyumini Karunarathne,Polonnaruwa,Kahatagasdigiliya,North Central,1205,5509,6714,48200,220360,268560
12/6/2024,Piyumini Karunarathne,Polonnaruwa,Kahatagasdigiliya,North Central,2446,4293,6739,97840,171720,269560
12/7/2024,Piyumini Karunarathne,Polonnaruwa,Kahatagasdigiliya,North Central,1243,63,1306,49720,2520,52240
12/8/2024,Piyumini Karunarathne,Polonnaruwa,Kahatagasdigiliya,North Central,4535,6901,11436,181400,276040,457440
12/9/2024,Piyumini Karunarathne,Polonnaruwa,Kahatagasdigiliya,North Central,7081,3449,10530,283240,137960,421200
12/10/2024,Piyumini Karunarathne,Polonnaruwa,Kahatagasdigiliya,North Central,6117,7654,13771,244680,306160,550840
12/11/2024,Piyumini Karunarathne,Polonnaruwa,Kahatagasdigiliya,North Central,9178,9645,18823,367120,385800,752920
12/12/2024,Piyumini Karunarathne,Polonnaruwa,Kahatagasdigiliya,North Central,3339,6505,9844,133560,260200,393760
12/13/2024,Piyumini Karunarathne,Polonnaruwa,Kahatagasdigiliya,North Central,2839,5144,7983,113560,205760,319320
12/14/2024,Piyumini Karunarathne,Polonnaruwa,Kahatagasdigiliya,North Central,225,4054,4279,9000,162160,171160
12/15/2024,Piyumini Karunarathne,Polonnaruwa,Kahatagasdigiliya,North Central,9598,6480,16078,383920,259200,643120
12/16/2024,Piyumini Karunarathne,Polonnaruwa,Kahatagasdigiliya,North Central,4873,1480,6353,194920,59200,254120
12/17/2024,Piyumini Karunarathne,Polonnaruwa,Kahatagasdigiliya,North Central,4823,5032,9855,192920,201280,394200
12/18/2024,Piyumini Karunarathne,Polonnaruwa,Kahatagasdigiliya,North Central,2547,2841,5388,101880,113640,215520
12/19/2024,Piyumini Karunarathne,Polonnaruwa,Kahatagasdigiliya,North Central,1850,683,2533,74000,27320,101320
12/20/2024,Piyumini Karunarathne,Polonnaruwa,Kahatagasdigiliya,North Central,9629,2046,11675,385160,81840,467000
12/21/2024,Piyumini Karunarathne,Polonnaruwa,Kahatagasdigiliya,North Central,1606,9969,11575,64240,398760,463000
12/22/2024,Piyumini Karunarathne,Polonnaruwa,Kahatagasdigiliya,North Central,2240,2435,4675,89600,97400,187000
12/23/2024,Piyumini Karunarathne,Polonnaruwa,Kahatagasdigiliya,North Central,4042,8041,12083,161680,321640,483320
12/24/2024,Piyumini Karunarathne,Polonnaruwa,Kahatagasdigiliya,North Central,2285,146,2431,91400,5840,97240
12/25/2024,Piyumini Karunarathne,Polonnaruwa,Kahatagasdigiliya,North Central,8696,5478,14174,347840,219120,566960
12/26/2024,Piyumini Karunarathne,Polonnaruwa,Kahatagasdigiliya,North Central,9408,524,9932,376320,20960,397280
12/27/2024,Piyumini Karunarathne,Polonnaruwa,Kahatagasdigiliya,North Central,4219,9789,14008,168760,391560,560320
12/28/2024,Piyumini Karunarathne,Polonnaruwa,Kahatagasdigiliya,North Central,7674,1606,9280,306960,64240,371200
12/29/2024,Piyumini Karunarathne,Polonnaruwa,Kahatagasdigiliya,North Central,6935,3034,9969,277400,121360,398760
12/30/2024,Piyumini Karunarathne,Polonnaruwa,Kahatagasdigiliya,North Central,8014,4514,12528,320560,180560,501120
12/31/2024,Piyumini Karunarathne,Polonnaruwa,Kahatagasdigiliya,North Central,7562,2482,10044,302480,99280,401760
1/1/2025,Piyumini Karunarathne,Polonnaruwa,Kahatagasdigiliya,North Central,2976,862,3838,119040,34480,153520
1/2/2025,Piyumini Karunarathne,Polonnaruwa,Kahatagasdigiliya,North Central,9587,9576,19163,383480,383040,766520
1/3/2025,Piyumini Karunarathne,Polonnaruwa,Kahatagasdigiliya,North Central,6782,1451,8233,271280,58040,329320
1/4/2025,Piyumini Karunarathne,Polonnaruwa,Kahatagasdigiliya,North Central,2399,1211,3610,95960,48440,144400
1/5/2025,Piyumini Karunarathne,Polonnaruwa,Kahatagasdigiliya,North Central,2741,8402,11143,109640,336080,445720
1/6/2025,Piyumini Karunarathne,Polonnaruwa,Kahatagasdigiliya,North Central,3982,7309,11291,159280,292360,451640
1/7/2025,Piyumini Karunarathne,Polonnaruwa,Kahatagasdigiliya,North Central,2180,8924,11104,87200,356960,444160
1/8/2025,Piyumini Karunarathne,Polonnaruwa,Kahatagasdigiliya,North Central,7962,1473,9435,318480,58920,377400
1/9/2025,Piyumini Karunarathne,Polonnaruwa,Kahatagasdigiliya,North Central,5942,9611,15553,237680,384440,622120
1/10/2025,Piyumini Karunarathne,Polonnaruwa,Kahatagasdigiliya,North Central,2627,4892,7519,105080,195680,300760
1/11/2025,Piyumini Karunarathne,Polonnaruwa,Kahatagasdigiliya,North Central,6556,7826,14382,262240,313040,575280
1/12/2025,Piyumini Karunarathne,Polonnaruwa,Kahatagasdigiliya,North Central,7600,3106,10706,304000,124240,428240
1/13/2025,Piyumini Karunarathne,Polonnaruwa,Kahatagasdigiliya,North Central,174,5282,5456,6960,211280,218240
1/14/2025,Piyumini Karunarathne,Polonnaruwa,Kahatagasdigiliya,North Central,4378,2021,6399,175120,80840,255960
1/15/2025,Piyumini Karunarathne,Polonnaruwa,Kahatagasdigiliya,North Central,367,7933,8300,14680,317320,332000
1/16/2025,Piyumini Karunarathne,Polonnaruwa,Kahatagasdigiliya,North Central,61,989,1050,2440,39560,42000
1/17/2025,Piyumini Karunarathne,Polonnaruwa,Kahatagasdigiliya,North Central,956,538,1494,38240,21520,59760
1/18/2025,Piyumini Karunarathne,Polonnaruwa,Kahatagasdigiliya,North Central,7535,3016,10551,301400,120640,422040
1/19/2025,Piyumini Karunarathne,Polonnaruwa,Kahatagasdigiliya,North Central,2164,7479,9643,86560,299160,385720
1/20/2025,Piyumini Karunarathne,Polonnaruwa,Kahatagasdigiliya,North Central,5817,9331,15148,232680,373240,605920
1/21/2025,Piyumini Karunarathne,Polonnaruwa,Kahatagasdigiliya,North Central,4262,8313,12575,170480,332520,503000
1/22/2025,Piyumini Karunarathne,Polonnaruwa,Kahatagasdigiliya,North Central,7353,3526,10879,294120,141040,435160
1/23/2025,Piyumini Karunarathne,Polonnaruwa,Kahatagasdigiliya,North Central,838,6507,7345,33520,260280,293800
1/24/2025,Piyumini Karunarathne,Polonnaruwa,Kahatagasdigiliya,North Central,584,4379,4963,23360,175160,198520
1/25/2025,Piyumini Karunarathne,Polonnaruwa,Kahatagasdigiliya,North Central,868,2586,3454,34720,103440,138160
1/26/2025,Piyumini Karunarathne,Polonnaruwa,Kahatagasdigiliya,North Central,2550,4997,7547,102000,199880,301880
1/27/2025,Piyumini Karunarathne,Polonnaruwa,Kahatagasdigiliya,North Central,4463,5295,9758,178520,211800,390320
1/28/2025,Piyumini Karunarathne,Polonnaruwa,Kahatagasdigiliya,North Central,4441,4972,9413,177640,198880,376520
1/29/2025,Piyumini Karunarathne,Polonnaruwa,Kahatagasdigiliya,North Central,5420,3130,8550,216800,125200,342000
1/30/2025,Piyumini Karunarathne,Polonnaruwa,Kahatagasdigiliya,North Central,6801,4683,11484,272040,187320,459360
1/31/2025,Piyumini Karunarathne,Polonnaruwa,Kahatagasdigiliya,North Central,651,9295,9946,26040,371800,397840
2/1/2025,Piyumini Karunarathne,Polonnaruwa,Kahatagasdigiliya,North Central,8199,9632,17831,327960,385280,713240
2/2/2025,Piyumini Karunarathne,Polonnaruwa,Kahatagasdigiliya,North Central,7590,6970,14560,303600,278800,582400
2/3/2025,Piyumini Karunarathne,Polonnaruwa,Kahatagasdigiliya,North Central,9439,5537,14976,377560,221480,599040
2/4/2025,Piyumini Karunarathne,Polonnaruwa,Kahatagasdigiliya,North Central,5012,8364,13376,200480,334560,535040
2/5/2025,Piyumini Karunarathne,Polonnaruwa,Kahatagasdigiliya,North Central,5012,4653,9665,200480,186120,386600
2/6/2025,Piyumini Karunarathne,Polonnaruwa,Kahatagasdigiliya,North Central,79,9934,10013,3160,397360,400520
2/7/2025,Piyumini Karunarathne,Polonnaruwa,Kahatagasdigiliya,North Central,6260,7556,13816,250400,302240,552640
2/8/2025,Piyumini Karunarathne,Polonnaruwa,Kahatagasdigiliya,North Central,7687,5885,13572,307480,235400,542880
2/9/2025,Piyumini Karunarathne,Polonnaruwa,Kahatagasdigiliya,North Central,1910,9398,11308,76400,375920,452320
2/10/2025,Piyumini Karunarathne,Polonnaruwa,Kahatagasdigiliya,North Central,5358,1981,7339,214320,79240,293560
2/11/2025,Piyumini Karunarathne,Polonnaruwa,Kahatagasdigiliya,North Central,1907,6253,8160,76280,250120,326400
2/12/2025,Piyumini Karunarathne,Polonnaruwa,Kahatagasdigiliya,North Central,2559,1952,4511,102360,78080,180440
2/13/2025,Piyumini Karunarathne,Polonnaruwa,Kahatagasdigiliya,North Central,6142,9723,15865,245680,388920,634600
2/14/2025,Piyumini Karunarathne,Polonnaruwa,Kahatagasdigiliya,North Central,4459,934,5393,178360,37360,215720
2/15/2025,Piyumini Karunarathne,Polonnaruwa,Kahatagasdigiliya,North Central,9170,9964,19134,366800,398560,765360
2/16/2025,Piyumini Karunarathne,Polonnaruwa,Kahatagasdigiliya,North Central,8199,4942,13141,327960,197680,525640
2/17/2025,Piyumini Karunarathne,Polonnaruwa,Kahatagasdigiliya,North Central,5598,2934,8532,223920,117360,341280
2/18/2025,Piyumini Karunarathne,Polonnaruwa,Kahatagasdigiliya,North Central,9338,149,9487,373520,5960,379480
2/19/2025,Piyumini Karunarathne,Polonnaruwa,Kahatagasdigiliya,North Central,7929,511,8440,317160,20440,337600
2/20/2025,Piyumini Karunarathne,Polonnaruwa,Kahatagasdigiliya,North Central,5645,7401,13046,225800,296040,521840
2/21/2025,Piyumini Karunarathne,Polonnaruwa,Kahatagasdigiliya,North Central,7696,1143,8839,307840,45720,353560
2/22/2025,Piyumini Karunarathne,Polonnaruwa,Kahatagasdigiliya,North Central,1388,8165,9553,55520,326600,382120
2/23/2025,Piyumini Karunarathne,Polonnaruwa,Kahatagasdigiliya,North Central,7571,1673,9244,302840,66920,369760
2/24/2025,Piyumini Karunarathne,Polonnaruwa,Kahatagasdigiliya,North Central,2159,9280,11439,86360,371200,457560
2/25/2025,Piyumini Karunarathne,Polonnaruwa,Kahatagasdigiliya,North Central,3848,5472,9320,153920,218880,372800
2/26/2025,Piyumini Karunarathne,Polonnaruwa,Kahatagasdigiliya,North Central,3465,6834,10299,138600,273360,411960
2/27/2025,Piyumini Karunarathne,Polonnaruwa,Kahatagasdigiliya,North Central,2951,4327,7278,118040,173080,291120
2/28/2025,Piyumini Karunarathne,Polonnaruwa,Kahatagasdigiliya,North Central,8687,7460,16147,347480,298400,645880
3/1/2025,Piyumini Karunarathne,Polonnaruwa,Kahatagasdigiliya,North Central,868,9384,10252,34720,375360,410080
3/2/2025,Piyumini Karunarathne,Polonnaruwa,Kahatagasdigiliya,North Central,9837,5319,15156,393480,212760,606240
3/3/2025,Piyumini Karunarathne,Polonnaruwa,Kahatagasdigiliya,North Central,6532,7839,14371,261280,313560,574840
3/4/2025,Piyumini Karunarathne,Polonnaruwa,Kahatagasdigiliya,North Central,2386,5800,8186,95440,232000,327440
3/5/2025,Piyumini Karunarathne,Polonnaruwa,Kahatagasdigiliya,North Central,2260,9224,11484,90400,368960,459360
3/6/2025,Piyumini Karunarathne,Polonnaruwa,Kahatagasdigiliya,North Central,1704,2584,4288,68160,103360,171520
3/7/2025,Piyumini Karunarathne,Polonnaruwa,Kahatagasdigiliya,North Central,4222,7473,11695,168880,298920,467800
3/8/2025,Piyumini Karunarathne,Polonnaruwa,Kahatagasdigiliya,North Central,8594,4104,12698,343760,164160,507920
3/9/2025,Piyumini Karunarathne,Polonnaruwa,Kahatagasdigiliya,North Central,974,5227,6201,38960,209080,248040
3/10/2025,Piyumini Karunarathne,Polonnaruwa,Kahatagasdigiliya,North Central,1603,375,1978,64120,15000,79120
3/11/2025,Piyumini Karunarathne,Polonnaruwa,Kahatagasdigiliya,North Central,6123,2162,8285,244920,86480,331400
3/12/2025,Piyumini Karunarathne,Polonnaruwa,Kahatagasdigiliya,North Central,7632,678,8310,305280,27120,332400
3/13/2025,Piyumini Karunarathne,Polonnaruwa,Kahatagasdigiliya,North Central,611,5501,6112,24440,220040,244480
3/14/2025,Piyumini Karunarathne,Polonnaruwa,Kahatagasdigiliya,North Central,7672,2188,9860,306880,87520,394400
3/15/2025,Piyumini Karunarathne,Polonnaruwa,Kahatagasdigiliya,North Central,9631,4483,14114,385240,179320,564560
3/16/2025,Piyumini Karunarathne,Polonnaruwa,Kahatagasdigiliya,North Central,3376,5213,8589,135040,208520,343560
3/17/2025,Piyumini Karunarathne,Polonnaruwa,Kahatagasdigiliya,North Central,9606,141,9747,384240,5640,389880
3/18/2025,Piyumini Karunarathne,Polonnaruwa,Kahatagasdigiliya,North Central,8557,3408,11965,342280,136320,478600
3/19/2025,Piyumini Karunarathne,Polonnaruwa,Kahatagasdigiliya,North Central,8929,8855,17784,357160,354200,711360
3/20/2025,Piyumini Karunarathne,Polonnaruwa,Kahatagasdigiliya,North Central,8464,3054,11518,338560,122160,460720
3/21/2025,Piyumini Karunarathne,Polonnaruwa,Kahatagasdigiliya,North Central,8679,2027,10706,347160,81080,428240
3/22/2025,Piyumini Karunarathne,Polonnaruwa,Kahatagasdigiliya,North Central,8369,530,8899,334760,21200,355960
3/23/2025,Piyumini Karunarathne,Polonnaruwa,Kahatagasdigiliya,North Central,2984,5389,8373,119360,215560,334920
3/25/2024,Rajitha Karunarathne,Galle,Hikkaduwa,Southern,314,9141,9455,12560,365640,378200
3/26/2024,Rajitha Karunarathne,Galle,Hikkaduwa,Southern,3600,2285,5885,144000,91400,235400
3/27/2024,Rajitha Karunarathne,Galle,Hikkaduwa,Southern,7925,8763,16688,317000,350520,667520
3/28/2024,Rajitha Karunarathne,Galle,Hikkaduwa,Southern,4539,9660,14199,181560,386400,567960
3/29/2024,Rajitha Karunarathne,Galle,Hikkaduwa,Southern,5225,4564,9789,209000,182560,391560
3/30/2024,Rajitha Karunarathne,Galle,Hikkaduwa,Southern,1262,7635,8897,50480,305400,355880
3/31/2024,Rajitha Karunarathne,Galle,Hikkaduwa,Southern,276,8981,9257,11040,359240,370280
4/1/2024,Rajitha Karunarathne,Galle,Hikkaduwa,Southern,5405,3126,8531,216200,125040,341240
4/2/2024,Rajitha Karunarathne,Galle,Hikkaduwa,Southern,6878,8342,15220,275120,333680,608800
4/3/2024,Rajitha Karunarathne,Galle,Hikkaduwa,Southern,5204,4129,9333,208160,165160,373320
4/4/2024,Rajitha Karunarathne,Galle,Hikkaduwa,Southern,7692,6131,13823,307680,245240,552920
4/5/2024,Rajitha Karunarathne,Galle,Hikkaduwa,Southern,5951,7109,13060,238040,284360,522400
4/6/2024,Rajitha Karunarathne,Galle,Hikkaduwa,Southern,7984,3021,11005,319360,120840,440200
4/7/2024,Rajitha Karunarathne,Galle,Hikkaduwa,Southern,9068,9237,18305,362720,369480,732200
4/8/2024,Rajitha Karunarathne,Galle,Hikkaduwa,Southern,4394,9318,13712,175760,372720,548480
4/9/2024,Rajitha Karunarathne,Galle,Hikkaduwa,Southern,4410,6146,10556,176400,245840,422240
4/10/2024,Rajitha Karunarathne,Galle,Hikkaduwa,Southern,4152,9670,13822,166080,386800,552880
4/11/2024,Rajitha Karunarathne,Galle,Hikkaduwa,Southern,345,2717,3062,13800,108680,122480
4/19/2024,Rajitha Karunarathne,Galle,Hikkaduwa,Southern,8906,7778,16684,356240,311120,667360
4/20/2024,Rajitha Karunarathne,Galle,Hikkaduwa,Southern,4772,1055,5827,190880,42200,233080
4/21/2024,Rajitha Karunarathne,Galle,Hikkaduwa,Southern,7275,4039,11314,291000,161560,452560
4/22/2024,Rajitha Karunarathne,Galle,Hikkaduwa,Southern,2367,285,2652,94680,11400,106080
4/23/2024,Rajitha Karunarathne,Galle,Hikkaduwa,Southern,7285,8347,15632,291400,333880,625280
4/24/2024,Rajitha Karunarathne,Galle,Hikkaduwa,Southern,6693,1933,8626,267720,77320,345040
4/25/2024,Rajitha Karunarathne,Galle,Hikkaduwa,Southern,9246,1957,11203,369840,78280,448120
4/26/2024,Rajitha Karunarathne,Galle,Hikkaduwa,Southern,713,2879,3592,28520,115160,143680
4/27/2024,Rajitha Karunarathne,Galle,Hikkaduwa,Southern,3403,8859,12262,136120,354360,490480
4/28/2024,Rajitha Karunarathne,Galle,Hikkaduwa,Southern,6014,9494,15508,240560,379760,620320
4/29/2024,Rajitha Karunarathne,Galle,Hikkaduwa,Southern,1663,8903,10566,66520,356120,422640
4/30/2024,Rajitha Karunarathne,Galle,Hikkaduwa,Southern,2817,507,3324,112680,20280,132960
5/1/2024,Rajitha Karunarathne,Galle,Hikkaduwa,Southern,5300,832,6132,212000,33280,245280
5/2/2024,Rajitha Karunarathne,Galle,Hikkaduwa,Southern,3050,5782,8832,122000,231280,353280
5/3/2024,Rajitha Karunarathne,Galle,Hikkaduwa,Southern,4701,3724,8425,188040,148960,337000
5/4/2024,Rajitha Karunarathne,Galle,Hikkaduwa,Southern,1530,9468,10998,61200,378720,439920
5/5/2024,Rajitha Karunarathne,Galle,Hikkaduwa,Southern,6387,6188,12575,255480,247520,503000
5/6/2024,Rajitha Karunarathne,Galle,Hikkaduwa,Southern,1257,3660,4917,50280,146400,196680
5/7/2024,Rajitha Karunarathne,Galle,Hikkaduwa,Southern,5741,1733,7474,229640,69320,298960
5/8/2024,Rajitha Karunarathne,Galle,Hikkaduwa,Southern,7383,241,7624,295320,9640,304960
5/9/2024,Rajitha Karunarathne,Galle,Hikkaduwa,Southern,9150,8374,17524,366000,334960,700960
5/10/2024,Rajitha Karunarathne,Galle,Hikkaduwa,Southern,3311,6286,9597,132440,251440,383880
5/11/2024,Rajitha Karunarathne,Galle,Hikkaduwa,Southern,8083,235,8318,323320,9400,332720
5/12/2024,Rajitha Karunarathne,Galle,Hikkaduwa,Southern,6359,5322,11681,254360,212880,467240
5/13/2024,Rajitha Karunarathne,Galle,Hikkaduwa,Southern,1295,6264,7559,51800,250560,302360
5/14/2024,Rajitha Karunarathne,Galle,Hikkaduwa,Southern,7507,4636,12143,300280,185440,485720
5/15/2024,Rajitha Karunarathne,Galle,Hikkaduwa,Southern,9310,8416,17726,372400,336640,709040
5/16/2024,Rajitha Karunarathne,Galle,Hikkaduwa,Southern,858,6773,7631,34320,270920,305240
5/17/2024,Rajitha Karunarathne,Galle,Hikkaduwa,Southern,578,6508,7086,23120,260320,283440
5/18/2024,Rajitha Karunarathne,Galle,Hikkaduwa,Southern,9136,932,10068,365440,37280,402720
5/19/2024,Rajitha Karunarathne,Galle,Hikkaduwa,Southern,6186,241,6427,247440,9640,257080
5/20/2024,Rajitha Karunarathne,Galle,Hikkaduwa,Southern,2069,8211,10280,82760,328440,411200
5/21/2024,Rajitha Karunarathne,Galle,Hikkaduwa,Southern,4771,6248,11019,190840,249920,440760
5/22/2024,Rajitha Karunarathne,Galle,Hikkaduwa,Southern,7401,7390,14791,296040,295600,591640
5/24/2024,Rajitha Karunarathne,Galle,Hikkaduwa,Southern,3738,6114,9852,149520,244560,394080
5/25/2024,Rajitha Karunarathne,Galle,Hikkaduwa,Southern,9634,8741,18375,385360,349640,735000
5/26/2024,Rajitha Karunarathne,Galle,Hikkaduwa,Southern,5726,9388,15114,229040,375520,604560
5/27/2024,Rajitha Karunarathne,Galle,Hikkaduwa,Southern,2844,7561,10405,113760,302440,416200
5/28/2024,Rajitha Karunarathne,Galle,Hikkaduwa,Southern,4569,4004,8573,182760,160160,342920
5/29/2024,Rajitha Karunarathne,Galle,Hikkaduwa,Southern,192,5949,6141,7680,237960,245640
5/30/2024,Rajitha Karunarathne,Galle,Hikkaduwa,Southern,7192,1263,8455,287680,50520,338200
5/31/2024,Rajitha Karunarathne,Galle,Hikkaduwa,Southern,1514,7742,9256,60560,309680,370240
6/1/2024,Rajitha Karunarathne,Galle,Hikkaduwa,Southern,1070,6981,8051,42800,279240,322040
6/2/2024,Rajitha Karunarathne,Galle,Hikkaduwa,Southern,2726,1120,3846,109040,44800,153840
6/3/2024,Rajitha Karunarathne,Galle,Hikkaduwa,Southern,6204,9894,16098,248160,395760,643920
6/4/2024,Rajitha Karunarathne,Galle,Hikkaduwa,Southern,1431,8078,9509,57240,323120,380360
6/5/2024,Rajitha Karunarathne,Galle,Hikkaduwa,Southern,8469,5802,14271,338760,232080,570840
6/6/2024,Rajitha Karunarathne,Galle,Hikkaduwa,Southern,4660,3416,8076,186400,136640,323040
6/7/2024,Rajitha Karunarathne,Galle,Hikkaduwa,Southern,4568,8915,13483,182720,356600,539320
6/8/2024,Rajitha Karunarathne,Galle,Hikkaduwa,Southern,894,7593,8487,35760,303720,339480
6/9/2024,Rajitha Karunarathne,Galle,Hikkaduwa,Southern,2477,4966,7443,99080,198640,297720
6/10/2024,Rajitha Karunarathne,Galle,Hikkaduwa,Southern,8641,8312,16953,345640,332480,678120
6/11/2024,Rajitha Karunarathne,Galle,Hikkaduwa,Southern,1977,8177,10154,79080,327080,406160
6/12/2024,Rajitha Karunarathne,Galle,Hikkaduwa,Southern,3968,3681,7649,158720,147240,305960
6/13/2024,Rajitha Karunarathne,Galle,Hikkaduwa,Southern,3547,297,3844,141880,11880,153760
6/14/2024,Rajitha Karunarathne,Galle,Hikkaduwa,Southern,4003,618,4621,160120,24720,184840
6/15/2024,Rajitha Karunarathne,Galle,Hikkaduwa,Southern,5380,7225,12605,215200,289000,504200
6/16/2024,Rajitha Karunarathne,Galle,Hikkaduwa,Southern,3219,3557,6776,128760,142280,271040
6/17/2024,Rajitha Karunarathne,Galle,Hikkaduwa,Southern,3448,7522,10970,137920,300880,438800
6/18/2024,Rajitha Karunarathne,Galle,Hikkaduwa,Southern,9619,8516,18135,384760,340640,725400
6/19/2024,Rajitha Karunarathne,Galle,Hikkaduwa,Southern,9422,9200,18622,376880,368000,744880
6/20/2024,Rajitha Karunarathne,Galle,Hikkaduwa,Southern,7778,2601,10379,311120,104040,415160
6/21/2024,Rajitha Karunarathne,Galle,Hikkaduwa,Southern,5866,6898,12764,234640,275920,510560
6/22/2024,Rajitha Karunarathne,Galle,Hikkaduwa,Southern,1231,8612,9843,49240,344480,393720
6/23/2024,Rajitha Karunarathne,Galle,Hikkaduwa,Southern,1208,3006,4214,48320,120240,168560
6/24/2024,Rajitha Karunarathne,Galle,Hikkaduwa,Southern,1194,9915,11109,47760,396600,444360
6/25/2024,Rajitha Karunarathne,Galle,Hikkaduwa,Southern,5261,9343,14604,210440,373720,584160
6/26/2024,Rajitha Karunarathne,Galle,Hikkaduwa,Southern,2589,6635,9224,103560,265400,368960
6/27/2024,Rajitha Karunarathne,Galle,Hikkaduwa,Southern,312,5580,5892,12480,223200,235680
6/28/2024,Rajitha Karunarathne,Galle,Hikkaduwa,Southern,9377,3074,12451,375080,122960,498040
6/29/2024,Rajitha Karunarathne,Galle,Hikkaduwa,Southern,1542,8075,9617,61680,323000,384680
6/30/2024,Rajitha Karunarathne,Galle,Hikkaduwa,Southern,6743,1754,8497,269720,70160,339880
7/1/2024,Rajitha Karunarathne,Galle,Hikkaduwa,Southern,7302,7236,14538,292080,289440,581520
7/2/2024,Rajitha Karunarathne,Galle,Hikkaduwa,Southern,5549,9133,14682,221960,365320,587280
7/3/2024,Rajitha Karunarathne,Galle,Hikkaduwa,Southern,2,4320,4322,80,172800,172880
7/4/2024,Rajitha Karunarathne,Galle,Hikkaduwa,Southern,362,7476,7838,14480,299040,313520
7/5/2024,Rajitha Karunarathne,Galle,Hikkaduwa,Southern,5674,5560,11234,226960,222400,449360
7/6/2024,Rajitha Karunarathne,Galle,Hikkaduwa,Southern,112,4783,4895,4480,191320,195800
7/7/2024,Rajitha Karunarathne,Galle,Hikkaduwa,Southern,6230,4294,10524,249200,171760,420960
7/8/2024,Rajitha Karunarathne,Galle,Hikkaduwa,Southern,5640,6662,12302,225600,266480,492080
7/9/2024,Rajitha Karunarathne,Galle,Hikkaduwa,Southern,906,7636,8542,36240,305440,341680
7/10/2024,Rajitha Karunarathne,Galle,Hikkaduwa,Southern,5954,5027,10981,238160,201080,439240
7/11/2024,Rajitha Karunarathne,Galle,Hikkaduwa,Southern,1750,3945,5695,70000,157800,227800
7/12/2024,Rajitha Karunarathne,Galle,Hikkaduwa,Southern,1579,8878,10457,63160,355120,418280
7/13/2024,Rajitha Karunarathne,Galle,Hikkaduwa,Southern,3859,3190,7049,154360,127600,281960
7/14/2024,Rajitha Karunarathne,Galle,Hikkaduwa,Southern,5375,187,5562,215000,7480,222480
7/15/2024,Rajitha Karunarathne,Galle,Hikkaduwa,Southern,5247,5599,10846,209880,223960,433840
7/16/2024,Rajitha Karunarathne,Galle,Hikkaduwa,Southern,8402,3293,11695,336080,131720,467800
7/17/2024,Rajitha Karunarathne,Galle,Hikkaduwa,Southern,3750,7111,10861,150000,284440,434440
7/18/2024,Rajitha Karunarathne,Galle,Hikkaduwa,Southern,8570,4204,12774,342800,168160,510960
7/19/2024,Rajitha Karunarathne,Galle,Hikkaduwa,Southern,8036,5741,13777,321440,229640,551080
7/20/2024,Rajitha Karunarathne,Galle,Hikkaduwa,Southern,4024,4757,8781,160960,190280,351240
7/21/2024,Rajitha Karunarathne,Galle,Hikkaduwa,Southern,7450,6280,13730,298000,251200,549200
7/22/2024,Rajitha Karunarathne,Galle,Hikkaduwa,Southern,2700,7698,10398,108000,307920,415920
7/23/2024,Rajitha Karunarathne,Galle,Hikkaduwa,Southern,2995,4561,7556,119800,182440,302240
7/24/2024,Rajitha Karunarathne,Galle,Hikkaduwa,Southern,3863,691,4554,154520,27640,182160
7/25/2024,Rajitha Karunarathne,Galle,Hikkaduwa,Southern,9407,9655,19062,376280,386200,762480
7/26/2024,Rajitha Karunarathne,Galle,Hikkaduwa,Southern,1255,8560,9815,50200,342400,392600
7/27/2024,Rajitha Karunarathne,Galle,Hikkaduwa,Southern,9923,2909,12832,396920,116360,513280
7/28/2024,Rajitha Karunarathne,Galle,Hikkaduwa,Southern,7346,7853,15199,293840,314120,607960
7/29/2024,Rajitha Karunarathne,Galle,Hikkaduwa,Southern,4253,2726,6979,170120,109040,279160
7/30/2024,Rajitha Karunarathne,Galle,Hikkaduwa,Southern,3181,4970,8151,127240,198800,326040
7/31/2024,Rajitha Karunarathne,Galle,Hikkaduwa,Southern,1333,3266,4599,53320,130640,183960
8/1/2024,Rajitha Karunarathne,Galle,Hikkaduwa,Southern,2160,3277,5437,86400,131080,217480
8/2/2024,Rajitha Karunarathne,Galle,Hikkaduwa,Southern,5257,9512,14769,210280,380480,590760
8/3/2024,Rajitha Karunarathne,Galle,Hikkaduwa,Southern,5977,6428,12405,239080,257120,496200
8/4/2024,Rajitha Karunarathne,Galle,Hikkaduwa,Southern,4394,5048,9442,175760,201920,377680
8/5/2024,Rajitha Karunarathne,Galle,Hikkaduwa,Southern,7006,5141,12147,280240,205640,485880
8/6/2024,Rajitha Karunarathne,Galle,Hikkaduwa,Southern,5326,249,5575,213040,9960,223000
8/7/2024,Rajitha Karunarathne,Galle,Hikkaduwa,Southern,3796,198,3994,151840,7920,159760
8/8/2024,Rajitha Karunarathne,Galle,Hikkaduwa,Southern,7655,2253,9908,306200,90120,396320
8/9/2024,Rajitha Karunarathne,Galle,Hikkaduwa,Southern,3905,2652,6557,156200,106080,262280
8/10/2024,Rajitha Karunarathne,Galle,Hikkaduwa,Southern,7046,150,7196,281840,6000,287840
8/11/2024,Rajitha Karunarathne,Galle,Hikkaduwa,Southern,385,3130,3515,15400,125200,140600
8/12/2024,Rajitha Karunarathne,Galle,Hikkaduwa,Southern,8137,6175,14312,325480,247000,572480
8/13/2024,Rajitha Karunarathne,Galle,Hikkaduwa,Southern,5331,7448,12779,213240,297920,511160
8/14/2024,Rajitha Karunarathne,Galle,Hikkaduwa,Southern,2459,2719,5178,98360,108760,207120
8/15/2024,Rajitha Karunarathne,Galle,Hikkaduwa,Southern,4400,3305,7705,176000,132200,308200
8/16/2024,Rajitha Karunarathne,Galle,Hikkaduwa,Southern,5329,8875,14204,213160,355000,568160
8/17/2024,Rajitha Karunarathne,Galle,Hikkaduwa,Southern,3686,4203,7889,147440,168120,315560
8/18/2024,Rajitha Karunarathne,Galle,Hikkaduwa,Southern,2794,9714,12508,111760,388560,500320
8/19/2024,Rajitha Karunarathne,Galle,Hikkaduwa,Southern,2275,5917,8192,91000,236680,327680
8/20/2024,Rajitha Karunarathne,Galle,Hikkaduwa,Southern,8455,3955,12410,338200,158200,496400
8/21/2024,Rajitha Karunarathne,Galle,Hikkaduwa,Southern,5624,3509,9133,224960,140360,365320
8/22/2024,Rajitha Karunarathne,Galle,Hikkaduwa,Southern,2134,3235,5369,85360,129400,214760
8/23/2024,Rajitha Karunarathne,Galle,Hikkaduwa,Southern,6278,4698,10976,251120,187920,439040
8/24/2024,Rajitha Karunarathne,Galle,Hikkaduwa,Southern,8263,5301,13564,330520,212040,542560
8/25/2024,Rajitha Karunarathne,Galle,Hikkaduwa,Southern,318,108,426,12720,4320,17040
8/26/2024,Rajitha Karunarathne,Galle,Hikkaduwa,Southern,7193,1085,8278,287720,43400,331120
8/27/2024,Rajitha Karunarathne,Galle,Hikkaduwa,Southern,964,684,1648,38560,27360,65920
8/28/2024,Rajitha Karunarathne,Galle,Hikkaduwa,Southern,8346,9648,17994,333840,385920,719760
8/29/2024,Rajitha Karunarathne,Galle,Hikkaduwa,Southern,5514,1307,6821,220560,52280,272840
8/30/2024,Rajitha Karunarathne,Galle,Hikkaduwa,Southern,9715,9183,18898,388600,367320,755920
8/31/2024,Rajitha Karunarathne,Galle,Hikkaduwa,Southern,8877,5713,14590,355080,228520,583600
9/1/2024,Rajitha Karunarathne,Galle,Hikkaduwa,Southern,9675,5753,15428,387000,230120,617120
9/2/2024,Rajitha Karunarathne,Galle,Hikkaduwa,Southern,3729,2759,6488,149160,110360,259520
9/3/2024,Rajitha Karunarathne,Galle,Hikkaduwa,Southern,8126,4487,12613,325040,179480,504520
9/4/2024,Rajitha Karunarathne,Galle,Hikkaduwa,Southern,2059,5703,7762,82360,228120,310480
9/5/2024,Rajitha Karunarathne,Galle,Hikkaduwa,Southern,6319,880,7199,252760,35200,287960
9/6/2024,Rajitha Karunarathne,Galle,Hikkaduwa,Southern,29,2399,2428,1160,95960,97120
9/7/2024,Rajitha Karunarathne,Galle,Hikkaduwa,Southern,6228,190,6418,249120,7600,256720
9/8/2024,Rajitha Karunarathne,Galle,Hikkaduwa,Southern,2620,5225,7845,104800,209000,313800
9/9/2024,Rajitha Karunarathne,Galle,Hikkaduwa,Southern,7681,1973,9654,307240,78920,386160
9/10/2024,Rajitha Karunarathne,Galle,Hikkaduwa,Southern,4734,5444,10178,189360,217760,407120
9/11/2024,Rajitha Karunarathne,Galle,Hikkaduwa,Southern,8794,7377,16171,351760,295080,646840
9/12/2024,Rajitha Karunarathne,Galle,Hikkaduwa,Southern,1064,3848,4912,42560,153920,196480
9/13/2024,Rajitha Karunarathne,Galle,Hikkaduwa,Southern,8383,7318,15701,335320,292720,628040
9/14/2024,Rajitha Karunarathne,Galle,Hikkaduwa,Southern,7611,6397,14008,304440,255880,560320
9/15/2024,Rajitha Karunarathne,Galle,Hikkaduwa,Southern,7446,1156,8602,297840,46240,344080
9/16/2024,Rajitha Karunarathne,Galle,Hikkaduwa,Southern,9451,2318,11769,378040,92720,470760
9/17/2024,Rajitha Karunarathne,Galle,Hikkaduwa,Southern,8490,8160,16650,339600,326400,666000
9/18/2024,Rajitha Karunarathne,Galle,Hikkaduwa,Southern,7804,2239,10043,312160,89560,401720
9/19/2024,Rajitha Karunarathne,Galle,Hikkaduwa,Southern,7063,2278,9341,282520,91120,373640
9/20/2024,Rajitha Karunarathne,Galle,Hikkaduwa,Southern,8057,1471,9528,322280,58840,381120
9/21/2024,Rajitha Karunarathne,Galle,Hikkaduwa,Southern,6292,791,7083,251680,31640,283320
9/22/2024,Rajitha Karunarathne,Galle,Hikkaduwa,Southern,5610,7769,13379,224400,310760,535160
9/23/2024,Rajitha Karunarathne,Galle,Hikkaduwa,Southern,7172,352,7524,286880,14080,300960
9/24/2024,Rajitha Karunarathne,Galle,Hikkaduwa,Southern,1497,8218,9715,59880,328720,388600
9/25/2024,Rajitha Karunarathne,Galle,Hikkaduwa,Southern,9177,6227,15404,367080,249080,616160
9/26/2024,Rajitha Karunarathne,Galle,Hikkaduwa,Southern,3632,4385,8017,145280,175400,320680
9/27/2024,Rajitha Karunarathne,Galle,Hikkaduwa,Southern,707,234,941,28280,9360,37640
9/28/2024,Rajitha Karunarathne,Galle,Hikkaduwa,Southern,5938,6433,12371,237520,257320,494840
9/29/2024,Rajitha Karunarathne,Galle,Hikkaduwa,Southern,6640,9313,15953,265600,372520,638120
9/30/2024,Rajitha Karunarathne,Galle,Hikkaduwa,Southern,3397,7896,11293,135880,315840,451720
10/1/2024,Rajitha Karunarathne,Galle,Hikkaduwa,Southern,9957,993,10950,398280,39720,438000
10/2/2024,Rajitha Karunarathne,Galle,Hikkaduwa,Southern,1166,760,1926,46640,30400,77040
10/3/2024,Rajitha Karunarathne,Galle,Hikkaduwa,Southern,9342,4964,14306,373680,198560,572240
10/4/2024,Rajitha Karunarathne,Galle,Hikkaduwa,Southern,6899,4335,11234,275960,173400,449360
10/5/2024,Rajitha Karunarathne,Galle,Hikkaduwa,Southern,2181,5512,7693,87240,220480,307720
10/6/2024,Rajitha Karunarathne,Galle,Hikkaduwa,Southern,3303,8184,11487,132120,327360,459480
10/7/2024,Rajitha Karunarathne,Galle,Hikkaduwa,Southern,9270,3745,13015,370800,149800,520600
10/8/2024,Rajitha Karunarathne,Galle,Hikkaduwa,Southern,2709,120,2829,108360,4800,113160
10/9/2024,Rajitha Karunarathne,Galle,Hikkaduwa,Southern,421,3076,3497,16840,123040,139880
10/10/2024,Rajitha Karunarathne,Galle,Hikkaduwa,Southern,222,8748,8970,8880,349920,358800
10/11/2024,Rajitha Karunarathne,Galle,Hikkaduwa,Southern,8933,3221,12154,357320,128840,486160
10/12/2024,Rajitha Karunarathne,Galle,Hikkaduwa,Southern,4949,1535,6484,197960,61400,259360
10/13/2024,Rajitha Karunarathne,Galle,Hikkaduwa,Southern,97,4686,4783,3880,187440,191320
10/14/2024,Rajitha Karunarathne,Galle,Hikkaduwa,Southern,2834,3768,6602,113360,150720,264080
10/15/2024,Rajitha Karunarathne,Galle,Hikkaduwa,Southern,40,8511,8551,1600,340440,342040
10/16/2024,Rajitha Karunarathne,Galle,Hikkaduwa,Southern,6139,8752,14891,245560,350080,595640
10/17/2024,Rajitha Karunarathne,Galle,Hikkaduwa,Southern,3561,6997,10558,142440,279880,422320
10/18/2024,Rajitha Karunarathne,Galle,Hikkaduwa,Southern,8161,8294,16455,326440,331760,658200
10/19/2024,Rajitha Karunarathne,Galle,Hikkaduwa,Southern,8074,9007,17081,322960,360280,683240
10/20/2024,Rajitha Karunarathne,Galle,Hikkaduwa,Southern,3243,6432,9675,129720,257280,387000
10/21/2024,Rajitha Karunarathne,Galle,Hikkaduwa,Southern,7580,7935,15515,303200,317400,620600
10/22/2024,Rajitha Karunarathne,Galle,Hikkaduwa,Southern,6377,9388,15765,255080,375520,630600
10/23/2024,Rajitha Karunarathne,Galle,Hikkaduwa,Southern,4313,9449,13762,172520,377960,550480
10/24/2024,Rajitha Karunarathne,Galle,Hikkaduwa,Southern,7494,5556,13050,299760,222240,522000
10/25/2024,Rajitha Karunarathne,Galle,Hikkaduwa,Southern,1993,2496,4489,79720,99840,179560
10/26/2024,Rajitha Karunarathne,Galle,Hikkaduwa,Southern,2780,902,3682,111200,36080,147280
10/27/2024,Rajitha Karunarathne,Galle,Hikkaduwa,Southern,1040,9240,10280,41600,369600,411200
10/28/2024,Rajitha Karunarathne,Galle,Hikkaduwa,Southern,9662,9817,19479,386480,392680,779160
10/29/2024,Rajitha Karunarathne,Galle,Hikkaduwa,Southern,775,3771,4546,31000,150840,181840
10/30/2024,Rajitha Karunarathne,Galle,Hikkaduwa,Southern,3963,6925,10888,158520,277000,435520
10/31/2024,Rajitha Karunarathne,Galle,Hikkaduwa,Southern,2847,8191,11038,113880,327640,441520
11/1/2024,Rajitha Karunarathne,Galle,Hikkaduwa,Southern,2834,6961,9795,113360,278440,391800
11/2/2024,Rajitha Karunarathne,Galle,Hikkaduwa,Southern,9781,9440,19221,391240,377600,768840
11/3/2024,Rajitha Karunarathne,Galle,Hikkaduwa,Southern,4794,8979,13773,191760,359160,550920
11/4/2024,Rajitha Karunarathne,Galle,Hikkaduwa,Southern,9087,8115,17202,363480,324600,688080
11/5/2024,Rajitha Karunarathne,Galle,Hikkaduwa,Southern,2223,7135,9358,88920,285400,374320
11/6/2024,Rajitha Karunarathne,Galle,Hikkaduwa,Southern,2865,5080,7945,114600,203200,317800
11/7/2024,Rajitha Karunarathne,Galle,Hikkaduwa,Southern,3765,5088,8853,150600,203520,354120
11/8/2024,Rajitha Karunarathne,Galle,Hikkaduwa,Southern,8606,8691,17297,344240,347640,691880
11/9/2024,Rajitha Karunarathne,Galle,Hikkaduwa,Southern,6909,7927,14836,276360,317080,593440
11/10/2024,Rajitha Karunarathne,Galle,Hikkaduwa,Southern,7933,3727,11660,317320,149080,466400
11/11/2024,Rajitha Karunarathne,Galle,Hikkaduwa,Southern,6285,5011,11296,251400,200440,451840
11/12/2024,Rajitha Karunarathne,Galle,Hikkaduwa,Southern,8887,6078,14965,355480,243120,598600
11/13/2024,Rajitha Karunarathne,Galle,Hikkaduwa,Southern,9470,6519,15989,378800,260760,639560
11/14/2024,Rajitha Karunarathne,Galle,Hikkaduwa,Southern,831,1475,2306,33240,59000,92240
11/15/2024,Rajitha Karunarathne,Galle,Hikkaduwa,Southern,7951,3861,11812,318040,154440,472480
11/16/2024,Rajitha Karunarathne,Galle,Hikkaduwa,Southern,937,868,1805,37480,34720,72200
11/17/2024,Rajitha Karunarathne,Galle,Hikkaduwa,Southern,578,8304,8882,23120,332160,355280
11/18/2024,Rajitha Karunarathne,Galle,Hikkaduwa,Southern,6537,5048,11585,261480,201920,463400
11/19/2024,Rajitha Karunarathne,Galle,Hikkaduwa,Southern,3739,1137,4876,149560,45480,195040
11/20/2024,Rajitha Karunarathne,Galle,Hikkaduwa,Southern,1529,2466,3995,61160,98640,159800
11/21/2024,Rajitha Karunarathne,Galle,Hikkaduwa,Southern,9364,6050,15414,374560,242000,616560
11/22/2024,Rajitha Karunarathne,Galle,Hikkaduwa,Southern,3283,2440,5723,131320,97600,228920
11/23/2024,Rajitha Karunarathne,Galle,Hikkaduwa,Southern,3416,5637,9053,136640,225480,362120
11/24/2024,Rajitha Karunarathne,Galle,Hikkaduwa,Southern,6416,6749,13165,256640,269960,526600
11/25/2024,Rajitha Karunarathne,Galle,Hikkaduwa,Southern,1673,7402,9075,66920,296080,363000
11/26/2024,Rajitha Karunarathne,Galle,Hikkaduwa,Southern,3309,6626,9935,132360,265040,397400
11/27/2024,Rajitha Karunarathne,Galle,Hikkaduwa,Southern,6796,1701,8497,271840,68040,339880
11/28/2024,Rajitha Karunarathne,Galle,Hikkaduwa,Southern,4118,7687,11805,164720,307480,472200
11/29/2024,Rajitha Karunarathne,Galle,Hikkaduwa,Southern,9102,3336,12438,364080,133440,497520
11/30/2024,Rajitha Karunarathne,Galle,Hikkaduwa,Southern,6279,466,6745,251160,18640,269800
12/1/2024,Rajitha Karunarathne,Galle,Hikkaduwa,Southern,751,3101,3852,30040,124040,154080
12/2/2024,Rajitha Karunarathne,Galle,Hikkaduwa,Southern,5003,1485,6488,200120,59400,259520
12/3/2024,Rajitha Karunarathne,Galle,Hikkaduwa,Southern,7045,8807,15852,281800,352280,634080
12/4/2024,Rajitha Karunarathne,Galle,Hikkaduwa,Southern,9325,2592,11917,373000,103680,476680
12/5/2024,Rajitha Karunarathne,Galle,Hikkaduwa,Southern,5200,2272,7472,208000,90880,298880
12/6/2024,Rajitha Karunarathne,Galle,Hikkaduwa,Southern,1949,6263,8212,77960,250520,328480
12/7/2024,Rajitha Karunarathne,Galle,Hikkaduwa,Southern,7884,5345,13229,315360,213800,529160
12/8/2024,Rajitha Karunarathne,Galle,Hikkaduwa,Southern,4098,5493,9591,163920,219720,383640
12/9/2024,Rajitha Karunarathne,Galle,Hikkaduwa,Southern,441,7448,7889,17640,297920,315560
12/10/2024,Rajitha Karunarathne,Galle,Hikkaduwa,Southern,6163,9467,15630,246520,378680,625200
12/11/2024,Rajitha Karunarathne,Galle,Hikkaduwa,Southern,4884,1457,6341,195360,58280,253640
12/12/2024,Rajitha Karunarathne,Galle,Hikkaduwa,Southern,5166,113,5279,206640,4520,211160
12/13/2024,Rajitha Karunarathne,Galle,Hikkaduwa,Southern,3005,1258,4263,120200,50320,170520
12/14/2024,Rajitha Karunarathne,Galle,Hikkaduwa,Southern,6300,470,6770,252000,18800,270800
12/15/2024,Rajitha Karunarathne,Galle,Hikkaduwa,Southern,2800,7768,10568,112000,310720,422720
12/16/2024,Rajitha Karunarathne,Galle,Hikkaduwa,Southern,2490,5189,7679,99600,207560,307160
12/17/2024,Rajitha Karunarathne,Galle,Hikkaduwa,Southern,8101,5966,14067,324040,238640,562680
12/18/2024,Rajitha Karunarathne,Galle,Hikkaduwa,Southern,5432,5009,10441,217280,200360,417640
12/19/2024,Rajitha Karunarathne,Galle,Hikkaduwa,Southern,3479,9654,13133,139160,386160,525320
12/20/2024,Rajitha Karunarathne,Galle,Hikkaduwa,Southern,9553,5306,14859,382120,212240,594360
12/21/2024,Rajitha Karunarathne,Galle,Hikkaduwa,Southern,3883,1276,5159,155320,51040,206360
12/22/2024,Rajitha Karunarathne,Galle,Hikkaduwa,Southern,7637,3906,11543,305480,156240,461720
12/23/2024,Rajitha Karunarathne,Galle,Hikkaduwa,Southern,5193,8365,13558,207720,334600,542320
12/24/2024,Rajitha Karunarathne,Galle,Hikkaduwa,Southern,2099,239,2338,83960,9560,93520
12/25/2024,Rajitha Karunarathne,Galle,Hikkaduwa,Southern,2447,1967,4414,97880,78680,176560
12/26/2024,Rajitha Karunarathne,Galle,Hikkaduwa,Southern,9728,3423,13151,389120,136920,526040
12/27/2024,Rajitha Karunarathne,Galle,Hikkaduwa,Southern,1910,6556,8466,76400,262240,338640
12/28/2024,Rajitha Karunarathne,Galle,Hikkaduwa,Southern,1729,4815,6544,69160,192600,261760
12/29/2024,Rajitha Karunarathne,Galle,Hikkaduwa,Southern,2743,9731,12474,109720,389240,498960
12/30/2024,Rajitha Karunarathne,Galle,Hikkaduwa,Southern,9589,6877,16466,383560,275080,658640
12/31/2024,Rajitha Karunarathne,Galle,Hikkaduwa,Southern,3971,5994,9965,158840,239760,398600
1/1/2025,Rajitha Karunarathne,Galle,Hikkaduwa,Southern,4039,8885,12924,161560,355400,516960
1/2/2025,Rajitha Karunarathne,Galle,Hikkaduwa,Southern,9118,6489,15607,364720,259560,624280
1/3/2025,Rajitha Karunarathne,Galle,Hikkaduwa,Southern,1540,9880,11420,61600,395200,456800
1/4/2025,Rajitha Karunarathne,Galle,Hikkaduwa,Southern,4194,4140,8334,167760,165600,333360
1/5/2025,Rajitha Karunarathne,Galle,Hikkaduwa,Southern,3064,7168,10232,122560,286720,409280
1/6/2025,Rajitha Karunarathne,Galle,Hikkaduwa,Southern,8535,1500,10035,341400,60000,401400
1/7/2025,Rajitha Karunarathne,Galle,Hikkaduwa,Southern,1823,1404,3227,72920,56160,129080
1/8/2025,Rajitha Karunarathne,Galle,Hikkaduwa,Southern,4843,6723,11566,193720,268920,462640
1/9/2025,Rajitha Karunarathne,Galle,Hikkaduwa,Southern,5070,8118,13188,202800,324720,527520
1/10/2025,Rajitha Karunarathne,Galle,Hikkaduwa,Southern,1834,286,2120,73360,11440,84800
1/11/2025,Rajitha Karunarathne,Galle,Hikkaduwa,Southern,5133,864,5997,205320,34560,239880
1/12/2025,Rajitha Karunarathne,Galle,Hikkaduwa,Southern,9083,7470,16553,363320,298800,662120
1/13/2025,Rajitha Karunarathne,Galle,Hikkaduwa,Southern,4749,5686,10435,189960,227440,417400
1/14/2025,Rajitha Karunarathne,Galle,Hikkaduwa,Southern,7545,193,7738,301800,7720,309520
1/15/2025,Rajitha Karunarathne,Galle,Hikkaduwa,Southern,2686,9952,12638,107440,398080,505520
1/16/2025,Rajitha Karunarathne,Galle,Hikkaduwa,Southern,3448,3453,6901,137920,138120,276040
1/17/2025,Rajitha Karunarathne,Galle,Hikkaduwa,Southern,1430,7432,8862,57200,297280,354480
1/18/2025,Rajitha Karunarathne,Galle,Hikkaduwa,Southern,786,3946,4732,31440,157840,189280
1/19/2025,Rajitha Karunarathne,Galle,Hikkaduwa,Southern,7731,4578,12309,309240,183120,492360
1/20/2025,Rajitha Karunarathne,Galle,Hikkaduwa,Southern,5150,6090,11240,206000,243600,449600
1/21/2025,Rajitha Karunarathne,Galle,Hikkaduwa,Southern,8950,7897,16847,358000,315880,673880
1/22/2025,Rajitha Karunarathne,Galle,Hikkaduwa,Southern,6440,3434,9874,257600,137360,394960
1/23/2025,Rajitha Karunarathne,Galle,Hikkaduwa,Southern,409,9867,10276,16360,394680,411040
1/24/2025,Rajitha Karunarathne,Galle,Hikkaduwa,Southern,2667,2391,5058,106680,95640,202320
1/25/2025,Rajitha Karunarathne,Galle,Hikkaduwa,Southern,9161,4827,13988,366440,193080,559520
1/26/2025,Rajitha Karunarathne,Galle,Hikkaduwa,Southern,8622,2204,10826,344880,88160,433040
1/27/2025,Rajitha Karunarathne,Galle,Hikkaduwa,Southern,9619,9843,19462,384760,393720,778480
1/28/2025,Rajitha Karunarathne,Galle,Hikkaduwa,Southern,3385,8637,12022,135400,345480,480880
1/29/2025,Rajitha Karunarathne,Galle,Hikkaduwa,Southern,5570,3419,8989,222800,136760,359560
1/30/2025,Rajitha Karunarathne,Galle,Hikkaduwa,Southern,4896,6092,10988,195840,243680,439520
1/31/2025,Rajitha Karunarathne,Galle,Hikkaduwa,Southern,257,6168,6425,10280,246720,257000
2/1/2025,Rajitha Karunarathne,Galle,Hikkaduwa,Southern,6104,8643,14747,244160,345720,589880
2/2/2025,Rajitha Karunarathne,Galle,Hikkaduwa,Southern,3584,3638,7222,143360,145520,288880
2/3/2025,Rajitha Karunarathne,Galle,Hikkaduwa,Southern,6181,5451,11632,247240,218040,465280
2/4/2025,Rajitha Karunarathne,Galle,Hikkaduwa,Southern,3624,4426,8050,144960,177040,322000
2/5/2025,Rajitha Karunarathne,Galle,Hikkaduwa,Southern,6680,6993,13673,267200,279720,546920
2/6/2025,Rajitha Karunarathne,Galle,Hikkaduwa,Southern,2097,3663,5760,83880,146520,230400
2/7/2025,Rajitha Karunarathne,Galle,Hikkaduwa,Southern,1467,5918,7385,58680,236720,295400
2/8/2025,Rajitha Karunarathne,Galle,Hikkaduwa,Southern,3675,9876,13551,147000,395040,542040
2/9/2025,Rajitha Karunarathne,Galle,Hikkaduwa,Southern,2492,3758,6250,99680,150320,250000
2/10/2025,Rajitha Karunarathne,Galle,Hikkaduwa,Southern,8015,9330,17345,320600,373200,693800
2/11/2025,Rajitha Karunarathne,Galle,Hikkaduwa,Southern,8240,7330,15570,329600,293200,622800
2/12/2025,Rajitha Karunarathne,Galle,Hikkaduwa,Southern,6082,5731,11813,243280,229240,472520
2/13/2025,Rajitha Karunarathne,Galle,Hikkaduwa,Southern,330,4126,4456,13200,165040,178240
2/14/2025,Rajitha Karunarathne,Galle,Hikkaduwa,Southern,5341,535,5876,213640,21400,235040
2/15/2025,Rajitha Karunarathne,Galle,Hikkaduwa,Southern,8660,9845,18505,346400,393800,740200
2/16/2025,Rajitha Karunarathne,Galle,Hikkaduwa,Southern,7955,3397,11352,318200,135880,454080
2/17/2025,Rajitha Karunarathne,Galle,Hikkaduwa,Southern,3258,7708,10966,130320,308320,438640
2/18/2025,Rajitha Karunarathne,Galle,Hikkaduwa,Southern,8550,4226,12776,342000,169040,511040
2/19/2025,Rajitha Karunarathne,Galle,Hikkaduwa,Southern,3019,9407,12426,120760,376280,497040
2/20/2025,Rajitha Karunarathne,Galle,Hikkaduwa,Southern,3136,5970,9106,125440,238800,364240
2/21/2025,Rajitha Karunarathne,Galle,Hikkaduwa,Southern,7121,1388,8509,284840,55520,340360
2/22/2025,Rajitha Karunarathne,Galle,Hikkaduwa,Southern,4421,8208,12629,176840,328320,505160
2/23/2025,Rajitha Karunarathne,Galle,Hikkaduwa,Southern,137,8336,8473,5480,333440,338920
2/24/2025,Rajitha Karunarathne,Galle,Hikkaduwa,Southern,6597,4136,10733,263880,165440,429320
2/25/2025,Rajitha Karunarathne,Galle,Hikkaduwa,Southern,4134,1097,5231,165360,43880,209240
2/26/2025,Rajitha Karunarathne,Galle,Hikkaduwa,Southern,3395,5972,9367,135800,238880,374680
2/27/2025,Rajitha Karunarathne,Galle,Hikkaduwa,Southern,1236,5338,6574,49440,213520,262960
2/28/2025,Rajitha Karunarathne,Galle,Hikkaduwa,Southern,7598,6269,13867,303920,250760,554680
3/1/2025,Rajitha Karunarathne,Galle,Hikkaduwa,Southern,4747,9933,14680,189880,397320,587200
3/2/2025,Rajitha Karunarathne,Galle,Hikkaduwa,Southern,2932,5241,8173,117280,209640,326920
3/3/2025,Rajitha Karunarathne,Galle,Hikkaduwa,Southern,3921,7858,11779,156840,314320,471160
3/4/2025,Rajitha Karunarathne,Galle,Hikkaduwa,Southern,8953,3533,12486,358120,141320,499440
3/5/2025,Rajitha Karunarathne,Galle,Hikkaduwa,Southern,4383,4204,8587,175320,168160,343480
3/6/2025,Rajitha Karunarathne,Galle,Hikkaduwa,Southern,5103,3231,8334,204120,129240,333360
3/7/2025,Rajitha Karunarathne,Galle,Hikkaduwa,Southern,6488,9638,16126,259520,385520,645040
3/8/2025,Rajitha Karunarathne,Galle,Hikkaduwa,Southern,2606,621,3227,104240,24840,129080
3/9/2025,Rajitha Karunarathne,Galle,Hikkaduwa,Southern,9446,2923,12369,377840,116920,494760
3/10/2025,Rajitha Karunarathne,Galle,Hikkaduwa,Southern,1656,6401,8057,66240,256040,322280
3/11/2025,Rajitha Karunarathne,Galle,Hikkaduwa,Southern,1196,7938,9134,47840,317520,365360
3/12/2025,Rajitha Karunarathne,Galle,Hikkaduwa,Southern,9598,2950,12548,383920,118000,501920
3/13/2025,Rajitha Karunarathne,Galle,Hikkaduwa,Southern,3052,1055,4107,122080,42200,164280
3/14/2025,Rajitha Karunarathne,Galle,Hikkaduwa,Southern,1285,1322,2607,51400,52880,104280
3/15/2025,Rajitha Karunarathne,Galle,Hikkaduwa,Southern,8361,3931,12292,334440,157240,491680
3/16/2025,Rajitha Karunarathne,Galle,Hikkaduwa,Southern,2832,1189,4021,113280,47560,160840
3/17/2025,Rajitha Karunarathne,Galle,Hikkaduwa,Southern,9138,198,9336,365520,7920,373440
3/18/2025,Rajitha Karunarathne,Galle,Hikkaduwa,Southern,9324,733,10057,372960,29320,402280
3/19/2025,Rajitha Karunarathne,Galle,Hikkaduwa,Southern,533,1039,1572,21320,41560,62880
3/20/2025,Rajitha Karunarathne,Galle,Hikkaduwa,Southern,7830,359,8189,313200,14360,327560
3/21/2025,Rajitha Karunarathne,Galle,Hikkaduwa,Southern,4905,2590,7495,196200,103600,299800
3/22/2025,Rajitha Karunarathne,Galle,Hikkaduwa,Southern,5312,8041,13353,212480,321640,534120
3/23/2025,Rajitha Karunarathne,Galle,Hikkaduwa,Southern,5939,172,6111,237560,6880,244440
3/25/2024,Nalaka Wijesuriya,Polonnaruwa,Habarana,North Central,1440,2072,3512,57600,82880,140480
3/26/2024,Nalaka Wijesuriya,Polonnaruwa,Habarana,North Central,646,7454,8100,25840,298160,324000
3/27/2024,Nalaka Wijesuriya,Polonnaruwa,Habarana,North Central,4009,8411,12420,160360,336440,496800
3/28/2024,Nalaka Wijesuriya,Polonnaruwa,Habarana,North Central,7937,8599,16536,317480,343960,661440
3/29/2024,Nalaka Wijesuriya,Polonnaruwa,Habarana,North Central,6182,9535,15717,247280,381400,628680
3/30/2024,Nalaka Wijesuriya,Polonnaruwa,Habarana,North Central,4463,7443,11906,178520,297720,476240
3/31/2024,Nalaka Wijesuriya,Polonnaruwa,Habarana,North Central,4920,6162,11082,196800,246480,443280
4/1/2024,Nalaka Wijesuriya,Polonnaruwa,Habarana,North Central,3046,677,3723,121840,27080,148920
4/2/2024,Nalaka Wijesuriya,Polonnaruwa,Habarana,North Central,3099,1432,4531,123960,57280,181240
4/3/2024,Nalaka Wijesuriya,Polonnaruwa,Habarana,North Central,1980,5660,7640,79200,226400,305600
4/4/2024,Nalaka Wijesuriya,Polonnaruwa,Habarana,North Central,8659,3160,11819,346360,126400,472760
4/5/2024,Nalaka Wijesuriya,Polonnaruwa,Habarana,North Central,6650,5206,11856,266000,208240,474240
4/6/2024,Nalaka Wijesuriya,Polonnaruwa,Habarana,North Central,1455,6197,7652,58200,247880,306080
4/7/2024,Nalaka Wijesuriya,Polonnaruwa,Habarana,North Central,8076,6211,14287,323040,248440,571480
4/8/2024,Nalaka Wijesuriya,Polonnaruwa,Habarana,North Central,8839,9517,18356,353560,380680,734240
4/9/2024,Nalaka Wijesuriya,Polonnaruwa,Habarana,North Central,9357,1189,10546,374280,47560,421840
4/10/2024,Nalaka Wijesuriya,Polonnaruwa,Habarana,North Central,9248,1782,11030,369920,71280,441200
4/11/2024,Nalaka Wijesuriya,Polonnaruwa,Habarana,North Central,9722,366,10088,388880,14640,403520
4/19/2024,Nalaka Wijesuriya,Polonnaruwa,Habarana,North Central,1172,4726,5898,46880,189040,235920
4/20/2024,Nalaka Wijesuriya,Polonnaruwa,Habarana,North Central,8393,8695,17088,335720,347800,683520
4/21/2024,Nalaka Wijesuriya,Polonnaruwa,Habarana,North Central,8987,2890,11877,359480,115600,475080
4/22/2024,Nalaka Wijesuriya,Polonnaruwa,Habarana,North Central,4344,1332,5676,173760,53280,227040
4/23/2024,Nalaka Wijesuriya,Polonnaruwa,Habarana,North Central,9616,6825,16441,384640,273000,657640
4/24/2024,Nalaka Wijesuriya,Polonnaruwa,Habarana,North Central,2183,7355,9538,87320,294200,381520
4/25/2024,Nalaka Wijesuriya,Polonnaruwa,Habarana,North Central,4317,234,4551,172680,9360,182040
4/26/2024,Nalaka Wijesuriya,Polonnaruwa,Habarana,North Central,5361,4291,9652,214440,171640,386080
4/27/2024,Nalaka Wijesuriya,Polonnaruwa,Habarana,North Central,5094,6147,11241,203760,245880,449640
4/28/2024,Nalaka Wijesuriya,Polonnaruwa,Habarana,North Central,5626,8863,14489,225040,354520,579560
4/29/2024,Nalaka Wijesuriya,Polonnaruwa,Habarana,North Central,8967,388,9355,358680,15520,374200
4/30/2024,Nalaka Wijesuriya,Polonnaruwa,Habarana,North Central,5482,6532,12014,219280,261280,480560
5/1/2024,Nalaka Wijesuriya,Polonnaruwa,Habarana,North Central,9021,1631,10652,360840,65240,426080
5/2/2024,Nalaka Wijesuriya,Polonnaruwa,Habarana,North Central,8771,8222,16993,350840,328880,679720
5/3/2024,Nalaka Wijesuriya,Polonnaruwa,Habarana,North Central,1039,8054,9093,41560,322160,363720
5/4/2024,Nalaka Wijesuriya,Polonnaruwa,Habarana,North Central,9511,3134,12645,380440,125360,505800
5/5/2024,Nalaka Wijesuriya,Polonnaruwa,Habarana,North Central,9996,9626,19622,399840,385040,784880
5/6/2024,Nalaka Wijesuriya,Polonnaruwa,Habarana,North Central,2146,8399,10545,85840,335960,421800
5/7/2024,Nalaka Wijesuriya,Polonnaruwa,Habarana,North Central,3364,333,3697,134560,13320,147880
5/8/2024,Nalaka Wijesuriya,Polonnaruwa,Habarana,North Central,1425,5360,6785,57000,214400,271400
5/9/2024,Nalaka Wijesuriya,Polonnaruwa,Habarana,North Central,1424,6990,8414,56960,279600,336560
5/10/2024,Nalaka Wijesuriya,Polonnaruwa,Habarana,North Central,1583,2263,3846,63320,90520,153840
5/11/2024,Nalaka Wijesuriya,Polonnaruwa,Habarana,North Central,8340,1146,9486,333600,45840,379440
5/12/2024,Nalaka Wijesuriya,Polonnaruwa,Habarana,North Central,6855,8054,14909,274200,322160,596360
5/13/2024,Nalaka Wijesuriya,Polonnaruwa,Habarana,North Central,1671,5872,7543,66840,234880,301720
5/14/2024,Nalaka Wijesuriya,Polonnaruwa,Habarana,North Central,3085,9702,12787,123400,388080,511480
5/15/2024,Nalaka Wijesuriya,Polonnaruwa,Habarana,North Central,8949,2972,11921,357960,118880,476840
5/16/2024,Nalaka Wijesuriya,Polonnaruwa,Habarana,North Central,9199,8758,17957,367960,350320,718280
5/17/2024,Nalaka Wijesuriya,Polonnaruwa,Habarana,North Central,8045,4762,12807,321800,190480,512280
5/18/2024,Nalaka Wijesuriya,Polonnaruwa,Habarana,North Central,6466,6183,12649,258640,247320,505960
5/19/2024,Nalaka Wijesuriya,Polonnaruwa,Habarana,North Central,7305,8045,15350,292200,321800,614000
5/20/2024,Nalaka Wijesuriya,Polonnaruwa,Habarana,North Central,7997,5276,13273,319880,211040,530920
5/21/2024,Nalaka Wijesuriya,Polonnaruwa,Habarana,North Central,9301,7924,17225,372040,316960,689000
5/22/2024,Nalaka Wijesuriya,Polonnaruwa,Habarana,North Central,6507,3107,9614,260280,124280,384560
5/24/2024,Nalaka Wijesuriya,Polonnaruwa,Habarana,North Central,6173,9190,15363,246920,367600,614520
5/25/2024,Nalaka Wijesuriya,Polonnaruwa,Habarana,North Central,2772,5336,8108,110880,213440,324320
5/26/2024,Nalaka Wijesuriya,Polonnaruwa,Habarana,North Central,8855,165,9020,354200,6600,360800
5/27/2024,Nalaka Wijesuriya,Polonnaruwa,Habarana,North Central,6295,9299,15594,251800,371960,623760
5/28/2024,Nalaka Wijesuriya,Polonnaruwa,Habarana,North Central,2356,1298,3654,94240,51920,146160
5/29/2024,Nalaka Wijesuriya,Polonnaruwa,Habarana,North Central,7667,1076,8743,306680,43040,349720
5/30/2024,Nalaka Wijesuriya,Polonnaruwa,Habarana,North Central,6998,9742,16740,279920,389680,669600
5/31/2024,Nalaka Wijesuriya,Polonnaruwa,Habarana,North Central,5703,4785,10488,228120,191400,419520
6/1/2024,Nalaka Wijesuriya,Polonnaruwa,Habarana,North Central,8152,1349,9501,326080,53960,380040
6/2/2024,Nalaka Wijesuriya,Polonnaruwa,Habarana,North Central,6525,3735,10260,261000,149400,410400
6/3/2024,Nalaka Wijesuriya,Polonnaruwa,Habarana,North Central,5198,6975,12173,207920,279000,486920
6/4/2024,Nalaka Wijesuriya,Polonnaruwa,Habarana,North Central,26,3997,4023,1040,159880,160920
6/5/2024,Nalaka Wijesuriya,Polonnaruwa,Habarana,North Central,5946,8551,14497,237840,342040,579880
6/6/2024,Nalaka Wijesuriya,Polonnaruwa,Habarana,North Central,1284,9653,10937,51360,386120,437480
6/7/2024,Nalaka Wijesuriya,Polonnaruwa,Habarana,North Central,3552,6727,10279,142080,269080,411160
6/8/2024,Nalaka Wijesuriya,Polonnaruwa,Habarana,North Central,2142,3946,6088,85680,157840,243520
6/9/2024,Nalaka Wijesuriya,Polonnaruwa,Habarana,North Central,8813,1182,9995,352520,47280,399800
6/10/2024,Nalaka Wijesuriya,Polonnaruwa,Habarana,North Central,2387,8969,11356,95480,358760,454240
6/11/2024,Nalaka Wijesuriya,Polonnaruwa,Habarana,North Central,7461,3907,11368,298440,156280,454720
6/12/2024,Nalaka Wijesuriya,Polonnaruwa,Habarana,North Central,8908,988,9896,356320,39520,395840
6/13/2024,Nalaka Wijesuriya,Polonnaruwa,Habarana,North Central,1193,7815,9008,47720,312600,360320
6/14/2024,Nalaka Wijesuriya,Polonnaruwa,Habarana,North Central,5989,1779,7768,239560,71160,310720
6/15/2024,Nalaka Wijesuriya,Polonnaruwa,Habarana,North Central,84,806,890,3360,32240,35600
6/16/2024,Nalaka Wijesuriya,Polonnaruwa,Habarana,North Central,4938,8065,13003,197520,322600,520120
6/17/2024,Nalaka Wijesuriya,Polonnaruwa,Habarana,North Central,5793,9778,15571,231720,391120,622840
6/18/2024,Nalaka Wijesuriya,Polonnaruwa,Habarana,North Central,7678,3599,11277,307120,143960,451080
6/19/2024,Nalaka Wijesuriya,Polonnaruwa,Habarana,North Central,3188,55,3243,127520,2200,129720
6/20/2024,Nalaka Wijesuriya,Polonnaruwa,Habarana,North Central,7538,9330,16868,301520,373200,674720
6/21/2024,Nalaka Wijesuriya,Polonnaruwa,Habarana,North Central,4643,2158,6801,185720,86320,272040
6/22/2024,Nalaka Wijesuriya,Polonnaruwa,Habarana,North Central,9579,4735,14314,383160,189400,572560
6/23/2024,Nalaka Wijesuriya,Polonnaruwa,Habarana,North Central,3648,7994,11642,145920,319760,465680
6/24/2024,Nalaka Wijesuriya,Polonnaruwa,Habarana,North Central,5124,8207,13331,204960,328280,533240
6/25/2024,Nalaka Wijesuriya,Polonnaruwa,Habarana,North Central,9822,3100,12922,392880,124000,516880
6/26/2024,Nalaka Wijesuriya,Polonnaruwa,Habarana,North Central,8083,4337,12420,323320,173480,496800
6/27/2024,Nalaka Wijesuriya,Polonnaruwa,Habarana,North Central,6315,1748,8063,252600,69920,322520
6/28/2024,Nalaka Wijesuriya,Polonnaruwa,Habarana,North Central,1243,1644,2887,49720,65760,115480
6/29/2024,Nalaka Wijesuriya,Polonnaruwa,Habarana,North Central,2751,7205,9956,110040,288200,398240
6/30/2024,Nalaka Wijesuriya,Polonnaruwa,Habarana,North Central,2659,7064,9723,106360,282560,388920
7/1/2024,Nalaka Wijesuriya,Polonnaruwa,Habarana,North Central,9824,970,10794,392960,38800,431760
7/2/2024,Nalaka Wijesuriya,Polonnaruwa,Habarana,North Central,1171,7087,8258,46840,283480,330320
7/3/2024,Nalaka Wijesuriya,Polonnaruwa,Habarana,North Central,8930,4552,13482,357200,182080,539280
7/4/2024,Nalaka Wijesuriya,Polonnaruwa,Habarana,North Central,8442,778,9220,337680,31120,368800
7/5/2024,Nalaka Wijesuriya,Polonnaruwa,Habarana,North Central,9311,3002,12313,372440,120080,492520
7/6/2024,Nalaka Wijesuriya,Polonnaruwa,Habarana,North Central,8869,4276,13145,354760,171040,525800
7/7/2024,Nalaka Wijesuriya,Polonnaruwa,Habarana,North Central,5250,9029,14279,210000,361160,571160
7/8/2024,Nalaka Wijesuriya,Polonnaruwa,Habarana,North Central,6835,2302,9137,273400,92080,365480
7/9/2024,Nalaka Wijesuriya,Polonnaruwa,Habarana,North Central,6591,776,7367,263640,31040,294680
7/10/2024,Nalaka Wijesuriya,Polonnaruwa,Habarana,North Central,2363,4856,7219,94520,194240,288760
7/11/2024,Nalaka Wijesuriya,Polonnaruwa,Habarana,North Central,5001,7171,12172,200040,286840,486880
7/12/2024,Nalaka Wijesuriya,Polonnaruwa,Habarana,North Central,8876,9073,17949,355040,362920,717960
7/13/2024,Nalaka Wijesuriya,Polonnaruwa,Habarana,North Central,54,4742,4796,2160,189680,191840
7/14/2024,Nalaka Wijesuriya,Polonnaruwa,Habarana,North Central,2567,1599,4166,102680,63960,166640
7/15/2024,Nalaka Wijesuriya,Polonnaruwa,Habarana,North Central,7785,5044,12829,311400,201760,513160
7/16/2024,Nalaka Wijesuriya,Polonnaruwa,Habarana,North Central,1228,539,1767,49120,21560,70680
7/17/2024,Nalaka Wijesuriya,Polonnaruwa,Habarana,North Central,3308,5297,8605,132320,211880,344200
7/18/2024,Nalaka Wijesuriya,Polonnaruwa,Habarana,North Central,7676,2457,10133,307040,98280,405320
7/19/2024,Nalaka Wijesuriya,Polonnaruwa,Habarana,North Central,9874,6352,16226,394960,254080,649040
7/20/2024,Nalaka Wijesuriya,Polonnaruwa,Habarana,North Central,8928,8969,17897,357120,358760,715880
7/21/2024,Nalaka Wijesuriya,Polonnaruwa,Habarana,North Central,3191,2870,6061,127640,114800,242440
7/22/2024,Nalaka Wijesuriya,Polonnaruwa,Habarana,North Central,558,7996,8554,22320,319840,342160
7/23/2024,Nalaka Wijesuriya,Polonnaruwa,Habarana,North Central,4229,5996,10225,169160,239840,409000
7/24/2024,Nalaka Wijesuriya,Polonnaruwa,Habarana,North Central,7216,8412,15628,288640,336480,625120
7/25/2024,Nalaka Wijesuriya,Polonnaruwa,Habarana,North Central,9316,7037,16353,372640,281480,654120
7/26/2024,Nalaka Wijesuriya,Polonnaruwa,Habarana,North Central,3080,20,3100,123200,800,124000
7/27/2024,Nalaka Wijesuriya,Polonnaruwa,Habarana,North Central,9446,3434,12880,377840,137360,515200
7/28/2024,Nalaka Wijesuriya,Polonnaruwa,Habarana,North Central,2867,5683,8550,114680,227320,342000
7/29/2024,Nalaka Wijesuriya,Polonnaruwa,Habarana,North Central,2473,5279,7752,98920,211160,310080
7/30/2024,Nalaka Wijesuriya,Polonnaruwa,Habarana,North Central,8766,3746,12512,350640,149840,500480
7/31/2024,Nalaka Wijesuriya,Polonnaruwa,Habarana,North Central,7963,4360,12323,318520,174400,492920
8/1/2024,Nalaka Wijesuriya,Polonnaruwa,Habarana,North Central,3615,1457,5072,144600,58280,202880
8/2/2024,Nalaka Wijesuriya,Polonnaruwa,Habarana,North Central,8761,7374,16135,350440,294960,645400
8/3/2024,Nalaka Wijesuriya,Polonnaruwa,Habarana,North Central,5571,7767,13338,222840,310680,533520
8/4/2024,Nalaka Wijesuriya,Polonnaruwa,Habarana,North Central,6407,8967,15374,256280,358680,614960
8/5/2024,Nalaka Wijesuriya,Polonnaruwa,Habarana,North Central,1679,7211,8890,67160,288440,355600
8/6/2024,Nalaka Wijesuriya,Polonnaruwa,Habarana,North Central,9716,434,10150,388640,17360,406000
8/7/2024,Nalaka Wijesuriya,Polonnaruwa,Habarana,North Central,4725,514,5239,189000,20560,209560
8/8/2024,Nalaka Wijesuriya,Polonnaruwa,Habarana,North Central,5352,8086,13438,214080,323440,537520
8/9/2024,Nalaka Wijesuriya,Polonnaruwa,Habarana,North Central,4809,2915,7724,192360,116600,308960
8/10/2024,Nalaka Wijesuriya,Polonnaruwa,Habarana,North Central,9972,2602,12574,398880,104080,502960
8/11/2024,Nalaka Wijesuriya,Polonnaruwa,Habarana,North Central,9464,1821,11285,378560,72840,451400
8/12/2024,Nalaka Wijesuriya,Polonnaruwa,Habarana,North Central,2184,6845,9029,87360,273800,361160
8/13/2024,Nalaka Wijesuriya,Polonnaruwa,Habarana,North Central,7857,840,8697,314280,33600,347880
8/14/2024,Nalaka Wijesuriya,Polonnaruwa,Habarana,North Central,9866,5058,14924,394640,202320,596960
8/15/2024,Nalaka Wijesuriya,Polonnaruwa,Habarana,North Central,99,4255,4354,3960,170200,174160
8/16/2024,Nalaka Wijesuriya,Polonnaruwa,Habarana,North Central,8959,8159,17118,358360,326360,684720
8/17/2024,Nalaka Wijesuriya,Polonnaruwa,Habarana,North Central,7305,7942,15247,292200,317680,609880
8/18/2024,Nalaka Wijesuriya,Polonnaruwa,Habarana,North Central,315,4644,4959,12600,185760,198360
8/19/2024,Nalaka Wijesuriya,Polonnaruwa,Habarana,North Central,3121,8680,11801,124840,347200,472040
8/20/2024,Nalaka Wijesuriya,Polonnaruwa,Habarana,North Central,6762,7980,14742,270480,319200,589680
8/21/2024,Nalaka Wijesuriya,Polonnaruwa,Habarana,North Central,5181,7049,12230,207240,281960,489200
8/22/2024,Nalaka Wijesuriya,Polonnaruwa,Habarana,North Central,75,9558,9633,3000,382320,385320
8/23/2024,Nalaka Wijesuriya,Polonnaruwa,Habarana,North Central,2735,6522,9257,109400,260880,370280
8/24/2024,Nalaka Wijesuriya,Polonnaruwa,Habarana,North Central,2056,5800,7856,82240,232000,314240
8/25/2024,Nalaka Wijesuriya,Polonnaruwa,Habarana,North Central,1773,2931,4704,70920,117240,188160
8/26/2024,Nalaka Wijesuriya,Polonnaruwa,Habarana,North Central,4201,4827,9028,168040,193080,361120
8/27/2024,Nalaka Wijesuriya,Polonnaruwa,Habarana,North Central,6063,5823,11886,242520,232920,475440
8/28/2024,Nalaka Wijesuriya,Polonnaruwa,Habarana,North Central,2335,8443,10778,93400,337720,431120
8/29/2024,Nalaka Wijesuriya,Polonnaruwa,Habarana,North Central,7229,3901,11130,289160,156040,445200
8/30/2024,Nalaka Wijesuriya,Polonnaruwa,Habarana,North Central,3711,5197,8908,148440,207880,356320
8/31/2024,Nalaka Wijesuriya,Polonnaruwa,Habarana,North Central,5471,2674,8145,218840,106960,325800
9/1/2024,Nalaka Wijesuriya,Polonnaruwa,Habarana,North Central,1295,5168,6463,51800,206720,258520
9/2/2024,Nalaka Wijesuriya,Polonnaruwa,Habarana,North Central,9630,7049,16679,385200,281960,667160
9/3/2024,Nalaka Wijesuriya,Polonnaruwa,Habarana,North Central,6376,5492,11868,255040,219680,474720
9/4/2024,Nalaka Wijesuriya,Polonnaruwa,Habarana,North Central,3783,6159,9942,151320,246360,397680
9/5/2024,Nalaka Wijesuriya,Polonnaruwa,Habarana,North Central,2627,3429,6056,105080,137160,242240
9/6/2024,Nalaka Wijesuriya,Polonnaruwa,Habarana,North Central,661,3394,4055,26440,135760,162200
9/7/2024,Nalaka Wijesuriya,Polonnaruwa,Habarana,North Central,6569,8424,14993,262760,336960,599720
9/8/2024,Nalaka Wijesuriya,Polonnaruwa,Habarana,North Central,2403,7568,9971,96120,302720,398840
9/9/2024,Nalaka Wijesuriya,Polonnaruwa,Habarana,North Central,3889,7215,11104,155560,288600,444160
9/10/2024,Nalaka Wijesuriya,Polonnaruwa,Habarana,North Central,2185,1282,3467,87400,51280,138680
9/11/2024,Nalaka Wijesuriya,Polonnaruwa,Habarana,North Central,7016,6461,13477,280640,258440,539080
9/12/2024,Nalaka Wijesuriya,Polonnaruwa,Habarana,North Central,3866,7359,11225,154640,294360,449000
9/13/2024,Nalaka Wijesuriya,Polonnaruwa,Habarana,North Central,1400,7476,8876,56000,299040,355040
9/14/2024,Nalaka Wijesuriya,Polonnaruwa,Habarana,North Central,4866,5154,10020,194640,206160,400800
9/15/2024,Nalaka Wijesuriya,Polonnaruwa,Habarana,North Central,2570,4503,7073,102800,180120,282920
9/16/2024,Nalaka Wijesuriya,Polonnaruwa,Habarana,North Central,2888,5156,8044,115520,206240,321760
9/17/2024,Nalaka Wijesuriya,Polonnaruwa,Habarana,North Central,2002,2001,4003,80080,80040,160120
9/18/2024,Nalaka Wijesuriya,Polonnaruwa,Habarana,North Central,3265,2866,6131,130600,114640,245240
9/19/2024,Nalaka Wijesuriya,Polonnaruwa,Habarana,North Central,7454,9532,16986,298160,381280,679440
9/20/2024,Nalaka Wijesuriya,Polonnaruwa,Habarana,North Central,3636,7994,11630,145440,319760,465200
9/21/2024,Nalaka Wijesuriya,Polonnaruwa,Habarana,North Central,1976,632,2608,79040,25280,104320
9/22/2024,Nalaka Wijesuriya,Polonnaruwa,Habarana,North Central,5119,7797,12916,204760,311880,516640
9/23/2024,Nalaka Wijesuriya,Polonnaruwa,Habarana,North Central,6385,6408,12793,255400,256320,511720
9/24/2024,Nalaka Wijesuriya,Polonnaruwa,Habarana,North Central,7449,8714,16163,297960,348560,646520
9/25/2024,Nalaka Wijesuriya,Polonnaruwa,Habarana,North Central,4565,5187,9752,182600,207480,390080
9/26/2024,Nalaka Wijesuriya,Polonnaruwa,Habarana,North Central,6650,8228,14878,266000,329120,595120
9/27/2024,Nalaka Wijesuriya,Polonnaruwa,Habarana,North Central,5778,1040,6818,231120,41600,272720
9/28/2024,Nalaka Wijesuriya,Polonnaruwa,Habarana,North Central,9452,1241,10693,378080,49640,427720
9/29/2024,Nalaka Wijesuriya,Polonnaruwa,Habarana,North Central,4867,349,5216,194680,13960,208640
9/30/2024,Nalaka Wijesuriya,Polonnaruwa,Habarana,North Central,2842,5339,8181,113680,213560,327240
10/1/2024,Nalaka Wijesuriya,Polonnaruwa,Habarana,North Central,5213,7054,12267,208520,282160,490680
10/2/2024,Nalaka Wijesuriya,Polonnaruwa,Habarana,North Central,5115,1368,6483,204600,54720,259320
10/3/2024,Nalaka Wijesuriya,Polonnaruwa,Habarana,North Central,1825,1941,3766,73000,77640,150640
10/4/2024,Nalaka Wijesuriya,Polonnaruwa,Habarana,North Central,463,5206,5669,18520,208240,226760
10/5/2024,Nalaka Wijesuriya,Polonnaruwa,Habarana,North Central,9127,9803,18930,365080,392120,757200
10/6/2024,Nalaka Wijesuriya,Polonnaruwa,Habarana,North Central,5615,1780,7395,224600,71200,295800
10/7/2024,Nalaka Wijesuriya,Polonnaruwa,Habarana,North Central,6632,588,7220,265280,23520,288800
10/8/2024,Nalaka Wijesuriya,Polonnaruwa,Habarana,North Central,6889,8366,15255,275560,334640,610200
10/9/2024,Nalaka Wijesuriya,Polonnaruwa,Habarana,North Central,7043,8732,15775,281720,349280,631000
10/10/2024,Nalaka Wijesuriya,Polonnaruwa,Habarana,North Central,3427,9946,13373,137080,397840,534920
10/11/2024,Nalaka Wijesuriya,Polonnaruwa,Habarana,North Central,5488,5988,11476,219520,239520,459040
10/12/2024,Nalaka Wijesuriya,Polonnaruwa,Habarana,North Central,7816,7636,15452,312640,305440,618080
10/13/2024,Nalaka Wijesuriya,Polonnaruwa,Habarana,North Central,415,9190,9605,16600,367600,384200
10/14/2024,Nalaka Wijesuriya,Polonnaruwa,Habarana,North Central,4353,5087,9440,174120,203480,377600
10/15/2024,Nalaka Wijesuriya,Polonnaruwa,Habarana,North Central,2265,6384,8649,90600,255360,345960
10/16/2024,Nalaka Wijesuriya,Polonnaruwa,Habarana,North Central,3116,2699,5815,124640,107960,232600
10/17/2024,Nalaka Wijesuriya,Polonnaruwa,Habarana,North Central,4186,9421,13607,167440,376840,544280
10/18/2024,Nalaka Wijesuriya,Polonnaruwa,Habarana,North Central,5169,4405,9574,206760,176200,382960
10/19/2024,Nalaka Wijesuriya,Polonnaruwa,Habarana,North Central,6651,3280,9931,266040,131200,397240
10/20/2024,Nalaka Wijesuriya,Polonnaruwa,Habarana,North Central,1548,3764,5312,61920,150560,212480
10/21/2024,Nalaka Wijesuriya,Polonnaruwa,Habarana,North Central,6858,8114,14972,274320,324560,598880
10/22/2024,Nalaka Wijesuriya,Polonnaruwa,Habarana,North Central,4353,5700,10053,174120,228000,402120
10/23/2024,Nalaka Wijesuriya,Polonnaruwa,Habarana,North Central,133,82,215,5320,3280,8600
10/24/2024,Nalaka Wijesuriya,Polonnaruwa,Habarana,North Central,1920,7904,9824,76800,316160,392960
10/25/2024,Nalaka Wijesuriya,Polonnaruwa,Habarana,North Central,1135,7126,8261,45400,285040,330440
10/26/2024,Nalaka Wijesuriya,Polonnaruwa,Habarana,North Central,259,9868,10127,10360,394720,405080
10/27/2024,Nalaka Wijesuriya,Polonnaruwa,Habarana,North Central,5651,3115,8766,226040,124600,350640
10/28/2024,Nalaka Wijesuriya,Polonnaruwa,Habarana,North Central,8517,3046,11563,340680,121840,462520
10/29/2024,Nalaka Wijesuriya,Polonnaruwa,Habarana,North Central,5044,2929,7973,201760,117160,318920
10/30/2024,Nalaka Wijesuriya,Polonnaruwa,Habarana,North Central,1825,1743,3568,73000,69720,142720
10/31/2024,Nalaka Wijesuriya,Polonnaruwa,Habarana,North Central,547,8767,9314,21880,350680,372560
11/1/2024,Nalaka Wijesuriya,Polonnaruwa,Habarana,North Central,7714,2282,9996,308560,91280,399840
11/2/2024,Nalaka Wijesuriya,Polonnaruwa,Habarana,North Central,9738,7388,17126,389520,295520,685040
11/3/2024,Nalaka Wijesuriya,Polonnaruwa,Habarana,North Central,8819,4217,13036,352760,168680,521440
11/4/2024,Nalaka Wijesuriya,Polonnaruwa,Habarana,North Central,6443,6915,13358,257720,276600,534320
11/5/2024,Nalaka Wijesuriya,Polonnaruwa,Habarana,North Central,3122,2085,5207,124880,83400,208280
11/6/2024,Nalaka Wijesuriya,Polonnaruwa,Habarana,North Central,7659,8002,15661,306360,320080,626440
11/7/2024,Nalaka Wijesuriya,Polonnaruwa,Habarana,North Central,1811,7295,9106,72440,291800,364240
11/8/2024,Nalaka Wijesuriya,Polonnaruwa,Habarana,North Central,6240,9278,15518,249600,371120,620720
11/9/2024,Nalaka Wijesuriya,Polonnaruwa,Habarana,North Central,6389,4478,10867,255560,179120,434680
11/10/2024,Nalaka Wijesuriya,Polonnaruwa,Habarana,North Central,3272,7986,11258,130880,319440,450320
11/11/2024,Nalaka Wijesuriya,Polonnaruwa,Habarana,North Central,2049,8146,10195,81960,325840,407800
11/12/2024,Nalaka Wijesuriya,Polonnaruwa,Habarana,North Central,7991,7523,15514,319640,300920,620560
11/13/2024,Nalaka Wijesuriya,Polonnaruwa,Habarana,North Central,8529,4555,13084,341160,182200,523360
11/14/2024,Nalaka Wijesuriya,Polonnaruwa,Habarana,North Central,4208,1896,6104,168320,75840,244160
11/15/2024,Nalaka Wijesuriya,Polonnaruwa,Habarana,North Central,3082,1729,4811,123280,69160,192440
11/16/2024,Nalaka Wijesuriya,Polonnaruwa,Habarana,North Central,8556,9403,17959,342240,376120,718360
11/17/2024,Nalaka Wijesuriya,Polonnaruwa,Habarana,North Central,8714,8773,17487,348560,350920,699480
11/18/2024,Nalaka Wijesuriya,Polonnaruwa,Habarana,North Central,2994,3220,6214,119760,128800,248560
11/19/2024,Nalaka Wijesuriya,Polonnaruwa,Habarana,North Central,7342,7722,15064,293680,308880,602560
11/20/2024,Nalaka Wijesuriya,Polonnaruwa,Habarana,North Central,2941,6034,8975,117640,241360,359000
11/21/2024,Nalaka Wijesuriya,Polonnaruwa,Habarana,North Central,8566,2892,11458,342640,115680,458320
11/22/2024,Nalaka Wijesuriya,Polonnaruwa,Habarana,North Central,818,4908,5726,32720,196320,229040
11/23/2024,Nalaka Wijesuriya,Polonnaruwa,Habarana,North Central,3886,4928,8814,155440,197120,352560
11/24/2024,Nalaka Wijesuriya,Polonnaruwa,Habarana,North Central,8441,530,8971,337640,21200,358840
11/25/2024,Nalaka Wijesuriya,Polonnaruwa,Habarana,North Central,4737,840,5577,189480,33600,223080
11/26/2024,Nalaka Wijesuriya,Polonnaruwa,Habarana,North Central,4336,1752,6088,173440,70080,243520
11/27/2024,Nalaka Wijesuriya,Polonnaruwa,Habarana,North Central,8943,6713,15656,357720,268520,626240
11/28/2024,Nalaka Wijesuriya,Polonnaruwa,Habarana,North Central,7805,9822,17627,312200,392880,705080
11/29/2024,Nalaka Wijesuriya,Polonnaruwa,Habarana,North Central,7018,2866,9884,280720,114640,395360
11/30/2024,Nalaka Wijesuriya,Polonnaruwa,Habarana,North Central,8558,9303,17861,342320,372120,714440
12/1/2024,Nalaka Wijesuriya,Polonnaruwa,Habarana,North Central,1423,1913,3336,56920,76520,133440
12/2/2024,Nalaka Wijesuriya,Polonnaruwa,Habarana,North Central,8306,6358,14664,332240,254320,586560
12/3/2024,Nalaka Wijesuriya,Polonnaruwa,Habarana,North Central,4284,1022,5306,171360,40880,212240
12/4/2024,Nalaka Wijesuriya,Polonnaruwa,Habarana,North Central,10,992,1002,400,39680,40080
12/5/2024,Nalaka Wijesuriya,Polonnaruwa,Habarana,North Central,3695,4148,7843,147800,165920,313720
12/6/2024,Nalaka Wijesuriya,Polonnaruwa,Habarana,North Central,1628,2421,4049,65120,96840,161960
12/7/2024,Nalaka Wijesuriya,Polonnaruwa,Habarana,North Central,1421,5726,7147,56840,229040,285880
12/8/2024,Nalaka Wijesuriya,Polonnaruwa,Habarana,North Central,8859,409,9268,354360,16360,370720
12/9/2024,Nalaka Wijesuriya,Polonnaruwa,Habarana,North Central,5233,4656,9889,209320,186240,395560
12/10/2024,Nalaka Wijesuriya,Polonnaruwa,Habarana,North Central,8046,7988,16034,321840,319520,641360
12/11/2024,Nalaka Wijesuriya,Polonnaruwa,Habarana,North Central,3590,8553,12143,143600,342120,485720
12/12/2024,Nalaka Wijesuriya,Polonnaruwa,Habarana,North Central,9579,581,10160,383160,23240,406400
12/13/2024,Nalaka Wijesuriya,Polonnaruwa,Habarana,North Central,3991,9331,13322,159640,373240,532880
12/14/2024,Nalaka Wijesuriya,Polonnaruwa,Habarana,North Central,5316,9181,14497,212640,367240,579880
12/15/2024,Nalaka Wijesuriya,Polonnaruwa,Habarana,North Central,5931,6270,12201,237240,250800,488040
12/16/2024,Nalaka Wijesuriya,Polonnaruwa,Habarana,North Central,6343,900,7243,253720,36000,289720
12/17/2024,Nalaka Wijesuriya,Polonnaruwa,Habarana,North Central,4395,217,4612,175800,8680,184480
12/18/2024,Nalaka Wijesuriya,Polonnaruwa,Habarana,North Central,5473,3160,8633,218920,126400,345320
12/19/2024,Nalaka Wijesuriya,Polonnaruwa,Habarana,North Central,7820,5291,13111,312800,211640,524440
12/20/2024,Nalaka Wijesuriya,Polonnaruwa,Habarana,North Central,2571,5301,7872,102840,212040,314880
12/21/2024,Nalaka Wijesuriya,Polonnaruwa,Habarana,North Central,6159,227,6386,246360,9080,255440
12/22/2024,Nalaka Wijesuriya,Polonnaruwa,Habarana,North Central,1796,7115,8911,71840,284600,356440
12/23/2024,Nalaka Wijesuriya,Polonnaruwa,Habarana,North Central,9011,6828,15839,360440,273120,633560
12/24/2024,Nalaka Wijesuriya,Polonnaruwa,Habarana,North Central,6781,5529,12310,271240,221160,492400
12/25/2024,Nalaka Wijesuriya,Polonnaruwa,Habarana,North Central,3297,4537,7834,131880,181480,313360
12/26/2024,Nalaka Wijesuriya,Polonnaruwa,Habarana,North Central,1653,7537,9190,66120,301480,367600
12/27/2024,Nalaka Wijesuriya,Polonnaruwa,Habarana,North Central,3988,7858,11846,159520,314320,473840
12/28/2024,Nalaka Wijesuriya,Polonnaruwa,Habarana,North Central,1383,1908,3291,55320,76320,131640
12/29/2024,Nalaka Wijesuriya,Polonnaruwa,Habarana,North Central,3305,3085,6390,132200,123400,255600
12/30/2024,Nalaka Wijesuriya,Polonnaruwa,Habarana,North Central,3978,3631,7609,159120,145240,304360
12/31/2024,Nalaka Wijesuriya,Polonnaruwa,Habarana,North Central,634,385,1019,25360,15400,40760
1/1/2025,Nalaka Wijesuriya,Polonnaruwa,Habarana,North Central,1529,954,2483,61160,38160,99320
1/2/2025,Nalaka Wijesuriya,Polonnaruwa,Habarana,North Central,375,579,954,15000,23160,38160
1/3/2025,Nalaka Wijesuriya,Polonnaruwa,Habarana,North Central,3135,8736,11871,125400,349440,474840
1/4/2025,Nalaka Wijesuriya,Polonnaruwa,Habarana,North Central,1388,109,1497,55520,4360,59880
1/5/2025,Nalaka Wijesuriya,Polonnaruwa,Habarana,North Central,1682,9949,11631,67280,397960,465240
1/6/2025,Nalaka Wijesuriya,Polonnaruwa,Habarana,North Central,4834,2627,7461,193360,105080,298440
1/7/2025,Nalaka Wijesuriya,Polonnaruwa,Habarana,North Central,8575,2587,11162,343000,103480,446480
1/8/2025,Nalaka Wijesuriya,Polonnaruwa,Habarana,North Central,2640,3233,5873,105600,129320,234920
1/9/2025,Nalaka Wijesuriya,Polonnaruwa,Habarana,North Central,3521,3512,7033,140840,140480,281320
1/10/2025,Nalaka Wijesuriya,Polonnaruwa,Habarana,North Central,945,3758,4703,37800,150320,188120
1/11/2025,Nalaka Wijesuriya,Polonnaruwa,Habarana,North Central,8759,3308,12067,350360,132320,482680
1/12/2025,Nalaka Wijesuriya,Polonnaruwa,Habarana,North Central,5950,2404,8354,238000,96160,334160
1/13/2025,Nalaka Wijesuriya,Polonnaruwa,Habarana,North Central,9246,1793,11039,369840,71720,441560
1/14/2025,Nalaka Wijesuriya,Polonnaruwa,Habarana,North Central,6696,9755,16451,267840,390200,658040
1/15/2025,Nalaka Wijesuriya,Polonnaruwa,Habarana,North Central,7977,1484,9461,319080,59360,378440
1/16/2025,Nalaka Wijesuriya,Polonnaruwa,Habarana,North Central,2263,3589,5852,90520,143560,234080
1/17/2025,Nalaka Wijesuriya,Polonnaruwa,Habarana,North Central,9076,7019,16095,363040,280760,643800
1/18/2025,Nalaka Wijesuriya,Polonnaruwa,Habarana,North Central,9353,4036,13389,374120,161440,535560
1/19/2025,Nalaka Wijesuriya,Polonnaruwa,Habarana,North Central,3523,8320,11843,140920,332800,473720
1/20/2025,Nalaka Wijesuriya,Polonnaruwa,Habarana,North Central,7682,2055,9737,307280,82200,389480
1/21/2025,Nalaka Wijesuriya,Polonnaruwa,Habarana,North Central,6510,3629,10139,260400,145160,405560
1/22/2025,Nalaka Wijesuriya,Polonnaruwa,Habarana,North Central,9519,2019,11538,380760,80760,461520
1/23/2025,Nalaka Wijesuriya,Polonnaruwa,Habarana,North Central,678,3688,4366,27120,147520,174640
1/24/2025,Nalaka Wijesuriya,Polonnaruwa,Habarana,North Central,5096,2799,7895,203840,111960,315800
1/25/2025,Nalaka Wijesuriya,Polonnaruwa,Habarana,North Central,2156,9929,12085,86240,397160,483400
1/26/2025,Nalaka Wijesuriya,Polonnaruwa,Habarana,North Central,9444,5323,14767,377760,212920,590680
1/27/2025,Nalaka Wijesuriya,Polonnaruwa,Habarana,North Central,2799,3545,6344,111960,141800,253760
1/28/2025,Nalaka Wijesuriya,Polonnaruwa,Habarana,North Central,6276,5585,11861,251040,223400,474440
1/29/2025,Nalaka Wijesuriya,Polonnaruwa,Habarana,North Central,5569,9734,15303,222760,389360,612120
1/30/2025,Nalaka Wijesuriya,Polonnaruwa,Habarana,North Central,8000,2679,10679,320000,107160,427160
1/31/2025,Nalaka Wijesuriya,Polonnaruwa,Habarana,North Central,136,8941,9077,5440,357640,363080
2/1/2025,Nalaka Wijesuriya,Polonnaruwa,Habarana,North Central,1682,3653,5335,67280,146120,213400
2/2/2025,Nalaka Wijesuriya,Polonnaruwa,Habarana,North Central,9389,3821,13210,375560,152840,528400
2/3/2025,Nalaka Wijesuriya,Polonnaruwa,Habarana,North Central,9884,225,10109,395360,9000,404360
2/4/2025,Nalaka Wijesuriya,Polonnaruwa,Habarana,North Central,2486,8686,11172,99440,347440,446880
2/5/2025,Nalaka Wijesuriya,Polonnaruwa,Habarana,North Central,4162,6924,11086,166480,276960,443440
2/6/2025,Nalaka Wijesuriya,Polonnaruwa,Habarana,North Central,5749,7877,13626,229960,315080,545040
2/7/2025,Nalaka Wijesuriya,Polonnaruwa,Habarana,North Central,9029,4923,13952,361160,196920,558080
2/8/2025,Nalaka Wijesuriya,Polonnaruwa,Habarana,North Central,5231,2110,7341,209240,84400,293640
2/9/2025,Nalaka Wijesuriya,Polonnaruwa,Habarana,North Central,701,5531,6232,28040,221240,249280
2/10/2025,Nalaka Wijesuriya,Polonnaruwa,Habarana,North Central,7442,7724,15166,297680,308960,606640
2/11/2025,Nalaka Wijesuriya,Polonnaruwa,Habarana,North Central,1582,5094,6676,63280,203760,267040
2/12/2025,Nalaka Wijesuriya,Polonnaruwa,Habarana,North Central,8649,9150,17799,345960,366000,711960
2/13/2025,Nalaka Wijesuriya,Polonnaruwa,Habarana,North Central,1253,5665,6918,50120,226600,276720
2/14/2025,Nalaka Wijesuriya,Polonnaruwa,Habarana,North Central,2855,588,3443,114200,23520,137720
2/15/2025,Nalaka Wijesuriya,Polonnaruwa,Habarana,North Central,6600,9861,16461,264000,394440,658440
2/16/2025,Nalaka Wijesuriya,Polonnaruwa,Habarana,North Central,1700,4633,6333,68000,185320,253320
2/17/2025,Nalaka Wijesuriya,Polonnaruwa,Habarana,North Central,5930,3678,9608,237200,147120,384320
2/18/2025,Nalaka Wijesuriya,Polonnaruwa,Habarana,North Central,7807,5229,13036,312280,209160,521440
2/19/2025,Nalaka Wijesuriya,Polonnaruwa,Habarana,North Central,2767,5987,8754,110680,239480,350160
2/20/2025,Nalaka Wijesuriya,Polonnaruwa,Habarana,North Central,8359,6339,14698,334360,253560,587920
2/21/2025,Nalaka Wijesuriya,Polonnaruwa,Habarana,North Central,2604,7999,10603,104160,319960,424120
2/22/2025,Nalaka Wijesuriya,Polonnaruwa,Habarana,North Central,3970,6053,10023,158800,242120,400920
2/23/2025,Nalaka Wijesuriya,Polonnaruwa,Habarana,North Central,8040,3977,12017,321600,159080,480680
2/24/2025,Nalaka Wijesuriya,Polonnaruwa,Habarana,North Central,7871,2608,10479,314840,104320,419160
2/25/2025,Nalaka Wijesuriya,Polonnaruwa,Habarana,North Central,5917,632,6549,236680,25280,261960
2/26/2025,Nalaka Wijesuriya,Polonnaruwa,Habarana,North Central,6855,7735,14590,274200,309400,583600
2/27/2025,Nalaka Wijesuriya,Polonnaruwa,Habarana,North Central,7716,2396,10112,308640,95840,404480
2/28/2025,Nalaka Wijesuriya,Polonnaruwa,Habarana,North Central,360,6007,6367,14400,240280,254680
3/1/2025,Nalaka Wijesuriya,Polonnaruwa,Habarana,North Central,1127,97,1224,45080,3880,48960
3/2/2025,Nalaka Wijesuriya,Polonnaruwa,Habarana,North Central,6112,1383,7495,244480,55320,299800
3/3/2025,Nalaka Wijesuriya,Polonnaruwa,Habarana,North Central,7711,6119,13830,308440,244760,553200
3/4/2025,Nalaka Wijesuriya,Polonnaruwa,Habarana,North Central,1351,3700,5051,54040,148000,202040
3/5/2025,Nalaka Wijesuriya,Polonnaruwa,Habarana,North Central,3125,5959,9084,125000,238360,363360
3/6/2025,Nalaka Wijesuriya,Polonnaruwa,Habarana,North Central,1184,4849,6033,47360,193960,241320
3/7/2025,Nalaka Wijesuriya,Polonnaruwa,Habarana,North Central,9614,7390,17004,384560,295600,680160
3/8/2025,Nalaka Wijesuriya,Polonnaruwa,Habarana,North Central,4108,3571,7679,164320,142840,307160
3/9/2025,Nalaka Wijesuriya,Polonnaruwa,Habarana,North Central,1254,8777,10031,50160,351080,401240
3/10/2025,Nalaka Wijesuriya,Polonnaruwa,Habarana,North Central,2408,4541,6949,96320,181640,277960
3/11/2025,Nalaka Wijesuriya,Polonnaruwa,Habarana,North Central,1846,5455,7301,73840,218200,292040
3/12/2025,Nalaka Wijesuriya,Polonnaruwa,Habarana,North Central,2464,8035,10499,98560,321400,419960
3/13/2025,Nalaka Wijesuriya,Polonnaruwa,Habarana,North Central,5647,4407,10054,225880,176280,402160
3/14/2025,Nalaka Wijesuriya,Polonnaruwa,Habarana,North Central,6547,3165,9712,261880,126600,388480
3/15/2025,Nalaka Wijesuriya,Polonnaruwa,Habarana,North Central,1548,6413,7961,61920,256520,318440
3/16/2025,Nalaka Wijesuriya,Polonnaruwa,Habarana,North Central,7489,8806,16295,299560,352240,651800
3/17/2025,Nalaka Wijesuriya,Polonnaruwa,Habarana,North Central,9985,7955,17940,399400,318200,717600
3/18/2025,Nalaka Wijesuriya,Polonnaruwa,Habarana,North Central,8377,2275,10652,335080,91000,426080
3/19/2025,Nalaka Wijesuriya,Polonnaruwa,Habarana,North Central,2611,6937,9548,104440,277480,381920
3/20/2025,Nalaka Wijesuriya,Polonnaruwa,Habarana,North Central,1755,12,1767,70200,480,70680
3/21/2025,Nalaka Wijesuriya,Polonnaruwa,Habarana,North Central,7189,634,7823,287560,25360,312920
3/22/2025,Nalaka Wijesuriya,Polonnaruwa,Habarana,North Central,6111,1345,7456,244440,53800,298240
3/23/2025,Nalaka Wijesuriya,Polonnaruwa,Habarana,North Central,968,7569,8537,38720,302760,341480
3/25/2024,Tushara Gunathilake,Kurunegala,Nakulugama,North Western,8925,835,9760,357000,33400,390400
3/26/2024,Tushara Gunathilake,Kurunegala,Nakulugama,North Western,8583,8169,16752,343320,326760,670080
3/27/2024,Tushara Gunathilake,Kurunegala,Nakulugama,North Western,3616,2491,6107,144640,99640,244280
3/28/2024,Tushara Gunathilake,Kurunegala,Nakulugama,North Western,8022,1887,9909,320880,75480,396360
3/29/2024,Tushara Gunathilake,Kurunegala,Nakulugama,North Western,1425,1726,3151,57000,69040,126040
3/30/2024,Tushara Gunathilake,Kurunegala,Nakulugama,North Western,9241,7373,16614,369640,294920,664560
3/31/2024,Tushara Gunathilake,Kurunegala,Nakulugama,North Western,6839,7544,14383,273560,301760,575320
4/1/2024,Tushara Gunathilake,Kurunegala,Nakulugama,North Western,5540,4806,10346,221600,192240,413840
4/2/2024,Tushara Gunathilake,Kurunegala,Nakulugama,North Western,463,6376,6839,18520,255040,273560
4/3/2024,Tushara Gunathilake,Kurunegala,Nakulugama,North Western,1812,1540,3352,72480,61600,134080
4/4/2024,Tushara Gunathilake,Kurunegala,Nakulugama,North Western,5959,5804,11763,238360,232160,470520
4/5/2024,Tushara Gunathilake,Kurunegala,Nakulugama,North Western,8233,2228,10461,329320,89120,418440
4/6/2024,Tushara Gunathilake,Kurunegala,Nakulugama,North Western,6602,2962,9564,264080,118480,382560
4/7/2024,Tushara Gunathilake,Kurunegala,Nakulugama,North Western,6115,7075,13190,244600,283000,527600
4/8/2024,Tushara Gunathilake,Kurunegala,Nakulugama,North Western,3393,3072,6465,135720,122880,258600
4/9/2024,Tushara Gunathilake,Kurunegala,Nakulugama,North Western,501,8737,9238,20040,349480,369520
4/10/2024,Tushara Gunathilake,Kurunegala,Nakulugama,North Western,1212,416,1628,48480,16640,65120
4/11/2024,Tushara Gunathilake,Kurunegala,Nakulugama,North Western,2443,6109,8552,97720,244360,342080
4/19/2024,Tushara Gunathilake,Kurunegala,Nakulugama,North Western,2501,6406,8907,100040,256240,356280
4/20/2024,Tushara Gunathilake,Kurunegala,Nakulugama,North Western,2003,2142,4145,80120,85680,165800
4/21/2024,Tushara Gunathilake,Kurunegala,Nakulugama,North Western,4754,8893,13647,190160,355720,545880
4/22/2024,Tushara Gunathilake,Kurunegala,Nakulugama,North Western,8281,6087,14368,331240,243480,574720
4/23/2024,Tushara Gunathilake,Kurunegala,Nakulugama,North Western,5365,8875,14240,214600,355000,569600
4/24/2024,Tushara Gunathilake,Kurunegala,Nakulugama,North Western,891,5447,6338,35640,217880,253520
4/25/2024,Tushara Gunathilake,Kurunegala,Nakulugama,North Western,3991,6759,10750,159640,270360,430000
4/26/2024,Tushara Gunathilake,Kurunegala,Nakulugama,North Western,656,8925,9581,26240,357000,383240
4/27/2024,Tushara Gunathilake,Kurunegala,Nakulugama,North Western,9034,3613,12647,361360,144520,505880
4/28/2024,Tushara Gunathilake,Kurunegala,Nakulugama,North Western,5718,3599,9317,228720,143960,372680
4/29/2024,Tushara Gunathilake,Kurunegala,Nakulugama,North Western,2322,3262,5584,92880,130480,223360
4/30/2024,Tushara Gunathilake,Kurunegala,Nakulugama,North Western,4177,9836,14013,167080,393440,560520
5/1/2024,Tushara Gunathilake,Kurunegala,Nakulugama,North Western,9908,2253,12161,396320,90120,486440
5/2/2024,Tushara Gunathilake,Kurunegala,Nakulugama,North Western,7627,7697,15324,305080,307880,612960
5/3/2024,Tushara Gunathilake,Kurunegala,Nakulugama,North Western,2146,8259,10405,85840,330360,416200
5/4/2024,Tushara Gunathilake,Kurunegala,Nakulugama,North Western,7103,3801,10904,284120,152040,436160
5/5/2024,Tushara Gunathilake,Kurunegala,Nakulugama,North Western,8062,9551,17613,322480,382040,704520
5/6/2024,Tushara Gunathilake,Kurunegala,Nakulugama,North Western,4095,7023,11118,163800,280920,444720
5/7/2024,Tushara Gunathilake,Kurunegala,Nakulugama,North Western,2431,5625,8056,97240,225000,322240
5/8/2024,Tushara Gunathilake,Kurunegala,Nakulugama,North Western,2343,8893,11236,93720,355720,449440
5/9/2024,Tushara Gunathilake,Kurunegala,Nakulugama,North Western,5864,2557,8421,234560,102280,336840
5/10/2024,Tushara Gunathilake,Kurunegala,Nakulugama,North Western,5955,877,6832,238200,35080,273280
5/11/2024,Tushara Gunathilake,Kurunegala,Nakulugama,North Western,5698,9885,15583,227920,395400,623320
5/12/2024,Tushara Gunathilake,Kurunegala,Nakulugama,North Western,8228,9661,17889,329120,386440,715560
5/13/2024,Tushara Gunathilake,Kurunegala,Nakulugama,North Western,9489,5303,14792,379560,212120,591680
5/14/2024,Tushara Gunathilake,Kurunegala,Nakulugama,North Western,5728,4660,10388,229120,186400,415520
5/15/2024,Tushara Gunathilake,Kurunegala,Nakulugama,North Western,1967,9736,11703,78680,389440,468120
5/16/2024,Tushara Gunathilake,Kurunegala,Nakulugama,North Western,7414,2939,10353,296560,117560,414120
5/17/2024,Tushara Gunathilake,Kurunegala,Nakulugama,North Western,203,5379,5582,8120,215160,223280
5/18/2024,Tushara Gunathilake,Kurunegala,Nakulugama,North Western,1477,4708,6185,59080,188320,247400
5/19/2024,Tushara Gunathilake,Kurunegala,Nakulugama,North Western,9054,8247,17301,362160,329880,692040
5/20/2024,Tushara Gunathilake,Kurunegala,Nakulugama,North Western,319,7014,7333,12760,280560,293320
5/21/2024,Tushara Gunathilake,Kurunegala,Nakulugama,North Western,3282,762,4044,131280,30480,161760
5/22/2024,Tushara Gunathilake,Kurunegala,Nakulugama,North Western,6232,8397,14629,249280,335880,585160
5/24/2024,Tushara Gunathilake,Kurunegala,Nakulugama,North Western,4771,3085,7856,190840,123400,314240
5/25/2024,Tushara Gunathilake,Kurunegala,Nakulugama,North Western,5243,1942,7185,209720,77680,287400
5/26/2024,Tushara Gunathilake,Kurunegala,Nakulugama,North Western,5657,4427,10084,226280,177080,403360
5/27/2024,Tushara Gunathilake,Kurunegala,Nakulugama,North Western,7269,4848,12117,290760,193920,484680
5/28/2024,Tushara Gunathilake,Kurunegala,Nakulugama,North Western,6316,8456,14772,252640,338240,590880
5/29/2024,Tushara Gunathilake,Kurunegala,Nakulugama,North Western,587,7164,7751,23480,286560,310040
5/30/2024,Tushara Gunathilake,Kurunegala,Nakulugama,North Western,1545,7574,9119,61800,302960,364760
5/31/2024,Tushara Gunathilake,Kurunegala,Nakulugama,North Western,8043,5045,13088,321720,201800,523520
6/1/2024,Tushara Gunathilake,Kurunegala,Nakulugama,North Western,6089,4835,10924,243560,193400,436960
6/2/2024,Tushara Gunathilake,Kurunegala,Nakulugama,North Western,2049,3478,5527,81960,139120,221080
6/3/2024,Tushara Gunathilake,Kurunegala,Nakulugama,North Western,6272,7121,13393,250880,284840,535720
6/4/2024,Tushara Gunathilake,Kurunegala,Nakulugama,North Western,564,6965,7529,22560,278600,301160
6/5/2024,Tushara Gunathilake,Kurunegala,Nakulugama,North Western,2010,8090,10100,80400,323600,404000
6/6/2024,Tushara Gunathilake,Kurunegala,Nakulugama,North Western,3311,1412,4723,132440,56480,188920
6/7/2024,Tushara Gunathilake,Kurunegala,Nakulugama,North Western,7993,7387,15380,319720,295480,615200
6/8/2024,Tushara Gunathilake,Kurunegala,Nakulugama,North Western,1276,324,1600,51040,12960,64000
6/9/2024,Tushara Gunathilake,Kurunegala,Nakulugama,North Western,7610,837,8447,304400,33480,337880
6/10/2024,Tushara Gunathilake,Kurunegala,Nakulugama,North Western,8090,1852,9942,323600,74080,397680
6/11/2024,Tushara Gunathilake,Kurunegala,Nakulugama,North Western,7680,1433,9113,307200,57320,364520
6/12/2024,Tushara Gunathilake,Kurunegala,Nakulugama,North Western,1793,6722,8515,71720,268880,340600
6/13/2024,Tushara Gunathilake,Kurunegala,Nakulugama,North Western,3186,2097,5283,127440,83880,211320
6/14/2024,Tushara Gunathilake,Kurunegala,Nakulugama,North Western,6410,4942,11352,256400,197680,454080
6/15/2024,Tushara Gunathilake,Kurunegala,Nakulugama,North Western,5463,8829,14292,218520,353160,571680
6/16/2024,Tushara Gunathilake,Kurunegala,Nakulugama,North Western,2624,4951,7575,104960,198040,303000
6/17/2024,Tushara Gunathilake,Kurunegala,Nakulugama,North Western,6658,9430,16088,266320,377200,643520
6/18/2024,Tushara Gunathilake,Kurunegala,Nakulugama,North Western,828,1645,2473,33120,65800,98920
6/19/2024,Tushara Gunathilake,Kurunegala,Nakulugama,North Western,5244,6172,11416,209760,246880,456640
6/20/2024,Tushara Gunathilake,Kurunegala,Nakulugama,North Western,7826,9934,17760,313040,397360,710400
6/21/2024,Tushara Gunathilake,Kurunegala,Nakulugama,North Western,7125,4014,11139,285000,160560,445560
6/22/2024,Tushara Gunathilake,Kurunegala,Nakulugama,North Western,9866,986,10852,394640,39440,434080
6/23/2024,Tushara Gunathilake,Kurunegala,Nakulugama,North Western,8786,4434,13220,351440,177360,528800
6/24/2024,Tushara Gunathilake,Kurunegala,Nakulugama,North Western,3903,5955,9858,156120,238200,394320
6/25/2024,Tushara Gunathilake,Kurunegala,Nakulugama,North Western,1935,1761,3696,77400,70440,147840
6/26/2024,Tushara Gunathilake,Kurunegala,Nakulugama,North Western,6552,1098,7650,262080,43920,306000
6/27/2024,Tushara Gunathilake,Kurunegala,Nakulugama,North Western,4911,7242,12153,196440,289680,486120
6/28/2024,Tushara Gunathilake,Kurunegala,Nakulugama,North Western,2370,6009,8379,94800,240360,335160
6/29/2024,Tushara Gunathilake,Kurunegala,Nakulugama,North Western,2766,2335,5101,110640,93400,204040
6/30/2024,Tushara Gunathilake,Kurunegala,Nakulugama,North Western,2998,7657,10655,119920,306280,426200
7/1/2024,Tushara Gunathilake,Kurunegala,Nakulugama,North Western,5149,5859,11008,205960,234360,440320
7/2/2024,Tushara Gunathilake,Kurunegala,Nakulugama,North Western,8863,3845,12708,354520,153800,508320
7/3/2024,Tushara Gunathilake,Kurunegala,Nakulugama,North Western,2452,5024,7476,98080,200960,299040
7/4/2024,Tushara Gunathilake,Kurunegala,Nakulugama,North Western,2139,5132,7271,85560,205280,290840
7/5/2024,Tushara Gunathilake,Kurunegala,Nakulugama,North Western,7262,2455,9717,290480,98200,388680
7/6/2024,Tushara Gunathilake,Kurunegala,Nakulugama,North Western,7357,1552,8909,294280,62080,356360
7/7/2024,Tushara Gunathilake,Kurunegala,Nakulugama,North Western,6368,2088,8456,254720,83520,338240
7/8/2024,Tushara Gunathilake,Kurunegala,Nakulugama,North Western,5999,7779,13778,239960,311160,551120
7/9/2024,Tushara Gunathilake,Kurunegala,Nakulugama,North Western,8788,1169,9957,351520,46760,398280
7/10/2024,Tushara Gunathilake,Kurunegala,Nakulugama,North Western,6899,1380,8279,275960,55200,331160
7/11/2024,Tushara Gunathilake,Kurunegala,Nakulugama,North Western,3369,8439,11808,134760,337560,472320
7/12/2024,Tushara Gunathilake,Kurunegala,Nakulugama,North Western,2308,9631,11939,92320,385240,477560
7/13/2024,Tushara Gunathilake,Kurunegala,Nakulugama,North Western,9993,9980,19973,399720,399200,798920
7/14/2024,Tushara Gunathilake,Kurunegala,Nakulugama,North Western,8473,4573,13046,338920,182920,521840
7/15/2024,Tushara Gunathilake,Kurunegala,Nakulugama,North Western,368,8592,8960,14720,343680,358400
7/16/2024,Tushara Gunathilake,Kurunegala,Nakulugama,North Western,4154,7715,11869,166160,308600,474760
7/17/2024,Tushara Gunathilake,Kurunegala,Nakulugama,North Western,7264,9117,16381,290560,364680,655240
7/18/2024,Tushara Gunathilake,Kurunegala,Nakulugama,North Western,5730,2165,7895,229200,86600,315800
7/19/2024,Tushara Gunathilake,Kurunegala,Nakulugama,North Western,3476,3237,6713,139040,129480,268520
7/20/2024,Tushara Gunathilake,Kurunegala,Nakulugama,North Western,5353,1234,6587,214120,49360,263480
7/21/2024,Tushara Gunathilake,Kurunegala,Nakulugama,North Western,6551,8097,14648,262040,323880,585920
7/22/2024,Tushara Gunathilake,Kurunegala,Nakulugama,North Western,1650,6857,8507,66000,274280,340280
7/23/2024,Tushara Gunathilake,Kurunegala,Nakulugama,North Western,8713,2425,11138,348520,97000,445520
7/24/2024,Tushara Gunathilake,Kurunegala,Nakulugama,North Western,4555,7220,11775,182200,288800,471000
7/25/2024,Tushara Gunathilake,Kurunegala,Nakulugama,North Western,8790,7453,16243,351600,298120,649720
7/26/2024,Tushara Gunathilake,Kurunegala,Nakulugama,North Western,4806,6098,10904,192240,243920,436160
7/27/2024,Tushara Gunathilake,Kurunegala,Nakulugama,North Western,3322,8104,11426,132880,324160,457040
7/28/2024,Tushara Gunathilake,Kurunegala,Nakulugama,North Western,5753,9540,15293,230120,381600,611720
7/29/2024,Tushara Gunathilake,Kurunegala,Nakulugama,North Western,6237,9126,15363,249480,365040,614520
7/30/2024,Tushara Gunathilake,Kurunegala,Nakulugama,North Western,1425,4833,6258,57000,193320,250320
7/31/2024,Tushara Gunathilake,Kurunegala,Nakulugama,North Western,7191,1450,8641,287640,58000,345640
8/1/2024,Tushara Gunathilake,Kurunegala,Nakulugama,North Western,1157,8059,9216,46280,322360,368640
8/2/2024,Tushara Gunathilake,Kurunegala,Nakulugama,North Western,2829,1410,4239,113160,56400,169560
8/3/2024,Tushara Gunathilake,Kurunegala,Nakulugama,North Western,4662,9592,14254,186480,383680,570160
8/4/2024,Tushara Gunathilake,Kurunegala,Nakulugama,North Western,6555,4851,11406,262200,194040,456240
8/5/2024,Tushara Gunathilake,Kurunegala,Nakulugama,North Western,5537,6165,11702,221480,246600,468080
8/6/2024,Tushara Gunathilake,Kurunegala,Nakulugama,North Western,815,9586,10401,32600,383440,416040
8/7/2024,Tushara Gunathilake,Kurunegala,Nakulugama,North Western,1152,7303,8455,46080,292120,338200
8/8/2024,Tushara Gunathilake,Kurunegala,Nakulugama,North Western,4987,1988,6975,199480,79520,279000
8/9/2024,Tushara Gunathilake,Kurunegala,Nakulugama,North Western,9319,2154,11473,372760,86160,458920
8/10/2024,Tushara Gunathilake,Kurunegala,Nakulugama,North Western,4598,7228,11826,183920,289120,473040
8/11/2024,Tushara Gunathilake,Kurunegala,Nakulugama,North Western,3267,7656,10923,130680,306240,436920
8/12/2024,Tushara Gunathilake,Kurunegala,Nakulugama,North Western,4186,2009,6195,167440,80360,247800
8/13/2024,Tushara Gunathilake,Kurunegala,Nakulugama,North Western,9087,7257,16344,363480,290280,653760
8/14/2024,Tushara Gunathilake,Kurunegala,Nakulugama,North Western,970,6942,7912,38800,277680,316480
8/15/2024,Tushara Gunathilake,Kurunegala,Nakulugama,North Western,7725,7780,15505,309000,311200,620200
8/16/2024,Tushara Gunathilake,Kurunegala,Nakulugama,North Western,4393,9904,14297,175720,396160,571880
8/17/2024,Tushara Gunathilake,Kurunegala,Nakulugama,North Western,4670,6468,11138,186800,258720,445520
8/18/2024,Tushara Gunathilake,Kurunegala,Nakulugama,North Western,634,4487,5121,25360,179480,204840
8/19/2024,Tushara Gunathilake,Kurunegala,Nakulugama,North Western,4443,2434,6877,177720,97360,275080
8/20/2024,Tushara Gunathilake,Kurunegala,Nakulugama,North Western,5558,7337,12895,222320,293480,515800
8/21/2024,Tushara Gunathilake,Kurunegala,Nakulugama,North Western,4662,5322,9984,186480,212880,399360
8/22/2024,Tushara Gunathilake,Kurunegala,Nakulugama,North Western,6091,5015,11106,243640,200600,444240
8/23/2024,Tushara Gunathilake,Kurunegala,Nakulugama,North Western,1998,399,2397,79920,15960,95880
8/24/2024,Tushara Gunathilake,Kurunegala,Nakulugama,North Western,9310,2950,12260,372400,118000,490400
8/25/2024,Tushara Gunathilake,Kurunegala,Nakulugama,North Western,5247,632,5879,209880,25280,235160
8/26/2024,Tushara Gunathilake,Kurunegala,Nakulugama,North Western,9460,2781,12241,378400,111240,489640
8/27/2024,Tushara Gunathilake,Kurunegala,Nakulugama,North Western,1403,5555,6958,56120,222200,278320
8/28/2024,Tushara Gunathilake,Kurunegala,Nakulugama,North Western,8849,2131,10980,353960,85240,439200
8/29/2024,Tushara Gunathilake,Kurunegala,Nakulugama,North Western,9503,2973,12476,380120,118920,499040
8/30/2024,Tushara Gunathilake,Kurunegala,Nakulugama,North Western,5607,5230,10837,224280,209200,433480
8/31/2024,Tushara Gunathilake,Kurunegala,Nakulugama,North Western,5521,257,5778,220840,10280,231120
9/1/2024,Tushara Gunathilake,Kurunegala,Nakulugama,North Western,3112,7836,10948,124480,313440,437920
9/2/2024,Tushara Gunathilake,Kurunegala,Nakulugama,North Western,2902,1342,4244,116080,53680,169760
9/3/2024,Tushara Gunathilake,Kurunegala,Nakulugama,North Western,7860,163,8023,314400,6520,320920
9/4/2024,Tushara Gunathilake,Kurunegala,Nakulugama,North Western,6724,2666,9390,268960,106640,375600
9/5/2024,Tushara Gunathilake,Kurunegala,Nakulugama,North Western,1758,7294,9052,70320,291760,362080
9/6/2024,Tushara Gunathilake,Kurunegala,Nakulugama,North Western,5251,1170,6421,210040,46800,256840
9/7/2024,Tushara Gunathilake,Kurunegala,Nakulugama,North Western,4115,2089,6204,164600,83560,248160
9/8/2024,Tushara Gunathilake,Kurunegala,Nakulugama,North Western,3137,4664,7801,125480,186560,312040
9/9/2024,Tushara Gunathilake,Kurunegala,Nakulugama,North Western,9555,322,9877,382200,12880,395080
9/10/2024,Tushara Gunathilake,Kurunegala,Nakulugama,North Western,3936,6212,10148,157440,248480,405920
9/11/2024,Tushara Gunathilake,Kurunegala,Nakulugama,North Western,2073,4878,6951,82920,195120,278040
9/12/2024,Tushara Gunathilake,Kurunegala,Nakulugama,North Western,5031,1801,6832,201240,72040,273280
9/13/2024,Tushara Gunathilake,Kurunegala,Nakulugama,North Western,6405,9357,15762,256200,374280,630480
9/14/2024,Tushara Gunathilake,Kurunegala,Nakulugama,North Western,1787,6258,8045,71480,250320,321800
9/15/2024,Tushara Gunathilake,Kurunegala,Nakulugama,North Western,3162,4759,7921,126480,190360,316840
9/16/2024,Tushara Gunathilake,Kurunegala,Nakulugama,North Western,9299,783,10082,371960,31320,403280
9/17/2024,Tushara Gunathilake,Kurunegala,Nakulugama,North Western,934,9161,10095,37360,366440,403800
9/18/2024,Tushara Gunathilake,Kurunegala,Nakulugama,North Western,3144,3849,6993,125760,153960,279720
9/19/2024,Tushara Gunathilake,Kurunegala,Nakulugama,North Western,4701,2200,6901,188040,88000,276040
9/20/2024,Tushara Gunathilake,Kurunegala,Nakulugama,North Western,6730,5979,12709,269200,239160,508360
9/21/2024,Tushara Gunathilake,Kurunegala,Nakulugama,North Western,9342,912,10254,373680,36480,410160
9/22/2024,Tushara Gunathilake,Kurunegala,Nakulugama,North Western,7518,2221,9739,300720,88840,389560
9/23/2024,Tushara Gunathilake,Kurunegala,Nakulugama,North Western,6706,5891,12597,268240,235640,503880
9/24/2024,Tushara Gunathilake,Kurunegala,Nakulugama,North Western,6254,1113,7367,250160,44520,294680
9/25/2024,Tushara Gunathilake,Kurunegala,Nakulugama,North Western,2418,1027,3445,96720,41080,137800
9/26/2024,Tushara Gunathilake,Kurunegala,Nakulugama,North Western,5370,1335,6705,214800,53400,268200
9/27/2024,Tushara Gunathilake,Kurunegala,Nakulugama,North Western,9919,4797,14716,396760,191880,588640
9/28/2024,Tushara Gunathilake,Kurunegala,Nakulugama,North Western,3408,7118,10526,136320,284720,421040
9/29/2024,Tushara Gunathilake,Kurunegala,Nakulugama,North Western,9651,7847,17498,386040,313880,699920
9/30/2024,Tushara Gunathilake,Kurunegala,Nakulugama,North Western,8853,1367,10220,354120,54680,408800
10/1/2024,Tushara Gunathilake,Kurunegala,Nakulugama,North Western,5487,5422,10909,219480,216880,436360
10/2/2024,Tushara Gunathilake,Kurunegala,Nakulugama,North Western,6358,5049,11407,254320,201960,456280
10/3/2024,Tushara Gunathilake,Kurunegala,Nakulugama,North Western,7341,4027,11368,293640,161080,454720
10/4/2024,Tushara Gunathilake,Kurunegala,Nakulugama,North Western,3247,5809,9056,129880,232360,362240
10/5/2024,Tushara Gunathilake,Kurunegala,Nakulugama,North Western,6336,9704,16040,253440,388160,641600
10/6/2024,Tushara Gunathilake,Kurunegala,Nakulugama,North Western,4711,4182,8893,188440,167280,355720
10/7/2024,Tushara Gunathilake,Kurunegala,Nakulugama,North Western,7069,6094,13163,282760,243760,526520
10/8/2024,Tushara Gunathilake,Kurunegala,Nakulugama,North Western,320,8406,8726,12800,336240,349040
10/9/2024,Tushara Gunathilake,Kurunegala,Nakulugama,North Western,9590,6934,16524,383600,277360,660960
10/10/2024,Tushara Gunathilake,Kurunegala,Nakulugama,North Western,104,7233,7337,4160,289320,293480
10/11/2024,Tushara Gunathilake,Kurunegala,Nakulugama,North Western,9129,9012,18141,365160,360480,725640
10/12/2024,Tushara Gunathilake,Kurunegala,Nakulugama,North Western,7759,7632,15391,310360,305280,615640
10/13/2024,Tushara Gunathilake,Kurunegala,Nakulugama,North Western,4273,1660,5933,170920,66400,237320
10/14/2024,Tushara Gunathilake,Kurunegala,Nakulugama,North Western,8765,1006,9771,350600,40240,390840
10/15/2024,Tushara Gunathilake,Kurunegala,Nakulugama,North Western,6758,1758,8516,270320,70320,340640
10/16/2024,Tushara Gunathilake,Kurunegala,Nakulugama,North Western,1598,4501,6099,63920,180040,243960
10/17/2024,Tushara Gunathilake,Kurunegala,Nakulugama,North Western,4353,663,5016,174120,26520,200640
10/18/2024,Tushara Gunathilake,Kurunegala,Nakulugama,North Western,8073,3361,11434,322920,134440,457360
10/19/2024,Tushara Gunathilake,Kurunegala,Nakulugama,North Western,3631,1149,4780,145240,45960,191200
10/20/2024,Tushara Gunathilake,Kurunegala,Nakulugama,North Western,4216,6790,11006,168640,271600,440240
10/21/2024,Tushara Gunathilake,Kurunegala,Nakulugama,North Western,5717,1918,7635,228680,76720,305400
10/22/2024,Tushara Gunathilake,Kurunegala,Nakulugama,North Western,884,6032,6916,35360,241280,276640
10/23/2024,Tushara Gunathilake,Kurunegala,Nakulugama,North Western,7845,9459,17304,313800,378360,692160
10/24/2024,Tushara Gunathilake,Kurunegala,Nakulugama,North Western,659,9351,10010,26360,374040,400400
10/25/2024,Tushara Gunathilake,Kurunegala,Nakulugama,North Western,1470,3513,4983,58800,140520,199320
10/26/2024,Tushara Gunathilake,Kurunegala,Nakulugama,North Western,859,561,1420,34360,22440,56800
10/27/2024,Tushara Gunathilake,Kurunegala,Nakulugama,North Western,3662,1530,5192,146480,61200,207680
10/28/2024,Tushara Gunathilake,Kurunegala,Nakulugama,North Western,5040,4388,9428,201600,175520,377120
10/29/2024,Tushara Gunathilake,Kurunegala,Nakulugama,North Western,8789,1040,9829,351560,41600,393160
10/30/2024,Tushara Gunathilake,Kurunegala,Nakulugama,North Western,5159,3857,9016,206360,154280,360640
10/31/2024,Tushara Gunathilake,Kurunegala,Nakulugama,North Western,5067,610,5677,202680,24400,227080
11/1/2024,Tushara Gunathilake,Kurunegala,Nakulugama,North Western,7328,4538,11866,293120,181520,474640
11/2/2024,Tushara Gunathilake,Kurunegala,Nakulugama,North Western,1303,6302,7605,52120,252080,304200
11/3/2024,Tushara Gunathilake,Kurunegala,Nakulugama,North Western,101,3913,4014,4040,156520,160560
11/4/2024,Tushara Gunathilake,Kurunegala,Nakulugama,North Western,9197,9463,18660,367880,378520,746400
11/5/2024,Tushara Gunathilake,Kurunegala,Nakulugama,North Western,8008,2538,10546,320320,101520,421840
11/6/2024,Tushara Gunathilake,Kurunegala,Nakulugama,North Western,2407,2518,4925,96280,100720,197000
11/7/2024,Tushara Gunathilake,Kurunegala,Nakulugama,North Western,4016,4079,8095,160640,163160,323800
11/8/2024,Tushara Gunathilake,Kurunegala,Nakulugama,North Western,7275,5731,13006,291000,229240,520240
11/9/2024,Tushara Gunathilake,Kurunegala,Nakulugama,North Western,8974,2707,11681,358960,108280,467240
11/10/2024,Tushara Gunathilake,Kurunegala,Nakulugama,North Western,5473,6741,12214,218920,269640,488560
11/11/2024,Tushara Gunathilake,Kurunegala,Nakulugama,North Western,8344,6918,15262,333760,276720,610480
11/12/2024,Tushara Gunathilake,Kurunegala,Nakulugama,North Western,3294,603,3897,131760,24120,155880
11/13/2024,Tushara Gunathilake,Kurunegala,Nakulugama,North Western,130,5694,5824,5200,227760,232960
11/14/2024,Tushara Gunathilake,Kurunegala,Nakulugama,North Western,3820,908,4728,152800,36320,189120
11/15/2024,Tushara Gunathilake,Kurunegala,Nakulugama,North Western,736,7276,8012,29440,291040,320480
11/16/2024,Tushara Gunathilake,Kurunegala,Nakulugama,North Western,2873,6600,9473,114920,264000,378920
11/17/2024,Tushara Gunathilake,Kurunegala,Nakulugama,North Western,2950,2482,5432,118000,99280,217280
11/18/2024,Tushara Gunathilake,Kurunegala,Nakulugama,North Western,7064,3953,11017,282560,158120,440680
11/19/2024,Tushara Gunathilake,Kurunegala,Nakulugama,North Western,1879,4836,6715,75160,193440,268600
11/20/2024,Tushara Gunathilake,Kurunegala,Nakulugama,North Western,9187,8972,18159,367480,358880,726360
11/21/2024,Tushara Gunathilake,Kurunegala,Nakulugama,North Western,4452,1168,5620,178080,46720,224800
11/22/2024,Tushara Gunathilake,Kurunegala,Nakulugama,North Western,4954,9984,14938,198160,399360,597520
11/23/2024,Tushara Gunathilake,Kurunegala,Nakulugama,North Western,189,3850,4039,7560,154000,161560
11/24/2024,Tushara Gunathilake,Kurunegala,Nakulugama,North Western,5712,1203,6915,228480,48120,276600
11/25/2024,Tushara Gunathilake,Kurunegala,Nakulugama,North Western,4000,6065,10065,160000,242600,402600
11/26/2024,Tushara Gunathilake,Kurunegala,Nakulugama,North Western,243,4507,4750,9720,180280,190000
11/27/2024,Tushara Gunathilake,Kurunegala,Nakulugama,North Western,2443,5715,8158,97720,228600,326320
11/28/2024,Tushara Gunathilake,Kurunegala,Nakulugama,North Western,6067,3497,9564,242680,139880,382560
11/29/2024,Tushara Gunathilake,Kurunegala,Nakulugama,North Western,7805,6369,14174,312200,254760,566960
11/30/2024,Tushara Gunathilake,Kurunegala,Nakulugama,North Western,9084,1291,10375,363360,51640,415000
12/1/2024,Tushara Gunathilake,Kurunegala,Nakulugama,North Western,9705,2770,12475,388200,110800,499000
12/2/2024,Tushara Gunathilake,Kurunegala,Nakulugama,North Western,5312,4731,10043,212480,189240,401720
12/3/2024,Tushara Gunathilake,Kurunegala,Nakulugama,North Western,5170,2412,7582,206800,96480,303280
12/4/2024,Tushara Gunathilake,Kurunegala,Nakulugama,North Western,4520,6366,10886,180800,254640,435440
12/5/2024,Tushara Gunathilake,Kurunegala,Nakulugama,North Western,8087,8479,16566,323480,339160,662640
12/6/2024,Tushara Gunathilake,Kurunegala,Nakulugama,North Western,1210,7542,8752,48400,301680,350080
12/7/2024,Tushara Gunathilake,Kurunegala,Nakulugama,North Western,2800,4423,7223,112000,176920,288920
12/8/2024,Tushara Gunathilake,Kurunegala,Nakulugama,North Western,964,9435,10399,38560,377400,415960
12/9/2024,Tushara Gunathilake,Kurunegala,Nakulugama,North Western,6174,3823,9997,246960,152920,399880
12/10/2024,Tushara Gunathilake,Kurunegala,Nakulugama,North Western,7771,8158,15929,310840,326320,637160
12/11/2024,Tushara Gunathilake,Kurunegala,Nakulugama,North Western,4746,7820,12566,189840,312800,502640
12/12/2024,Tushara Gunathilake,Kurunegala,Nakulugama,North Western,8551,9476,18027,342040,379040,721080
12/13/2024,Tushara Gunathilake,Kurunegala,Nakulugama,North Western,1158,607,1765,46320,24280,70600
12/14/2024,Tushara Gunathilake,Kurunegala,Nakulugama,North Western,1799,9328,11127,71960,373120,445080
12/15/2024,Tushara Gunathilake,Kurunegala,Nakulugama,North Western,3458,425,3883,138320,17000,155320
12/16/2024,Tushara Gunathilake,Kurunegala,Nakulugama,North Western,1425,3108,4533,57000,124320,181320
12/17/2024,Tushara Gunathilake,Kurunegala,Nakulugama,North Western,168,2634,2802,6720,105360,112080
12/18/2024,Tushara Gunathilake,Kurunegala,Nakulugama,North Western,3266,7474,10740,130640,298960,429600
12/19/2024,Tushara Gunathilake,Kurunegala,Nakulugama,North Western,21,8871,8892,840,354840,355680
12/20/2024,Tushara Gunathilake,Kurunegala,Nakulugama,North Western,2894,5143,8037,115760,205720,321480
12/21/2024,Tushara Gunathilake,Kurunegala,Nakulugama,North Western,2493,7722,10215,99720,308880,408600
12/22/2024,Tushara Gunathilake,Kurunegala,Nakulugama,North Western,8421,3945,12366,336840,157800,494640
12/23/2024,Tushara Gunathilake,Kurunegala,Nakulugama,North Western,1858,1241,3099,74320,49640,123960
12/24/2024,Tushara Gunathilake,Kurunegala,Nakulugama,North Western,1223,5565,6788,48920,222600,271520
12/25/2024,Tushara Gunathilake,Kurunegala,Nakulugama,North Western,4497,1346,5843,179880,53840,233720
12/26/2024,Tushara Gunathilake,Kurunegala,Nakulugama,North Western,2983,5484,8467,119320,219360,338680
12/27/2024,Tushara Gunathilake,Kurunegala,Nakulugama,North Western,9874,7589,17463,394960,303560,698520
12/28/2024,Tushara Gunathilake,Kurunegala,Nakulugama,North Western,5537,9009,14546,221480,360360,581840
12/29/2024,Tushara Gunathilake,Kurunegala,Nakulugama,North Western,5332,6248,11580,213280,249920,463200
12/30/2024,Tushara Gunathilake,Kurunegala,Nakulugama,North Western,7984,4436,12420,319360,177440,496800
12/31/2024,Tushara Gunathilake,Kurunegala,Nakulugama,North Western,1773,9825,11598,70920,393000,463920
1/1/2025,Tushara Gunathilake,Kurunegala,Nakulugama,North Western,4091,3672,7763,163640,146880,310520
1/2/2025,Tushara Gunathilake,Kurunegala,Nakulugama,North Western,716,2773,3489,28640,110920,139560
1/3/2025,Tushara Gunathilake,Kurunegala,Nakulugama,North Western,5144,8585,13729,205760,343400,549160
1/4/2025,Tushara Gunathilake,Kurunegala,Nakulugama,North Western,7136,6278,13414,285440,251120,536560
1/5/2025,Tushara Gunathilake,Kurunegala,Nakulugama,North Western,8167,6360,14527,326680,254400,581080
1/6/2025,Tushara Gunathilake,Kurunegala,Nakulugama,North Western,8562,2419,10981,342480,96760,439240
1/7/2025,Tushara Gunathilake,Kurunegala,Nakulugama,North Western,4810,3903,8713,192400,156120,348520
1/8/2025,Tushara Gunathilake,Kurunegala,Nakulugama,North Western,4926,1180,6106,197040,47200,244240
1/9/2025,Tushara Gunathilake,Kurunegala,Nakulugama,North Western,3042,4534,7576,121680,181360,303040
1/10/2025,Tushara Gunathilake,Kurunegala,Nakulugama,North Western,4686,5205,9891,187440,208200,395640
1/11/2025,Tushara Gunathilake,Kurunegala,Nakulugama,North Western,1269,4789,6058,50760,191560,242320
1/12/2025,Tushara Gunathilake,Kurunegala,Nakulugama,North Western,5356,8583,13939,214240,343320,557560
1/13/2025,Tushara Gunathilake,Kurunegala,Nakulugama,North Western,9595,9374,18969,383800,374960,758760
1/14/2025,Tushara Gunathilake,Kurunegala,Nakulugama,North Western,532,8418,8950,21280,336720,358000
1/15/2025,Tushara Gunathilake,Kurunegala,Nakulugama,North Western,6498,3259,9757,259920,130360,390280
1/16/2025,Tushara Gunathilake,Kurunegala,Nakulugama,North Western,5745,1670,7415,229800,66800,296600
1/17/2025,Tushara Gunathilake,Kurunegala,Nakulugama,North Western,8898,5555,14453,355920,222200,578120
1/18/2025,Tushara Gunathilake,Kurunegala,Nakulugama,North Western,3986,6325,10311,159440,253000,412440
1/19/2025,Tushara Gunathilake,Kurunegala,Nakulugama,North Western,8854,4592,13446,354160,183680,537840
1/20/2025,Tushara Gunathilake,Kurunegala,Nakulugama,North Western,7985,261,8246,319400,10440,329840
1/21/2025,Tushara Gunathilake,Kurunegala,Nakulugama,North Western,889,2723,3612,35560,108920,144480
1/22/2025,Tushara Gunathilake,Kurunegala,Nakulugama,North Western,5817,2981,8798,232680,119240,351920
1/23/2025,Tushara Gunathilake,Kurunegala,Nakulugama,North Western,9274,6936,16210,370960,277440,648400
1/24/2025,Tushara Gunathilake,Kurunegala,Nakulugama,North Western,6109,9467,15576,244360,378680,623040
1/25/2025,Tushara Gunathilake,Kurunegala,Nakulugama,North Western,2254,9856,12110,90160,394240,484400
1/26/2025,Tushara Gunathilake,Kurunegala,Nakulugama,North Western,2044,2293,4337,81760,91720,173480
1/27/2025,Tushara Gunathilake,Kurunegala,Nakulugama,North Western,109,23,132,4360,920,5280
1/28/2025,Tushara Gunathilake,Kurunegala,Nakulugama,North Western,2205,1290,3495,88200,51600,139800
1/29/2025,Tushara Gunathilake,Kurunegala,Nakulugama,North Western,7732,7760,15492,309280,310400,619680
1/30/2025,Tushara Gunathilake,Kurunegala,Nakulugama,North Western,329,4074,4403,13160,162960,176120
1/31/2025,Tushara Gunathilake,Kurunegala,Nakulugama,North Western,5206,8796,14002,208240,351840,560080
2/1/2025,Tushara Gunathilake,Kurunegala,Nakulugama,North Western,7371,472,7843,294840,18880,313720
2/2/2025,Tushara Gunathilake,Kurunegala,Nakulugama,North Western,4116,269,4385,164640,10760,175400
2/3/2025,Tushara Gunathilake,Kurunegala,Nakulugama,North Western,1014,5897,6911,40560,235880,276440
2/4/2025,Tushara Gunathilake,Kurunegala,Nakulugama,North Western,1134,626,1760,45360,25040,70400
2/5/2025,Tushara Gunathilake,Kurunegala,Nakulugama,North Western,2679,3453,6132,107160,138120,245280
2/6/2025,Tushara Gunathilake,Kurunegala,Nakulugama,North Western,8735,8223,16958,349400,328920,678320
2/7/2025,Tushara Gunathilake,Kurunegala,Nakulugama,North Western,9252,8679,17931,370080,347160,717240
2/8/2025,Tushara Gunathilake,Kurunegala,Nakulugama,North Western,1366,6509,7875,54640,260360,315000
2/9/2025,Tushara Gunathilake,Kurunegala,Nakulugama,North Western,4891,8038,12929,195640,321520,517160
2/10/2025,Tushara Gunathilake,Kurunegala,Nakulugama,North Western,4664,2437,7101,186560,97480,284040
2/11/2025,Tushara Gunathilake,Kurunegala,Nakulugama,North Western,7502,3088,10590,300080,123520,423600
2/12/2025,Tushara Gunathilake,Kurunegala,Nakulugama,North Western,3518,8067,11585,140720,322680,463400
2/13/2025,Tushara Gunathilake,Kurunegala,Nakulugama,North Western,9926,8925,18851,397040,357000,754040
2/14/2025,Tushara Gunathilake,Kurunegala,Nakulugama,North Western,6479,6253,12732,259160,250120,509280
2/15/2025,Tushara Gunathilake,Kurunegala,Nakulugama,North Western,9526,876,10402,381040,35040,416080
2/16/2025,Tushara Gunathilake,Kurunegala,Nakulugama,North Western,3560,426,3986,142400,17040,159440
2/17/2025,Tushara Gunathilake,Kurunegala,Nakulugama,North Western,1809,7881,9690,72360,315240,387600
2/18/2025,Tushara Gunathilake,Kurunegala,Nakulugama,North Western,2939,2464,5403,117560,98560,216120
2/19/2025,Tushara Gunathilake,Kurunegala,Nakulugama,North Western,2311,4719,7030,92440,188760,281200
2/20/2025,Tushara Gunathilake,Kurunegala,Nakulugama,North Western,8304,8484,16788,332160,339360,671520
2/21/2025,Tushara Gunathilake,Kurunegala,Nakulugama,North Western,9433,6573,16006,377320,262920,640240
2/22/2025,Tushara Gunathilake,Kurunegala,Nakulugama,North Western,3398,2231,5629,135920,89240,225160
2/23/2025,Tushara Gunathilake,Kurunegala,Nakulugama,North Western,7403,1649,9052,296120,65960,362080
2/24/2025,Tushara Gunathilake,Kurunegala,Nakulugama,North Western,4731,9778,14509,189240,391120,580360
2/25/2025,Tushara Gunathilake,Kurunegala,Nakulugama,North Western,3583,9232,12815,143320,369280,512600
2/26/2025,Tushara Gunathilake,Kurunegala,Nakulugama,North Western,858,1714,2572,34320,68560,102880
2/27/2025,Tushara Gunathilake,Kurunegala,Nakulugama,North Western,520,7914,8434,20800,316560,337360
2/28/2025,Tushara Gunathilake,Kurunegala,Nakulugama,North Western,7719,8724,16443,308760,348960,657720
3/1/2025,Tushara Gunathilake,Kurunegala,Nakulugama,North Western,1473,932,2405,58920,37280,96200
3/2/2025,Tushara Gunathilake,Kurunegala,Nakulugama,North Western,6168,147,6315,246720,5880,252600
3/3/2025,Tushara Gunathilake,Kurunegala,Nakulugama,North Western,3854,6842,10696,154160,273680,427840
3/4/2025,Tushara Gunathilake,Kurunegala,Nakulugama,North Western,8964,4953,13917,358560,198120,556680
3/5/2025,Tushara Gunathilake,Kurunegala,Nakulugama,North Western,2660,1809,4469,106400,72360,178760
3/6/2025,Tushara Gunathilake,Kurunegala,Nakulugama,North Western,3317,8135,11452,132680,325400,458080
3/7/2025,Tushara Gunathilake,Kurunegala,Nakulugama,North Western,8375,4361,12736,335000,174440,509440
3/8/2025,Tushara Gunathilake,Kurunegala,Nakulugama,North Western,6563,1519,8082,262520,60760,323280
3/9/2025,Tushara Gunathilake,Kurunegala,Nakulugama,North Western,6652,7785,14437,266080,311400,577480
3/10/2025,Tushara Gunathilake,Kurunegala,Nakulugama,North Western,1561,8787,10348,62440,351480,413920
3/11/2025,Tushara Gunathilake,Kurunegala,Nakulugama,North Western,6981,1235,8216,279240,49400,328640
3/12/2025,Tushara Gunathilake,Kurunegala,Nakulugama,North Western,2514,2217,4731,100560,88680,189240
3/13/2025,Tushara Gunathilake,Kurunegala,Nakulugama,North Western,9719,5872,15591,388760,234880,623640
3/14/2025,Tushara Gunathilake,Kurunegala,Nakulugama,North Western,991,3930,4921,39640,157200,196840
3/15/2025,Tushara Gunathilake,Kurunegala,Nakulugama,North Western,8481,4272,12753,339240,170880,510120
3/16/2025,Tushara Gunathilake,Kurunegala,Nakulugama,North Western,5458,5769,11227,218320,230760,449080
3/17/2025,Tushara Gunathilake,Kurunegala,Nakulugama,North Western,9310,3245,12555,372400,129800,502200
3/18/2025,Tushara Gunathilake,Kurunegala,Nakulugama,North Western,6057,4064,10121,242280,162560,404840
3/19/2025,Tushara Gunathilake,Kurunegala,Nakulugama,North Western,2936,8513,11449,117440,340520,457960
3/20/2025,Tushara Gunathilake,Kurunegala,Nakulugama,North Western,4229,7707,11936,169160,308280,477440
3/21/2025,Tushara Gunathilake,Kurunegala,Nakulugama,North Western,7789,2694,10483,311560,107760,419320
3/22/2025,Tushara Gunathilake,Kurunegala,Nakulugama,North Western,799,21,820,31960,840,32800
3/23/2025,Tushara Gunathilake,Kurunegala,Nakulugama,North Western,4027,8183,12210,161080,327320,488400
3/25/2024,Subhani Khatun,Anuradhapura,Medawachchiya,North Central,5185,1072,6257,207400,42880,250280
3/26/2024,Subhani Khatun,Anuradhapura,Medawachchiya,North Central,4218,8033,12251,168720,321320,490040
3/27/2024,Subhani Khatun,Anuradhapura,Medawachchiya,North Central,9818,8713,18531,392720,348520,741240
3/28/2024,Subhani Khatun,Anuradhapura,Medawachchiya,North Central,7886,5264,13150,315440,210560,526000
3/29/2024,Subhani Khatun,Anuradhapura,Medawachchiya,North Central,2728,5519,8247,109120,220760,329880
3/30/2024,Subhani Khatun,Anuradhapura,Medawachchiya,North Central,4338,8125,12463,173520,325000,498520
3/31/2024,Subhani Khatun,Anuradhapura,Medawachchiya,North Central,3569,9182,12751,142760,367280,510040
4/1/2024,Subhani Khatun,Anuradhapura,Medawachchiya,North Central,6127,6392,12519,245080,255680,500760
4/2/2024,Subhani Khatun,Anuradhapura,Medawachchiya,North Central,4135,2342,6477,165400,93680,259080
4/3/2024,Subhani Khatun,Anuradhapura,Medawachchiya,North Central,6182,8452,14634,247280,338080,585360
4/4/2024,Subhani Khatun,Anuradhapura,Medawachchiya,North Central,6993,1701,8694,279720,68040,347760
4/5/2024,Subhani Khatun,Anuradhapura,Medawachchiya,North Central,8602,5350,13952,344080,214000,558080
4/6/2024,Subhani Khatun,Anuradhapura,Medawachchiya,North Central,3830,3561,7391,153200,142440,295640
4/7/2024,Subhani Khatun,Anuradhapura,Medawachchiya,North Central,2227,4711,6938,89080,188440,277520
4/8/2024,Subhani Khatun,Anuradhapura,Medawachchiya,North Central,7026,3281,10307,281040,131240,412280
4/9/2024,Subhani Khatun,Anuradhapura,Medawachchiya,North Central,6330,1135,7465,253200,45400,298600
4/10/2024,Subhani Khatun,Anuradhapura,Medawachchiya,North Central,9,1918,1927,360,76720,77080
4/11/2024,Subhani Khatun,Anuradhapura,Medawachchiya,North Central,3686,9133,12819,147440,365320,512760
4/19/2024,Subhani Khatun,Anuradhapura,Medawachchiya,North Central,7108,467,7575,284320,18680,303000
4/20/2024,Subhani Khatun,Anuradhapura,Medawachchiya,North Central,526,8944,9470,21040,357760,378800
4/21/2024,Subhani Khatun,Anuradhapura,Medawachchiya,North Central,7298,5671,12969,291920,226840,518760
4/22/2024,Subhani Khatun,Anuradhapura,Medawachchiya,North Central,3162,4027,7189,126480,161080,287560
4/23/2024,Subhani Khatun,Anuradhapura,Medawachchiya,North Central,3630,1084,4714,145200,43360,188560
4/24/2024,Subhani Khatun,Anuradhapura,Medawachchiya,North Central,8902,351,9253,356080,14040,370120
4/25/2024,Subhani Khatun,Anuradhapura,Medawachchiya,North Central,8111,5155,13266,324440,206200,530640
4/26/2024,Subhani Khatun,Anuradhapura,Medawachchiya,North Central,626,7167,7793,25040,286680,311720
4/27/2024,Subhani Khatun,Anuradhapura,Medawachchiya,North Central,5114,9506,14620,204560,380240,584800
4/28/2024,Subhani Khatun,Anuradhapura,Medawachchiya,North Central,7980,7708,15688,319200,308320,627520
4/29/2024,Subhani Khatun,Anuradhapura,Medawachchiya,North Central,671,982,1653,26840,39280,66120
4/30/2024,Subhani Khatun,Anuradhapura,Medawachchiya,North Central,2781,5407,8188,111240,216280,327520
5/1/2024,Subhani Khatun,Anuradhapura,Medawachchiya,North Central,6404,8806,15210,256160,352240,608400
5/2/2024,Subhani Khatun,Anuradhapura,Medawachchiya,North Central,550,9001,9551,22000,360040,382040
5/3/2024,Subhani Khatun,Anuradhapura,Medawachchiya,North Central,744,7103,7847,29760,284120,313880
5/4/2024,Subhani Khatun,Anuradhapura,Medawachchiya,North Central,8076,3050,11126,323040,122000,445040
5/5/2024,Subhani Khatun,Anuradhapura,Medawachchiya,North Central,462,7852,8314,18480,314080,332560
5/6/2024,Subhani Khatun,Anuradhapura,Medawachchiya,North Central,989,6460,7449,39560,258400,297960
5/7/2024,Subhani Khatun,Anuradhapura,Medawachchiya,North Central,1945,8876,10821,77800,355040,432840
5/8/2024,Subhani Khatun,Anuradhapura,Medawachchiya,North Central,4561,7222,11783,182440,288880,471320
5/9/2024,Subhani Khatun,Anuradhapura,Medawachchiya,North Central,9145,4126,13271,365800,165040,530840
5/10/2024,Subhani Khatun,Anuradhapura,Medawachchiya,North Central,6482,5612,12094,259280,224480,483760
5/11/2024,Subhani Khatun,Anuradhapura,Medawachchiya,North Central,3662,6060,9722,146480,242400,388880
5/12/2024,Subhani Khatun,Anuradhapura,Medawachchiya,North Central,8657,9409,18066,346280,376360,722640
5/13/2024,Subhani Khatun,Anuradhapura,Medawachchiya,North Central,2275,6936,9211,91000,277440,368440
5/14/2024,Subhani Khatun,Anuradhapura,Medawachchiya,North Central,8038,5606,13644,321520,224240,545760
5/15/2024,Subhani Khatun,Anuradhapura,Medawachchiya,North Central,9433,1460,10893,377320,58400,435720
5/16/2024,Subhani Khatun,Anuradhapura,Medawachchiya,North Central,7709,452,8161,308360,18080,326440
5/17/2024,Subhani Khatun,Anuradhapura,Medawachchiya,North Central,3732,6696,10428,149280,267840,417120
5/18/2024,Subhani Khatun,Anuradhapura,Medawachchiya,North Central,2668,7789,10457,106720,311560,418280
5/19/2024,Subhani Khatun,Anuradhapura,Medawachchiya,North Central,2777,7719,10496,111080,308760,419840
5/20/2024,Subhani Khatun,Anuradhapura,Medawachchiya,North Central,8363,4958,13321,334520,198320,532840
5/21/2024,Subhani Khatun,Anuradhapura,Medawachchiya,North Central,2496,1902,4398,99840,76080,175920
5/22/2024,Subhani Khatun,Anuradhapura,Medawachchiya,North Central,8280,2827,11107,331200,113080,444280
5/24/2024,Subhani Khatun,Anuradhapura,Medawachchiya,North Central,411,4719,5130,16440,188760,205200
5/25/2024,Subhani Khatun,Anuradhapura,Medawachchiya,North Central,9674,1491,11165,386960,59640,446600
5/26/2024,Subhani Khatun,Anuradhapura,Medawachchiya,North Central,5060,6094,11154,202400,243760,446160
5/27/2024,Subhani Khatun,Anuradhapura,Medawachchiya,North Central,7954,144,8098,318160,5760,323920
5/28/2024,Subhani Khatun,Anuradhapura,Medawachchiya,North Central,1610,7226,8836,64400,289040,353440
5/29/2024,Subhani Khatun,Anuradhapura,Medawachchiya,North Central,5857,8790,14647,234280,351600,585880
5/30/2024,Subhani Khatun,Anuradhapura,Medawachchiya,North Central,2840,832,3672,113600,33280,146880
5/31/2024,Subhani Khatun,Anuradhapura,Medawachchiya,North Central,5655,97,5752,226200,3880,230080
6/1/2024,Subhani Khatun,Anuradhapura,Medawachchiya,North Central,1410,2089,3499,56400,83560,139960
6/2/2024,Subhani Khatun,Anuradhapura,Medawachchiya,North Central,7526,7494,15020,301040,299760,600800
6/3/2024,Subhani Khatun,Anuradhapura,Medawachchiya,North Central,7027,7924,14951,281080,316960,598040
6/4/2024,Subhani Khatun,Anuradhapura,Medawachchiya,North Central,8018,1466,9484,320720,58640,379360
6/5/2024,Subhani Khatun,Anuradhapura,Medawachchiya,North Central,4438,1431,5869,177520,57240,234760
6/6/2024,Subhani Khatun,Anuradhapura,Medawachchiya,North Central,1249,1615,2864,49960,64600,114560
6/7/2024,Subhani Khatun,Anuradhapura,Medawachchiya,North Central,5176,9818,14994,207040,392720,599760
6/8/2024,Subhani Khatun,Anuradhapura,Medawachchiya,North Central,3689,4436,8125,147560,177440,325000
6/9/2024,Subhani Khatun,Anuradhapura,Medawachchiya,North Central,7319,516,7835,292760,20640,313400
6/10/2024,Subhani Khatun,Anuradhapura,Medawachchiya,North Central,2417,4231,6648,96680,169240,265920
6/11/2024,Subhani Khatun,Anuradhapura,Medawachchiya,North Central,7648,3654,11302,305920,146160,452080
6/12/2024,Subhani Khatun,Anuradhapura,Medawachchiya,North Central,1974,969,2943,78960,38760,117720
6/13/2024,Subhani Khatun,Anuradhapura,Medawachchiya,North Central,9207,3125,12332,368280,125000,493280
6/14/2024,Subhani Khatun,Anuradhapura,Medawachchiya,North Central,2944,1501,4445,117760,60040,177800
6/15/2024,Subhani Khatun,Anuradhapura,Medawachchiya,North Central,6205,2794,8999,248200,111760,359960
6/16/2024,Subhani Khatun,Anuradhapura,Medawachchiya,North Central,1973,4177,6150,78920,167080,246000
6/17/2024,Subhani Khatun,Anuradhapura,Medawachchiya,North Central,7551,8052,15603,302040,322080,624120
6/18/2024,Subhani Khatun,Anuradhapura,Medawachchiya,North Central,4287,3281,7568,171480,131240,302720
6/19/2024,Subhani Khatun,Anuradhapura,Medawachchiya,North Central,5188,9928,15116,207520,397120,604640
6/20/2024,Subhani Khatun,Anuradhapura,Medawachchiya,North Central,8431,3900,12331,337240,156000,493240
6/21/2024,Subhani Khatun,Anuradhapura,Medawachchiya,North Central,8994,652,9646,359760,26080,385840
6/22/2024,Subhani Khatun,Anuradhapura,Medawachchiya,North Central,2760,590,3350,110400,23600,134000
6/23/2024,Subhani Khatun,Anuradhapura,Medawachchiya,North Central,5524,4477,10001,220960,179080,400040
6/24/2024,Subhani Khatun,Anuradhapura,Medawachchiya,North Central,7681,7447,15128,307240,297880,605120
6/25/2024,Subhani Khatun,Anuradhapura,Medawachchiya,North Central,4521,6870,11391,180840,274800,455640
6/26/2024,Subhani Khatun,Anuradhapura,Medawachchiya,North Central,4784,8438,13222,191360,337520,528880
6/27/2024,Subhani Khatun,Anuradhapura,Medawachchiya,North Central,6541,6998,13539,261640,279920,541560
6/28/2024,Subhani Khatun,Anuradhapura,Medawachchiya,North Central,2048,3993,6041,81920,159720,241640
6/29/2024,Subhani Khatun,Anuradhapura,Medawachchiya,North Central,435,872,1307,17400,34880,52280
6/30/2024,Subhani Khatun,Anuradhapura,Medawachchiya,North Central,4918,6603,11521,196720,264120,460840
7/1/2024,Subhani Khatun,Anuradhapura,Medawachchiya,North Central,8767,6463,15230,350680,258520,609200
7/2/2024,Subhani Khatun,Anuradhapura,Medawachchiya,North Central,6130,7294,13424,245200,291760,536960
7/3/2024,Subhani Khatun,Anuradhapura,Medawachchiya,North Central,2378,844,3222,95120,33760,128880
7/4/2024,Subhani Khatun,Anuradhapura,Medawachchiya,North Central,1774,7370,9144,70960,294800,365760
7/5/2024,Subhani Khatun,Anuradhapura,Medawachchiya,North Central,9125,6044,15169,365000,241760,606760
7/6/2024,Subhani Khatun,Anuradhapura,Medawachchiya,North Central,9183,6900,16083,367320,276000,643320
7/7/2024,Subhani Khatun,Anuradhapura,Medawachchiya,North Central,1548,8855,10403,61920,354200,416120
7/8/2024,Subhani Khatun,Anuradhapura,Medawachchiya,North Central,7356,3547,10903,294240,141880,436120
7/9/2024,Subhani Khatun,Anuradhapura,Medawachchiya,North Central,1360,7990,9350,54400,319600,374000
7/10/2024,Subhani Khatun,Anuradhapura,Medawachchiya,North Central,3714,3168,6882,148560,126720,275280
7/11/2024,Subhani Khatun,Anuradhapura,Medawachchiya,North Central,9658,6924,16582,386320,276960,663280
7/12/2024,Subhani Khatun,Anuradhapura,Medawachchiya,North Central,30,2352,2382,1200,94080,95280
7/13/2024,Subhani Khatun,Anuradhapura,Medawachchiya,North Central,235,9914,10149,9400,396560,405960
7/14/2024,Subhani Khatun,Anuradhapura,Medawachchiya,North Central,6246,4847,11093,249840,193880,443720
7/15/2024,Subhani Khatun,Anuradhapura,Medawachchiya,North Central,4182,4936,9118,167280,197440,364720
7/16/2024,Subhani Khatun,Anuradhapura,Medawachchiya,North Central,3028,858,3886,121120,34320,155440
7/17/2024,Subhani Khatun,Anuradhapura,Medawachchiya,North Central,3974,1596,5570,158960,63840,222800
7/18/2024,Subhani Khatun,Anuradhapura,Medawachchiya,North Central,1444,7204,8648,57760,288160,345920
7/19/2024,Subhani Khatun,Anuradhapura,Medawachchiya,North Central,8008,1511,9519,320320,60440,380760
7/20/2024,Subhani Khatun,Anuradhapura,Medawachchiya,North Central,3005,8648,11653,120200,345920,466120
7/21/2024,Subhani Khatun,Anuradhapura,Medawachchiya,North Central,3921,4894,8815,156840,195760,352600
7/22/2024,Subhani Khatun,Anuradhapura,Medawachchiya,North Central,3374,7251,10625,134960,290040,425000
7/23/2024,Subhani Khatun,Anuradhapura,Medawachchiya,North Central,2000,6764,8764,80000,270560,350560
7/24/2024,Subhani Khatun,Anuradhapura,Medawachchiya,North Central,7267,7387,14654,290680,295480,586160
7/25/2024,Subhani Khatun,Anuradhapura,Medawachchiya,North Central,9405,5274,14679,376200,210960,587160
7/26/2024,Subhani Khatun,Anuradhapura,Medawachchiya,North Central,8610,7059,15669,344400,282360,626760
7/27/2024,Subhani Khatun,Anuradhapura,Medawachchiya,North Central,5731,6080,11811,229240,243200,472440
7/28/2024,Subhani Khatun,Anuradhapura,Medawachchiya,North Central,330,2897,3227,13200,115880,129080
7/29/2024,Subhani Khatun,Anuradhapura,Medawachchiya,North Central,6818,8971,15789,272720,358840,631560
7/30/2024,Subhani Khatun,Anuradhapura,Medawachchiya,North Central,4084,1661,5745,163360,66440,229800
7/31/2024,Subhani Khatun,Anuradhapura,Medawachchiya,North Central,4613,9495,14108,184520,379800,564320
8/1/2024,Subhani Khatun,Anuradhapura,Medawachchiya,North Central,6517,2334,8851,260680,93360,354040
8/2/2024,Subhani Khatun,Anuradhapura,Medawachchiya,North Central,6850,4319,11169,274000,172760,446760
8/3/2024,Subhani Khatun,Anuradhapura,Medawachchiya,North Central,9590,3522,13112,383600,140880,524480
8/4/2024,Subhani Khatun,Anuradhapura,Medawachchiya,North Central,7864,8969,16833,314560,358760,673320
8/5/2024,Subhani Khatun,Anuradhapura,Medawachchiya,North Central,3574,5909,9483,142960,236360,379320
8/6/2024,Subhani Khatun,Anuradhapura,Medawachchiya,North Central,4433,9355,13788,177320,374200,551520
8/7/2024,Subhani Khatun,Anuradhapura,Medawachchiya,North Central,9390,262,9652,375600,10480,386080
8/8/2024,Subhani Khatun,Anuradhapura,Medawachchiya,North Central,1870,7237,9107,74800,289480,364280
8/9/2024,Subhani Khatun,Anuradhapura,Medawachchiya,North Central,1227,5227,6454,49080,209080,258160
8/10/2024,Subhani Khatun,Anuradhapura,Medawachchiya,North Central,5440,8730,14170,217600,349200,566800
8/11/2024,Subhani Khatun,Anuradhapura,Medawachchiya,North Central,5087,2293,7380,203480,91720,295200
8/12/2024,Subhani Khatun,Anuradhapura,Medawachchiya,North Central,2968,877,3845,118720,35080,153800
8/13/2024,Subhani Khatun,Anuradhapura,Medawachchiya,North Central,8438,9939,18377,337520,397560,735080
8/14/2024,Subhani Khatun,Anuradhapura,Medawachchiya,North Central,699,6202,6901,27960,248080,276040
8/15/2024,Subhani Khatun,Anuradhapura,Medawachchiya,North Central,234,9402,9636,9360,376080,385440
8/16/2024,Subhani Khatun,Anuradhapura,Medawachchiya,North Central,3980,9123,13103,159200,364920,524120
8/17/2024,Subhani Khatun,Anuradhapura,Medawachchiya,North Central,3097,4313,7410,123880,172520,296400
8/18/2024,Subhani Khatun,Anuradhapura,Medawachchiya,North Central,5108,5006,10114,204320,200240,404560
8/19/2024,Subhani Khatun,Anuradhapura,Medawachchiya,North Central,5753,5277,11030,230120,211080,441200
8/20/2024,Subhani Khatun,Anuradhapura,Medawachchiya,North Central,3035,6854,9889,121400,274160,395560
8/21/2024,Subhani Khatun,Anuradhapura,Medawachchiya,North Central,1799,2553,4352,71960,102120,174080
8/22/2024,Subhani Khatun,Anuradhapura,Medawachchiya,North Central,5711,5521,11232,228440,220840,449280
8/23/2024,Subhani Khatun,Anuradhapura,Medawachchiya,North Central,4199,6177,10376,167960,247080,415040
8/24/2024,Subhani Khatun,Anuradhapura,Medawachchiya,North Central,4416,7733,12149,176640,309320,485960
8/25/2024,Subhani Khatun,Anuradhapura,Medawachchiya,North Central,2976,2793,5769,119040,111720,230760
8/26/2024,Subhani Khatun,Anuradhapura,Medawachchiya,North Central,9664,4623,14287,386560,184920,571480
8/27/2024,Subhani Khatun,Anuradhapura,Medawachchiya,North Central,4872,8456,13328,194880,338240,533120
8/28/2024,Subhani Khatun,Anuradhapura,Medawachchiya,North Central,5417,7430,12847,216680,297200,513880
8/29/2024,Subhani Khatun,Anuradhapura,Medawachchiya,North Central,7815,1566,9381,312600,62640,375240
8/30/2024,Subhani Khatun,Anuradhapura,Medawachchiya,North Central,4224,5421,9645,168960,216840,385800
8/31/2024,Subhani Khatun,Anuradhapura,Medawachchiya,North Central,4923,7215,12138,196920,288600,485520
9/1/2024,Subhani Khatun,Anuradhapura,Medawachchiya,North Central,2362,4063,6425,94480,162520,257000
9/2/2024,Subhani Khatun,Anuradhapura,Medawachchiya,North Central,8215,1140,9355,328600,45600,374200
9/3/2024,Subhani Khatun,Anuradhapura,Medawachchiya,North Central,3618,4209,7827,144720,168360,313080
9/4/2024,Subhani Khatun,Anuradhapura,Medawachchiya,North Central,7615,6947,14562,304600,277880,582480
9/5/2024,Subhani Khatun,Anuradhapura,Medawachchiya,North Central,974,8119,9093,38960,324760,363720
9/6/2024,Subhani Khatun,Anuradhapura,Medawachchiya,North Central,2434,2466,4900,97360,98640,196000
9/7/2024,Subhani Khatun,Anuradhapura,Medawachchiya,North Central,7199,646,7845,287960,25840,313800
9/8/2024,Subhani Khatun,Anuradhapura,Medawachchiya,North Central,4298,8919,13217,171920,356760,528680
9/9/2024,Subhani Khatun,Anuradhapura,Medawachchiya,North Central,2463,7298,9761,98520,291920,390440
9/10/2024,Subhani Khatun,Anuradhapura,Medawachchiya,North Central,4906,411,5317,196240,16440,212680
9/11/2024,Subhani Khatun,Anuradhapura,Medawachchiya,North Central,4993,1751,6744,199720,70040,269760
9/12/2024,Subhani Khatun,Anuradhapura,Medawachchiya,North Central,3788,6374,10162,151520,254960,406480
9/13/2024,Subhani Khatun,Anuradhapura,Medawachchiya,North Central,439,7871,8310,17560,314840,332400
9/14/2024,Subhani Khatun,Anuradhapura,Medawachchiya,North Central,8947,2639,11586,357880,105560,463440
9/15/2024,Subhani Khatun,Anuradhapura,Medawachchiya,North Central,1728,1815,3543,69120,72600,141720
9/16/2024,Subhani Khatun,Anuradhapura,Medawachchiya,North Central,3706,6140,9846,148240,245600,393840
9/17/2024,Subhani Khatun,Anuradhapura,Medawachchiya,North Central,9458,8130,17588,378320,325200,703520
9/18/2024,Subhani Khatun,Anuradhapura,Medawachchiya,North Central,2373,2365,4738,94920,94600,189520
9/19/2024,Subhani Khatun,Anuradhapura,Medawachchiya,North Central,1399,161,1560,55960,6440,62400
9/20/2024,Subhani Khatun,Anuradhapura,Medawachchiya,North Central,9683,2196,11879,387320,87840,475160
9/21/2024,Subhani Khatun,Anuradhapura,Medawachchiya,North Central,2263,6568,8831,90520,262720,353240
9/22/2024,Subhani Khatun,Anuradhapura,Medawachchiya,North Central,7368,3922,11290,294720,156880,451600
9/23/2024,Subhani Khatun,Anuradhapura,Medawachchiya,North Central,6744,6758,13502,269760,270320,540080
9/24/2024,Subhani Khatun,Anuradhapura,Medawachchiya,North Central,5047,5899,10946,201880,235960,437840
9/25/2024,Subhani Khatun,Anuradhapura,Medawachchiya,North Central,6720,5209,11929,268800,208360,477160
9/26/2024,Subhani Khatun,Anuradhapura,Medawachchiya,North Central,4906,1461,6367,196240,58440,254680
9/27/2024,Subhani Khatun,Anuradhapura,Medawachchiya,North Central,2570,3126,5696,102800,125040,227840
9/28/2024,Subhani Khatun,Anuradhapura,Medawachchiya,North Central,5332,3568,8900,213280,142720,356000
9/29/2024,Subhani Khatun,Anuradhapura,Medawachchiya,North Central,5278,8420,13698,211120,336800,547920
9/30/2024,Subhani Khatun,Anuradhapura,Medawachchiya,North Central,170,9211,9381,6800,368440,375240
10/1/2024,Subhani Khatun,Anuradhapura,Medawachchiya,North Central,4505,2387,6892,180200,95480,275680
10/2/2024,Subhani Khatun,Anuradhapura,Medawachchiya,North Central,4973,5005,9978,198920,200200,399120
10/3/2024,Subhani Khatun,Anuradhapura,Medawachchiya,North Central,4899,8052,12951,195960,322080,518040
10/4/2024,Subhani Khatun,Anuradhapura,Medawachchiya,North Central,5797,3857,9654,231880,154280,386160
10/5/2024,Subhani Khatun,Anuradhapura,Medawachchiya,North Central,6518,902,7420,260720,36080,296800
10/6/2024,Subhani Khatun,Anuradhapura,Medawachchiya,North Central,4690,6251,10941,187600,250040,437640
10/7/2024,Subhani Khatun,Anuradhapura,Medawachchiya,North Central,8130,2443,10573,325200,97720,422920
10/8/2024,Subhani Khatun,Anuradhapura,Medawachchiya,North Central,4041,5073,9114,161640,202920,364560
10/9/2024,Subhani Khatun,Anuradhapura,Medawachchiya,North Central,1614,8914,10528,64560,356560,421120
10/10/2024,Subhani Khatun,Anuradhapura,Medawachchiya,North Central,1004,772,1776,40160,30880,71040
10/11/2024,Subhani Khatun,Anuradhapura,Medawachchiya,North Central,1655,2831,4486,66200,113240,179440
10/12/2024,Subhani Khatun,Anuradhapura,Medawachchiya,North Central,4885,1990,6875,195400,79600,275000
10/13/2024,Subhani Khatun,Anuradhapura,Medawachchiya,North Central,2130,1809,3939,85200,72360,157560
10/14/2024,Subhani Khatun,Anuradhapura,Medawachchiya,North Central,1008,294,1302,40320,11760,52080
10/15/2024,Subhani Khatun,Anuradhapura,Medawachchiya,North Central,4843,7903,12746,193720,316120,509840
10/16/2024,Subhani Khatun,Anuradhapura,Medawachchiya,North Central,4883,2947,7830,195320,117880,313200
10/17/2024,Subhani Khatun,Anuradhapura,Medawachchiya,North Central,9123,6052,15175,364920,242080,607000
10/18/2024,Subhani Khatun,Anuradhapura,Medawachchiya,North Central,6978,1297,8275,279120,51880,331000
10/19/2024,Subhani Khatun,Anuradhapura,Medawachchiya,North Central,2308,6539,8847,92320,261560,353880
10/20/2024,Subhani Khatun,Anuradhapura,Medawachchiya,North Central,491,6780,7271,19640,271200,290840
10/21/2024,Subhani Khatun,Anuradhapura,Medawachchiya,North Central,6095,7548,13643,243800,301920,545720
10/22/2024,Subhani Khatun,Anuradhapura,Medawachchiya,North Central,6910,1203,8113,276400,48120,324520
10/23/2024,Subhani Khatun,Anuradhapura,Medawachchiya,North Central,3689,9981,13670,147560,399240,546800
10/24/2024,Subhani Khatun,Anuradhapura,Medawachchiya,North Central,501,5528,6029,20040,221120,241160
10/25/2024,Subhani Khatun,Anuradhapura,Medawachchiya,North Central,7237,3255,10492,289480,130200,419680
10/26/2024,Subhani Khatun,Anuradhapura,Medawachchiya,North Central,7081,7606,14687,283240,304240,587480
10/27/2024,Subhani Khatun,Anuradhapura,Medawachchiya,North Central,3168,5878,9046,126720,235120,361840
10/28/2024,Subhani Khatun,Anuradhapura,Medawachchiya,North Central,2309,364,2673,92360,14560,106920
10/29/2024,Subhani Khatun,Anuradhapura,Medawachchiya,North Central,7450,2269,9719,298000,90760,388760
10/30/2024,Subhani Khatun,Anuradhapura,Medawachchiya,North Central,6884,1501,8385,275360,60040,335400
10/31/2024,Subhani Khatun,Anuradhapura,Medawachchiya,North Central,5969,9588,15557,238760,383520,622280
11/1/2024,Subhani Khatun,Anuradhapura,Medawachchiya,North Central,4394,3301,7695,175760,132040,307800
11/2/2024,Subhani Khatun,Anuradhapura,Medawachchiya,North Central,4452,7427,11879,178080,297080,475160
11/3/2024,Subhani Khatun,Anuradhapura,Medawachchiya,North Central,9963,2316,12279,398520,92640,491160
11/4/2024,Subhani Khatun,Anuradhapura,Medawachchiya,North Central,3341,1451,4792,133640,58040,191680
11/5/2024,Subhani Khatun,Anuradhapura,Medawachchiya,North Central,9801,6203,16004,392040,248120,640160
11/6/2024,Subhani Khatun,Anuradhapura,Medawachchiya,North Central,3891,5810,9701,155640,232400,388040
11/7/2024,Subhani Khatun,Anuradhapura,Medawachchiya,North Central,8717,8523,17240,348680,340920,689600
11/8/2024,Subhani Khatun,Anuradhapura,Medawachchiya,North Central,649,5171,5820,25960,206840,232800
11/9/2024,Subhani Khatun,Anuradhapura,Medawachchiya,North Central,3870,9449,13319,154800,377960,532760
11/10/2024,Subhani Khatun,Anuradhapura,Medawachchiya,North Central,7895,2896,10791,315800,115840,431640
11/11/2024,Subhani Khatun,Anuradhapura,Medawachchiya,North Central,6259,5885,12144,250360,235400,485760
11/12/2024,Subhani Khatun,Anuradhapura,Medawachchiya,North Central,9515,5528,15043,380600,221120,601720
11/13/2024,Subhani Khatun,Anuradhapura,Medawachchiya,North Central,5389,6532,11921,215560,261280,476840
11/14/2024,Subhani Khatun,Anuradhapura,Medawachchiya,North Central,1689,6636,8325,67560,265440,333000
11/15/2024,Subhani Khatun,Anuradhapura,Medawachchiya,North Central,6614,1746,8360,264560,69840,334400
11/16/2024,Subhani Khatun,Anuradhapura,Medawachchiya,North Central,9035,5882,14917,361400,235280,596680
11/17/2024,Subhani Khatun,Anuradhapura,Medawachchiya,North Central,2035,509,2544,81400,20360,101760
11/18/2024,Subhani Khatun,Anuradhapura,Medawachchiya,North Central,216,8770,8986,8640,350800,359440
11/19/2024,Subhani Khatun,Anuradhapura,Medawachchiya,North Central,5925,4006,9931,237000,160240,397240
11/20/2024,Subhani Khatun,Anuradhapura,Medawachchiya,North Central,4284,4957,9241,171360,198280,369640
11/21/2024,Subhani Khatun,Anuradhapura,Medawachchiya,North Central,2794,897,3691,111760,35880,147640
11/22/2024,Subhani Khatun,Anuradhapura,Medawachchiya,North Central,9306,3158,12464,372240,126320,498560
11/23/2024,Subhani Khatun,Anuradhapura,Medawachchiya,North Central,6459,6996,13455,258360,279840,538200
11/24/2024,Subhani Khatun,Anuradhapura,Medawachchiya,North Central,2578,7834,10412,103120,313360,416480
11/25/2024,Subhani Khatun,Anuradhapura,Medawachchiya,North Central,490,2870,3360,19600,114800,134400
11/26/2024,Subhani Khatun,Anuradhapura,Medawachchiya,North Central,3093,9815,12908,123720,392600,516320
11/27/2024,Subhani Khatun,Anuradhapura,Medawachchiya,North Central,3671,2947,6618,146840,117880,264720
11/28/2024,Subhani Khatun,Anuradhapura,Medawachchiya,North Central,9828,4810,14638,393120,192400,585520
11/29/2024,Subhani Khatun,Anuradhapura,Medawachchiya,North Central,187,6932,7119,7480,277280,284760
11/30/2024,Subhani Khatun,Anuradhapura,Medawachchiya,North Central,5621,7276,12897,224840,291040,515880
12/1/2024,Subhani Khatun,Anuradhapura,Medawachchiya,North Central,1806,9027,10833,72240,361080,433320
12/2/2024,Subhani Khatun,Anuradhapura,Medawachchiya,North Central,2836,7104,9940,113440,284160,397600
12/3/2024,Subhani Khatun,Anuradhapura,Medawachchiya,North Central,213,3943,4156,8520,157720,166240
12/4/2024,Subhani Khatun,Anuradhapura,Medawachchiya,North Central,3355,3256,6611,134200,130240,264440
12/5/2024,Subhani Khatun,Anuradhapura,Medawachchiya,North Central,361,3457,3818,14440,138280,152720
12/6/2024,Subhani Khatun,Anuradhapura,Medawachchiya,North Central,587,5994,6581,23480,239760,263240
12/7/2024,Subhani Khatun,Anuradhapura,Medawachchiya,North Central,8616,9508,18124,344640,380320,724960
12/8/2024,Subhani Khatun,Anuradhapura,Medawachchiya,North Central,9792,9931,19723,391680,397240,788920
12/9/2024,Subhani Khatun,Anuradhapura,Medawachchiya,North Central,6808,9499,16307,272320,379960,652280
12/10/2024,Subhani Khatun,Anuradhapura,Medawachchiya,North Central,4073,2598,6671,162920,103920,266840
12/11/2024,Subhani Khatun,Anuradhapura,Medawachchiya,North Central,4144,4047,8191,165760,161880,327640
12/12/2024,Subhani Khatun,Anuradhapura,Medawachchiya,North Central,8,4387,4395,320,175480,175800
12/13/2024,Subhani Khatun,Anuradhapura,Medawachchiya,North Central,7788,1270,9058,311520,50800,362320
12/14/2024,Subhani Khatun,Anuradhapura,Medawachchiya,North Central,1129,6571,7700,45160,262840,308000
12/15/2024,Subhani Khatun,Anuradhapura,Medawachchiya,North Central,5368,6418,11786,214720,256720,471440
12/16/2024,Subhani Khatun,Anuradhapura,Medawachchiya,North Central,6197,9329,15526,247880,373160,621040
12/17/2024,Subhani Khatun,Anuradhapura,Medawachchiya,North Central,2459,8647,11106,98360,345880,444240
12/18/2024,Subhani Khatun,Anuradhapura,Medawachchiya,North Central,4318,840,5158,172720,33600,206320
12/19/2024,Subhani Khatun,Anuradhapura,Medawachchiya,North Central,4247,8691,12938,169880,347640,517520
12/20/2024,Subhani Khatun,Anuradhapura,Medawachchiya,North Central,6823,5718,12541,272920,228720,501640
12/21/2024,Subhani Khatun,Anuradhapura,Medawachchiya,North Central,440,7164,7604,17600,286560,304160
12/22/2024,Subhani Khatun,Anuradhapura,Medawachchiya,North Central,487,5832,6319,19480,233280,252760
12/23/2024,Subhani Khatun,Anuradhapura,Medawachchiya,North Central,2562,4041,6603,102480,161640,264120
12/24/2024,Subhani Khatun,Anuradhapura,Medawachchiya,North Central,7602,1102,8704,304080,44080,348160
12/25/2024,Subhani Khatun,Anuradhapura,Medawachchiya,North Central,652,2386,3038,26080,95440,121520
12/26/2024,Subhani Khatun,Anuradhapura,Medawachchiya,North Central,2420,6823,9243,96800,272920,369720
12/27/2024,Subhani Khatun,Anuradhapura,Medawachchiya,North Central,7154,9237,16391,286160,369480,655640
12/28/2024,Subhani Khatun,Anuradhapura,Medawachchiya,North Central,6158,5100,11258,246320,204000,450320
12/29/2024,Subhani Khatun,Anuradhapura,Medawachchiya,North Central,5349,8621,13970,213960,344840,558800
12/30/2024,Subhani Khatun,Anuradhapura,Medawachchiya,North Central,3923,4287,8210,156920,171480,328400
12/31/2024,Subhani Khatun,Anuradhapura,Medawachchiya,North Central,1999,1730,3729,79960,69200,149160
1/1/2025,Subhani Khatun,Anuradhapura,Medawachchiya,North Central,9764,6679,16443,390560,267160,657720
1/2/2025,Subhani Khatun,Anuradhapura,Medawachchiya,North Central,9181,4363,13544,367240,174520,541760
1/3/2025,Subhani Khatun,Anuradhapura,Medawachchiya,North Central,8977,9789,18766,359080,391560,750640
1/4/2025,Subhani Khatun,Anuradhapura,Medawachchiya,North Central,8912,581,9493,356480,23240,379720
1/5/2025,Subhani Khatun,Anuradhapura,Medawachchiya,North Central,6111,5511,11622,244440,220440,464880
1/6/2025,Subhani Khatun,Anuradhapura,Medawachchiya,North Central,1956,4302,6258,78240,172080,250320
1/7/2025,Subhani Khatun,Anuradhapura,Medawachchiya,North Central,8106,1364,9470,324240,54560,378800
1/8/2025,Subhani Khatun,Anuradhapura,Medawachchiya,North Central,5267,2533,7800,210680,101320,312000
1/9/2025,Subhani Khatun,Anuradhapura,Medawachchiya,North Central,91,5126,5217,3640,205040,208680
1/10/2025,Subhani Khatun,Anuradhapura,Medawachchiya,North Central,6528,1555,8083,261120,62200,323320
1/11/2025,Subhani Khatun,Anuradhapura,Medawachchiya,North Central,9593,2510,12103,383720,100400,484120
1/12/2025,Subhani Khatun,Anuradhapura,Medawachchiya,North Central,2526,6217,8743,101040,248680,349720
1/13/2025,Subhani Khatun,Anuradhapura,Medawachchiya,North Central,8608,5737,14345,344320,229480,573800
1/14/2025,Subhani Khatun,Anuradhapura,Medawachchiya,North Central,5651,8894,14545,226040,355760,581800
1/15/2025,Subhani Khatun,Anuradhapura,Medawachchiya,North Central,4044,2131,6175,161760,85240,247000
1/16/2025,Subhani Khatun,Anuradhapura,Medawachchiya,North Central,5186,4562,9748,207440,182480,389920
1/17/2025,Subhani Khatun,Anuradhapura,Medawachchiya,North Central,6072,982,7054,242880,39280,282160
1/18/2025,Subhani Khatun,Anuradhapura,Medawachchiya,North Central,1683,2077,3760,67320,83080,150400
1/19/2025,Subhani Khatun,Anuradhapura,Medawachchiya,North Central,3859,5864,9723,154360,234560,388920
1/20/2025,Subhani Khatun,Anuradhapura,Medawachchiya,North Central,4304,1364,5668,172160,54560,226720
1/21/2025,Subhani Khatun,Anuradhapura,Medawachchiya,North Central,2899,5817,8716,115960,232680,348640
1/22/2025,Subhani Khatun,Anuradhapura,Medawachchiya,North Central,7144,7871,15015,285760,314840,600600
1/23/2025,Subhani Khatun,Anuradhapura,Medawachchiya,North Central,7568,6271,13839,302720,250840,553560
1/24/2025,Subhani Khatun,Anuradhapura,Medawachchiya,North Central,1179,4099,5278,47160,163960,211120
1/25/2025,Subhani Khatun,Anuradhapura,Medawachchiya,North Central,176,7269,7445,7040,290760,297800
1/26/2025,Subhani Khatun,Anuradhapura,Medawachchiya,North Central,7219,3375,10594,288760,135000,423760
1/27/2025,Subhani Khatun,Anuradhapura,Medawachchiya,North Central,5686,3201,8887,227440,128040,355480
1/28/2025,Subhani Khatun,Anuradhapura,Medawachchiya,North Central,9124,8744,17868,364960,349760,714720
1/29/2025,Subhani Khatun,Anuradhapura,Medawachchiya,North Central,5522,5454,10976,220880,218160,439040
1/30/2025,Subhani Khatun,Anuradhapura,Medawachchiya,North Central,3968,2276,6244,158720,91040,249760
1/31/2025,Subhani Khatun,Anuradhapura,Medawachchiya,North Central,6739,5861,12600,269560,234440,504000
2/1/2025,Subhani Khatun,Anuradhapura,Medawachchiya,North Central,9857,6817,16674,394280,272680,666960
2/2/2025,Subhani Khatun,Anuradhapura,Medawachchiya,North Central,2595,897,3492,103800,35880,139680
2/3/2025,Subhani Khatun,Anuradhapura,Medawachchiya,North Central,5699,9763,15462,227960,390520,618480
2/4/2025,Subhani Khatun,Anuradhapura,Medawachchiya,North Central,525,4300,4825,21000,172000,193000
2/5/2025,Subhani Khatun,Anuradhapura,Medawachchiya,North Central,8703,5435,14138,348120,217400,565520
2/6/2025,Subhani Khatun,Anuradhapura,Medawachchiya,North Central,3499,4742,8241,139960,189680,329640
2/7/2025,Subhani Khatun,Anuradhapura,Medawachchiya,North Central,7516,3164,10680,300640,126560,427200
2/8/2025,Subhani Khatun,Anuradhapura,Medawachchiya,North Central,7433,2261,9694,297320,90440,387760
2/9/2025,Subhani Khatun,Anuradhapura,Medawachchiya,North Central,2660,7017,9677,106400,280680,387080
2/10/2025,Subhani Khatun,Anuradhapura,Medawachchiya,North Central,9973,1195,11168,398920,47800,446720
2/11/2025,Subhani Khatun,Anuradhapura,Medawachchiya,North Central,5948,862,6810,237920,34480,272400
2/12/2025,Subhani Khatun,Anuradhapura,Medawachchiya,North Central,698,6016,6714,27920,240640,268560
2/13/2025,Subhani Khatun,Anuradhapura,Medawachchiya,North Central,2030,2330,4360,81200,93200,174400
2/14/2025,Subhani Khatun,Anuradhapura,Medawachchiya,North Central,615,9727,10342,24600,389080,413680
2/15/2025,Subhani Khatun,Anuradhapura,Medawachchiya,North Central,4502,7036,11538,180080,281440,461520
2/16/2025,Subhani Khatun,Anuradhapura,Medawachchiya,North Central,4217,2684,6901,168680,107360,276040
2/17/2025,Subhani Khatun,Anuradhapura,Medawachchiya,North Central,6119,4236,10355,244760,169440,414200
2/18/2025,Subhani Khatun,Anuradhapura,Medawachchiya,North Central,2614,3646,6260,104560,145840,250400
2/19/2025,Subhani Khatun,Anuradhapura,Medawachchiya,North Central,51,5904,5955,2040,236160,238200
2/20/2025,Subhani Khatun,Anuradhapura,Medawachchiya,North Central,8483,9955,18438,339320,398200,737520
2/21/2025,Subhani Khatun,Anuradhapura,Medawachchiya,North Central,4396,8407,12803,175840,336280,512120
2/22/2025,Subhani Khatun,Anuradhapura,Medawachchiya,North Central,5248,6211,11459,209920,248440,458360
2/23/2025,Subhani Khatun,Anuradhapura,Medawachchiya,North Central,4365,6781,11146,174600,271240,445840
2/24/2025,Subhani Khatun,Anuradhapura,Medawachchiya,North Central,8167,1853,10020,326680,74120,400800
2/25/2025,Subhani Khatun,Anuradhapura,Medawachchiya,North Central,293,6120,6413,11720,244800,256520
2/26/2025,Subhani Khatun,Anuradhapura,Medawachchiya,North Central,8842,4455,13297,353680,178200,531880
2/27/2025,Subhani Khatun,Anuradhapura,Medawachchiya,North Central,1667,4223,5890,66680,168920,235600
2/28/2025,Subhani Khatun,Anuradhapura,Medawachchiya,North Central,5797,9438,15235,231880,377520,609400
3/1/2025,Subhani Khatun,Anuradhapura,Medawachchiya,North Central,7762,7581,15343,310480,303240,613720
3/2/2025,Subhani Khatun,Anuradhapura,Medawachchiya,North Central,1097,7335,8432,43880,293400,337280
3/3/2025,Subhani Khatun,Anuradhapura,Medawachchiya,North Central,1127,915,2042,45080,36600,81680
3/4/2025,Subhani Khatun,Anuradhapura,Medawachchiya,North Central,4242,6754,10996,169680,270160,439840
3/5/2025,Subhani Khatun,Anuradhapura,Medawachchiya,North Central,615,5237,5852,24600,209480,234080
3/6/2025,Subhani Khatun,Anuradhapura,Medawachchiya,North Central,890,2509,3399,35600,100360,135960
3/7/2025,Subhani Khatun,Anuradhapura,Medawachchiya,North Central,6475,503,6978,259000,20120,279120
3/8/2025,Subhani Khatun,Anuradhapura,Medawachchiya,North Central,7580,8605,16185,303200,344200,647400
3/9/2025,Subhani Khatun,Anuradhapura,Medawachchiya,North Central,4753,6037,10790,190120,241480,431600
3/10/2025,Subhani Khatun,Anuradhapura,Medawachchiya,North Central,222,5841,6063,8880,233640,242520
3/11/2025,Subhani Khatun,Anuradhapura,Medawachchiya,North Central,1057,7971,9028,42280,318840,361120
3/12/2025,Subhani Khatun,Anuradhapura,Medawachchiya,North Central,6417,7480,13897,256680,299200,555880
3/13/2025,Subhani Khatun,Anuradhapura,Medawachchiya,North Central,1364,1133,2497,54560,45320,99880
3/14/2025,Subhani Khatun,Anuradhapura,Medawachchiya,North Central,929,3637,4566,37160,145480,182640
3/15/2025,Subhani Khatun,Anuradhapura,Medawachchiya,North Central,3162,1448,4610,126480,57920,184400
3/16/2025,Subhani Khatun,Anuradhapura,Medawachchiya,North Central,9349,3812,13161,373960,152480,526440
3/17/2025,Subhani Khatun,Anuradhapura,Medawachchiya,North Central,5720,3743,9463,228800,149720,378520
3/18/2025,Subhani Khatun,Anuradhapura,Medawachchiya,North Central,5710,8590,14300,228400,343600,572000
3/19/2025,Subhani Khatun,Anuradhapura,Medawachchiya,North Central,5665,7960,13625,226600,318400,545000
3/20/2025,Subhani Khatun,Anuradhapura,Medawachchiya,North Central,6526,4835,11361,261040,193400,454440
3/21/2025,Subhani Khatun,Anuradhapura,Medawachchiya,North Central,8398,9095,17493,335920,363800,699720
3/22/2025,Subhani Khatun,Anuradhapura,Medawachchiya,North Central,9643,7543,17186,385720,301720,687440
3/23/2025,Subhani Khatun,Anuradhapura,Medawachchiya,North Central,2711,2405,5116,108440,96200,204640
3/25/2024,Charitha Jayaweera,Kegalle,Mawanella,Sabaragamuwa,1726,691,2417,69040,27640,96680
3/26/2024,Charitha Jayaweera,Kegalle,Mawanella,Sabaragamuwa,3185,8278,11463,127400,331120,458520
3/27/2024,Charitha Jayaweera,Kegalle,Mawanella,Sabaragamuwa,9886,7496,17382,395440,299840,695280
3/28/2024,Charitha Jayaweera,Kegalle,Mawanella,Sabaragamuwa,2591,2088,4679,103640,83520,187160
3/29/2024,Charitha Jayaweera,Kegalle,Mawanella,Sabaragamuwa,7922,7824,15746,316880,312960,629840
3/30/2024,Charitha Jayaweera,Kegalle,Mawanella,Sabaragamuwa,9001,5957,14958,360040,238280,598320
3/31/2024,Charitha Jayaweera,Kegalle,Mawanella,Sabaragamuwa,482,1012,1494,19280,40480,59760
4/1/2024,Charitha Jayaweera,Kegalle,Mawanella,Sabaragamuwa,4883,4655,9538,195320,186200,381520
4/2/2024,Charitha Jayaweera,Kegalle,Mawanella,Sabaragamuwa,7811,5978,13789,312440,239120,551560
4/3/2024,Charitha Jayaweera,Kegalle,Mawanella,Sabaragamuwa,2580,7761,10341,103200,310440,413640
4/4/2024,Charitha Jayaweera,Kegalle,Mawanella,Sabaragamuwa,7169,9299,16468,286760,371960,658720
4/5/2024,Charitha Jayaweera,Kegalle,Mawanella,Sabaragamuwa,2535,9198,11733,101400,367920,469320
4/6/2024,Charitha Jayaweera,Kegalle,Mawanella,Sabaragamuwa,1995,6598,8593,79800,263920,343720
4/7/2024,Charitha Jayaweera,Kegalle,Mawanella,Sabaragamuwa,5805,978,6783,232200,39120,271320
4/8/2024,Charitha Jayaweera,Kegalle,Mawanella,Sabaragamuwa,7453,289,7742,298120,11560,309680
4/9/2024,Charitha Jayaweera,Kegalle,Mawanella,Sabaragamuwa,4458,8073,12531,178320,322920,501240
4/10/2024,Charitha Jayaweera,Kegalle,Mawanella,Sabaragamuwa,4757,2642,7399,190280,105680,295960
4/11/2024,Charitha Jayaweera,Kegalle,Mawanella,Sabaragamuwa,9764,7997,17761,390560,319880,710440
4/19/2024,Charitha Jayaweera,Kegalle,Mawanella,Sabaragamuwa,1765,2175,3940,70600,87000,157600
4/20/2024,Charitha Jayaweera,Kegalle,Mawanella,Sabaragamuwa,8759,4761,13520,350360,190440,540800
4/21/2024,Charitha Jayaweera,Kegalle,Mawanella,Sabaragamuwa,7853,761,8614,314120,30440,344560
4/22/2024,Charitha Jayaweera,Kegalle,Mawanella,Sabaragamuwa,5256,5842,11098,210240,233680,443920
4/23/2024,Charitha Jayaweera,Kegalle,Mawanella,Sabaragamuwa,1187,7885,9072,47480,315400,362880
4/24/2024,Charitha Jayaweera,Kegalle,Mawanella,Sabaragamuwa,6351,4812,11163,254040,192480,446520
4/25/2024,Charitha Jayaweera,Kegalle,Mawanella,Sabaragamuwa,2836,3442,6278,113440,137680,251120
4/26/2024,Charitha Jayaweera,Kegalle,Mawanella,Sabaragamuwa,4644,252,4896,185760,10080,195840
4/27/2024,Charitha Jayaweera,Kegalle,Mawanella,Sabaragamuwa,6722,7066,13788,268880,282640,551520
4/28/2024,Charitha Jayaweera,Kegalle,Mawanella,Sabaragamuwa,954,1313,2267,38160,52520,90680
4/29/2024,Charitha Jayaweera,Kegalle,Mawanella,Sabaragamuwa,3413,4030,7443,136520,161200,297720
4/30/2024,Charitha Jayaweera,Kegalle,Mawanella,Sabaragamuwa,5870,9517,15387,234800,380680,615480
5/1/2024,Charitha Jayaweera,Kegalle,Mawanella,Sabaragamuwa,9808,5121,14929,392320,204840,597160
5/2/2024,Charitha Jayaweera,Kegalle,Mawanella,Sabaragamuwa,3867,5169,9036,154680,206760,361440
5/3/2024,Charitha Jayaweera,Kegalle,Mawanella,Sabaragamuwa,6499,7527,14026,259960,301080,561040
5/4/2024,Charitha Jayaweera,Kegalle,Mawanella,Sabaragamuwa,8716,8410,17126,348640,336400,685040
5/5/2024,Charitha Jayaweera,Kegalle,Mawanella,Sabaragamuwa,1080,3750,4830,43200,150000,193200
5/6/2024,Charitha Jayaweera,Kegalle,Mawanella,Sabaragamuwa,4250,1558,5808,170000,62320,232320
5/7/2024,Charitha Jayaweera,Kegalle,Mawanella,Sabaragamuwa,6070,6079,12149,242800,243160,485960
5/8/2024,Charitha Jayaweera,Kegalle,Mawanella,Sabaragamuwa,6199,7688,13887,247960,307520,555480
5/9/2024,Charitha Jayaweera,Kegalle,Mawanella,Sabaragamuwa,2744,583,3327,109760,23320,133080
5/10/2024,Charitha Jayaweera,Kegalle,Mawanella,Sabaragamuwa,879,6888,7767,35160,275520,310680
5/11/2024,Charitha Jayaweera,Kegalle,Mawanella,Sabaragamuwa,3980,5946,9926,159200,237840,397040
5/12/2024,Charitha Jayaweera,Kegalle,Mawanella,Sabaragamuwa,5937,4323,10260,237480,172920,410400
5/13/2024,Charitha Jayaweera,Kegalle,Mawanella,Sabaragamuwa,9762,3067,12829,390480,122680,513160
5/14/2024,Charitha Jayaweera,Kegalle,Mawanella,Sabaragamuwa,3847,4919,8766,153880,196760,350640
5/15/2024,Charitha Jayaweera,Kegalle,Mawanella,Sabaragamuwa,1174,9276,10450,46960,371040,418000
5/16/2024,Charitha Jayaweera,Kegalle,Mawanella,Sabaragamuwa,6417,4162,10579,256680,166480,423160
5/17/2024,Charitha Jayaweera,Kegalle,Mawanella,Sabaragamuwa,2972,6702,9674,118880,268080,386960
5/18/2024,Charitha Jayaweera,Kegalle,Mawanella,Sabaragamuwa,6022,2447,8469,240880,97880,338760
5/19/2024,Charitha Jayaweera,Kegalle,Mawanella,Sabaragamuwa,5736,8392,14128,229440,335680,565120
5/20/2024,Charitha Jayaweera,Kegalle,Mawanella,Sabaragamuwa,7916,1741,9657,316640,69640,386280
5/21/2024,Charitha Jayaweera,Kegalle,Mawanella,Sabaragamuwa,8190,4793,12983,327600,191720,519320
5/22/2024,Charitha Jayaweera,Kegalle,Mawanella,Sabaragamuwa,2080,5229,7309,83200,209160,292360
5/24/2024,Charitha Jayaweera,Kegalle,Mawanella,Sabaragamuwa,9081,7440,16521,363240,297600,660840
5/25/2024,Charitha Jayaweera,Kegalle,Mawanella,Sabaragamuwa,2229,988,3217,89160,39520,128680
5/26/2024,Charitha Jayaweera,Kegalle,Mawanella,Sabaragamuwa,5159,772,5931,206360,30880,237240
5/27/2024,Charitha Jayaweera,Kegalle,Mawanella,Sabaragamuwa,586,5175,5761,23440,207000,230440
5/28/2024,Charitha Jayaweera,Kegalle,Mawanella,Sabaragamuwa,5862,1860,7722,234480,74400,308880
5/29/2024,Charitha Jayaweera,Kegalle,Mawanella,Sabaragamuwa,7588,4722,12310,303520,188880,492400
5/30/2024,Charitha Jayaweera,Kegalle,Mawanella,Sabaragamuwa,1038,2102,3140,41520,84080,125600
5/31/2024,Charitha Jayaweera,Kegalle,Mawanella,Sabaragamuwa,2671,5140,7811,106840,205600,312440
6/1/2024,Charitha Jayaweera,Kegalle,Mawanella,Sabaragamuwa,6785,1604,8389,271400,64160,335560
6/2/2024,Charitha Jayaweera,Kegalle,Mawanella,Sabaragamuwa,941,2606,3547,37640,104240,141880
6/3/2024,Charitha Jayaweera,Kegalle,Mawanella,Sabaragamuwa,4282,3722,8004,171280,148880,320160
6/4/2024,Charitha Jayaweera,Kegalle,Mawanella,Sabaragamuwa,4457,6873,11330,178280,274920,453200
6/5/2024,Charitha Jayaweera,Kegalle,Mawanella,Sabaragamuwa,6664,2820,9484,266560,112800,379360
6/6/2024,Charitha Jayaweera,Kegalle,Mawanella,Sabaragamuwa,9605,5240,14845,384200,209600,593800
6/7/2024,Charitha Jayaweera,Kegalle,Mawanella,Sabaragamuwa,3440,5366,8806,137600,214640,352240
6/8/2024,Charitha Jayaweera,Kegalle,Mawanella,Sabaragamuwa,193,6221,6414,7720,248840,256560
6/9/2024,Charitha Jayaweera,Kegalle,Mawanella,Sabaragamuwa,1215,170,1385,48600,6800,55400
6/10/2024,Charitha Jayaweera,Kegalle,Mawanella,Sabaragamuwa,8680,747,9427,347200,29880,377080
6/11/2024,Charitha Jayaweera,Kegalle,Mawanella,Sabaragamuwa,5115,7189,12304,204600,287560,492160
6/12/2024,Charitha Jayaweera,Kegalle,Mawanella,Sabaragamuwa,508,1848,2356,20320,73920,94240
6/13/2024,Charitha Jayaweera,Kegalle,Mawanella,Sabaragamuwa,7335,9942,17277,293400,397680,691080
6/14/2024,Charitha Jayaweera,Kegalle,Mawanella,Sabaragamuwa,7943,1570,9513,317720,62800,380520
6/15/2024,Charitha Jayaweera,Kegalle,Mawanella,Sabaragamuwa,9824,988,10812,392960,39520,432480
6/16/2024,Charitha Jayaweera,Kegalle,Mawanella,Sabaragamuwa,6666,4141,10807,266640,165640,432280
6/17/2024,Charitha Jayaweera,Kegalle,Mawanella,Sabaragamuwa,6672,4366,11038,266880,174640,441520
6/18/2024,Charitha Jayaweera,Kegalle,Mawanella,Sabaragamuwa,6455,9277,15732,258200,371080,629280
6/19/2024,Charitha Jayaweera,Kegalle,Mawanella,Sabaragamuwa,9848,6529,16377,393920,261160,655080
6/20/2024,Charitha Jayaweera,Kegalle,Mawanella,Sabaragamuwa,2939,1516,4455,117560,60640,178200
6/21/2024,Charitha Jayaweera,Kegalle,Mawanella,Sabaragamuwa,2026,177,2203,81040,7080,88120
6/22/2024,Charitha Jayaweera,Kegalle,Mawanella,Sabaragamuwa,5243,7851,13094,209720,314040,523760
6/23/2024,Charitha Jayaweera,Kegalle,Mawanella,Sabaragamuwa,5801,3201,9002,232040,128040,360080
6/24/2024,Charitha Jayaweera,Kegalle,Mawanella,Sabaragamuwa,6202,6772,12974,248080,270880,518960
6/25/2024,Charitha Jayaweera,Kegalle,Mawanella,Sabaragamuwa,5710,3885,9595,228400,155400,383800
6/26/2024,Charitha Jayaweera,Kegalle,Mawanella,Sabaragamuwa,2148,9011,11159,85920,360440,446360
6/27/2024,Charitha Jayaweera,Kegalle,Mawanella,Sabaragamuwa,5251,9204,14455,210040,368160,578200
6/28/2024,Charitha Jayaweera,Kegalle,Mawanella,Sabaragamuwa,330,302,632,13200,12080,25280
6/29/2024,Charitha Jayaweera,Kegalle,Mawanella,Sabaragamuwa,4836,5947,10783,193440,237880,431320
6/30/2024,Charitha Jayaweera,Kegalle,Mawanella,Sabaragamuwa,1169,6445,7614,46760,257800,304560
7/1/2024,Charitha Jayaweera,Kegalle,Mawanella,Sabaragamuwa,9262,9439,18701,370480,377560,748040
7/2/2024,Charitha Jayaweera,Kegalle,Mawanella,Sabaragamuwa,724,2705,3429,28960,108200,137160
7/3/2024,Charitha Jayaweera,Kegalle,Mawanella,Sabaragamuwa,4786,7221,12007,191440,288840,480280
7/4/2024,Charitha Jayaweera,Kegalle,Mawanella,Sabaragamuwa,8027,7104,15131,321080,284160,605240
7/5/2024,Charitha Jayaweera,Kegalle,Mawanella,Sabaragamuwa,246,5997,6243,9840,239880,249720
7/6/2024,Charitha Jayaweera,Kegalle,Mawanella,Sabaragamuwa,6932,4949,11881,277280,197960,475240
7/7/2024,Charitha Jayaweera,Kegalle,Mawanella,Sabaragamuwa,9686,6079,15765,387440,243160,630600
7/8/2024,Charitha Jayaweera,Kegalle,Mawanella,Sabaragamuwa,4579,4308,8887,183160,172320,355480
7/9/2024,Charitha Jayaweera,Kegalle,Mawanella,Sabaragamuwa,9012,9291,18303,360480,371640,732120
7/10/2024,Charitha Jayaweera,Kegalle,Mawanella,Sabaragamuwa,5139,2954,8093,205560,118160,323720
7/11/2024,Charitha Jayaweera,Kegalle,Mawanella,Sabaragamuwa,7147,331,7478,285880,13240,299120
7/12/2024,Charitha Jayaweera,Kegalle,Mawanella,Sabaragamuwa,4118,3343,7461,164720,133720,298440
7/13/2024,Charitha Jayaweera,Kegalle,Mawanella,Sabaragamuwa,7435,3578,11013,297400,143120,440520
7/14/2024,Charitha Jayaweera,Kegalle,Mawanella,Sabaragamuwa,8243,9006,17249,329720,360240,689960
7/15/2024,Charitha Jayaweera,Kegalle,Mawanella,Sabaragamuwa,2368,546,2914,94720,21840,116560
7/16/2024,Charitha Jayaweera,Kegalle,Mawanella,Sabaragamuwa,3580,1512,5092,143200,60480,203680
7/17/2024,Charitha Jayaweera,Kegalle,Mawanella,Sabaragamuwa,2198,4710,6908,87920,188400,276320
7/18/2024,Charitha Jayaweera,Kegalle,Mawanella,Sabaragamuwa,7151,340,7491,286040,13600,299640
7/19/2024,Charitha Jayaweera,Kegalle,Mawanella,Sabaragamuwa,9758,4084,13842,390320,163360,553680
7/20/2024,Charitha Jayaweera,Kegalle,Mawanella,Sabaragamuwa,6141,5063,11204,245640,202520,448160
7/21/2024,Charitha Jayaweera,Kegalle,Mawanella,Sabaragamuwa,38,7513,7551,1520,300520,302040
7/22/2024,Charitha Jayaweera,Kegalle,Mawanella,Sabaragamuwa,8564,7451,16015,342560,298040,640600
7/23/2024,Charitha Jayaweera,Kegalle,Mawanella,Sabaragamuwa,3672,563,4235,146880,22520,169400
7/24/2024,Charitha Jayaweera,Kegalle,Mawanella,Sabaragamuwa,4410,3056,7466,176400,122240,298640
7/25/2024,Charitha Jayaweera,Kegalle,Mawanella,Sabaragamuwa,5588,2504,8092,223520,100160,323680
7/26/2024,Charitha Jayaweera,Kegalle,Mawanella,Sabaragamuwa,970,7348,8318,38800,293920,332720
7/27/2024,Charitha Jayaweera,Kegalle,Mawanella,Sabaragamuwa,683,7837,8520,27320,313480,340800
7/28/2024,Charitha Jayaweera,Kegalle,Mawanella,Sabaragamuwa,6481,988,7469,259240,39520,298760
7/29/2024,Charitha Jayaweera,Kegalle,Mawanella,Sabaragamuwa,9757,2003,11760,390280,80120,470400
7/30/2024,Charitha Jayaweera,Kegalle,Mawanella,Sabaragamuwa,7839,9565,17404,313560,382600,696160
7/31/2024,Charitha Jayaweera,Kegalle,Mawanella,Sabaragamuwa,808,1406,2214,32320,56240,88560
8/1/2024,Charitha Jayaweera,Kegalle,Mawanella,Sabaragamuwa,7274,3195,10469,290960,127800,418760
8/2/2024,Charitha Jayaweera,Kegalle,Mawanella,Sabaragamuwa,5713,607,6320,228520,24280,252800
8/3/2024,Charitha Jayaweera,Kegalle,Mawanella,Sabaragamuwa,9318,77,9395,372720,3080,375800
8/4/2024,Charitha Jayaweera,Kegalle,Mawanella,Sabaragamuwa,8887,7562,16449,355480,302480,657960
8/5/2024,Charitha Jayaweera,Kegalle,Mawanella,Sabaragamuwa,6666,5792,12458,266640,231680,498320
8/6/2024,Charitha Jayaweera,Kegalle,Mawanella,Sabaragamuwa,7927,2354,10281,317080,94160,411240
8/7/2024,Charitha Jayaweera,Kegalle,Mawanella,Sabaragamuwa,9601,5932,15533,384040,237280,621320
8/8/2024,Charitha Jayaweera,Kegalle,Mawanella,Sabaragamuwa,5004,3809,8813,200160,152360,352520
8/9/2024,Charitha Jayaweera,Kegalle,Mawanella,Sabaragamuwa,9190,9656,18846,367600,386240,753840
8/10/2024,Charitha Jayaweera,Kegalle,Mawanella,Sabaragamuwa,613,5174,5787,24520,206960,231480
8/11/2024,Charitha Jayaweera,Kegalle,Mawanella,Sabaragamuwa,9792,9867,19659,391680,394680,786360
8/12/2024,Charitha Jayaweera,Kegalle,Mawanella,Sabaragamuwa,1427,6077,7504,57080,243080,300160
8/13/2024,Charitha Jayaweera,Kegalle,Mawanella,Sabaragamuwa,3033,113,3146,121320,4520,125840
8/14/2024,Charitha Jayaweera,Kegalle,Mawanella,Sabaragamuwa,1450,5567,7017,58000,222680,280680
8/15/2024,Charitha Jayaweera,Kegalle,Mawanella,Sabaragamuwa,3464,2556,6020,138560,102240,240800
8/16/2024,Charitha Jayaweera,Kegalle,Mawanella,Sabaragamuwa,4131,9556,13687,165240,382240,547480
8/17/2024,Charitha Jayaweera,Kegalle,Mawanella,Sabaragamuwa,9756,4254,14010,390240,170160,560400
8/18/2024,Charitha Jayaweera,Kegalle,Mawanella,Sabaragamuwa,3030,7552,10582,121200,302080,423280
8/19/2024,Charitha Jayaweera,Kegalle,Mawanella,Sabaragamuwa,8374,7140,15514,334960,285600,620560
8/20/2024,Charitha Jayaweera,Kegalle,Mawanella,Sabaragamuwa,9221,4165,13386,368840,166600,535440
8/21/2024,Charitha Jayaweera,Kegalle,Mawanella,Sabaragamuwa,2330,5178,7508,93200,207120,300320
8/22/2024,Charitha Jayaweera,Kegalle,Mawanella,Sabaragamuwa,7569,3825,11394,302760,153000,455760
8/23/2024,Charitha Jayaweera,Kegalle,Mawanella,Sabaragamuwa,8807,9401,18208,352280,376040,728320
8/24/2024,Charitha Jayaweera,Kegalle,Mawanella,Sabaragamuwa,355,6460,6815,14200,258400,272600
8/25/2024,Charitha Jayaweera,Kegalle,Mawanella,Sabaragamuwa,3568,6906,10474,142720,276240,418960
8/26/2024,Charitha Jayaweera,Kegalle,Mawanella,Sabaragamuwa,7094,4533,11627,283760,181320,465080
8/27/2024,Charitha Jayaweera,Kegalle,Mawanella,Sabaragamuwa,1243,2267,3510,49720,90680,140400
8/28/2024,Charitha Jayaweera,Kegalle,Mawanella,Sabaragamuwa,2466,9272,11738,98640,370880,469520
8/29/2024,Charitha Jayaweera,Kegalle,Mawanella,Sabaragamuwa,8530,1890,10420,341200,75600,416800
8/30/2024,Charitha Jayaweera,Kegalle,Mawanella,Sabaragamuwa,8310,4729,13039,332400,189160,521560
8/31/2024,Charitha Jayaweera,Kegalle,Mawanella,Sabaragamuwa,2540,7239,9779,101600,289560,391160
9/1/2024,Charitha Jayaweera,Kegalle,Mawanella,Sabaragamuwa,2400,6263,8663,96000,250520,346520
9/2/2024,Charitha Jayaweera,Kegalle,Mawanella,Sabaragamuwa,5884,9735,15619,235360,389400,624760
9/3/2024,Charitha Jayaweera,Kegalle,Mawanella,Sabaragamuwa,427,1738,2165,17080,69520,86600
9/4/2024,Charitha Jayaweera,Kegalle,Mawanella,Sabaragamuwa,1252,7181,8433,50080,287240,337320
9/5/2024,Charitha Jayaweera,Kegalle,Mawanella,Sabaragamuwa,6507,774,7281,260280,30960,291240
9/6/2024,Charitha Jayaweera,Kegalle,Mawanella,Sabaragamuwa,7506,8137,15643,300240,325480,625720
9/7/2024,Charitha Jayaweera,Kegalle,Mawanella,Sabaragamuwa,7828,513,8341,313120,20520,333640
9/8/2024,Charitha Jayaweera,Kegalle,Mawanella,Sabaragamuwa,2551,461,3012,102040,18440,120480
9/9/2024,Charitha Jayaweera,Kegalle,Mawanella,Sabaragamuwa,7989,9543,17532,319560,381720,701280
9/10/2024,Charitha Jayaweera,Kegalle,Mawanella,Sabaragamuwa,3378,8838,12216,135120,353520,488640
9/11/2024,Charitha Jayaweera,Kegalle,Mawanella,Sabaragamuwa,2964,8236,11200,118560,329440,448000
9/12/2024,Charitha Jayaweera,Kegalle,Mawanella,Sabaragamuwa,312,8050,8362,12480,322000,334480
9/13/2024,Charitha Jayaweera,Kegalle,Mawanella,Sabaragamuwa,616,5790,6406,24640,231600,256240
9/14/2024,Charitha Jayaweera,Kegalle,Mawanella,Sabaragamuwa,266,3306,3572,10640,132240,142880
9/15/2024,Charitha Jayaweera,Kegalle,Mawanella,Sabaragamuwa,5060,6643,11703,202400,265720,468120
9/16/2024,Charitha Jayaweera,Kegalle,Mawanella,Sabaragamuwa,7625,2010,9635,305000,80400,385400
9/17/2024,Charitha Jayaweera,Kegalle,Mawanella,Sabaragamuwa,7431,1078,8509,297240,43120,340360
9/18/2024,Charitha Jayaweera,Kegalle,Mawanella,Sabaragamuwa,6114,8993,15107,244560,359720,604280
9/19/2024,Charitha Jayaweera,Kegalle,Mawanella,Sabaragamuwa,3151,2261,5412,126040,90440,216480
9/20/2024,Charitha Jayaweera,Kegalle,Mawanella,Sabaragamuwa,8499,9055,17554,339960,362200,702160
9/21/2024,Charitha Jayaweera,Kegalle,Mawanella,Sabaragamuwa,492,7784,8276,19680,311360,331040
9/22/2024,Charitha Jayaweera,Kegalle,Mawanella,Sabaragamuwa,9856,6805,16661,394240,272200,666440
9/23/2024,Charitha Jayaweera,Kegalle,Mawanella,Sabaragamuwa,3472,7597,11069,138880,303880,442760
9/24/2024,Charitha Jayaweera,Kegalle,Mawanella,Sabaragamuwa,3877,1895,5772,155080,75800,230880
9/25/2024,Charitha Jayaweera,Kegalle,Mawanella,Sabaragamuwa,9075,1369,10444,363000,54760,417760
9/26/2024,Charitha Jayaweera,Kegalle,Mawanella,Sabaragamuwa,880,2082,2962,35200,83280,118480
9/27/2024,Charitha Jayaweera,Kegalle,Mawanella,Sabaragamuwa,6737,3141,9878,269480,125640,395120
9/28/2024,Charitha Jayaweera,Kegalle,Mawanella,Sabaragamuwa,5191,9672,14863,207640,386880,594520
9/29/2024,Charitha Jayaweera,Kegalle,Mawanella,Sabaragamuwa,2562,7182,9744,102480,287280,389760
9/30/2024,Charitha Jayaweera,Kegalle,Mawanella,Sabaragamuwa,343,5119,5462,13720,204760,218480
10/1/2024,Charitha Jayaweera,Kegalle,Mawanella,Sabaragamuwa,504,6393,6897,20160,255720,275880
10/2/2024,Charitha Jayaweera,Kegalle,Mawanella,Sabaragamuwa,6838,2011,8849,273520,80440,353960
10/3/2024,Charitha Jayaweera,Kegalle,Mawanella,Sabaragamuwa,3813,5642,9455,152520,225680,378200
10/4/2024,Charitha Jayaweera,Kegalle,Mawanella,Sabaragamuwa,7343,680,8023,293720,27200,320920
10/5/2024,Charitha Jayaweera,Kegalle,Mawanella,Sabaragamuwa,3511,6793,10304,140440,271720,412160
10/6/2024,Charitha Jayaweera,Kegalle,Mawanella,Sabaragamuwa,4913,7832,12745,196520,313280,509800
10/7/2024,Charitha Jayaweera,Kegalle,Mawanella,Sabaragamuwa,489,9868,10357,19560,394720,414280
10/8/2024,Charitha Jayaweera,Kegalle,Mawanella,Sabaragamuwa,9678,7207,16885,387120,288280,675400
10/9/2024,Charitha Jayaweera,Kegalle,Mawanella,Sabaragamuwa,5588,6159,11747,223520,246360,469880
10/10/2024,Charitha Jayaweera,Kegalle,Mawanella,Sabaragamuwa,3998,5272,9270,159920,210880,370800
10/11/2024,Charitha Jayaweera,Kegalle,Mawanella,Sabaragamuwa,6408,436,6844,256320,17440,273760
10/12/2024,Charitha Jayaweera,Kegalle,Mawanella,Sabaragamuwa,4376,3544,7920,175040,141760,316800
10/13/2024,Charitha Jayaweera,Kegalle,Mawanella,Sabaragamuwa,3570,7343,10913,142800,293720,436520
10/14/2024,Charitha Jayaweera,Kegalle,Mawanella,Sabaragamuwa,6465,9951,16416,258600,398040,656640
10/15/2024,Charitha Jayaweera,Kegalle,Mawanella,Sabaragamuwa,699,3406,4105,27960,136240,164200
10/16/2024,Charitha Jayaweera,Kegalle,Mawanella,Sabaragamuwa,2442,5643,8085,97680,225720,323400
10/17/2024,Charitha Jayaweera,Kegalle,Mawanella,Sabaragamuwa,7531,8808,16339,301240,352320,653560
10/18/2024,Charitha Jayaweera,Kegalle,Mawanella,Sabaragamuwa,102,4931,5033,4080,197240,201320
10/19/2024,Charitha Jayaweera,Kegalle,Mawanella,Sabaragamuwa,7966,2302,10268,318640,92080,410720
10/20/2024,Charitha Jayaweera,Kegalle,Mawanella,Sabaragamuwa,2572,7995,10567,102880,319800,422680
10/21/2024,Charitha Jayaweera,Kegalle,Mawanella,Sabaragamuwa,7561,9210,16771,302440,368400,670840
10/22/2024,Charitha Jayaweera,Kegalle,Mawanella,Sabaragamuwa,9977,321,10298,399080,12840,411920
10/23/2024,Charitha Jayaweera,Kegalle,Mawanella,Sabaragamuwa,2826,8150,10976,113040,326000,439040
10/24/2024,Charitha Jayaweera,Kegalle,Mawanella,Sabaragamuwa,1655,9318,10973,66200,372720,438920
10/25/2024,Charitha Jayaweera,Kegalle,Mawanella,Sabaragamuwa,6720,9922,16642,268800,396880,665680
10/26/2024,Charitha Jayaweera,Kegalle,Mawanella,Sabaragamuwa,9335,6359,15694,373400,254360,627760
10/27/2024,Charitha Jayaweera,Kegalle,Mawanella,Sabaragamuwa,8560,7158,15718,342400,286320,628720
10/28/2024,Charitha Jayaweera,Kegalle,Mawanella,Sabaragamuwa,9004,4685,13689,360160,187400,547560
10/29/2024,Charitha Jayaweera,Kegalle,Mawanella,Sabaragamuwa,3998,1042,5040,159920,41680,201600
10/30/2024,Charitha Jayaweera,Kegalle,Mawanella,Sabaragamuwa,3049,9120,12169,121960,364800,486760
10/31/2024,Charitha Jayaweera,Kegalle,Mawanella,Sabaragamuwa,5672,1768,7440,226880,70720,297600
11/1/2024,Charitha Jayaweera,Kegalle,Mawanella,Sabaragamuwa,3181,1855,5036,127240,74200,201440
11/2/2024,Charitha Jayaweera,Kegalle,Mawanella,Sabaragamuwa,5929,6786,12715,237160,271440,508600
11/3/2024,Charitha Jayaweera,Kegalle,Mawanella,Sabaragamuwa,6820,1723,8543,272800,68920,341720
11/4/2024,Charitha Jayaweera,Kegalle,Mawanella,Sabaragamuwa,2232,1407,3639,89280,56280,145560
11/5/2024,Charitha Jayaweera,Kegalle,Mawanella,Sabaragamuwa,9749,9220,18969,389960,368800,758760
11/6/2024,Charitha Jayaweera,Kegalle,Mawanella,Sabaragamuwa,9467,3593,13060,378680,143720,522400
11/7/2024,Charitha Jayaweera,Kegalle,Mawanella,Sabaragamuwa,2158,577,2735,86320,23080,109400
11/8/2024,Charitha Jayaweera,Kegalle,Mawanella,Sabaragamuwa,9259,8907,18166,370360,356280,726640
11/9/2024,Charitha Jayaweera,Kegalle,Mawanella,Sabaragamuwa,9186,1761,10947,367440,70440,437880
11/10/2024,Charitha Jayaweera,Kegalle,Mawanella,Sabaragamuwa,5201,1356,6557,208040,54240,262280
11/11/2024,Charitha Jayaweera,Kegalle,Mawanella,Sabaragamuwa,4542,3070,7612,181680,122800,304480
11/12/2024,Charitha Jayaweera,Kegalle,Mawanella,Sabaragamuwa,6213,9986,16199,248520,399440,647960
11/13/2024,Charitha Jayaweera,Kegalle,Mawanella,Sabaragamuwa,5679,6991,12670,227160,279640,506800
11/14/2024,Charitha Jayaweera,Kegalle,Mawanella,Sabaragamuwa,7592,9853,17445,303680,394120,697800
11/15/2024,Charitha Jayaweera,Kegalle,Mawanella,Sabaragamuwa,2220,2319,4539,88800,92760,181560
11/16/2024,Charitha Jayaweera,Kegalle,Mawanella,Sabaragamuwa,2588,1595,4183,103520,63800,167320
11/17/2024,Charitha Jayaweera,Kegalle,Mawanella,Sabaragamuwa,313,8481,8794,12520,339240,351760
11/18/2024,Charitha Jayaweera,Kegalle,Mawanella,Sabaragamuwa,9648,2204,11852,385920,88160,474080
11/19/2024,Charitha Jayaweera,Kegalle,Mawanella,Sabaragamuwa,2906,2143,5049,116240,85720,201960
11/20/2024,Charitha Jayaweera,Kegalle,Mawanella,Sabaragamuwa,6621,7188,13809,264840,287520,552360
11/21/2024,Charitha Jayaweera,Kegalle,Mawanella,Sabaragamuwa,9325,79,9404,373000,3160,376160
11/22/2024,Charitha Jayaweera,Kegalle,Mawanella,Sabaragamuwa,1824,757,2581,72960,30280,103240
11/23/2024,Charitha Jayaweera,Kegalle,Mawanella,Sabaragamuwa,654,401,1055,26160,16040,42200
11/24/2024,Charitha Jayaweera,Kegalle,Mawanella,Sabaragamuwa,1727,482,2209,69080,19280,88360
11/25/2024,Charitha Jayaweera,Kegalle,Mawanella,Sabaragamuwa,521,7960,8481,20840,318400,339240
11/26/2024,Charitha Jayaweera,Kegalle,Mawanella,Sabaragamuwa,7583,6102,13685,303320,244080,547400
11/27/2024,Charitha Jayaweera,Kegalle,Mawanella,Sabaragamuwa,118,6655,6773,4720,266200,270920
11/28/2024,Charitha Jayaweera,Kegalle,Mawanella,Sabaragamuwa,5962,5658,11620,238480,226320,464800
11/29/2024,Charitha Jayaweera,Kegalle,Mawanella,Sabaragamuwa,1606,2766,4372,64240,110640,174880
11/30/2024,Charitha Jayaweera,Kegalle,Mawanella,Sabaragamuwa,1929,6563,8492,77160,262520,339680
12/1/2024,Charitha Jayaweera,Kegalle,Mawanella,Sabaragamuwa,3229,2991,6220,129160,119640,248800
12/2/2024,Charitha Jayaweera,Kegalle,Mawanella,Sabaragamuwa,4871,2928,7799,194840,117120,311960
12/3/2024,Charitha Jayaweera,Kegalle,Mawanella,Sabaragamuwa,1443,9018,10461,57720,360720,418440
12/4/2024,Charitha Jayaweera,Kegalle,Mawanella,Sabaragamuwa,5268,4260,9528,210720,170400,381120
12/5/2024,Charitha Jayaweera,Kegalle,Mawanella,Sabaragamuwa,8364,4000,12364,334560,160000,494560
12/6/2024,Charitha Jayaweera,Kegalle,Mawanella,Sabaragamuwa,5755,5566,11321,230200,222640,452840
12/7/2024,Charitha Jayaweera,Kegalle,Mawanella,Sabaragamuwa,8418,963,9381,336720,38520,375240
12/8/2024,Charitha Jayaweera,Kegalle,Mawanella,Sabaragamuwa,4433,57,4490,177320,2280,179600
12/9/2024,Charitha Jayaweera,Kegalle,Mawanella,Sabaragamuwa,7543,5804,13347,301720,232160,533880
12/10/2024,Charitha Jayaweera,Kegalle,Mawanella,Sabaragamuwa,1138,2480,3618,45520,99200,144720
12/11/2024,Charitha Jayaweera,Kegalle,Mawanella,Sabaragamuwa,7113,7115,14228,284520,284600,569120
12/12/2024,Charitha Jayaweera,Kegalle,Mawanella,Sabaragamuwa,897,6891,7788,35880,275640,311520
12/13/2024,Charitha Jayaweera,Kegalle,Mawanella,Sabaragamuwa,6031,6873,12904,241240,274920,516160
12/14/2024,Charitha Jayaweera,Kegalle,Mawanella,Sabaragamuwa,8876,4483,13359,355040,179320,534360
12/15/2024,Charitha Jayaweera,Kegalle,Mawanella,Sabaragamuwa,2920,5283,8203,116800,211320,328120
12/16/2024,Charitha Jayaweera,Kegalle,Mawanella,Sabaragamuwa,9169,8909,18078,366760,356360,723120
12/17/2024,Charitha Jayaweera,Kegalle,Mawanella,Sabaragamuwa,7148,3400,10548,285920,136000,421920
12/18/2024,Charitha Jayaweera,Kegalle,Mawanella,Sabaragamuwa,4809,6413,11222,192360,256520,448880
12/19/2024,Charitha Jayaweera,Kegalle,Mawanella,Sabaragamuwa,2203,5018,7221,88120,200720,288840
12/20/2024,Charitha Jayaweera,Kegalle,Mawanella,Sabaragamuwa,166,8719,8885,6640,348760,355400
12/21/2024,Charitha Jayaweera,Kegalle,Mawanella,Sabaragamuwa,1231,6831,8062,49240,273240,322480
12/22/2024,Charitha Jayaweera,Kegalle,Mawanella,Sabaragamuwa,4870,8385,13255,194800,335400,530200
12/23/2024,Charitha Jayaweera,Kegalle,Mawanella,Sabaragamuwa,3512,1384,4896,140480,55360,195840
12/24/2024,Charitha Jayaweera,Kegalle,Mawanella,Sabaragamuwa,9062,29,9091,362480,1160,363640
12/25/2024,Charitha Jayaweera,Kegalle,Mawanella,Sabaragamuwa,9,8816,8825,360,352640,353000
12/26/2024,Charitha Jayaweera,Kegalle,Mawanella,Sabaragamuwa,2773,583,3356,110920,23320,134240
12/27/2024,Charitha Jayaweera,Kegalle,Mawanella,Sabaragamuwa,4932,9036,13968,197280,361440,558720
12/28/2024,Charitha Jayaweera,Kegalle,Mawanella,Sabaragamuwa,3096,5668,8764,123840,226720,350560
12/29/2024,Charitha Jayaweera,Kegalle,Mawanella,Sabaragamuwa,2947,8351,11298,117880,334040,451920
12/30/2024,Charitha Jayaweera,Kegalle,Mawanella,Sabaragamuwa,124,8064,8188,4960,322560,327520
12/31/2024,Charitha Jayaweera,Kegalle,Mawanella,Sabaragamuwa,3615,1644,5259,144600,65760,210360
1/1/2025,Charitha Jayaweera,Kegalle,Mawanella,Sabaragamuwa,6352,9795,16147,254080,391800,645880
1/2/2025,Charitha Jayaweera,Kegalle,Mawanella,Sabaragamuwa,8175,6380,14555,327000,255200,582200
1/3/2025,Charitha Jayaweera,Kegalle,Mawanella,Sabaragamuwa,7354,9210,16564,294160,368400,662560
1/4/2025,Charitha Jayaweera,Kegalle,Mawanella,Sabaragamuwa,1265,9631,10896,50600,385240,435840
1/5/2025,Charitha Jayaweera,Kegalle,Mawanella,Sabaragamuwa,9174,9104,18278,366960,364160,731120
1/6/2025,Charitha Jayaweera,Kegalle,Mawanella,Sabaragamuwa,3691,1527,5218,147640,61080,208720
1/7/2025,Charitha Jayaweera,Kegalle,Mawanella,Sabaragamuwa,6448,5207,11655,257920,208280,466200
1/8/2025,Charitha Jayaweera,Kegalle,Mawanella,Sabaragamuwa,3474,9390,12864,138960,375600,514560
1/9/2025,Charitha Jayaweera,Kegalle,Mawanella,Sabaragamuwa,4473,2064,6537,178920,82560,261480
1/10/2025,Charitha Jayaweera,Kegalle,Mawanella,Sabaragamuwa,742,6910,7652,29680,276400,306080
1/11/2025,Charitha Jayaweera,Kegalle,Mawanella,Sabaragamuwa,3941,2267,6208,157640,90680,248320
1/12/2025,Charitha Jayaweera,Kegalle,Mawanella,Sabaragamuwa,2616,7988,10604,104640,319520,424160
1/13/2025,Charitha Jayaweera,Kegalle,Mawanella,Sabaragamuwa,2601,5216,7817,104040,208640,312680
1/14/2025,Charitha Jayaweera,Kegalle,Mawanella,Sabaragamuwa,413,308,721,16520,12320,28840
1/15/2025,Charitha Jayaweera,Kegalle,Mawanella,Sabaragamuwa,8109,2764,10873,324360,110560,434920
1/16/2025,Charitha Jayaweera,Kegalle,Mawanella,Sabaragamuwa,7980,4700,12680,319200,188000,507200
1/17/2025,Charitha Jayaweera,Kegalle,Mawanella,Sabaragamuwa,8965,9709,18674,358600,388360,746960
1/18/2025,Charitha Jayaweera,Kegalle,Mawanella,Sabaragamuwa,8384,4877,13261,335360,195080,530440
1/19/2025,Charitha Jayaweera,Kegalle,Mawanella,Sabaragamuwa,7964,8365,16329,318560,334600,653160
1/20/2025,Charitha Jayaweera,Kegalle,Mawanella,Sabaragamuwa,2728,8306,11034,109120,332240,441360
1/21/2025,Charitha Jayaweera,Kegalle,Mawanella,Sabaragamuwa,2797,4778,7575,111880,191120,303000
1/22/2025,Charitha Jayaweera,Kegalle,Mawanella,Sabaragamuwa,8376,4986,13362,335040,199440,534480
1/23/2025,Charitha Jayaweera,Kegalle,Mawanella,Sabaragamuwa,9720,487,10207,388800,19480,408280
1/24/2025,Charitha Jayaweera,Kegalle,Mawanella,Sabaragamuwa,9801,1840,11641,392040,73600,465640
1/25/2025,Charitha Jayaweera,Kegalle,Mawanella,Sabaragamuwa,2231,1873,4104,89240,74920,164160
1/26/2025,Charitha Jayaweera,Kegalle,Mawanella,Sabaragamuwa,6069,6321,12390,242760,252840,495600
1/27/2025,Charitha Jayaweera,Kegalle,Mawanella,Sabaragamuwa,7660,7956,15616,306400,318240,624640
1/28/2025,Charitha Jayaweera,Kegalle,Mawanella,Sabaragamuwa,9669,8084,17753,386760,323360,710120
1/29/2025,Charitha Jayaweera,Kegalle,Mawanella,Sabaragamuwa,1929,3944,5873,77160,157760,234920
1/30/2025,Charitha Jayaweera,Kegalle,Mawanella,Sabaragamuwa,2804,8820,11624,112160,352800,464960
1/31/2025,Charitha Jayaweera,Kegalle,Mawanella,Sabaragamuwa,3364,813,4177,134560,32520,167080
2/1/2025,Charitha Jayaweera,Kegalle,Mawanella,Sabaragamuwa,5348,1206,6554,213920,48240,262160
2/2/2025,Charitha Jayaweera,Kegalle,Mawanella,Sabaragamuwa,9438,8329,17767,377520,333160,710680
2/3/2025,Charitha Jayaweera,Kegalle,Mawanella,Sabaragamuwa,1498,2164,3662,59920,86560,146480
2/4/2025,Charitha Jayaweera,Kegalle,Mawanella,Sabaragamuwa,603,1662,2265,24120,66480,90600
2/5/2025,Charitha Jayaweera,Kegalle,Mawanella,Sabaragamuwa,7983,2818,10801,319320,112720,432040
2/6/2025,Charitha Jayaweera,Kegalle,Mawanella,Sabaragamuwa,7346,4167,11513,293840,166680,460520
2/7/2025,Charitha Jayaweera,Kegalle,Mawanella,Sabaragamuwa,7109,5039,12148,284360,201560,485920
2/8/2025,Charitha Jayaweera,Kegalle,Mawanella,Sabaragamuwa,708,1863,2571,28320,74520,102840
2/9/2025,Charitha Jayaweera,Kegalle,Mawanella,Sabaragamuwa,5032,6731,11763,201280,269240,470520
2/10/2025,Charitha Jayaweera,Kegalle,Mawanella,Sabaragamuwa,4438,2565,7003,177520,102600,280120
2/11/2025,Charitha Jayaweera,Kegalle,Mawanella,Sabaragamuwa,4735,8664,13399,189400,346560,535960
2/12/2025,Charitha Jayaweera,Kegalle,Mawanella,Sabaragamuwa,2462,880,3342,98480,35200,133680
2/13/2025,Charitha Jayaweera,Kegalle,Mawanella,Sabaragamuwa,5427,1171,6598,217080,46840,263920
2/14/2025,Charitha Jayaweera,Kegalle,Mawanella,Sabaragamuwa,6451,2069,8520,258040,82760,340800
2/15/2025,Charitha Jayaweera,Kegalle,Mawanella,Sabaragamuwa,154,2194,2348,6160,87760,93920
2/16/2025,Charitha Jayaweera,Kegalle,Mawanella,Sabaragamuwa,9380,1985,11365,375200,79400,454600
2/17/2025,Charitha Jayaweera,Kegalle,Mawanella,Sabaragamuwa,8269,4668,12937,330760,186720,517480
2/18/2025,Charitha Jayaweera,Kegalle,Mawanella,Sabaragamuwa,5466,2408,7874,218640,96320,314960
2/19/2025,Charitha Jayaweera,Kegalle,Mawanella,Sabaragamuwa,621,3516,4137,24840,140640,165480
2/20/2025,Charitha Jayaweera,Kegalle,Mawanella,Sabaragamuwa,7276,4884,12160,291040,195360,486400
2/21/2025,Charitha Jayaweera,Kegalle,Mawanella,Sabaragamuwa,6033,530,6563,241320,21200,262520
2/22/2025,Charitha Jayaweera,Kegalle,Mawanella,Sabaragamuwa,8839,5899,14738,353560,235960,589520
2/23/2025,Charitha Jayaweera,Kegalle,Mawanella,Sabaragamuwa,8060,7059,15119,322400,282360,604760
2/24/2025,Charitha Jayaweera,Kegalle,Mawanella,Sabaragamuwa,338,8470,8808,13520,338800,352320
2/25/2025,Charitha Jayaweera,Kegalle,Mawanella,Sabaragamuwa,5359,452,5811,214360,18080,232440
2/26/2025,Charitha Jayaweera,Kegalle,Mawanella,Sabaragamuwa,2828,5159,7987,113120,206360,319480
2/27/2025,Charitha Jayaweera,Kegalle,Mawanella,Sabaragamuwa,4201,6374,10575,168040,254960,423000
2/28/2025,Charitha Jayaweera,Kegalle,Mawanella,Sabaragamuwa,1256,4171,5427,50240,166840,217080
3/1/2025,Charitha Jayaweera,Kegalle,Mawanella,Sabaragamuwa,243,5080,5323,9720,203200,212920
3/2/2025,Charitha Jayaweera,Kegalle,Mawanella,Sabaragamuwa,3733,3121,6854,149320,124840,274160
3/3/2025,Charitha Jayaweera,Kegalle,Mawanella,Sabaragamuwa,8392,8084,16476,335680,323360,659040
3/4/2025,Charitha Jayaweera,Kegalle,Mawanella,Sabaragamuwa,9168,9922,19090,366720,396880,763600
3/5/2025,Charitha Jayaweera,Kegalle,Mawanella,Sabaragamuwa,2241,4885,7126,89640,195400,285040
3/6/2025,Charitha Jayaweera,Kegalle,Mawanella,Sabaragamuwa,7962,5276,13238,318480,211040,529520
3/7/2025,Charitha Jayaweera,Kegalle,Mawanella,Sabaragamuwa,8424,3138,11562,336960,125520,462480
3/8/2025,Charitha Jayaweera,Kegalle,Mawanella,Sabaragamuwa,8324,2996,11320,332960,119840,452800
3/9/2025,Charitha Jayaweera,Kegalle,Mawanella,Sabaragamuwa,7894,74,7968,315760,2960,318720
3/10/2025,Charitha Jayaweera,Kegalle,Mawanella,Sabaragamuwa,7751,5081,12832,310040,203240,513280
3/11/2025,Charitha Jayaweera,Kegalle,Mawanella,Sabaragamuwa,8487,5821,14308,339480,232840,572320
3/12/2025,Charitha Jayaweera,Kegalle,Mawanella,Sabaragamuwa,1301,1004,2305,52040,40160,92200
3/13/2025,Charitha Jayaweera,Kegalle,Mawanella,Sabaragamuwa,4093,9500,13593,163720,380000,543720
3/14/2025,Charitha Jayaweera,Kegalle,Mawanella,Sabaragamuwa,963,8229,9192,38520,329160,367680
3/15/2025,Charitha Jayaweera,Kegalle,Mawanella,Sabaragamuwa,2056,5199,7255,82240,207960,290200
3/16/2025,Charitha Jayaweera,Kegalle,Mawanella,Sabaragamuwa,7432,5556,12988,297280,222240,519520
3/17/2025,Charitha Jayaweera,Kegalle,Mawanella,Sabaragamuwa,4144,7857,12001,165760,314280,480040
3/18/2025,Charitha Jayaweera,Kegalle,Mawanella,Sabaragamuwa,2447,2846,5293,97880,113840,211720
3/19/2025,Charitha Jayaweera,Kegalle,Mawanella,Sabaragamuwa,1486,4122,5608,59440,164880,224320
3/20/2025,Charitha Jayaweera,Kegalle,Mawanella,Sabaragamuwa,7255,8658,15913,290200,346320,636520
3/21/2025,Charitha Jayaweera,Kegalle,Mawanella,Sabaragamuwa,3899,5651,9550,155960,226040,382000
3/22/2025,Charitha Jayaweera,Kegalle,Mawanella,Sabaragamuwa,3974,7241,11215,158960,289640,448600
3/23/2025,Charitha Jayaweera,Kegalle,Mawanella,Sabaragamuwa,1289,9872,11161,51560,394880,446440
3/25/2024,Senaka Abeysinghe,Kegalle,Mawanella,Sabaragamuwa,5950,3638,9588,238000,145520,383520
3/26/2024,Senaka Abeysinghe,Kegalle,Mawanella,Sabaragamuwa,70,4507,4577,2800,180280,183080
3/27/2024,Senaka Abeysinghe,Kegalle,Mawanella,Sabaragamuwa,8684,6827,15511,347360,273080,620440
3/28/2024,Senaka Abeysinghe,Kegalle,Mawanella,Sabaragamuwa,7002,8023,15025,280080,320920,601000
3/29/2024,Senaka Abeysinghe,Kegalle,Mawanella,Sabaragamuwa,7452,211,7663,298080,8440,306520
3/30/2024,Senaka Abeysinghe,Kegalle,Mawanella,Sabaragamuwa,1378,4515,5893,55120,180600,235720
3/31/2024,Senaka Abeysinghe,Kegalle,Mawanella,Sabaragamuwa,2580,4530,7110,103200,181200,284400
4/1/2024,Senaka Abeysinghe,Kegalle,Mawanella,Sabaragamuwa,263,1271,1534,10520,50840,61360
4/2/2024,Senaka Abeysinghe,Kegalle,Mawanella,Sabaragamuwa,3541,155,3696,141640,6200,147840
4/3/2024,Senaka Abeysinghe,Kegalle,Mawanella,Sabaragamuwa,9362,5660,15022,374480,226400,600880
4/4/2024,Senaka Abeysinghe,Kegalle,Mawanella,Sabaragamuwa,9955,7193,17148,398200,287720,685920
4/5/2024,Senaka Abeysinghe,Kegalle,Mawanella,Sabaragamuwa,4222,7923,12145,168880,316920,485800
4/6/2024,Senaka Abeysinghe,Kegalle,Mawanella,Sabaragamuwa,3642,8980,12622,145680,359200,504880
4/7/2024,Senaka Abeysinghe,Kegalle,Mawanella,Sabaragamuwa,619,110,729,24760,4400,29160
4/8/2024,Senaka Abeysinghe,Kegalle,Mawanella,Sabaragamuwa,6936,962,7898,277440,38480,315920
4/9/2024,Senaka Abeysinghe,Kegalle,Mawanella,Sabaragamuwa,5223,4518,9741,208920,180720,389640
4/10/2024,Senaka Abeysinghe,Kegalle,Mawanella,Sabaragamuwa,8819,8662,17481,352760,346480,699240
4/11/2024,Senaka Abeysinghe,Kegalle,Mawanella,Sabaragamuwa,9395,4769,14164,375800,190760,566560
4/19/2024,Senaka Abeysinghe,Kegalle,Mawanella,Sabaragamuwa,1668,5585,7253,66720,223400,290120
4/20/2024,Senaka Abeysinghe,Kegalle,Mawanella,Sabaragamuwa,454,5625,6079,18160,225000,243160
4/21/2024,Senaka Abeysinghe,Kegalle,Mawanella,Sabaragamuwa,6352,8705,15057,254080,348200,602280
4/22/2024,Senaka Abeysinghe,Kegalle,Mawanella,Sabaragamuwa,2711,9564,12275,108440,382560,491000
4/23/2024,Senaka Abeysinghe,Kegalle,Mawanella,Sabaragamuwa,2343,9091,11434,93720,363640,457360
4/24/2024,Senaka Abeysinghe,Kegalle,Mawanella,Sabaragamuwa,5253,3454,8707,210120,138160,348280
4/25/2024,Senaka Abeysinghe,Kegalle,Mawanella,Sabaragamuwa,6237,5776,12013,249480,231040,480520
4/26/2024,Senaka Abeysinghe,Kegalle,Mawanella,Sabaragamuwa,1991,7408,9399,79640,296320,375960
4/27/2024,Senaka Abeysinghe,Kegalle,Mawanella,Sabaragamuwa,1205,8150,9355,48200,326000,374200
4/28/2024,Senaka Abeysinghe,Kegalle,Mawanella,Sabaragamuwa,9160,5769,14929,366400,230760,597160
4/29/2024,Senaka Abeysinghe,Kegalle,Mawanella,Sabaragamuwa,2741,8967,11708,109640,358680,468320
4/30/2024,Senaka Abeysinghe,Kegalle,Mawanella,Sabaragamuwa,3862,3750,7612,154480,150000,304480
5/1/2024,Senaka Abeysinghe,Kegalle,Mawanella,Sabaragamuwa,9387,676,10063,375480,27040,402520
5/2/2024,Senaka Abeysinghe,Kegalle,Mawanella,Sabaragamuwa,242,7953,8195,9680,318120,327800
5/3/2024,Senaka Abeysinghe,Kegalle,Mawanella,Sabaragamuwa,1364,4125,5489,54560,165000,219560
5/4/2024,Senaka Abeysinghe,Kegalle,Mawanella,Sabaragamuwa,1042,4663,5705,41680,186520,228200
5/5/2024,Senaka Abeysinghe,Kegalle,Mawanella,Sabaragamuwa,3911,3360,7271,156440,134400,290840
5/6/2024,Senaka Abeysinghe,Kegalle,Mawanella,Sabaragamuwa,5527,9618,15145,221080,384720,605800
5/7/2024,Senaka Abeysinghe,Kegalle,Mawanella,Sabaragamuwa,212,7383,7595,8480,295320,303800
5/8/2024,Senaka Abeysinghe,Kegalle,Mawanella,Sabaragamuwa,8145,2071,10216,325800,82840,408640
5/9/2024,Senaka Abeysinghe,Kegalle,Mawanella,Sabaragamuwa,9925,3099,13024,397000,123960,520960
5/10/2024,Senaka Abeysinghe,Kegalle,Mawanella,Sabaragamuwa,7220,8978,16198,288800,359120,647920
5/11/2024,Senaka Abeysinghe,Kegalle,Mawanella,Sabaragamuwa,2968,3462,6430,118720,138480,257200
5/12/2024,Senaka Abeysinghe,Kegalle,Mawanella,Sabaragamuwa,3952,227,4179,158080,9080,167160
5/13/2024,Senaka Abeysinghe,Kegalle,Mawanella,Sabaragamuwa,1621,71,1692,64840,2840,67680
5/14/2024,Senaka Abeysinghe,Kegalle,Mawanella,Sabaragamuwa,7605,6421,14026,304200,256840,561040
5/15/2024,Senaka Abeysinghe,Kegalle,Mawanella,Sabaragamuwa,5150,4850,10000,206000,194000,400000
5/16/2024,Senaka Abeysinghe,Kegalle,Mawanella,Sabaragamuwa,1913,628,2541,76520,25120,101640
5/17/2024,Senaka Abeysinghe,Kegalle,Mawanella,Sabaragamuwa,4945,2267,7212,197800,90680,288480
5/18/2024,Senaka Abeysinghe,Kegalle,Mawanella,Sabaragamuwa,3656,5488,9144,146240,219520,365760
5/19/2024,Senaka Abeysinghe,Kegalle,Mawanella,Sabaragamuwa,7788,4042,11830,311520,161680,473200
5/20/2024,Senaka Abeysinghe,Kegalle,Mawanella,Sabaragamuwa,5390,7910,13300,215600,316400,532000
5/21/2024,Senaka Abeysinghe,Kegalle,Mawanella,Sabaragamuwa,2450,3343,5793,98000,133720,231720
5/22/2024,Senaka Abeysinghe,Kegalle,Mawanella,Sabaragamuwa,1091,4228,5319,43640,169120,212760
5/24/2024,Senaka Abeysinghe,Kegalle,Mawanella,Sabaragamuwa,1893,313,2206,75720,12520,88240
5/25/2024,Senaka Abeysinghe,Kegalle,Mawanella,Sabaragamuwa,6503,9962,16465,260120,398480,658600
5/26/2024,Senaka Abeysinghe,Kegalle,Mawanella,Sabaragamuwa,727,3768,4495,29080,150720,179800
5/27/2024,Senaka Abeysinghe,Kegalle,Mawanella,Sabaragamuwa,4856,4589,9445,194240,183560,377800
5/28/2024,Senaka Abeysinghe,Kegalle,Mawanella,Sabaragamuwa,5555,3799,9354,222200,151960,374160
5/29/2024,Senaka Abeysinghe,Kegalle,Mawanella,Sabaragamuwa,8326,3264,11590,333040,130560,463600
5/30/2024,Senaka Abeysinghe,Kegalle,Mawanella,Sabaragamuwa,6374,1128,7502,254960,45120,300080
5/31/2024,Senaka Abeysinghe,Kegalle,Mawanella,Sabaragamuwa,3569,9884,13453,142760,395360,538120
6/1/2024,Senaka Abeysinghe,Kegalle,Mawanella,Sabaragamuwa,2654,5809,8463,106160,232360,338520
6/2/2024,Senaka Abeysinghe,Kegalle,Mawanella,Sabaragamuwa,2832,1378,4210,113280,55120,168400
6/3/2024,Senaka Abeysinghe,Kegalle,Mawanella,Sabaragamuwa,9704,6619,16323,388160,264760,652920
6/4/2024,Senaka Abeysinghe,Kegalle,Mawanella,Sabaragamuwa,6731,677,7408,269240,27080,296320
6/5/2024,Senaka Abeysinghe,Kegalle,Mawanella,Sabaragamuwa,7383,8727,16110,295320,349080,644400
6/6/2024,Senaka Abeysinghe,Kegalle,Mawanella,Sabaragamuwa,1341,8575,9916,53640,343000,396640
6/7/2024,Senaka Abeysinghe,Kegalle,Mawanella,Sabaragamuwa,5407,2835,8242,216280,113400,329680
6/8/2024,Senaka Abeysinghe,Kegalle,Mawanella,Sabaragamuwa,256,4181,4437,10240,167240,177480
6/9/2024,Senaka Abeysinghe,Kegalle,Mawanella,Sabaragamuwa,2836,9397,12233,113440,375880,489320
6/10/2024,Senaka Abeysinghe,Kegalle,Mawanella,Sabaragamuwa,3923,823,4746,156920,32920,189840
6/11/2024,Senaka Abeysinghe,Kegalle,Mawanella,Sabaragamuwa,1258,2006,3264,50320,80240,130560
6/12/2024,Senaka Abeysinghe,Kegalle,Mawanella,Sabaragamuwa,4774,1224,5998,190960,48960,239920
6/13/2024,Senaka Abeysinghe,Kegalle,Mawanella,Sabaragamuwa,5526,1566,7092,221040,62640,283680
6/14/2024,Senaka Abeysinghe,Kegalle,Mawanella,Sabaragamuwa,8642,1697,10339,345680,67880,413560
6/15/2024,Senaka Abeysinghe,Kegalle,Mawanella,Sabaragamuwa,5145,3114,8259,205800,124560,330360
6/16/2024,Senaka Abeysinghe,Kegalle,Mawanella,Sabaragamuwa,4324,8853,13177,172960,354120,527080
6/17/2024,Senaka Abeysinghe,Kegalle,Mawanella,Sabaragamuwa,9913,9961,19874,396520,398440,794960
6/18/2024,Senaka Abeysinghe,Kegalle,Mawanella,Sabaragamuwa,3841,6800,10641,153640,272000,425640
6/19/2024,Senaka Abeysinghe,Kegalle,Mawanella,Sabaragamuwa,2293,3663,5956,91720,146520,238240
6/20/2024,Senaka Abeysinghe,Kegalle,Mawanella,Sabaragamuwa,7479,4954,12433,299160,198160,497320
6/21/2024,Senaka Abeysinghe,Kegalle,Mawanella,Sabaragamuwa,8498,2844,11342,339920,113760,453680
6/22/2024,Senaka Abeysinghe,Kegalle,Mawanella,Sabaragamuwa,2435,2681,5116,97400,107240,204640
6/23/2024,Senaka Abeysinghe,Kegalle,Mawanella,Sabaragamuwa,6907,595,7502,276280,23800,300080
6/24/2024,Senaka Abeysinghe,Kegalle,Mawanella,Sabaragamuwa,6742,5783,12525,269680,231320,501000
6/25/2024,Senaka Abeysinghe,Kegalle,Mawanella,Sabaragamuwa,1558,3279,4837,62320,131160,193480
6/26/2024,Senaka Abeysinghe,Kegalle,Mawanella,Sabaragamuwa,2579,1693,4272,103160,67720,170880
6/27/2024,Senaka Abeysinghe,Kegalle,Mawanella,Sabaragamuwa,5383,7892,13275,215320,315680,531000
6/28/2024,Senaka Abeysinghe,Kegalle,Mawanella,Sabaragamuwa,9132,8424,17556,365280,336960,702240
6/29/2024,Senaka Abeysinghe,Kegalle,Mawanella,Sabaragamuwa,7134,4387,11521,285360,175480,460840
6/30/2024,Senaka Abeysinghe,Kegalle,Mawanella,Sabaragamuwa,4057,226,4283,162280,9040,171320
7/1/2024,Senaka Abeysinghe,Kegalle,Mawanella,Sabaragamuwa,4761,7807,12568,190440,312280,502720
7/2/2024,Senaka Abeysinghe,Kegalle,Mawanella,Sabaragamuwa,7963,2660,10623,318520,106400,424920
7/3/2024,Senaka Abeysinghe,Kegalle,Mawanella,Sabaragamuwa,9587,5383,14970,383480,215320,598800
7/4/2024,Senaka Abeysinghe,Kegalle,Mawanella,Sabaragamuwa,1448,1652,3100,57920,66080,124000
7/5/2024,Senaka Abeysinghe,Kegalle,Mawanella,Sabaragamuwa,4214,7597,11811,168560,303880,472440
7/6/2024,Senaka Abeysinghe,Kegalle,Mawanella,Sabaragamuwa,1829,9754,11583,73160,390160,463320
7/7/2024,Senaka Abeysinghe,Kegalle,Mawanella,Sabaragamuwa,7052,9301,16353,282080,372040,654120
7/8/2024,Senaka Abeysinghe,Kegalle,Mawanella,Sabaragamuwa,9999,3357,13356,399960,134280,534240
7/9/2024,Senaka Abeysinghe,Kegalle,Mawanella,Sabaragamuwa,7622,5090,12712,304880,203600,508480
7/10/2024,Senaka Abeysinghe,Kegalle,Mawanella,Sabaragamuwa,8492,9615,18107,339680,384600,724280
7/11/2024,Senaka Abeysinghe,Kegalle,Mawanella,Sabaragamuwa,3056,8638,11694,122240,345520,467760
7/12/2024,Senaka Abeysinghe,Kegalle,Mawanella,Sabaragamuwa,358,7591,7949,14320,303640,317960
7/13/2024,Senaka Abeysinghe,Kegalle,Mawanella,Sabaragamuwa,135,6303,6438,5400,252120,257520
7/14/2024,Senaka Abeysinghe,Kegalle,Mawanella,Sabaragamuwa,500,8971,9471,20000,358840,378840
7/15/2024,Senaka Abeysinghe,Kegalle,Mawanella,Sabaragamuwa,4804,1856,6660,192160,74240,266400
7/16/2024,Senaka Abeysinghe,Kegalle,Mawanella,Sabaragamuwa,9075,7776,16851,363000,311040,674040
7/17/2024,Senaka Abeysinghe,Kegalle,Mawanella,Sabaragamuwa,7951,3047,10998,318040,121880,439920
7/18/2024,Senaka Abeysinghe,Kegalle,Mawanella,Sabaragamuwa,5464,2125,7589,218560,85000,303560
7/19/2024,Senaka Abeysinghe,Kegalle,Mawanella,Sabaragamuwa,4901,9668,14569,196040,386720,582760
7/20/2024,Senaka Abeysinghe,Kegalle,Mawanella,Sabaragamuwa,4318,1557,5875,172720,62280,235000
7/21/2024,Senaka Abeysinghe,Kegalle,Mawanella,Sabaragamuwa,9865,6380,16245,394600,255200,649800
7/22/2024,Senaka Abeysinghe,Kegalle,Mawanella,Sabaragamuwa,801,3370,4171,32040,134800,166840
7/23/2024,Senaka Abeysinghe,Kegalle,Mawanella,Sabaragamuwa,7136,4424,11560,285440,176960,462400
7/24/2024,Senaka Abeysinghe,Kegalle,Mawanella,Sabaragamuwa,8076,9170,17246,323040,366800,689840
7/25/2024,Senaka Abeysinghe,Kegalle,Mawanella,Sabaragamuwa,2383,5289,7672,95320,211560,306880
7/26/2024,Senaka Abeysinghe,Kegalle,Mawanella,Sabaragamuwa,8678,8339,17017,347120,333560,680680
7/27/2024,Senaka Abeysinghe,Kegalle,Mawanella,Sabaragamuwa,4891,7706,12597,195640,308240,503880
7/28/2024,Senaka Abeysinghe,Kegalle,Mawanella,Sabaragamuwa,7373,6074,13447,294920,242960,537880
7/29/2024,Senaka Abeysinghe,Kegalle,Mawanella,Sabaragamuwa,2031,1747,3778,81240,69880,151120
7/30/2024,Senaka Abeysinghe,Kegalle,Mawanella,Sabaragamuwa,6762,3951,10713,270480,158040,428520
7/31/2024,Senaka Abeysinghe,Kegalle,Mawanella,Sabaragamuwa,6569,6363,12932,262760,254520,517280
8/1/2024,Senaka Abeysinghe,Kegalle,Mawanella,Sabaragamuwa,6881,1072,7953,275240,42880,318120
8/2/2024,Senaka Abeysinghe,Kegalle,Mawanella,Sabaragamuwa,1061,76,1137,42440,3040,45480
8/3/2024,Senaka Abeysinghe,Kegalle,Mawanella,Sabaragamuwa,4082,5757,9839,163280,230280,393560
8/4/2024,Senaka Abeysinghe,Kegalle,Mawanella,Sabaragamuwa,2161,8170,10331,86440,326800,413240
8/5/2024,Senaka Abeysinghe,Kegalle,Mawanella,Sabaragamuwa,4951,4749,9700,198040,189960,388000
8/6/2024,Senaka Abeysinghe,Kegalle,Mawanella,Sabaragamuwa,2630,9868,12498,105200,394720,499920
8/7/2024,Senaka Abeysinghe,Kegalle,Mawanella,Sabaragamuwa,4905,8030,12935,196200,321200,517400
8/8/2024,Senaka Abeysinghe,Kegalle,Mawanella,Sabaragamuwa,870,3695,4565,34800,147800,182600
8/9/2024,Senaka Abeysinghe,Kegalle,Mawanella,Sabaragamuwa,6860,435,7295,274400,17400,291800
8/10/2024,Senaka Abeysinghe,Kegalle,Mawanella,Sabaragamuwa,8623,8130,16753,344920,325200,670120
8/11/2024,Senaka Abeysinghe,Kegalle,Mawanella,Sabaragamuwa,5724,1655,7379,228960,66200,295160
8/12/2024,Senaka Abeysinghe,Kegalle,Mawanella,Sabaragamuwa,1547,7021,8568,61880,280840,342720
8/13/2024,Senaka Abeysinghe,Kegalle,Mawanella,Sabaragamuwa,5440,7940,13380,217600,317600,535200
8/14/2024,Senaka Abeysinghe,Kegalle,Mawanella,Sabaragamuwa,6861,5754,12615,274440,230160,504600
8/15/2024,Senaka Abeysinghe,Kegalle,Mawanella,Sabaragamuwa,7737,2556,10293,309480,102240,411720
8/16/2024,Senaka Abeysinghe,Kegalle,Mawanella,Sabaragamuwa,5373,6103,11476,214920,244120,459040
8/17/2024,Senaka Abeysinghe,Kegalle,Mawanella,Sabaragamuwa,522,5780,6302,20880,231200,252080
8/18/2024,Senaka Abeysinghe,Kegalle,Mawanella,Sabaragamuwa,4555,4708,9263,182200,188320,370520
8/19/2024,Senaka Abeysinghe,Kegalle,Mawanella,Sabaragamuwa,1782,8177,9959,71280,327080,398360
8/20/2024,Senaka Abeysinghe,Kegalle,Mawanella,Sabaragamuwa,6815,5581,12396,272600,223240,495840
8/21/2024,Senaka Abeysinghe,Kegalle,Mawanella,Sabaragamuwa,5230,5224,10454,209200,208960,418160
8/22/2024,Senaka Abeysinghe,Kegalle,Mawanella,Sabaragamuwa,5752,2429,8181,230080,97160,327240
8/23/2024,Senaka Abeysinghe,Kegalle,Mawanella,Sabaragamuwa,3077,1568,4645,123080,62720,185800
8/24/2024,Senaka Abeysinghe,Kegalle,Mawanella,Sabaragamuwa,3232,1086,4318,129280,43440,172720
8/25/2024,Senaka Abeysinghe,Kegalle,Mawanella,Sabaragamuwa,2903,917,3820,116120,36680,152800
8/26/2024,Senaka Abeysinghe,Kegalle,Mawanella,Sabaragamuwa,1284,1212,2496,51360,48480,99840
8/27/2024,Senaka Abeysinghe,Kegalle,Mawanella,Sabaragamuwa,7767,6767,14534,310680,270680,581360
8/28/2024,Senaka Abeysinghe,Kegalle,Mawanella,Sabaragamuwa,7095,5918,13013,283800,236720,520520
8/29/2024,Senaka Abeysinghe,Kegalle,Mawanella,Sabaragamuwa,2276,512,2788,91040,20480,111520
8/30/2024,Senaka Abeysinghe,Kegalle,Mawanella,Sabaragamuwa,5884,5897,11781,235360,235880,471240
8/31/2024,Senaka Abeysinghe,Kegalle,Mawanella,Sabaragamuwa,4567,3819,8386,182680,152760,335440
9/1/2024,Senaka Abeysinghe,Kegalle,Mawanella,Sabaragamuwa,1281,5034,6315,51240,201360,252600
9/2/2024,Senaka Abeysinghe,Kegalle,Mawanella,Sabaragamuwa,7831,8716,16547,313240,348640,661880
9/3/2024,Senaka Abeysinghe,Kegalle,Mawanella,Sabaragamuwa,2090,8413,10503,83600,336520,420120
9/4/2024,Senaka Abeysinghe,Kegalle,Mawanella,Sabaragamuwa,279,2507,2786,11160,100280,111440
9/5/2024,Senaka Abeysinghe,Kegalle,Mawanella,Sabaragamuwa,5254,562,5816,210160,22480,232640
9/6/2024,Senaka Abeysinghe,Kegalle,Mawanella,Sabaragamuwa,4756,3761,8517,190240,150440,340680
9/7/2024,Senaka Abeysinghe,Kegalle,Mawanella,Sabaragamuwa,2284,3445,5729,91360,137800,229160
9/8/2024,Senaka Abeysinghe,Kegalle,Mawanella,Sabaragamuwa,4194,493,4687,167760,19720,187480
9/9/2024,Senaka Abeysinghe,Kegalle,Mawanella,Sabaragamuwa,2266,3235,5501,90640,129400,220040
9/10/2024,Senaka Abeysinghe,Kegalle,Mawanella,Sabaragamuwa,4590,4590,9180,183600,183600,367200
9/11/2024,Senaka Abeysinghe,Kegalle,Mawanella,Sabaragamuwa,7245,2147,9392,289800,85880,375680
9/12/2024,Senaka Abeysinghe,Kegalle,Mawanella,Sabaragamuwa,4488,8684,13172,179520,347360,526880
9/13/2024,Senaka Abeysinghe,Kegalle,Mawanella,Sabaragamuwa,8412,9094,17506,336480,363760,700240
9/14/2024,Senaka Abeysinghe,Kegalle,Mawanella,Sabaragamuwa,1567,6531,8098,62680,261240,323920
9/15/2024,Senaka Abeysinghe,Kegalle,Mawanella,Sabaragamuwa,3026,8881,11907,121040,355240,476280
9/16/2024,Senaka Abeysinghe,Kegalle,Mawanella,Sabaragamuwa,1027,4208,5235,41080,168320,209400
9/17/2024,Senaka Abeysinghe,Kegalle,Mawanella,Sabaragamuwa,2852,7677,10529,114080,307080,421160
9/18/2024,Senaka Abeysinghe,Kegalle,Mawanella,Sabaragamuwa,632,7911,8543,25280,316440,341720
9/19/2024,Senaka Abeysinghe,Kegalle,Mawanella,Sabaragamuwa,9517,9259,18776,380680,370360,751040
9/20/2024,Senaka Abeysinghe,Kegalle,Mawanella,Sabaragamuwa,610,5533,6143,24400,221320,245720
9/21/2024,Senaka Abeysinghe,Kegalle,Mawanella,Sabaragamuwa,5631,4991,10622,225240,199640,424880
9/22/2024,Senaka Abeysinghe,Kegalle,Mawanella,Sabaragamuwa,7709,2004,9713,308360,80160,388520
9/23/2024,Senaka Abeysinghe,Kegalle,Mawanella,Sabaragamuwa,5661,6244,11905,226440,249760,476200
9/24/2024,Senaka Abeysinghe,Kegalle,Mawanella,Sabaragamuwa,8585,411,8996,343400,16440,359840
9/25/2024,Senaka Abeysinghe,Kegalle,Mawanella,Sabaragamuwa,7876,5239,13115,315040,209560,524600
9/26/2024,Senaka Abeysinghe,Kegalle,Mawanella,Sabaragamuwa,277,2771,3048,11080,110840,121920
9/27/2024,Senaka Abeysinghe,Kegalle,Mawanella,Sabaragamuwa,8527,5133,13660,341080,205320,546400
9/28/2024,Senaka Abeysinghe,Kegalle,Mawanella,Sabaragamuwa,4650,8232,12882,186000,329280,515280
9/29/2024,Senaka Abeysinghe,Kegalle,Mawanella,Sabaragamuwa,8151,8753,16904,326040,350120,676160
9/30/2024,Senaka Abeysinghe,Kegalle,Mawanella,Sabaragamuwa,6362,7834,14196,254480,313360,567840
10/1/2024,Senaka Abeysinghe,Kegalle,Mawanella,Sabaragamuwa,2494,7442,9936,99760,297680,397440
10/2/2024,Senaka Abeysinghe,Kegalle,Mawanella,Sabaragamuwa,2188,6766,8954,87520,270640,358160
10/3/2024,Senaka Abeysinghe,Kegalle,Mawanella,Sabaragamuwa,3377,7828,11205,135080,313120,448200
10/4/2024,Senaka Abeysinghe,Kegalle,Mawanella,Sabaragamuwa,489,9641,10130,19560,385640,405200
10/5/2024,Senaka Abeysinghe,Kegalle,Mawanella,Sabaragamuwa,63,1452,1515,2520,58080,60600
10/6/2024,Senaka Abeysinghe,Kegalle,Mawanella,Sabaragamuwa,1679,684,2363,67160,27360,94520
10/7/2024,Senaka Abeysinghe,Kegalle,Mawanella,Sabaragamuwa,180,2687,2867,7200,107480,114680
10/8/2024,Senaka Abeysinghe,Kegalle,Mawanella,Sabaragamuwa,3970,7468,11438,158800,298720,457520
10/9/2024,Senaka Abeysinghe,Kegalle,Mawanella,Sabaragamuwa,1134,6161,7295,45360,246440,291800
10/10/2024,Senaka Abeysinghe,Kegalle,Mawanella,Sabaragamuwa,3105,2522,5627,124200,100880,225080
10/11/2024,Senaka Abeysinghe,Kegalle,Mawanella,Sabaragamuwa,3249,683,3932,129960,27320,157280
10/12/2024,Senaka Abeysinghe,Kegalle,Mawanella,Sabaragamuwa,8835,4426,13261,353400,177040,530440
10/13/2024,Senaka Abeysinghe,Kegalle,Mawanella,Sabaragamuwa,7865,9605,17470,314600,384200,698800
10/14/2024,Senaka Abeysinghe,Kegalle,Mawanella,Sabaragamuwa,9732,7388,17120,389280,295520,684800
10/15/2024,Senaka Abeysinghe,Kegalle,Mawanella,Sabaragamuwa,2172,6722,8894,86880,268880,355760
10/16/2024,Senaka Abeysinghe,Kegalle,Mawanella,Sabaragamuwa,8327,7627,15954,333080,305080,638160
10/17/2024,Senaka Abeysinghe,Kegalle,Mawanella,Sabaragamuwa,4216,3206,7422,168640,128240,296880
10/18/2024,Senaka Abeysinghe,Kegalle,Mawanella,Sabaragamuwa,6670,708,7378,266800,28320,295120
10/19/2024,Senaka Abeysinghe,Kegalle,Mawanella,Sabaragamuwa,2779,3739,6518,111160,149560,260720
10/20/2024,Senaka Abeysinghe,Kegalle,Mawanella,Sabaragamuwa,9784,4825,14609,391360,193000,584360
10/21/2024,Senaka Abeysinghe,Kegalle,Mawanella,Sabaragamuwa,1920,6129,8049,76800,245160,321960
10/22/2024,Senaka Abeysinghe,Kegalle,Mawanella,Sabaragamuwa,5472,4116,9588,218880,164640,383520
10/23/2024,Senaka Abeysinghe,Kegalle,Mawanella,Sabaragamuwa,3409,4565,7974,136360,182600,318960
10/24/2024,Senaka Abeysinghe,Kegalle,Mawanella,Sabaragamuwa,7705,7194,14899,308200,287760,595960
10/25/2024,Senaka Abeysinghe,Kegalle,Mawanella,Sabaragamuwa,8889,129,9018,355560,5160,360720
10/26/2024,Senaka Abeysinghe,Kegalle,Mawanella,Sabaragamuwa,7254,7450,14704,290160,298000,588160
10/27/2024,Senaka Abeysinghe,Kegalle,Mawanella,Sabaragamuwa,2453,3740,6193,98120,149600,247720
10/28/2024,Senaka Abeysinghe,Kegalle,Mawanella,Sabaragamuwa,5775,1529,7304,231000,61160,292160
10/29/2024,Senaka Abeysinghe,Kegalle,Mawanella,Sabaragamuwa,2284,7147,9431,91360,285880,377240
10/30/2024,Senaka Abeysinghe,Kegalle,Mawanella,Sabaragamuwa,620,9614,10234,24800,384560,409360
10/31/2024,Senaka Abeysinghe,Kegalle,Mawanella,Sabaragamuwa,8463,5143,13606,338520,205720,544240
11/1/2024,Senaka Abeysinghe,Kegalle,Mawanella,Sabaragamuwa,1849,5578,7427,73960,223120,297080
11/2/2024,Senaka Abeysinghe,Kegalle,Mawanella,Sabaragamuwa,158,173,331,6320,6920,13240
11/3/2024,Senaka Abeysinghe,Kegalle,Mawanella,Sabaragamuwa,229,2503,2732,9160,100120,109280
11/4/2024,Senaka Abeysinghe,Kegalle,Mawanella,Sabaragamuwa,2010,498,2508,80400,19920,100320
11/5/2024,Senaka Abeysinghe,Kegalle,Mawanella,Sabaragamuwa,8656,4232,12888,346240,169280,515520
11/6/2024,Senaka Abeysinghe,Kegalle,Mawanella,Sabaragamuwa,2575,6915,9490,103000,276600,379600
11/7/2024,Senaka Abeysinghe,Kegalle,Mawanella,Sabaragamuwa,7603,6707,14310,304120,268280,572400
11/8/2024,Senaka Abeysinghe,Kegalle,Mawanella,Sabaragamuwa,3022,4011,7033,120880,160440,281320
11/9/2024,Senaka Abeysinghe,Kegalle,Mawanella,Sabaragamuwa,5523,7737,13260,220920,309480,530400
11/10/2024,Senaka Abeysinghe,Kegalle,Mawanella,Sabaragamuwa,2800,6837,9637,112000,273480,385480
11/11/2024,Senaka Abeysinghe,Kegalle,Mawanella,Sabaragamuwa,4823,1793,6616,192920,71720,264640
11/12/2024,Senaka Abeysinghe,Kegalle,Mawanella,Sabaragamuwa,246,2253,2499,9840,90120,99960
11/13/2024,Senaka Abeysinghe,Kegalle,Mawanella,Sabaragamuwa,8644,4630,13274,345760,185200,530960
11/14/2024,Senaka Abeysinghe,Kegalle,Mawanella,Sabaragamuwa,6127,3388,9515,245080,135520,380600
11/15/2024,Senaka Abeysinghe,Kegalle,Mawanella,Sabaragamuwa,8128,3580,11708,325120,143200,468320
11/16/2024,Senaka Abeysinghe,Kegalle,Mawanella,Sabaragamuwa,9640,8262,17902,385600,330480,716080
11/17/2024,Senaka Abeysinghe,Kegalle,Mawanella,Sabaragamuwa,3349,6096,9445,133960,243840,377800
11/18/2024,Senaka Abeysinghe,Kegalle,Mawanella,Sabaragamuwa,2438,923,3361,97520,36920,134440
11/19/2024,Senaka Abeysinghe,Kegalle,Mawanella,Sabaragamuwa,8287,6125,14412,331480,245000,576480
11/20/2024,Senaka Abeysinghe,Kegalle,Mawanella,Sabaragamuwa,9864,1223,11087,394560,48920,443480
11/21/2024,Senaka Abeysinghe,Kegalle,Mawanella,Sabaragamuwa,7987,2262,10249,319480,90480,409960
11/22/2024,Senaka Abeysinghe,Kegalle,Mawanella,Sabaragamuwa,8190,9213,17403,327600,368520,696120
11/23/2024,Senaka Abeysinghe,Kegalle,Mawanella,Sabaragamuwa,6053,8774,14827,242120,350960,593080
11/24/2024,Senaka Abeysinghe,Kegalle,Mawanella,Sabaragamuwa,3635,3843,7478,145400,153720,299120
11/25/2024,Senaka Abeysinghe,Kegalle,Mawanella,Sabaragamuwa,8352,5121,13473,334080,204840,538920
11/26/2024,Senaka Abeysinghe,Kegalle,Mawanella,Sabaragamuwa,8800,3370,12170,352000,134800,486800
11/27/2024,Senaka Abeysinghe,Kegalle,Mawanella,Sabaragamuwa,2273,2906,5179,90920,116240,207160
11/28/2024,Senaka Abeysinghe,Kegalle,Mawanella,Sabaragamuwa,58,9425,9483,2320,377000,379320
11/29/2024,Senaka Abeysinghe,Kegalle,Mawanella,Sabaragamuwa,2865,9766,12631,114600,390640,505240
11/30/2024,Senaka Abeysinghe,Kegalle,Mawanella,Sabaragamuwa,9562,3232,12794,382480,129280,511760
12/1/2024,Senaka Abeysinghe,Kegalle,Mawanella,Sabaragamuwa,2903,9079,11982,116120,363160,479280
12/2/2024,Senaka Abeysinghe,Kegalle,Mawanella,Sabaragamuwa,9594,3043,12637,383760,121720,505480
12/3/2024,Senaka Abeysinghe,Kegalle,Mawanella,Sabaragamuwa,7786,3294,11080,311440,131760,443200
12/4/2024,Senaka Abeysinghe,Kegalle,Mawanella,Sabaragamuwa,3034,8187,11221,121360,327480,448840
12/5/2024,Senaka Abeysinghe,Kegalle,Mawanella,Sabaragamuwa,1704,3954,5658,68160,158160,226320
12/6/2024,Senaka Abeysinghe,Kegalle,Mawanella,Sabaragamuwa,137,1050,1187,5480,42000,47480
12/7/2024,Senaka Abeysinghe,Kegalle,Mawanella,Sabaragamuwa,2940,5341,8281,117600,213640,331240
12/8/2024,Senaka Abeysinghe,Kegalle,Mawanella,Sabaragamuwa,306,6103,6409,12240,244120,256360
12/9/2024,Senaka Abeysinghe,Kegalle,Mawanella,Sabaragamuwa,6583,1339,7922,263320,53560,316880
12/10/2024,Senaka Abeysinghe,Kegalle,Mawanella,Sabaragamuwa,6237,3749,9986,249480,149960,399440
12/11/2024,Senaka Abeysinghe,Kegalle,Mawanella,Sabaragamuwa,3430,8434,11864,137200,337360,474560
12/12/2024,Senaka Abeysinghe,Kegalle,Mawanella,Sabaragamuwa,8412,2305,10717,336480,92200,428680
12/13/2024,Senaka Abeysinghe,Kegalle,Mawanella,Sabaragamuwa,88,2282,2370,3520,91280,94800
12/14/2024,Senaka Abeysinghe,Kegalle,Mawanella,Sabaragamuwa,8699,738,9437,347960,29520,377480
12/15/2024,Senaka Abeysinghe,Kegalle,Mawanella,Sabaragamuwa,925,5408,6333,37000,216320,253320
12/16/2024,Senaka Abeysinghe,Kegalle,Mawanella,Sabaragamuwa,747,2454,3201,29880,98160,128040
12/17/2024,Senaka Abeysinghe,Kegalle,Mawanella,Sabaragamuwa,7949,2266,10215,317960,90640,408600
12/18/2024,Senaka Abeysinghe,Kegalle,Mawanella,Sabaragamuwa,835,4297,5132,33400,171880,205280
12/19/2024,Senaka Abeysinghe,Kegalle,Mawanella,Sabaragamuwa,9878,7528,17406,395120,301120,696240
12/20/2024,Senaka Abeysinghe,Kegalle,Mawanella,Sabaragamuwa,4660,1311,5971,186400,52440,238840
12/21/2024,Senaka Abeysinghe,Kegalle,Mawanella,Sabaragamuwa,4186,3434,7620,167440,137360,304800
12/22/2024,Senaka Abeysinghe,Kegalle,Mawanella,Sabaragamuwa,5350,423,5773,214000,16920,230920
12/23/2024,Senaka Abeysinghe,Kegalle,Mawanella,Sabaragamuwa,9409,7221,16630,376360,288840,665200
12/24/2024,Senaka Abeysinghe,Kegalle,Mawanella,Sabaragamuwa,8933,7317,16250,357320,292680,650000
12/25/2024,Senaka Abeysinghe,Kegalle,Mawanella,Sabaragamuwa,409,8409,8818,16360,336360,352720
12/26/2024,Senaka Abeysinghe,Kegalle,Mawanella,Sabaragamuwa,2945,9685,12630,117800,387400,505200
12/27/2024,Senaka Abeysinghe,Kegalle,Mawanella,Sabaragamuwa,1978,9523,11501,79120,380920,460040
12/28/2024,Senaka Abeysinghe,Kegalle,Mawanella,Sabaragamuwa,522,8522,9044,20880,340880,361760
12/29/2024,Senaka Abeysinghe,Kegalle,Mawanella,Sabaragamuwa,6192,8941,15133,247680,357640,605320
12/30/2024,Senaka Abeysinghe,Kegalle,Mawanella,Sabaragamuwa,7023,4443,11466,280920,177720,458640
12/31/2024,Senaka Abeysinghe,Kegalle,Mawanella,Sabaragamuwa,3518,3317,6835,140720,132680,273400
1/1/2025,Senaka Abeysinghe,Kegalle,Mawanella,Sabaragamuwa,9938,3710,13648,397520,148400,545920
1/2/2025,Senaka Abeysinghe,Kegalle,Mawanella,Sabaragamuwa,3153,4295,7448,126120,171800,297920
1/3/2025,Senaka Abeysinghe,Kegalle,Mawanella,Sabaragamuwa,4713,1473,6186,188520,58920,247440
1/4/2025,Senaka Abeysinghe,Kegalle,Mawanella,Sabaragamuwa,4815,3886,8701,192600,155440,348040
1/5/2025,Senaka Abeysinghe,Kegalle,Mawanella,Sabaragamuwa,6894,4839,11733,275760,193560,469320
1/6/2025,Senaka Abeysinghe,Kegalle,Mawanella,Sabaragamuwa,8701,595,9296,348040,23800,371840
1/7/2025,Senaka Abeysinghe,Kegalle,Mawanella,Sabaragamuwa,5267,3738,9005,210680,149520,360200
1/8/2025,Senaka Abeysinghe,Kegalle,Mawanella,Sabaragamuwa,1924,5506,7430,76960,220240,297200
1/9/2025,Senaka Abeysinghe,Kegalle,Mawanella,Sabaragamuwa,8758,4835,13593,350320,193400,543720
1/10/2025,Senaka Abeysinghe,Kegalle,Mawanella,Sabaragamuwa,6556,2084,8640,262240,83360,345600
1/11/2025,Senaka Abeysinghe,Kegalle,Mawanella,Sabaragamuwa,7423,1661,9084,296920,66440,363360
1/12/2025,Senaka Abeysinghe,Kegalle,Mawanella,Sabaragamuwa,1468,2624,4092,58720,104960,163680
1/13/2025,Senaka Abeysinghe,Kegalle,Mawanella,Sabaragamuwa,501,6711,7212,20040,268440,288480
1/14/2025,Senaka Abeysinghe,Kegalle,Mawanella,Sabaragamuwa,3192,355,3547,127680,14200,141880
1/15/2025,Senaka Abeysinghe,Kegalle,Mawanella,Sabaragamuwa,5302,7508,12810,212080,300320,512400
1/16/2025,Senaka Abeysinghe,Kegalle,Mawanella,Sabaragamuwa,8139,6871,15010,325560,274840,600400
1/17/2025,Senaka Abeysinghe,Kegalle,Mawanella,Sabaragamuwa,6391,4972,11363,255640,198880,454520
1/18/2025,Senaka Abeysinghe,Kegalle,Mawanella,Sabaragamuwa,9240,1243,10483,369600,49720,419320
1/19/2025,Senaka Abeysinghe,Kegalle,Mawanella,Sabaragamuwa,834,7772,8606,33360,310880,344240
1/20/2025,Senaka Abeysinghe,Kegalle,Mawanella,Sabaragamuwa,8346,1663,10009,333840,66520,400360
1/21/2025,Senaka Abeysinghe,Kegalle,Mawanella,Sabaragamuwa,1490,4800,6290,59600,192000,251600
1/22/2025,Senaka Abeysinghe,Kegalle,Mawanella,Sabaragamuwa,7480,7795,15275,299200,311800,611000
1/23/2025,Senaka Abeysinghe,Kegalle,Mawanella,Sabaragamuwa,9682,1646,11328,387280,65840,453120
1/24/2025,Senaka Abeysinghe,Kegalle,Mawanella,Sabaragamuwa,6059,8626,14685,242360,345040,587400
1/25/2025,Senaka Abeysinghe,Kegalle,Mawanella,Sabaragamuwa,3294,8254,11548,131760,330160,461920
1/26/2025,Senaka Abeysinghe,Kegalle,Mawanella,Sabaragamuwa,9886,1423,11309,395440,56920,452360
1/27/2025,Senaka Abeysinghe,Kegalle,Mawanella,Sabaragamuwa,1498,1095,2593,59920,43800,103720
1/28/2025,Senaka Abeysinghe,Kegalle,Mawanella,Sabaragamuwa,8351,1561,9912,334040,62440,396480
1/29/2025,Senaka Abeysinghe,Kegalle,Mawanella,Sabaragamuwa,4335,3002,7337,173400,120080,293480
1/30/2025,Senaka Abeysinghe,Kegalle,Mawanella,Sabaragamuwa,5753,7073,12826,230120,282920,513040
1/31/2025,Senaka Abeysinghe,Kegalle,Mawanella,Sabaragamuwa,7583,5267,12850,303320,210680,514000
2/1/2025,Senaka Abeysinghe,Kegalle,Mawanella,Sabaragamuwa,4036,1170,5206,161440,46800,208240
2/2/2025,Senaka Abeysinghe,Kegalle,Mawanella,Sabaragamuwa,5923,4769,10692,236920,190760,427680
2/3/2025,Senaka Abeysinghe,Kegalle,Mawanella,Sabaragamuwa,974,1720,2694,38960,68800,107760
2/4/2025,Senaka Abeysinghe,Kegalle,Mawanella,Sabaragamuwa,3525,12,3537,141000,480,141480
2/5/2025,Senaka Abeysinghe,Kegalle,Mawanella,Sabaragamuwa,3176,6584,9760,127040,263360,390400
2/6/2025,Senaka Abeysinghe,Kegalle,Mawanella,Sabaragamuwa,7852,5757,13609,314080,230280,544360
2/7/2025,Senaka Abeysinghe,Kegalle,Mawanella,Sabaragamuwa,1163,8131,9294,46520,325240,371760
2/8/2025,Senaka Abeysinghe,Kegalle,Mawanella,Sabaragamuwa,2294,7492,9786,91760,299680,391440
2/9/2025,Senaka Abeysinghe,Kegalle,Mawanella,Sabaragamuwa,560,3818,4378,22400,152720,175120
2/10/2025,Senaka Abeysinghe,Kegalle,Mawanella,Sabaragamuwa,8095,9850,17945,323800,394000,717800
2/11/2025,Senaka Abeysinghe,Kegalle,Mawanella,Sabaragamuwa,2522,3377,5899,100880,135080,235960
2/12/2025,Senaka Abeysinghe,Kegalle,Mawanella,Sabaragamuwa,6177,4832,11009,247080,193280,440360
2/13/2025,Senaka Abeysinghe,Kegalle,Mawanella,Sabaragamuwa,3463,5598,9061,138520,223920,362440
2/14/2025,Senaka Abeysinghe,Kegalle,Mawanella,Sabaragamuwa,9552,4606,14158,382080,184240,566320
2/15/2025,Senaka Abeysinghe,Kegalle,Mawanella,Sabaragamuwa,164,5301,5465,6560,212040,218600
2/16/2025,Senaka Abeysinghe,Kegalle,Mawanella,Sabaragamuwa,3430,1447,4877,137200,57880,195080
2/17/2025,Senaka Abeysinghe,Kegalle,Mawanella,Sabaragamuwa,7391,7189,14580,295640,287560,583200
2/18/2025,Senaka Abeysinghe,Kegalle,Mawanella,Sabaragamuwa,9018,1725,10743,360720,69000,429720
2/19/2025,Senaka Abeysinghe,Kegalle,Mawanella,Sabaragamuwa,7179,273,7452,287160,10920,298080
2/20/2025,Senaka Abeysinghe,Kegalle,Mawanella,Sabaragamuwa,2520,6164,8684,100800,246560,347360
2/21/2025,Senaka Abeysinghe,Kegalle,Mawanella,Sabaragamuwa,4995,4955,9950,199800,198200,398000
2/22/2025,Senaka Abeysinghe,Kegalle,Mawanella,Sabaragamuwa,5270,8472,13742,210800,338880,549680
2/23/2025,Senaka Abeysinghe,Kegalle,Mawanella,Sabaragamuwa,9871,6069,15940,394840,242760,637600
2/24/2025,Senaka Abeysinghe,Kegalle,Mawanella,Sabaragamuwa,5653,9638,15291,226120,385520,611640
2/25/2025,Senaka Abeysinghe,Kegalle,Mawanella,Sabaragamuwa,3605,1547,5152,144200,61880,206080
2/26/2025,Senaka Abeysinghe,Kegalle,Mawanella,Sabaragamuwa,7501,5249,12750,300040,209960,510000
2/27/2025,Senaka Abeysinghe,Kegalle,Mawanella,Sabaragamuwa,6024,7361,13385,240960,294440,535400
2/28/2025,Senaka Abeysinghe,Kegalle,Mawanella,Sabaragamuwa,635,8976,9611,25400,359040,384440
3/1/2025,Senaka Abeysinghe,Kegalle,Mawanella,Sabaragamuwa,2007,3889,5896,80280,155560,235840
3/2/2025,Senaka Abeysinghe,Kegalle,Mawanella,Sabaragamuwa,2228,5761,7989,89120,230440,319560
3/3/2025,Senaka Abeysinghe,Kegalle,Mawanella,Sabaragamuwa,8352,502,8854,334080,20080,354160
3/4/2025,Senaka Abeysinghe,Kegalle,Mawanella,Sabaragamuwa,8137,5306,13443,325480,212240,537720
3/5/2025,Senaka Abeysinghe,Kegalle,Mawanella,Sabaragamuwa,2910,6196,9106,116400,247840,364240
3/6/2025,Senaka Abeysinghe,Kegalle,Mawanella,Sabaragamuwa,2260,4082,6342,90400,163280,253680
3/7/2025,Senaka Abeysinghe,Kegalle,Mawanella,Sabaragamuwa,9243,5912,15155,369720,236480,606200
3/8/2025,Senaka Abeysinghe,Kegalle,Mawanella,Sabaragamuwa,2712,7434,10146,108480,297360,405840
3/9/2025,Senaka Abeysinghe,Kegalle,Mawanella,Sabaragamuwa,8822,6834,15656,352880,273360,626240
3/10/2025,Senaka Abeysinghe,Kegalle,Mawanella,Sabaragamuwa,6872,9088,15960,274880,363520,638400
3/11/2025,Senaka Abeysinghe,Kegalle,Mawanella,Sabaragamuwa,3639,1710,5349,145560,68400,213960
3/12/2025,Senaka Abeysinghe,Kegalle,Mawanella,Sabaragamuwa,6438,8042,14480,257520,321680,579200
3/13/2025,Senaka Abeysinghe,Kegalle,Mawanella,Sabaragamuwa,9072,6221,15293,362880,248840,611720
3/14/2025,Senaka Abeysinghe,Kegalle,Mawanella,Sabaragamuwa,9349,2476,11825,373960,99040,473000
3/15/2025,Senaka Abeysinghe,Kegalle,Mawanella,Sabaragamuwa,7953,4243,12196,318120,169720,487840
3/16/2025,Senaka Abeysinghe,Kegalle,Mawanella,Sabaragamuwa,6877,7359,14236,275080,294360,569440
3/17/2025,Senaka Abeysinghe,Kegalle,Mawanella,Sabaragamuwa,6417,4459,10876,256680,178360,435040
3/18/2025,Senaka Abeysinghe,Kegalle,Mawanella,Sabaragamuwa,2694,4287,6981,107760,171480,279240
3/19/2025,Senaka Abeysinghe,Kegalle,Mawanella,Sabaragamuwa,3656,5028,8684,146240,201120,347360
3/20/2025,Senaka Abeysinghe,Kegalle,Mawanella,Sabaragamuwa,9961,7540,17501,398440,301600,700040
3/21/2025,Senaka Abeysinghe,Kegalle,Mawanella,Sabaragamuwa,9595,5365,14960,383800,214600,598400
3/22/2025,Senaka Abeysinghe,Kegalle,Mawanella,Sabaragamuwa,8723,2119,10842,348920,84760,433680
3/23/2025,Senaka Abeysinghe,Kegalle,Mawanella,Sabaragamuwa,7289,9983,17272,291560,399320,690880
3/25/2024,Sangeetha Munasinghe,Nuwara Eliya,Ginigathhena,Central,6064,473,6537,242560,18920,261480
3/26/2024,Sangeetha Munasinghe,Nuwara Eliya,Ginigathhena,Central,3002,3103,6105,120080,124120,244200
3/27/2024,Sangeetha Munasinghe,Nuwara Eliya,Ginigathhena,Central,4344,7947,12291,173760,317880,491640
3/28/2024,Sangeetha Munasinghe,Nuwara Eliya,Ginigathhena,Central,8111,4314,12425,324440,172560,497000
3/29/2024,Sangeetha Munasinghe,Nuwara Eliya,Ginigathhena,Central,9180,2359,11539,367200,94360,461560
3/30/2024,Sangeetha Munasinghe,Nuwara Eliya,Ginigathhena,Central,8544,5831,14375,341760,233240,575000
3/31/2024,Sangeetha Munasinghe,Nuwara Eliya,Ginigathhena,Central,6098,1897,7995,243920,75880,319800
4/1/2024,Sangeetha Munasinghe,Nuwara Eliya,Ginigathhena,Central,684,5911,6595,27360,236440,263800
4/2/2024,Sangeetha Munasinghe,Nuwara Eliya,Ginigathhena,Central,459,584,1043,18360,23360,41720
4/3/2024,Sangeetha Munasinghe,Nuwara Eliya,Ginigathhena,Central,6919,889,7808,276760,35560,312320
4/4/2024,Sangeetha Munasinghe,Nuwara Eliya,Ginigathhena,Central,9036,7022,16058,361440,280880,642320
4/5/2024,Sangeetha Munasinghe,Nuwara Eliya,Ginigathhena,Central,7972,3172,11144,318880,126880,445760
4/6/2024,Sangeetha Munasinghe,Nuwara Eliya,Ginigathhena,Central,5076,9269,14345,203040,370760,573800
4/7/2024,Sangeetha Munasinghe,Nuwara Eliya,Ginigathhena,Central,4111,3505,7616,164440,140200,304640
4/8/2024,Sangeetha Munasinghe,Nuwara Eliya,Ginigathhena,Central,6005,3443,9448,240200,137720,377920
4/9/2024,Sangeetha Munasinghe,Nuwara Eliya,Ginigathhena,Central,8668,6394,15062,346720,255760,602480
4/10/2024,Sangeetha Munasinghe,Nuwara Eliya,Ginigathhena,Central,6004,5420,11424,240160,216800,456960
4/11/2024,Sangeetha Munasinghe,Nuwara Eliya,Ginigathhena,Central,4655,3792,8447,186200,151680,337880
4/19/2024,Sangeetha Munasinghe,Nuwara Eliya,Ginigathhena,Central,1702,2832,4534,68080,113280,181360
4/20/2024,Sangeetha Munasinghe,Nuwara Eliya,Ginigathhena,Central,1391,1567,2958,55640,62680,118320
4/21/2024,Sangeetha Munasinghe,Nuwara Eliya,Ginigathhena,Central,3019,3222,6241,120760,128880,249640
4/22/2024,Sangeetha Munasinghe,Nuwara Eliya,Ginigathhena,Central,6318,8181,14499,252720,327240,579960
4/23/2024,Sangeetha Munasinghe,Nuwara Eliya,Ginigathhena,Central,1041,5523,6564,41640,220920,262560
4/24/2024,Sangeetha Munasinghe,Nuwara Eliya,Ginigathhena,Central,6924,5548,12472,276960,221920,498880
4/25/2024,Sangeetha Munasinghe,Nuwara Eliya,Ginigathhena,Central,2599,1458,4057,103960,58320,162280
4/26/2024,Sangeetha Munasinghe,Nuwara Eliya,Ginigathhena,Central,3395,2235,5630,135800,89400,225200
4/27/2024,Sangeetha Munasinghe,Nuwara Eliya,Ginigathhena,Central,5602,6607,12209,224080,264280,488360
4/28/2024,Sangeetha Munasinghe,Nuwara Eliya,Ginigathhena,Central,7662,3195,10857,306480,127800,434280
4/29/2024,Sangeetha Munasinghe,Nuwara Eliya,Ginigathhena,Central,3,404,407,120,16160,16280
4/30/2024,Sangeetha Munasinghe,Nuwara Eliya,Ginigathhena,Central,3059,7617,10676,122360,304680,427040
5/1/2024,Sangeetha Munasinghe,Nuwara Eliya,Ginigathhena,Central,2372,2724,5096,94880,108960,203840
5/2/2024,Sangeetha Munasinghe,Nuwara Eliya,Ginigathhena,Central,7580,7518,15098,303200,300720,603920
5/3/2024,Sangeetha Munasinghe,Nuwara Eliya,Ginigathhena,Central,1445,5546,6991,57800,221840,279640
5/4/2024,Sangeetha Munasinghe,Nuwara Eliya,Ginigathhena,Central,7144,4769,11913,285760,190760,476520
5/5/2024,Sangeetha Munasinghe,Nuwara Eliya,Ginigathhena,Central,8934,8157,17091,357360,326280,683640
5/6/2024,Sangeetha Munasinghe,Nuwara Eliya,Ginigathhena,Central,7587,3774,11361,303480,150960,454440
5/7/2024,Sangeetha Munasinghe,Nuwara Eliya,Ginigathhena,Central,7243,5220,12463,289720,208800,498520
5/8/2024,Sangeetha Munasinghe,Nuwara Eliya,Ginigathhena,Central,4248,5431,9679,169920,217240,387160
5/9/2024,Sangeetha Munasinghe,Nuwara Eliya,Ginigathhena,Central,6593,3654,10247,263720,146160,409880
5/10/2024,Sangeetha Munasinghe,Nuwara Eliya,Ginigathhena,Central,3424,1647,5071,136960,65880,202840
5/11/2024,Sangeetha Munasinghe,Nuwara Eliya,Ginigathhena,Central,7350,5315,12665,294000,212600,506600
5/12/2024,Sangeetha Munasinghe,Nuwara Eliya,Ginigathhena,Central,3148,1918,5066,125920,76720,202640
5/13/2024,Sangeetha Munasinghe,Nuwara Eliya,Ginigathhena,Central,9710,6826,16536,388400,273040,661440
5/14/2024,Sangeetha Munasinghe,Nuwara Eliya,Ginigathhena,Central,8670,9065,17735,346800,362600,709400
5/15/2024,Sangeetha Munasinghe,Nuwara Eliya,Ginigathhena,Central,872,1347,2219,34880,53880,88760
5/16/2024,Sangeetha Munasinghe,Nuwara Eliya,Ginigathhena,Central,6538,794,7332,261520,31760,293280
5/17/2024,Sangeetha Munasinghe,Nuwara Eliya,Ginigathhena,Central,9637,4977,14614,385480,199080,584560
5/18/2024,Sangeetha Munasinghe,Nuwara Eliya,Ginigathhena,Central,1817,5634,7451,72680,225360,298040
5/19/2024,Sangeetha Munasinghe,Nuwara Eliya,Ginigathhena,Central,1687,4442,6129,67480,177680,245160
5/20/2024,Sangeetha Munasinghe,Nuwara Eliya,Ginigathhena,Central,2948,9579,12527,117920,383160,501080
5/21/2024,Sangeetha Munasinghe,Nuwara Eliya,Ginigathhena,Central,6147,5629,11776,245880,225160,471040
5/22/2024,Sangeetha Munasinghe,Nuwara Eliya,Ginigathhena,Central,2873,2227,5100,114920,89080,204000
5/24/2024,Sangeetha Munasinghe,Nuwara Eliya,Ginigathhena,Central,2175,8028,10203,87000,321120,408120
5/25/2024,Sangeetha Munasinghe,Nuwara Eliya,Ginigathhena,Central,9361,5241,14602,374440,209640,584080
5/26/2024,Sangeetha Munasinghe,Nuwara Eliya,Ginigathhena,Central,755,8504,9259,30200,340160,370360
5/27/2024,Sangeetha Munasinghe,Nuwara Eliya,Ginigathhena,Central,9527,5376,14903,381080,215040,596120
5/28/2024,Sangeetha Munasinghe,Nuwara Eliya,Ginigathhena,Central,7589,964,8553,303560,38560,342120
5/29/2024,Sangeetha Munasinghe,Nuwara Eliya,Ginigathhena,Central,5424,8873,14297,216960,354920,571880
5/30/2024,Sangeetha Munasinghe,Nuwara Eliya,Ginigathhena,Central,4788,5178,9966,191520,207120,398640
5/31/2024,Sangeetha Munasinghe,Nuwara Eliya,Ginigathhena,Central,8521,9073,17594,340840,362920,703760
6/1/2024,Sangeetha Munasinghe,Nuwara Eliya,Ginigathhena,Central,2524,2091,4615,100960,83640,184600
6/2/2024,Sangeetha Munasinghe,Nuwara Eliya,Ginigathhena,Central,2110,2612,4722,84400,104480,188880
6/3/2024,Sangeetha Munasinghe,Nuwara Eliya,Ginigathhena,Central,9734,3829,13563,389360,153160,542520
6/4/2024,Sangeetha Munasinghe,Nuwara Eliya,Ginigathhena,Central,6637,3566,10203,265480,142640,408120
6/5/2024,Sangeetha Munasinghe,Nuwara Eliya,Ginigathhena,Central,5666,6572,12238,226640,262880,489520
6/6/2024,Sangeetha Munasinghe,Nuwara Eliya,Ginigathhena,Central,864,9101,9965,34560,364040,398600
6/7/2024,Sangeetha Munasinghe,Nuwara Eliya,Ginigathhena,Central,9056,9354,18410,362240,374160,736400
6/8/2024,Sangeetha Munasinghe,Nuwara Eliya,Ginigathhena,Central,5877,3049,8926,235080,121960,357040
6/9/2024,Sangeetha Munasinghe,Nuwara Eliya,Ginigathhena,Central,3368,5023,8391,134720,200920,335640
6/10/2024,Sangeetha Munasinghe,Nuwara Eliya,Ginigathhena,Central,4382,2324,6706,175280,92960,268240
6/11/2024,Sangeetha Munasinghe,Nuwara Eliya,Ginigathhena,Central,4108,3908,8016,164320,156320,320640
6/12/2024,Sangeetha Munasinghe,Nuwara Eliya,Ginigathhena,Central,8412,4794,13206,336480,191760,528240
6/13/2024,Sangeetha Munasinghe,Nuwara Eliya,Ginigathhena,Central,9222,1023,10245,368880,40920,409800
6/14/2024,Sangeetha Munasinghe,Nuwara Eliya,Ginigathhena,Central,3238,9978,13216,129520,399120,528640
6/15/2024,Sangeetha Munasinghe,Nuwara Eliya,Ginigathhena,Central,5578,2325,7903,223120,93000,316120
6/16/2024,Sangeetha Munasinghe,Nuwara Eliya,Ginigathhena,Central,542,6901,7443,21680,276040,297720
6/17/2024,Sangeetha Munasinghe,Nuwara Eliya,Ginigathhena,Central,517,6108,6625,20680,244320,265000
6/18/2024,Sangeetha Munasinghe,Nuwara Eliya,Ginigathhena,Central,3340,459,3799,133600,18360,151960
6/19/2024,Sangeetha Munasinghe,Nuwara Eliya,Ginigathhena,Central,1967,8750,10717,78680,350000,428680
6/20/2024,Sangeetha Munasinghe,Nuwara Eliya,Ginigathhena,Central,2280,8711,10991,91200,348440,439640
6/21/2024,Sangeetha Munasinghe,Nuwara Eliya,Ginigathhena,Central,7661,9271,16932,306440,370840,677280
6/22/2024,Sangeetha Munasinghe,Nuwara Eliya,Ginigathhena,Central,9645,6690,16335,385800,267600,653400
6/23/2024,Sangeetha Munasinghe,Nuwara Eliya,Ginigathhena,Central,2815,2631,5446,112600,105240,217840
6/24/2024,Sangeetha Munasinghe,Nuwara Eliya,Ginigathhena,Central,4887,4589,9476,195480,183560,379040
6/25/2024,Sangeetha Munasinghe,Nuwara Eliya,Ginigathhena,Central,6220,3251,9471,248800,130040,378840
6/26/2024,Sangeetha Munasinghe,Nuwara Eliya,Ginigathhena,Central,4226,3432,7658,169040,137280,306320
6/27/2024,Sangeetha Munasinghe,Nuwara Eliya,Ginigathhena,Central,3648,6974,10622,145920,278960,424880
6/28/2024,Sangeetha Munasinghe,Nuwara Eliya,Ginigathhena,Central,7775,8124,15899,311000,324960,635960
6/29/2024,Sangeetha Munasinghe,Nuwara Eliya,Ginigathhena,Central,9394,304,9698,375760,12160,387920
6/30/2024,Sangeetha Munasinghe,Nuwara Eliya,Ginigathhena,Central,3856,1259,5115,154240,50360,204600
7/1/2024,Sangeetha Munasinghe,Nuwara Eliya,Ginigathhena,Central,4688,1575,6263,187520,63000,250520
7/2/2024,Sangeetha Munasinghe,Nuwara Eliya,Ginigathhena,Central,498,3222,3720,19920,128880,148800
7/3/2024,Sangeetha Munasinghe,Nuwara Eliya,Ginigathhena,Central,8822,1769,10591,352880,70760,423640
7/4/2024,Sangeetha Munasinghe,Nuwara Eliya,Ginigathhena,Central,2151,1032,3183,86040,41280,127320
7/5/2024,Sangeetha Munasinghe,Nuwara Eliya,Ginigathhena,Central,3263,6849,10112,130520,273960,404480
7/6/2024,Sangeetha Munasinghe,Nuwara Eliya,Ginigathhena,Central,9346,3096,12442,373840,123840,497680
7/7/2024,Sangeetha Munasinghe,Nuwara Eliya,Ginigathhena,Central,4312,6671,10983,172480,266840,439320
7/8/2024,Sangeetha Munasinghe,Nuwara Eliya,Ginigathhena,Central,5783,3493,9276,231320,139720,371040
7/9/2024,Sangeetha Munasinghe,Nuwara Eliya,Ginigathhena,Central,620,778,1398,24800,31120,55920
7/10/2024,Sangeetha Munasinghe,Nuwara Eliya,Ginigathhena,Central,5489,2236,7725,219560,89440,309000
7/11/2024,Sangeetha Munasinghe,Nuwara Eliya,Ginigathhena,Central,5298,6933,12231,211920,277320,489240
7/12/2024,Sangeetha Munasinghe,Nuwara Eliya,Ginigathhena,Central,4685,9211,13896,187400,368440,555840
7/13/2024,Sangeetha Munasinghe,Nuwara Eliya,Ginigathhena,Central,6878,8875,15753,275120,355000,630120
7/14/2024,Sangeetha Munasinghe,Nuwara Eliya,Ginigathhena,Central,7566,9172,16738,302640,366880,669520
7/15/2024,Sangeetha Munasinghe,Nuwara Eliya,Ginigathhena,Central,1328,9011,10339,53120,360440,413560
7/16/2024,Sangeetha Munasinghe,Nuwara Eliya,Ginigathhena,Central,8951,5155,14106,358040,206200,564240
7/17/2024,Sangeetha Munasinghe,Nuwara Eliya,Ginigathhena,Central,5139,7205,12344,205560,288200,493760
7/18/2024,Sangeetha Munasinghe,Nuwara Eliya,Ginigathhena,Central,9148,9623,18771,365920,384920,750840
7/19/2024,Sangeetha Munasinghe,Nuwara Eliya,Ginigathhena,Central,610,5673,6283,24400,226920,251320
7/20/2024,Sangeetha Munasinghe,Nuwara Eliya,Ginigathhena,Central,7494,4989,12483,299760,199560,499320
7/21/2024,Sangeetha Munasinghe,Nuwara Eliya,Ginigathhena,Central,8276,9017,17293,331040,360680,691720
7/22/2024,Sangeetha Munasinghe,Nuwara Eliya,Ginigathhena,Central,9457,3848,13305,378280,153920,532200
7/23/2024,Sangeetha Munasinghe,Nuwara Eliya,Ginigathhena,Central,4027,9351,13378,161080,374040,535120
7/24/2024,Sangeetha Munasinghe,Nuwara Eliya,Ginigathhena,Central,1773,690,2463,70920,27600,98520
7/25/2024,Sangeetha Munasinghe,Nuwara Eliya,Ginigathhena,Central,5686,5689,11375,227440,227560,455000
7/26/2024,Sangeetha Munasinghe,Nuwara Eliya,Ginigathhena,Central,5034,9871,14905,201360,394840,596200
7/27/2024,Sangeetha Munasinghe,Nuwara Eliya,Ginigathhena,Central,8579,2824,11403,343160,112960,456120
7/28/2024,Sangeetha Munasinghe,Nuwara Eliya,Ginigathhena,Central,3006,2356,5362,120240,94240,214480
7/29/2024,Sangeetha Munasinghe,Nuwara Eliya,Ginigathhena,Central,4328,620,4948,173120,24800,197920
7/30/2024,Sangeetha Munasinghe,Nuwara Eliya,Ginigathhena,Central,254,4856,5110,10160,194240,204400
7/31/2024,Sangeetha Munasinghe,Nuwara Eliya,Ginigathhena,Central,1814,7965,9779,72560,318600,391160
8/1/2024,Sangeetha Munasinghe,Nuwara Eliya,Ginigathhena,Central,8022,8487,16509,320880,339480,660360
8/2/2024,Sangeetha Munasinghe,Nuwara Eliya,Ginigathhena,Central,1314,8506,9820,52560,340240,392800
8/3/2024,Sangeetha Munasinghe,Nuwara Eliya,Ginigathhena,Central,9301,7318,16619,372040,292720,664760
8/4/2024,Sangeetha Munasinghe,Nuwara Eliya,Ginigathhena,Central,1491,1046,2537,59640,41840,101480
8/5/2024,Sangeetha Munasinghe,Nuwara Eliya,Ginigathhena,Central,6364,6277,12641,254560,251080,505640
8/6/2024,Sangeetha Munasinghe,Nuwara Eliya,Ginigathhena,Central,6378,1425,7803,255120,57000,312120
8/7/2024,Sangeetha Munasinghe,Nuwara Eliya,Ginigathhena,Central,5551,1188,6739,222040,47520,269560
8/8/2024,Sangeetha Munasinghe,Nuwara Eliya,Ginigathhena,Central,7417,3391,10808,296680,135640,432320
8/9/2024,Sangeetha Munasinghe,Nuwara Eliya,Ginigathhena,Central,9365,5877,15242,374600,235080,609680
8/10/2024,Sangeetha Munasinghe,Nuwara Eliya,Ginigathhena,Central,7363,9401,16764,294520,376040,670560
8/11/2024,Sangeetha Munasinghe,Nuwara Eliya,Ginigathhena,Central,2795,7564,10359,111800,302560,414360
8/12/2024,Sangeetha Munasinghe,Nuwara Eliya,Ginigathhena,Central,7756,5641,13397,310240,225640,535880
8/13/2024,Sangeetha Munasinghe,Nuwara Eliya,Ginigathhena,Central,5472,4515,9987,218880,180600,399480
8/14/2024,Sangeetha Munasinghe,Nuwara Eliya,Ginigathhena,Central,8369,5096,13465,334760,203840,538600
8/15/2024,Sangeetha Munasinghe,Nuwara Eliya,Ginigathhena,Central,1228,6205,7433,49120,248200,297320
8/16/2024,Sangeetha Munasinghe,Nuwara Eliya,Ginigathhena,Central,9383,9301,18684,375320,372040,747360
8/17/2024,Sangeetha Munasinghe,Nuwara Eliya,Ginigathhena,Central,7242,1459,8701,289680,58360,348040
8/18/2024,Sangeetha Munasinghe,Nuwara Eliya,Ginigathhena,Central,7410,3972,11382,296400,158880,455280
8/19/2024,Sangeetha Munasinghe,Nuwara Eliya,Ginigathhena,Central,9205,561,9766,368200,22440,390640
8/20/2024,Sangeetha Munasinghe,Nuwara Eliya,Ginigathhena,Central,7648,1019,8667,305920,40760,346680
8/21/2024,Sangeetha Munasinghe,Nuwara Eliya,Ginigathhena,Central,2954,895,3849,118160,35800,153960
8/22/2024,Sangeetha Munasinghe,Nuwara Eliya,Ginigathhena,Central,4976,8347,13323,199040,333880,532920
8/23/2024,Sangeetha Munasinghe,Nuwara Eliya,Ginigathhena,Central,518,7713,8231,20720,308520,329240
8/24/2024,Sangeetha Munasinghe,Nuwara Eliya,Ginigathhena,Central,7945,1350,9295,317800,54000,371800
8/25/2024,Sangeetha Munasinghe,Nuwara Eliya,Ginigathhena,Central,5025,8051,13076,201000,322040,523040
8/26/2024,Sangeetha Munasinghe,Nuwara Eliya,Ginigathhena,Central,313,6638,6951,12520,265520,278040
8/27/2024,Sangeetha Munasinghe,Nuwara Eliya,Ginigathhena,Central,8231,5280,13511,329240,211200,540440
8/28/2024,Sangeetha Munasinghe,Nuwara Eliya,Ginigathhena,Central,5288,6807,12095,211520,272280,483800
8/29/2024,Sangeetha Munasinghe,Nuwara Eliya,Ginigathhena,Central,8658,8426,17084,346320,337040,683360
8/30/2024,Sangeetha Munasinghe,Nuwara Eliya,Ginigathhena,Central,9521,3534,13055,380840,141360,522200
8/31/2024,Sangeetha Munasinghe,Nuwara Eliya,Ginigathhena,Central,6704,4543,11247,268160,181720,449880
9/1/2024,Sangeetha Munasinghe,Nuwara Eliya,Ginigathhena,Central,2449,5982,8431,97960,239280,337240
9/2/2024,Sangeetha Munasinghe,Nuwara Eliya,Ginigathhena,Central,3275,8832,12107,131000,353280,484280
9/3/2024,Sangeetha Munasinghe,Nuwara Eliya,Ginigathhena,Central,8768,7220,15988,350720,288800,639520
9/4/2024,Sangeetha Munasinghe,Nuwara Eliya,Ginigathhena,Central,4962,1226,6188,198480,49040,247520
9/5/2024,Sangeetha Munasinghe,Nuwara Eliya,Ginigathhena,Central,401,6099,6500,16040,243960,260000
9/6/2024,Sangeetha Munasinghe,Nuwara Eliya,Ginigathhena,Central,7495,2050,9545,299800,82000,381800
9/7/2024,Sangeetha Munasinghe,Nuwara Eliya,Ginigathhena,Central,4097,9192,13289,163880,367680,531560
9/8/2024,Sangeetha Munasinghe,Nuwara Eliya,Ginigathhena,Central,5921,1924,7845,236840,76960,313800
9/9/2024,Sangeetha Munasinghe,Nuwara Eliya,Ginigathhena,Central,7737,9353,17090,309480,374120,683600
9/10/2024,Sangeetha Munasinghe,Nuwara Eliya,Ginigathhena,Central,3552,2877,6429,142080,115080,257160
9/11/2024,Sangeetha Munasinghe,Nuwara Eliya,Ginigathhena,Central,1651,210,1861,66040,8400,74440
9/12/2024,Sangeetha Munasinghe,Nuwara Eliya,Ginigathhena,Central,6660,5145,11805,266400,205800,472200
9/13/2024,Sangeetha Munasinghe,Nuwara Eliya,Ginigathhena,Central,2324,7165,9489,92960,286600,379560
9/14/2024,Sangeetha Munasinghe,Nuwara Eliya,Ginigathhena,Central,7339,3612,10951,293560,144480,438040
9/15/2024,Sangeetha Munasinghe,Nuwara Eliya,Ginigathhena,Central,4296,7570,11866,171840,302800,474640
9/16/2024,Sangeetha Munasinghe,Nuwara Eliya,Ginigathhena,Central,8943,699,9642,357720,27960,385680
9/17/2024,Sangeetha Munasinghe,Nuwara Eliya,Ginigathhena,Central,1018,6792,7810,40720,271680,312400
9/18/2024,Sangeetha Munasinghe,Nuwara Eliya,Ginigathhena,Central,2008,5319,7327,80320,212760,293080
9/19/2024,Sangeetha Munasinghe,Nuwara Eliya,Ginigathhena,Central,3548,7802,11350,141920,312080,454000
9/20/2024,Sangeetha Munasinghe,Nuwara Eliya,Ginigathhena,Central,699,9052,9751,27960,362080,390040
9/21/2024,Sangeetha Munasinghe,Nuwara Eliya,Ginigathhena,Central,4891,9750,14641,195640,390000,585640
9/22/2024,Sangeetha Munasinghe,Nuwara Eliya,Ginigathhena,Central,9402,7025,16427,376080,281000,657080
9/23/2024,Sangeetha Munasinghe,Nuwara Eliya,Ginigathhena,Central,8972,5181,14153,358880,207240,566120
9/24/2024,Sangeetha Munasinghe,Nuwara Eliya,Ginigathhena,Central,1943,2868,4811,77720,114720,192440
9/25/2024,Sangeetha Munasinghe,Nuwara Eliya,Ginigathhena,Central,2218,3993,6211,88720,159720,248440
9/26/2024,Sangeetha Munasinghe,Nuwara Eliya,Ginigathhena,Central,3674,6062,9736,146960,242480,389440
9/27/2024,Sangeetha Munasinghe,Nuwara Eliya,Ginigathhena,Central,8293,7202,15495,331720,288080,619800
9/28/2024,Sangeetha Munasinghe,Nuwara Eliya,Ginigathhena,Central,4527,4062,8589,181080,162480,343560
9/29/2024,Sangeetha Munasinghe,Nuwara Eliya,Ginigathhena,Central,9891,4573,14464,395640,182920,578560
9/30/2024,Sangeetha Munasinghe,Nuwara Eliya,Ginigathhena,Central,8102,1041,9143,324080,41640,365720
10/1/2024,Sangeetha Munasinghe,Nuwara Eliya,Ginigathhena,Central,1141,9779,10920,45640,391160,436800
10/2/2024,Sangeetha Munasinghe,Nuwara Eliya,Ginigathhena,Central,2989,3846,6835,119560,153840,273400
10/3/2024,Sangeetha Munasinghe,Nuwara Eliya,Ginigathhena,Central,8681,363,9044,347240,14520,361760
10/4/2024,Sangeetha Munasinghe,Nuwara Eliya,Ginigathhena,Central,5679,8737,14416,227160,349480,576640
10/5/2024,Sangeetha Munasinghe,Nuwara Eliya,Ginigathhena,Central,4236,4012,8248,169440,160480,329920
10/6/2024,Sangeetha Munasinghe,Nuwara Eliya,Ginigathhena,Central,7945,9126,17071,317800,365040,682840
10/7/2024,Sangeetha Munasinghe,Nuwara Eliya,Ginigathhena,Central,5272,9922,15194,210880,396880,607760
10/8/2024,Sangeetha Munasinghe,Nuwara Eliya,Ginigathhena,Central,6076,9433,15509,243040,377320,620360
10/9/2024,Sangeetha Munasinghe,Nuwara Eliya,Ginigathhena,Central,569,924,1493,22760,36960,59720
10/10/2024,Sangeetha Munasinghe,Nuwara Eliya,Ginigathhena,Central,2691,5467,8158,107640,218680,326320
10/11/2024,Sangeetha Munasinghe,Nuwara Eliya,Ginigathhena,Central,2105,8583,10688,84200,343320,427520
10/12/2024,Sangeetha Munasinghe,Nuwara Eliya,Ginigathhena,Central,382,9364,9746,15280,374560,389840
10/13/2024,Sangeetha Munasinghe,Nuwara Eliya,Ginigathhena,Central,5256,9533,14789,210240,381320,591560
10/14/2024,Sangeetha Munasinghe,Nuwara Eliya,Ginigathhena,Central,9962,7736,17698,398480,309440,707920
10/15/2024,Sangeetha Munasinghe,Nuwara Eliya,Ginigathhena,Central,4289,4826,9115,171560,193040,364600
10/16/2024,Sangeetha Munasinghe,Nuwara Eliya,Ginigathhena,Central,8028,1317,9345,321120,52680,373800
10/17/2024,Sangeetha Munasinghe,Nuwara Eliya,Ginigathhena,Central,5685,4832,10517,227400,193280,420680
10/18/2024,Sangeetha Munasinghe,Nuwara Eliya,Ginigathhena,Central,632,54,686,25280,2160,27440
10/19/2024,Sangeetha Munasinghe,Nuwara Eliya,Ginigathhena,Central,8896,9191,18087,355840,367640,723480
10/20/2024,Sangeetha Munasinghe,Nuwara Eliya,Ginigathhena,Central,8466,6243,14709,338640,249720,588360
10/21/2024,Sangeetha Munasinghe,Nuwara Eliya,Ginigathhena,Central,8041,3325,11366,321640,133000,454640
10/22/2024,Sangeetha Munasinghe,Nuwara Eliya,Ginigathhena,Central,4404,2868,7272,176160,114720,290880
10/23/2024,Sangeetha Munasinghe,Nuwara Eliya,Ginigathhena,Central,9062,1709,10771,362480,68360,430840
10/24/2024,Sangeetha Munasinghe,Nuwara Eliya,Ginigathhena,Central,2614,2351,4965,104560,94040,198600
10/25/2024,Sangeetha Munasinghe,Nuwara Eliya,Ginigathhena,Central,1389,7041,8430,55560,281640,337200
10/26/2024,Sangeetha Munasinghe,Nuwara Eliya,Ginigathhena,Central,4727,8517,13244,189080,340680,529760
10/27/2024,Sangeetha Munasinghe,Nuwara Eliya,Ginigathhena,Central,2536,4178,6714,101440,167120,268560
10/28/2024,Sangeetha Munasinghe,Nuwara Eliya,Ginigathhena,Central,2310,3550,5860,92400,142000,234400
10/29/2024,Sangeetha Munasinghe,Nuwara Eliya,Ginigathhena,Central,6323,1565,7888,252920,62600,315520
10/30/2024,Sangeetha Munasinghe,Nuwara Eliya,Ginigathhena,Central,9311,3947,13258,372440,157880,530320
10/31/2024,Sangeetha Munasinghe,Nuwara Eliya,Ginigathhena,Central,6764,4445,11209,270560,177800,448360
11/1/2024,Sangeetha Munasinghe,Nuwara Eliya,Ginigathhena,Central,508,206,714,20320,8240,28560
11/2/2024,Sangeetha Munasinghe,Nuwara Eliya,Ginigathhena,Central,5421,6396,11817,216840,255840,472680
11/3/2024,Sangeetha Munasinghe,Nuwara Eliya,Ginigathhena,Central,9866,7295,17161,394640,291800,686440
11/4/2024,Sangeetha Munasinghe,Nuwara Eliya,Ginigathhena,Central,8178,1602,9780,327120,64080,391200
11/5/2024,Sangeetha Munasinghe,Nuwara Eliya,Ginigathhena,Central,3564,9393,12957,142560,375720,518280
11/6/2024,Sangeetha Munasinghe,Nuwara Eliya,Ginigathhena,Central,4916,2251,7167,196640,90040,286680
11/7/2024,Sangeetha Munasinghe,Nuwara Eliya,Ginigathhena,Central,6050,1523,7573,242000,60920,302920
11/8/2024,Sangeetha Munasinghe,Nuwara Eliya,Ginigathhena,Central,7369,4899,12268,294760,195960,490720
11/9/2024,Sangeetha Munasinghe,Nuwara Eliya,Ginigathhena,Central,4458,7683,12141,178320,307320,485640
11/10/2024,Sangeetha Munasinghe,Nuwara Eliya,Ginigathhena,Central,8798,5601,14399,351920,224040,575960
11/11/2024,Sangeetha Munasinghe,Nuwara Eliya,Ginigathhena,Central,3053,9682,12735,122120,387280,509400
11/12/2024,Sangeetha Munasinghe,Nuwara Eliya,Ginigathhena,Central,9717,6476,16193,388680,259040,647720
11/13/2024,Sangeetha Munasinghe,Nuwara Eliya,Ginigathhena,Central,2876,698,3574,115040,27920,142960
11/14/2024,Sangeetha Munasinghe,Nuwara Eliya,Ginigathhena,Central,9470,2776,12246,378800,111040,489840
11/15/2024,Sangeetha Munasinghe,Nuwara Eliya,Ginigathhena,Central,108,389,497,4320,15560,19880
11/16/2024,Sangeetha Munasinghe,Nuwara Eliya,Ginigathhena,Central,4065,3733,7798,162600,149320,311920
11/17/2024,Sangeetha Munasinghe,Nuwara Eliya,Ginigathhena,Central,7160,5593,12753,286400,223720,510120
11/18/2024,Sangeetha Munasinghe,Nuwara Eliya,Ginigathhena,Central,3013,9598,12611,120520,383920,504440
11/19/2024,Sangeetha Munasinghe,Nuwara Eliya,Ginigathhena,Central,3878,6771,10649,155120,270840,425960
11/20/2024,Sangeetha Munasinghe,Nuwara Eliya,Ginigathhena,Central,1367,1409,2776,54680,56360,111040
11/21/2024,Sangeetha Munasinghe,Nuwara Eliya,Ginigathhena,Central,7063,448,7511,282520,17920,300440
11/22/2024,Sangeetha Munasinghe,Nuwara Eliya,Ginigathhena,Central,1741,7077,8818,69640,283080,352720
11/23/2024,Sangeetha Munasinghe,Nuwara Eliya,Ginigathhena,Central,7653,3437,11090,306120,137480,443600
11/24/2024,Sangeetha Munasinghe,Nuwara Eliya,Ginigathhena,Central,9940,9392,19332,397600,375680,773280
11/25/2024,Sangeetha Munasinghe,Nuwara Eliya,Ginigathhena,Central,3898,3149,7047,155920,125960,281880
11/26/2024,Sangeetha Munasinghe,Nuwara Eliya,Ginigathhena,Central,7514,7978,15492,300560,319120,619680
11/27/2024,Sangeetha Munasinghe,Nuwara Eliya,Ginigathhena,Central,6956,1642,8598,278240,65680,343920
11/28/2024,Sangeetha Munasinghe,Nuwara Eliya,Ginigathhena,Central,687,5999,6686,27480,239960,267440
11/29/2024,Sangeetha Munasinghe,Nuwara Eliya,Ginigathhena,Central,548,4096,4644,21920,163840,185760
11/30/2024,Sangeetha Munasinghe,Nuwara Eliya,Ginigathhena,Central,3313,6449,9762,132520,257960,390480
12/1/2024,Sangeetha Munasinghe,Nuwara Eliya,Ginigathhena,Central,2727,4211,6938,109080,168440,277520
12/2/2024,Sangeetha Munasinghe,Nuwara Eliya,Ginigathhena,Central,5941,3599,9540,237640,143960,381600
12/3/2024,Sangeetha Munasinghe,Nuwara Eliya,Ginigathhena,Central,6872,2560,9432,274880,102400,377280
12/4/2024,Sangeetha Munasinghe,Nuwara Eliya,Ginigathhena,Central,7598,1357,8955,303920,54280,358200
12/5/2024,Sangeetha Munasinghe,Nuwara Eliya,Ginigathhena,Central,8242,3845,12087,329680,153800,483480
12/6/2024,Sangeetha Munasinghe,Nuwara Eliya,Ginigathhena,Central,9497,6291,15788,379880,251640,631520
12/7/2024,Sangeetha Munasinghe,Nuwara Eliya,Ginigathhena,Central,6266,6843,13109,250640,273720,524360
12/8/2024,Sangeetha Munasinghe,Nuwara Eliya,Ginigathhena,Central,7893,2901,10794,315720,116040,431760
12/9/2024,Sangeetha Munasinghe,Nuwara Eliya,Ginigathhena,Central,3855,6169,10024,154200,246760,400960
12/10/2024,Sangeetha Munasinghe,Nuwara Eliya,Ginigathhena,Central,7984,297,8281,319360,11880,331240
12/11/2024,Sangeetha Munasinghe,Nuwara Eliya,Ginigathhena,Central,5174,148,5322,206960,5920,212880
12/12/2024,Sangeetha Munasinghe,Nuwara Eliya,Ginigathhena,Central,1106,6945,8051,44240,277800,322040
12/13/2024,Sangeetha Munasinghe,Nuwara Eliya,Ginigathhena,Central,9507,9726,19233,380280,389040,769320
12/14/2024,Sangeetha Munasinghe,Nuwara Eliya,Ginigathhena,Central,8653,6802,15455,346120,272080,618200
12/15/2024,Sangeetha Munasinghe,Nuwara Eliya,Ginigathhena,Central,1033,9547,10580,41320,381880,423200
12/16/2024,Sangeetha Munasinghe,Nuwara Eliya,Ginigathhena,Central,5377,4413,9790,215080,176520,391600
12/17/2024,Sangeetha Munasinghe,Nuwara Eliya,Ginigathhena,Central,395,4849,5244,15800,193960,209760
12/18/2024,Sangeetha Munasinghe,Nuwara Eliya,Ginigathhena,Central,1979,4376,6355,79160,175040,254200
12/19/2024,Sangeetha Munasinghe,Nuwara Eliya,Ginigathhena,Central,2224,8588,10812,88960,343520,432480
12/20/2024,Sangeetha Munasinghe,Nuwara Eliya,Ginigathhena,Central,4604,7483,12087,184160,299320,483480
12/21/2024,Sangeetha Munasinghe,Nuwara Eliya,Ginigathhena,Central,4029,656,4685,161160,26240,187400
12/22/2024,Sangeetha Munasinghe,Nuwara Eliya,Ginigathhena,Central,4585,6844,11429,183400,273760,457160
12/23/2024,Sangeetha Munasinghe,Nuwara Eliya,Ginigathhena,Central,7766,9257,17023,310640,370280,680920
12/24/2024,Sangeetha Munasinghe,Nuwara Eliya,Ginigathhena,Central,7224,2583,9807,288960,103320,392280
12/25/2024,Sangeetha Munasinghe,Nuwara Eliya,Ginigathhena,Central,6009,6195,12204,240360,247800,488160
12/26/2024,Sangeetha Munasinghe,Nuwara Eliya,Ginigathhena,Central,3450,3359,6809,138000,134360,272360
12/27/2024,Sangeetha Munasinghe,Nuwara Eliya,Ginigathhena,Central,797,6728,7525,31880,269120,301000
12/28/2024,Sangeetha Munasinghe,Nuwara Eliya,Ginigathhena,Central,5850,6005,11855,234000,240200,474200
12/29/2024,Sangeetha Munasinghe,Nuwara Eliya,Ginigathhena,Central,8895,1352,10247,355800,54080,409880
12/30/2024,Sangeetha Munasinghe,Nuwara Eliya,Ginigathhena,Central,2990,9966,12956,119600,398640,518240
12/31/2024,Sangeetha Munasinghe,Nuwara Eliya,Ginigathhena,Central,3350,7962,11312,134000,318480,452480
1/1/2025,Sangeetha Munasinghe,Nuwara Eliya,Ginigathhena,Central,5223,7721,12944,208920,308840,517760
1/2/2025,Sangeetha Munasinghe,Nuwara Eliya,Ginigathhena,Central,2856,5550,8406,114240,222000,336240
1/3/2025,Sangeetha Munasinghe,Nuwara Eliya,Ginigathhena,Central,4429,7449,11878,177160,297960,475120
1/4/2025,Sangeetha Munasinghe,Nuwara Eliya,Ginigathhena,Central,8429,6406,14835,337160,256240,593400
1/5/2025,Sangeetha Munasinghe,Nuwara Eliya,Ginigathhena,Central,8286,9090,17376,331440,363600,695040
1/6/2025,Sangeetha Munasinghe,Nuwara Eliya,Ginigathhena,Central,4367,8696,13063,174680,347840,522520
1/7/2025,Sangeetha Munasinghe,Nuwara Eliya,Ginigathhena,Central,7678,6672,14350,307120,266880,574000
1/8/2025,Sangeetha Munasinghe,Nuwara Eliya,Ginigathhena,Central,4282,8495,12777,171280,339800,511080
1/9/2025,Sangeetha Munasinghe,Nuwara Eliya,Ginigathhena,Central,5747,5124,10871,229880,204960,434840
1/10/2025,Sangeetha Munasinghe,Nuwara Eliya,Ginigathhena,Central,7089,7798,14887,283560,311920,595480
1/11/2025,Sangeetha Munasinghe,Nuwara Eliya,Ginigathhena,Central,3751,4314,8065,150040,172560,322600
1/12/2025,Sangeetha Munasinghe,Nuwara Eliya,Ginigathhena,Central,3837,6466,10303,153480,258640,412120
1/13/2025,Sangeetha Munasinghe,Nuwara Eliya,Ginigathhena,Central,7355,2796,10151,294200,111840,406040
1/14/2025,Sangeetha Munasinghe,Nuwara Eliya,Ginigathhena,Central,1693,8915,10608,67720,356600,424320
1/15/2025,Sangeetha Munasinghe,Nuwara Eliya,Ginigathhena,Central,3775,4780,8555,151000,191200,342200
1/16/2025,Sangeetha Munasinghe,Nuwara Eliya,Ginigathhena,Central,1979,232,2211,79160,9280,88440
1/17/2025,Sangeetha Munasinghe,Nuwara Eliya,Ginigathhena,Central,901,7070,7971,36040,282800,318840
1/18/2025,Sangeetha Munasinghe,Nuwara Eliya,Ginigathhena,Central,6384,2235,8619,255360,89400,344760
1/19/2025,Sangeetha Munasinghe,Nuwara Eliya,Ginigathhena,Central,1268,2639,3907,50720,105560,156280
1/20/2025,Sangeetha Munasinghe,Nuwara Eliya,Ginigathhena,Central,9495,1093,10588,379800,43720,423520
1/21/2025,Sangeetha Munasinghe,Nuwara Eliya,Ginigathhena,Central,7398,2487,9885,295920,99480,395400
1/22/2025,Sangeetha Munasinghe,Nuwara Eliya,Ginigathhena,Central,6442,9588,16030,257680,383520,641200
1/23/2025,Sangeetha Munasinghe,Nuwara Eliya,Ginigathhena,Central,4620,198,4818,184800,7920,192720
1/24/2025,Sangeetha Munasinghe,Nuwara Eliya,Ginigathhena,Central,9741,3180,12921,389640,127200,516840
1/25/2025,Sangeetha Munasinghe,Nuwara Eliya,Ginigathhena,Central,7804,9577,17381,312160,383080,695240
1/26/2025,Sangeetha Munasinghe,Nuwara Eliya,Ginigathhena,Central,3080,3140,6220,123200,125600,248800
1/27/2025,Sangeetha Munasinghe,Nuwara Eliya,Ginigathhena,Central,2840,9004,11844,113600,360160,473760
1/28/2025,Sangeetha Munasinghe,Nuwara Eliya,Ginigathhena,Central,9517,4378,13895,380680,175120,555800
1/29/2025,Sangeetha Munasinghe,Nuwara Eliya,Ginigathhena,Central,9259,3811,13070,370360,152440,522800
1/30/2025,Sangeetha Munasinghe,Nuwara Eliya,Ginigathhena,Central,3852,9225,13077,154080,369000,523080
1/31/2025,Sangeetha Munasinghe,Nuwara Eliya,Ginigathhena,Central,4068,8237,12305,162720,329480,492200
2/1/2025,Sangeetha Munasinghe,Nuwara Eliya,Ginigathhena,Central,3346,7061,10407,133840,282440,416280
2/2/2025,Sangeetha Munasinghe,Nuwara Eliya,Ginigathhena,Central,9751,800,10551,390040,32000,422040
2/3/2025,Sangeetha Munasinghe,Nuwara Eliya,Ginigathhena,Central,9406,8877,18283,376240,355080,731320
2/4/2025,Sangeetha Munasinghe,Nuwara Eliya,Ginigathhena,Central,320,1351,1671,12800,54040,66840
2/5/2025,Sangeetha Munasinghe,Nuwara Eliya,Ginigathhena,Central,9126,6516,15642,365040,260640,625680
2/6/2025,Sangeetha Munasinghe,Nuwara Eliya,Ginigathhena,Central,3398,1015,4413,135920,40600,176520
2/7/2025,Sangeetha Munasinghe,Nuwara Eliya,Ginigathhena,Central,3905,2918,6823,156200,116720,272920
2/8/2025,Sangeetha Munasinghe,Nuwara Eliya,Ginigathhena,Central,4461,4837,9298,178440,193480,371920
2/9/2025,Sangeetha Munasinghe,Nuwara Eliya,Ginigathhena,Central,8895,4079,12974,355800,163160,518960
2/10/2025,Sangeetha Munasinghe,Nuwara Eliya,Ginigathhena,Central,7658,5439,13097,306320,217560,523880
2/11/2025,Sangeetha Munasinghe,Nuwara Eliya,Ginigathhena,Central,9841,6882,16723,393640,275280,668920
2/12/2025,Sangeetha Munasinghe,Nuwara Eliya,Ginigathhena,Central,378,432,810,15120,17280,32400
2/13/2025,Sangeetha Munasinghe,Nuwara Eliya,Ginigathhena,Central,8919,3170,12089,356760,126800,483560
2/14/2025,Sangeetha Munasinghe,Nuwara Eliya,Ginigathhena,Central,3094,370,3464,123760,14800,138560
2/15/2025,Sangeetha Munasinghe,Nuwara Eliya,Ginigathhena,Central,1963,9219,11182,78520,368760,447280
2/16/2025,Sangeetha Munasinghe,Nuwara Eliya,Ginigathhena,Central,6395,3208,9603,255800,128320,384120
2/17/2025,Sangeetha Munasinghe,Nuwara Eliya,Ginigathhena,Central,3462,8789,12251,138480,351560,490040
2/18/2025,Sangeetha Munasinghe,Nuwara Eliya,Ginigathhena,Central,6231,8173,14404,249240,326920,576160
2/19/2025,Sangeetha Munasinghe,Nuwara Eliya,Ginigathhena,Central,6466,4195,10661,258640,167800,426440
2/20/2025,Sangeetha Munasinghe,Nuwara Eliya,Ginigathhena,Central,1275,3248,4523,51000,129920,180920
2/21/2025,Sangeetha Munasinghe,Nuwara Eliya,Ginigathhena,Central,8091,906,8997,323640,36240,359880
2/22/2025,Sangeetha Munasinghe,Nuwara Eliya,Ginigathhena,Central,9520,4437,13957,380800,177480,558280
2/23/2025,Sangeetha Munasinghe,Nuwara Eliya,Ginigathhena,Central,5325,1843,7168,213000,73720,286720
2/24/2025,Sangeetha Munasinghe,Nuwara Eliya,Ginigathhena,Central,5957,922,6879,238280,36880,275160
2/25/2025,Sangeetha Munasinghe,Nuwara Eliya,Ginigathhena,Central,5122,1379,6501,204880,55160,260040
2/26/2025,Sangeetha Munasinghe,Nuwara Eliya,Ginigathhena,Central,4877,5545,10422,195080,221800,416880
2/27/2025,Sangeetha Munasinghe,Nuwara Eliya,Ginigathhena,Central,5771,2387,8158,230840,95480,326320
2/28/2025,Sangeetha Munasinghe,Nuwara Eliya,Ginigathhena,Central,6268,731,6999,250720,29240,279960
3/1/2025,Sangeetha Munasinghe,Nuwara Eliya,Ginigathhena,Central,1371,989,2360,54840,39560,94400
3/2/2025,Sangeetha Munasinghe,Nuwara Eliya,Ginigathhena,Central,8793,5285,14078,351720,211400,563120
3/3/2025,Sangeetha Munasinghe,Nuwara Eliya,Ginigathhena,Central,1858,9055,10913,74320,362200,436520
3/4/2025,Sangeetha Munasinghe,Nuwara Eliya,Ginigathhena,Central,2518,4215,6733,100720,168600,269320
3/5/2025,Sangeetha Munasinghe,Nuwara Eliya,Ginigathhena,Central,5836,1143,6979,233440,45720,279160
3/6/2025,Sangeetha Munasinghe,Nuwara Eliya,Ginigathhena,Central,7082,5840,12922,283280,233600,516880
3/7/2025,Sangeetha Munasinghe,Nuwara Eliya,Ginigathhena,Central,8119,7442,15561,324760,297680,622440
3/8/2025,Sangeetha Munasinghe,Nuwara Eliya,Ginigathhena,Central,1287,1680,2967,51480,67200,118680
3/9/2025,Sangeetha Munasinghe,Nuwara Eliya,Ginigathhena,Central,2986,4100,7086,119440,164000,283440
3/10/2025,Sangeetha Munasinghe,Nuwara Eliya,Ginigathhena,Central,176,9463,9639,7040,378520,385560
3/11/2025,Sangeetha Munasinghe,Nuwara Eliya,Ginigathhena,Central,4341,779,5120,173640,31160,204800
3/12/2025,Sangeetha Munasinghe,Nuwara Eliya,Ginigathhena,Central,6979,1861,8840,279160,74440,353600
3/13/2025,Sangeetha Munasinghe,Nuwara Eliya,Ginigathhena,Central,8585,4849,13434,343400,193960,537360
3/14/2025,Sangeetha Munasinghe,Nuwara Eliya,Ginigathhena,Central,433,3816,4249,17320,152640,169960
3/15/2025,Sangeetha Munasinghe,Nuwara Eliya,Ginigathhena,Central,9656,2564,12220,386240,102560,488800
3/16/2025,Sangeetha Munasinghe,Nuwara Eliya,Ginigathhena,Central,6945,7397,14342,277800,295880,573680
3/17/2025,Sangeetha Munasinghe,Nuwara Eliya,Ginigathhena,Central,9899,822,10721,395960,32880,428840
3/18/2025,Sangeetha Munasinghe,Nuwara Eliya,Ginigathhena,Central,8626,645,9271,345040,25800,370840
3/19/2025,Sangeetha Munasinghe,Nuwara Eliya,Ginigathhena,Central,5834,8371,14205,233360,334840,568200
3/20/2025,Sangeetha Munasinghe,Nuwara Eliya,Ginigathhena,Central,1753,6766,8519,70120,270640,340760
3/21/2025,Sangeetha Munasinghe,Nuwara Eliya,Ginigathhena,Central,4926,3560,8486,197040,142400,339440
3/22/2025,Sangeetha Munasinghe,Nuwara Eliya,Ginigathhena,Central,2111,599,2710,84440,23960,108400
3/23/2025,Sangeetha Munasinghe,Nuwara Eliya,Ginigathhena,Central,7507,4606,12113,300280,184240,484520
3/25/2024,Pradeep Kumara,Kurunegala,Melsiripura,North Western,3790,1151,4941,151600,46040,197640
3/26/2024,Pradeep Kumara,Kurunegala,Melsiripura,North Western,9445,1405,10850,377800,56200,434000
3/27/2024,Pradeep Kumara,Kurunegala,Melsiripura,North Western,4998,2485,7483,199920,99400,299320
3/28/2024,Pradeep Kumara,Kurunegala,Melsiripura,North Western,8098,2147,10245,323920,85880,409800
3/29/2024,Pradeep Kumara,Kurunegala,Melsiripura,North Western,4847,7018,11865,193880,280720,474600
3/30/2024,Pradeep Kumara,Kurunegala,Melsiripura,North Western,8706,7327,16033,348240,293080,641320
3/31/2024,Pradeep Kumara,Kurunegala,Melsiripura,North Western,6243,6539,12782,249720,261560,511280
4/1/2024,Pradeep Kumara,Kurunegala,Melsiripura,North Western,7861,863,8724,314440,34520,348960
4/2/2024,Pradeep Kumara,Kurunegala,Melsiripura,North Western,2891,5793,8684,115640,231720,347360
4/3/2024,Pradeep Kumara,Kurunegala,Melsiripura,North Western,1900,6050,7950,76000,242000,318000
4/4/2024,Pradeep Kumara,Kurunegala,Melsiripura,North Western,8665,4165,12830,346600,166600,513200
4/5/2024,Pradeep Kumara,Kurunegala,Melsiripura,North Western,627,2767,3394,25080,110680,135760
4/6/2024,Pradeep Kumara,Kurunegala,Melsiripura,North Western,1344,2478,3822,53760,99120,152880
4/7/2024,Pradeep Kumara,Kurunegala,Melsiripura,North Western,5333,7913,13246,213320,316520,529840
4/8/2024,Pradeep Kumara,Kurunegala,Melsiripura,North Western,2467,6202,8669,98680,248080,346760
4/9/2024,Pradeep Kumara,Kurunegala,Melsiripura,North Western,8356,5961,14317,334240,238440,572680
4/10/2024,Pradeep Kumara,Kurunegala,Melsiripura,North Western,7597,7334,14931,303880,293360,597240
4/11/2024,Pradeep Kumara,Kurunegala,Melsiripura,North Western,6597,2477,9074,263880,99080,362960
4/19/2024,Pradeep Kumara,Kurunegala,Melsiripura,North Western,7106,4976,12082,284240,199040,483280
4/20/2024,Pradeep Kumara,Kurunegala,Melsiripura,North Western,5949,3482,9431,237960,139280,377240
4/21/2024,Pradeep Kumara,Kurunegala,Melsiripura,North Western,6203,6819,13022,248120,272760,520880
4/22/2024,Pradeep Kumara,Kurunegala,Melsiripura,North Western,8062,9397,17459,322480,375880,698360
4/23/2024,Pradeep Kumara,Kurunegala,Melsiripura,North Western,7561,6212,13773,302440,248480,550920
4/24/2024,Pradeep Kumara,Kurunegala,Melsiripura,North Western,4520,8450,12970,180800,338000,518800
4/25/2024,Pradeep Kumara,Kurunegala,Melsiripura,North Western,950,4931,5881,38000,197240,235240
4/26/2024,Pradeep Kumara,Kurunegala,Melsiripura,North Western,287,1077,1364,11480,43080,54560
4/27/2024,Pradeep Kumara,Kurunegala,Melsiripura,North Western,5607,4380,9987,224280,175200,399480
4/28/2024,Pradeep Kumara,Kurunegala,Melsiripura,North Western,7840,7164,15004,313600,286560,600160
4/29/2024,Pradeep Kumara,Kurunegala,Melsiripura,North Western,560,5651,6211,22400,226040,248440
4/30/2024,Pradeep Kumara,Kurunegala,Melsiripura,North Western,7153,7820,14973,286120,312800,598920
5/1/2024,Pradeep Kumara,Kurunegala,Melsiripura,North Western,2369,4263,6632,94760,170520,265280
5/2/2024,Pradeep Kumara,Kurunegala,Melsiripura,North Western,7911,6036,13947,316440,241440,557880
5/3/2024,Pradeep Kumara,Kurunegala,Melsiripura,North Western,9517,2487,12004,380680,99480,480160
5/4/2024,Pradeep Kumara,Kurunegala,Melsiripura,North Western,8601,1313,9914,344040,52520,396560
5/5/2024,Pradeep Kumara,Kurunegala,Melsiripura,North Western,6243,4798,11041,249720,191920,441640
5/6/2024,Pradeep Kumara,Kurunegala,Melsiripura,North Western,8346,6958,15304,333840,278320,612160
5/7/2024,Pradeep Kumara,Kurunegala,Melsiripura,North Western,9317,3950,13267,372680,158000,530680
5/8/2024,Pradeep Kumara,Kurunegala,Melsiripura,North Western,1519,7188,8707,60760,287520,348280
5/9/2024,Pradeep Kumara,Kurunegala,Melsiripura,North Western,7195,9649,16844,287800,385960,673760
5/10/2024,Pradeep Kumara,Kurunegala,Melsiripura,North Western,2420,9845,12265,96800,393800,490600
5/11/2024,Pradeep Kumara,Kurunegala,Melsiripura,North Western,436,5814,6250,17440,232560,250000
5/12/2024,Pradeep Kumara,Kurunegala,Melsiripura,North Western,7392,1594,8986,295680,63760,359440
5/13/2024,Pradeep Kumara,Kurunegala,Melsiripura,North Western,37,9764,9801,1480,390560,392040
5/14/2024,Pradeep Kumara,Kurunegala,Melsiripura,North Western,1736,6950,8686,69440,278000,347440
5/15/2024,Pradeep Kumara,Kurunegala,Melsiripura,North Western,7681,9925,17606,307240,397000,704240
5/16/2024,Pradeep Kumara,Kurunegala,Melsiripura,North Western,3142,6637,9779,125680,265480,391160
5/17/2024,Pradeep Kumara,Kurunegala,Melsiripura,North Western,302,4007,4309,12080,160280,172360
5/18/2024,Pradeep Kumara,Kurunegala,Melsiripura,North Western,1514,5645,7159,60560,225800,286360
5/19/2024,Pradeep Kumara,Kurunegala,Melsiripura,North Western,9012,5829,14841,360480,233160,593640
5/20/2024,Pradeep Kumara,Kurunegala,Melsiripura,North Western,7397,749,8146,295880,29960,325840
5/21/2024,Pradeep Kumara,Kurunegala,Melsiripura,North Western,9407,1337,10744,376280,53480,429760
5/22/2024,Pradeep Kumara,Kurunegala,Melsiripura,North Western,3349,8198,11547,133960,327920,461880
5/24/2024,Pradeep Kumara,Kurunegala,Melsiripura,North Western,3096,8095,11191,123840,323800,447640
5/25/2024,Pradeep Kumara,Kurunegala,Melsiripura,North Western,2774,5015,7789,110960,200600,311560
5/26/2024,Pradeep Kumara,Kurunegala,Melsiripura,North Western,3140,1742,4882,125600,69680,195280
5/27/2024,Pradeep Kumara,Kurunegala,Melsiripura,North Western,6852,60,6912,274080,2400,276480
5/28/2024,Pradeep Kumara,Kurunegala,Melsiripura,North Western,8126,1584,9710,325040,63360,388400
5/29/2024,Pradeep Kumara,Kurunegala,Melsiripura,North Western,475,2906,3381,19000,116240,135240
5/30/2024,Pradeep Kumara,Kurunegala,Melsiripura,North Western,7971,6927,14898,318840,277080,595920
5/31/2024,Pradeep Kumara,Kurunegala,Melsiripura,North Western,5532,3167,8699,221280,126680,347960
6/1/2024,Pradeep Kumara,Kurunegala,Melsiripura,North Western,3062,7975,11037,122480,319000,441480
6/2/2024,Pradeep Kumara,Kurunegala,Melsiripura,North Western,8001,6972,14973,320040,278880,598920
6/3/2024,Pradeep Kumara,Kurunegala,Melsiripura,North Western,6891,8927,15818,275640,357080,632720
6/4/2024,Pradeep Kumara,Kurunegala,Melsiripura,North Western,9255,9402,18657,370200,376080,746280
6/5/2024,Pradeep Kumara,Kurunegala,Melsiripura,North Western,1488,7236,8724,59520,289440,348960
6/6/2024,Pradeep Kumara,Kurunegala,Melsiripura,North Western,3213,2565,5778,128520,102600,231120
6/7/2024,Pradeep Kumara,Kurunegala,Melsiripura,North Western,8110,2545,10655,324400,101800,426200
6/8/2024,Pradeep Kumara,Kurunegala,Melsiripura,North Western,2296,1536,3832,91840,61440,153280
6/9/2024,Pradeep Kumara,Kurunegala,Melsiripura,North Western,8948,7615,16563,357920,304600,662520
6/10/2024,Pradeep Kumara,Kurunegala,Melsiripura,North Western,1702,6341,8043,68080,253640,321720
6/11/2024,Pradeep Kumara,Kurunegala,Melsiripura,North Western,7690,6776,14466,307600,271040,578640
6/12/2024,Pradeep Kumara,Kurunegala,Melsiripura,North Western,5032,2949,7981,201280,117960,319240
6/13/2024,Pradeep Kumara,Kurunegala,Melsiripura,North Western,7680,2896,10576,307200,115840,423040
6/14/2024,Pradeep Kumara,Kurunegala,Melsiripura,North Western,2326,3092,5418,93040,123680,216720
6/15/2024,Pradeep Kumara,Kurunegala,Melsiripura,North Western,2410,8800,11210,96400,352000,448400
6/16/2024,Pradeep Kumara,Kurunegala,Melsiripura,North Western,770,1257,2027,30800,50280,81080
6/17/2024,Pradeep Kumara,Kurunegala,Melsiripura,North Western,3389,8098,11487,135560,323920,459480
6/18/2024,Pradeep Kumara,Kurunegala,Melsiripura,North Western,914,52,966,36560,2080,38640
6/19/2024,Pradeep Kumara,Kurunegala,Melsiripura,North Western,2802,9378,12180,112080,375120,487200
6/20/2024,Pradeep Kumara,Kurunegala,Melsiripura,North Western,4721,6462,11183,188840,258480,447320
6/21/2024,Pradeep Kumara,Kurunegala,Melsiripura,North Western,1178,2141,3319,47120,85640,132760
6/22/2024,Pradeep Kumara,Kurunegala,Melsiripura,North Western,2074,2074,4148,82960,82960,165920
6/23/2024,Pradeep Kumara,Kurunegala,Melsiripura,North Western,8866,702,9568,354640,28080,382720
6/24/2024,Pradeep Kumara,Kurunegala,Melsiripura,North Western,7105,2510,9615,284200,100400,384600
6/25/2024,Pradeep Kumara,Kurunegala,Melsiripura,North Western,9555,379,9934,382200,15160,397360
6/26/2024,Pradeep Kumara,Kurunegala,Melsiripura,North Western,2960,5840,8800,118400,233600,352000
6/27/2024,Pradeep Kumara,Kurunegala,Melsiripura,North Western,2604,8298,10902,104160,331920,436080
6/28/2024,Pradeep Kumara,Kurunegala,Melsiripura,North Western,1418,2152,3570,56720,86080,142800
6/29/2024,Pradeep Kumara,Kurunegala,Melsiripura,North Western,3996,9940,13936,159840,397600,557440
6/30/2024,Pradeep Kumara,Kurunegala,Melsiripura,North Western,3748,99,3847,149920,3960,153880
7/1/2024,Pradeep Kumara,Kurunegala,Melsiripura,North Western,5657,8435,14092,226280,337400,563680
7/2/2024,Pradeep Kumara,Kurunegala,Melsiripura,North Western,7356,7807,15163,294240,312280,606520
7/3/2024,Pradeep Kumara,Kurunegala,Melsiripura,North Western,4523,4776,9299,180920,191040,371960
7/4/2024,Pradeep Kumara,Kurunegala,Melsiripura,North Western,4001,9405,13406,160040,376200,536240
7/5/2024,Pradeep Kumara,Kurunegala,Melsiripura,North Western,6513,8012,14525,260520,320480,581000
7/6/2024,Pradeep Kumara,Kurunegala,Melsiripura,North Western,7511,9397,16908,300440,375880,676320
7/7/2024,Pradeep Kumara,Kurunegala,Melsiripura,North Western,2138,5570,7708,85520,222800,308320
7/8/2024,Pradeep Kumara,Kurunegala,Melsiripura,North Western,730,4496,5226,29200,179840,209040
7/9/2024,Pradeep Kumara,Kurunegala,Melsiripura,North Western,989,533,1522,39560,21320,60880
7/10/2024,Pradeep Kumara,Kurunegala,Melsiripura,North Western,663,2095,2758,26520,83800,110320
7/11/2024,Pradeep Kumara,Kurunegala,Melsiripura,North Western,5180,1888,7068,207200,75520,282720
7/12/2024,Pradeep Kumara,Kurunegala,Melsiripura,North Western,5524,7672,13196,220960,306880,527840
7/13/2024,Pradeep Kumara,Kurunegala,Melsiripura,North Western,8864,5977,14841,354560,239080,593640
7/14/2024,Pradeep Kumara,Kurunegala,Melsiripura,North Western,4867,3905,8772,194680,156200,350880
7/15/2024,Pradeep Kumara,Kurunegala,Melsiripura,North Western,5415,5653,11068,216600,226120,442720
7/16/2024,Pradeep Kumara,Kurunegala,Melsiripura,North Western,1830,6305,8135,73200,252200,325400
7/17/2024,Pradeep Kumara,Kurunegala,Melsiripura,North Western,9611,8925,18536,384440,357000,741440
7/18/2024,Pradeep Kumara,Kurunegala,Melsiripura,North Western,1440,1766,3206,57600,70640,128240
7/19/2024,Pradeep Kumara,Kurunegala,Melsiripura,North Western,3437,8949,12386,137480,357960,495440
7/20/2024,Pradeep Kumara,Kurunegala,Melsiripura,North Western,7430,2240,9670,297200,89600,386800
7/21/2024,Pradeep Kumara,Kurunegala,Melsiripura,North Western,7271,2298,9569,290840,91920,382760
7/22/2024,Pradeep Kumara,Kurunegala,Melsiripura,North Western,252,626,878,10080,25040,35120
7/23/2024,Pradeep Kumara,Kurunegala,Melsiripura,North Western,9377,3436,12813,375080,137440,512520
7/24/2024,Pradeep Kumara,Kurunegala,Melsiripura,North Western,9480,6119,15599,379200,244760,623960
7/25/2024,Pradeep Kumara,Kurunegala,Melsiripura,North Western,5321,281,5602,212840,11240,224080
7/26/2024,Pradeep Kumara,Kurunegala,Melsiripura,North Western,6874,108,6982,274960,4320,279280
7/27/2024,Pradeep Kumara,Kurunegala,Melsiripura,North Western,5293,9284,14577,211720,371360,583080
7/28/2024,Pradeep Kumara,Kurunegala,Melsiripura,North Western,1237,4525,5762,49480,181000,230480
7/29/2024,Pradeep Kumara,Kurunegala,Melsiripura,North Western,3040,3692,6732,121600,147680,269280
7/30/2024,Pradeep Kumara,Kurunegala,Melsiripura,North Western,6223,1925,8148,248920,77000,325920
7/31/2024,Pradeep Kumara,Kurunegala,Melsiripura,North Western,6075,1301,7376,243000,52040,295040
8/1/2024,Pradeep Kumara,Kurunegala,Melsiripura,North Western,7932,3924,11856,317280,156960,474240
8/2/2024,Pradeep Kumara,Kurunegala,Melsiripura,North Western,2370,2961,5331,94800,118440,213240
8/3/2024,Pradeep Kumara,Kurunegala,Melsiripura,North Western,9487,1579,11066,379480,63160,442640
8/4/2024,Pradeep Kumara,Kurunegala,Melsiripura,North Western,3554,6414,9968,142160,256560,398720
8/5/2024,Pradeep Kumara,Kurunegala,Melsiripura,North Western,3774,4482,8256,150960,179280,330240
8/6/2024,Pradeep Kumara,Kurunegala,Melsiripura,North Western,8358,7100,15458,334320,284000,618320
8/7/2024,Pradeep Kumara,Kurunegala,Melsiripura,North Western,5153,2139,7292,206120,85560,291680
8/8/2024,Pradeep Kumara,Kurunegala,Melsiripura,North Western,236,4707,4943,9440,188280,197720
8/9/2024,Pradeep Kumara,Kurunegala,Melsiripura,North Western,4795,5283,10078,191800,211320,403120
8/10/2024,Pradeep Kumara,Kurunegala,Melsiripura,North Western,5194,8168,13362,207760,326720,534480
8/11/2024,Pradeep Kumara,Kurunegala,Melsiripura,North Western,8807,7583,16390,352280,303320,655600
8/12/2024,Pradeep Kumara,Kurunegala,Melsiripura,North Western,3323,5310,8633,132920,212400,345320
8/13/2024,Pradeep Kumara,Kurunegala,Melsiripura,North Western,9283,9243,18526,371320,369720,741040
8/14/2024,Pradeep Kumara,Kurunegala,Melsiripura,North Western,4914,701,5615,196560,28040,224600
8/15/2024,Pradeep Kumara,Kurunegala,Melsiripura,North Western,7444,869,8313,297760,34760,332520
8/16/2024,Pradeep Kumara,Kurunegala,Melsiripura,North Western,517,1424,1941,20680,56960,77640
8/17/2024,Pradeep Kumara,Kurunegala,Melsiripura,North Western,9347,8069,17416,373880,322760,696640
8/18/2024,Pradeep Kumara,Kurunegala,Melsiripura,North Western,8772,1295,10067,350880,51800,402680
8/19/2024,Pradeep Kumara,Kurunegala,Melsiripura,North Western,5956,5795,11751,238240,231800,470040
8/20/2024,Pradeep Kumara,Kurunegala,Melsiripura,North Western,4329,2699,7028,173160,107960,281120
8/21/2024,Pradeep Kumara,Kurunegala,Melsiripura,North Western,9179,9970,19149,367160,398800,765960
8/22/2024,Pradeep Kumara,Kurunegala,Melsiripura,North Western,7630,7621,15251,305200,304840,610040
8/23/2024,Pradeep Kumara,Kurunegala,Melsiripura,North Western,1153,6590,7743,46120,263600,309720
8/24/2024,Pradeep Kumara,Kurunegala,Melsiripura,North Western,2264,8127,10391,90560,325080,415640
8/25/2024,Pradeep Kumara,Kurunegala,Melsiripura,North Western,2579,5486,8065,103160,219440,322600
8/26/2024,Pradeep Kumara,Kurunegala,Melsiripura,North Western,9155,2917,12072,366200,116680,482880
8/27/2024,Pradeep Kumara,Kurunegala,Melsiripura,North Western,174,4976,5150,6960,199040,206000
8/28/2024,Pradeep Kumara,Kurunegala,Melsiripura,North Western,611,7449,8060,24440,297960,322400
8/29/2024,Pradeep Kumara,Kurunegala,Melsiripura,North Western,9900,2325,12225,396000,93000,489000
8/30/2024,Pradeep Kumara,Kurunegala,Melsiripura,North Western,5314,2413,7727,212560,96520,309080
8/31/2024,Pradeep Kumara,Kurunegala,Melsiripura,North Western,8243,4813,13056,329720,192520,522240
9/1/2024,Pradeep Kumara,Kurunegala,Melsiripura,North Western,8251,4523,12774,330040,180920,510960
9/2/2024,Pradeep Kumara,Kurunegala,Melsiripura,North Western,8767,1663,10430,350680,66520,417200
9/3/2024,Pradeep Kumara,Kurunegala,Melsiripura,North Western,6148,7664,13812,245920,306560,552480
9/4/2024,Pradeep Kumara,Kurunegala,Melsiripura,North Western,789,5946,6735,31560,237840,269400
9/5/2024,Pradeep Kumara,Kurunegala,Melsiripura,North Western,2417,6386,8803,96680,255440,352120
9/6/2024,Pradeep Kumara,Kurunegala,Melsiripura,North Western,7359,3464,10823,294360,138560,432920
9/7/2024,Pradeep Kumara,Kurunegala,Melsiripura,North Western,7251,3359,10610,290040,134360,424400
9/8/2024,Pradeep Kumara,Kurunegala,Melsiripura,North Western,9457,9846,19303,378280,393840,772120
9/9/2024,Pradeep Kumara,Kurunegala,Melsiripura,North Western,9572,7842,17414,382880,313680,696560
9/10/2024,Pradeep Kumara,Kurunegala,Melsiripura,North Western,8543,4813,13356,341720,192520,534240
9/11/2024,Pradeep Kumara,Kurunegala,Melsiripura,North Western,8698,2310,11008,347920,92400,440320
9/12/2024,Pradeep Kumara,Kurunegala,Melsiripura,North Western,5215,7972,13187,208600,318880,527480
9/13/2024,Pradeep Kumara,Kurunegala,Melsiripura,North Western,8819,8036,16855,352760,321440,674200
9/14/2024,Pradeep Kumara,Kurunegala,Melsiripura,North Western,65,7047,7112,2600,281880,284480
9/15/2024,Pradeep Kumara,Kurunegala,Melsiripura,North Western,407,3939,4346,16280,157560,173840
9/16/2024,Pradeep Kumara,Kurunegala,Melsiripura,North Western,5709,8359,14068,228360,334360,562720
9/17/2024,Pradeep Kumara,Kurunegala,Melsiripura,North Western,9357,9130,18487,374280,365200,739480
9/18/2024,Pradeep Kumara,Kurunegala,Melsiripura,North Western,8956,5659,14615,358240,226360,584600
9/19/2024,Pradeep Kumara,Kurunegala,Melsiripura,North Western,727,4220,4947,29080,168800,197880
9/20/2024,Pradeep Kumara,Kurunegala,Melsiripura,North Western,1752,5360,7112,70080,214400,284480
9/21/2024,Pradeep Kumara,Kurunegala,Melsiripura,North Western,4588,9598,14186,183520,383920,567440
9/22/2024,Pradeep Kumara,Kurunegala,Melsiripura,North Western,3209,2095,5304,128360,83800,212160
9/23/2024,Pradeep Kumara,Kurunegala,Melsiripura,North Western,3001,4662,7663,120040,186480,306520
9/24/2024,Pradeep Kumara,Kurunegala,Melsiripura,North Western,3076,7137,10213,123040,285480,408520
9/25/2024,Pradeep Kumara,Kurunegala,Melsiripura,North Western,3519,9928,13447,140760,397120,537880
9/26/2024,Pradeep Kumara,Kurunegala,Melsiripura,North Western,717,1454,2171,28680,58160,86840
9/27/2024,Pradeep Kumara,Kurunegala,Melsiripura,North Western,4449,8665,13114,177960,346600,524560
9/28/2024,Pradeep Kumara,Kurunegala,Melsiripura,North Western,3952,29,3981,158080,1160,159240
9/29/2024,Pradeep Kumara,Kurunegala,Melsiripura,North Western,9961,214,10175,398440,8560,407000
9/30/2024,Pradeep Kumara,Kurunegala,Melsiripura,North Western,8660,4277,12937,346400,171080,517480
10/1/2024,Pradeep Kumara,Kurunegala,Melsiripura,North Western,3815,3854,7669,152600,154160,306760
10/2/2024,Pradeep Kumara,Kurunegala,Melsiripura,North Western,5100,6983,12083,204000,279320,483320
10/3/2024,Pradeep Kumara,Kurunegala,Melsiripura,North Western,4244,5540,9784,169760,221600,391360
10/4/2024,Pradeep Kumara,Kurunegala,Melsiripura,North Western,2048,9096,11144,81920,363840,445760
10/5/2024,Pradeep Kumara,Kurunegala,Melsiripura,North Western,3466,5119,8585,138640,204760,343400
10/6/2024,Pradeep Kumara,Kurunegala,Melsiripura,North Western,5350,1965,7315,214000,78600,292600
10/7/2024,Pradeep Kumara,Kurunegala,Melsiripura,North Western,788,7065,7853,31520,282600,314120
10/8/2024,Pradeep Kumara,Kurunegala,Melsiripura,North Western,9344,4556,13900,373760,182240,556000
10/9/2024,Pradeep Kumara,Kurunegala,Melsiripura,North Western,7107,8671,15778,284280,346840,631120
10/10/2024,Pradeep Kumara,Kurunegala,Melsiripura,North Western,2691,6456,9147,107640,258240,365880
10/11/2024,Pradeep Kumara,Kurunegala,Melsiripura,North Western,1868,3973,5841,74720,158920,233640
10/12/2024,Pradeep Kumara,Kurunegala,Melsiripura,North Western,4413,1887,6300,176520,75480,252000
10/13/2024,Pradeep Kumara,Kurunegala,Melsiripura,North Western,1042,3938,4980,41680,157520,199200
10/14/2024,Pradeep Kumara,Kurunegala,Melsiripura,North Western,2175,1554,3729,87000,62160,149160
10/15/2024,Pradeep Kumara,Kurunegala,Melsiripura,North Western,1851,4370,6221,74040,174800,248840
10/16/2024,Pradeep Kumara,Kurunegala,Melsiripura,North Western,4176,7640,11816,167040,305600,472640
10/17/2024,Pradeep Kumara,Kurunegala,Melsiripura,North Western,286,3226,3512,11440,129040,140480
10/18/2024,Pradeep Kumara,Kurunegala,Melsiripura,North Western,8083,4427,12510,323320,177080,500400
10/19/2024,Pradeep Kumara,Kurunegala,Melsiripura,North Western,7410,2443,9853,296400,97720,394120
10/20/2024,Pradeep Kumara,Kurunegala,Melsiripura,North Western,3104,7631,10735,124160,305240,429400
10/21/2024,Pradeep Kumara,Kurunegala,Melsiripura,North Western,9482,6373,15855,379280,254920,634200
10/22/2024,Pradeep Kumara,Kurunegala,Melsiripura,North Western,8413,8873,17286,336520,354920,691440
10/23/2024,Pradeep Kumara,Kurunegala,Melsiripura,North Western,9912,6218,16130,396480,248720,645200
10/24/2024,Pradeep Kumara,Kurunegala,Melsiripura,North Western,2054,5415,7469,82160,216600,298760
10/25/2024,Pradeep Kumara,Kurunegala,Melsiripura,North Western,5350,5309,10659,214000,212360,426360
10/26/2024,Pradeep Kumara,Kurunegala,Melsiripura,North Western,7611,2837,10448,304440,113480,417920
10/27/2024,Pradeep Kumara,Kurunegala,Melsiripura,North Western,2162,686,2848,86480,27440,113920
10/28/2024,Pradeep Kumara,Kurunegala,Melsiripura,North Western,3334,9820,13154,133360,392800,526160
10/29/2024,Pradeep Kumara,Kurunegala,Melsiripura,North Western,9505,8642,18147,380200,345680,725880
10/30/2024,Pradeep Kumara,Kurunegala,Melsiripura,North Western,8157,1356,9513,326280,54240,380520
10/31/2024,Pradeep Kumara,Kurunegala,Melsiripura,North Western,9089,9681,18770,363560,387240,750800
11/1/2024,Pradeep Kumara,Kurunegala,Melsiripura,North Western,4799,509,5308,191960,20360,212320
11/2/2024,Pradeep Kumara,Kurunegala,Melsiripura,North Western,4029,9582,13611,161160,383280,544440
11/3/2024,Pradeep Kumara,Kurunegala,Melsiripura,North Western,4119,7825,11944,164760,313000,477760
11/4/2024,Pradeep Kumara,Kurunegala,Melsiripura,North Western,4663,6426,11089,186520,257040,443560
11/5/2024,Pradeep Kumara,Kurunegala,Melsiripura,North Western,3169,9816,12985,126760,392640,519400
11/6/2024,Pradeep Kumara,Kurunegala,Melsiripura,North Western,8993,2074,11067,359720,82960,442680
11/7/2024,Pradeep Kumara,Kurunegala,Melsiripura,North Western,9534,6371,15905,381360,254840,636200
11/8/2024,Pradeep Kumara,Kurunegala,Melsiripura,North Western,1426,4136,5562,57040,165440,222480
11/9/2024,Pradeep Kumara,Kurunegala,Melsiripura,North Western,3881,2655,6536,155240,106200,261440
11/10/2024,Pradeep Kumara,Kurunegala,Melsiripura,North Western,7156,8020,15176,286240,320800,607040
11/11/2024,Pradeep Kumara,Kurunegala,Melsiripura,North Western,7031,7709,14740,281240,308360,589600
11/12/2024,Pradeep Kumara,Kurunegala,Melsiripura,North Western,3976,6827,10803,159040,273080,432120
11/13/2024,Pradeep Kumara,Kurunegala,Melsiripura,North Western,8307,5331,13638,332280,213240,545520
11/14/2024,Pradeep Kumara,Kurunegala,Melsiripura,North Western,2675,3830,6505,107000,153200,260200
11/15/2024,Pradeep Kumara,Kurunegala,Melsiripura,North Western,2345,1846,4191,93800,73840,167640
11/16/2024,Pradeep Kumara,Kurunegala,Melsiripura,North Western,6310,8451,14761,252400,338040,590440
11/17/2024,Pradeep Kumara,Kurunegala,Melsiripura,North Western,6477,3953,10430,259080,158120,417200
11/18/2024,Pradeep Kumara,Kurunegala,Melsiripura,North Western,3834,7710,11544,153360,308400,461760
11/19/2024,Pradeep Kumara,Kurunegala,Melsiripura,North Western,1810,6115,7925,72400,244600,317000
11/20/2024,Pradeep Kumara,Kurunegala,Melsiripura,North Western,4790,1464,6254,191600,58560,250160
11/21/2024,Pradeep Kumara,Kurunegala,Melsiripura,North Western,7180,1222,8402,287200,48880,336080
11/22/2024,Pradeep Kumara,Kurunegala,Melsiripura,North Western,3859,5586,9445,154360,223440,377800
11/23/2024,Pradeep Kumara,Kurunegala,Melsiripura,North Western,5532,4398,9930,221280,175920,397200
11/24/2024,Pradeep Kumara,Kurunegala,Melsiripura,North Western,2696,470,3166,107840,18800,126640
11/25/2024,Pradeep Kumara,Kurunegala,Melsiripura,North Western,9738,5999,15737,389520,239960,629480
11/26/2024,Pradeep Kumara,Kurunegala,Melsiripura,North Western,934,795,1729,37360,31800,69160
11/27/2024,Pradeep Kumara,Kurunegala,Melsiripura,North Western,6403,1723,8126,256120,68920,325040
11/28/2024,Pradeep Kumara,Kurunegala,Melsiripura,North Western,8765,5775,14540,350600,231000,581600
11/29/2024,Pradeep Kumara,Kurunegala,Melsiripura,North Western,8762,2234,10996,350480,89360,439840
11/30/2024,Pradeep Kumara,Kurunegala,Melsiripura,North Western,8898,8671,17569,355920,346840,702760
12/1/2024,Pradeep Kumara,Kurunegala,Melsiripura,North Western,7422,3156,10578,296880,126240,423120
12/2/2024,Pradeep Kumara,Kurunegala,Melsiripura,North Western,5010,5837,10847,200400,233480,433880
12/3/2024,Pradeep Kumara,Kurunegala,Melsiripura,North Western,4455,8329,12784,178200,333160,511360
12/4/2024,Pradeep Kumara,Kurunegala,Melsiripura,North Western,4763,1946,6709,190520,77840,268360
12/5/2024,Pradeep Kumara,Kurunegala,Melsiripura,North Western,3982,2570,6552,159280,102800,262080
12/6/2024,Pradeep Kumara,Kurunegala,Melsiripura,North Western,673,6549,7222,26920,261960,288880
12/7/2024,Pradeep Kumara,Kurunegala,Melsiripura,North Western,2504,3015,5519,100160,120600,220760
12/8/2024,Pradeep Kumara,Kurunegala,Melsiripura,North Western,6978,3571,10549,279120,142840,421960
12/9/2024,Pradeep Kumara,Kurunegala,Melsiripura,North Western,4366,662,5028,174640,26480,201120
12/10/2024,Pradeep Kumara,Kurunegala,Melsiripura,North Western,9311,7779,17090,372440,311160,683600
12/11/2024,Pradeep Kumara,Kurunegala,Melsiripura,North Western,9376,1011,10387,375040,40440,415480
12/12/2024,Pradeep Kumara,Kurunegala,Melsiripura,North Western,7020,2164,9184,280800,86560,367360
12/13/2024,Pradeep Kumara,Kurunegala,Melsiripura,North Western,786,4377,5163,31440,175080,206520
12/14/2024,Pradeep Kumara,Kurunegala,Melsiripura,North Western,807,7335,8142,32280,293400,325680
12/15/2024,Pradeep Kumara,Kurunegala,Melsiripura,North Western,9915,1870,11785,396600,74800,471400
12/16/2024,Pradeep Kumara,Kurunegala,Melsiripura,North Western,3713,3968,7681,148520,158720,307240
12/17/2024,Pradeep Kumara,Kurunegala,Melsiripura,North Western,6288,6251,12539,251520,250040,501560
12/18/2024,Pradeep Kumara,Kurunegala,Melsiripura,North Western,3119,5114,8233,124760,204560,329320
12/19/2024,Pradeep Kumara,Kurunegala,Melsiripura,North Western,9230,3253,12483,369200,130120,499320
12/20/2024,Pradeep Kumara,Kurunegala,Melsiripura,North Western,3101,7839,10940,124040,313560,437600
12/21/2024,Pradeep Kumara,Kurunegala,Melsiripura,North Western,3553,9173,12726,142120,366920,509040
12/22/2024,Pradeep Kumara,Kurunegala,Melsiripura,North Western,6436,6584,13020,257440,263360,520800
12/23/2024,Pradeep Kumara,Kurunegala,Melsiripura,North Western,3942,2085,6027,157680,83400,241080
12/24/2024,Pradeep Kumara,Kurunegala,Melsiripura,North Western,4456,3118,7574,178240,124720,302960
12/25/2024,Pradeep Kumara,Kurunegala,Melsiripura,North Western,4317,624,4941,172680,24960,197640
12/26/2024,Pradeep Kumara,Kurunegala,Melsiripura,North Western,5498,9505,15003,219920,380200,600120
12/27/2024,Pradeep Kumara,Kurunegala,Melsiripura,North Western,3110,7293,10403,124400,291720,416120
12/28/2024,Pradeep Kumara,Kurunegala,Melsiripura,North Western,7425,6329,13754,297000,253160,550160
12/29/2024,Pradeep Kumara,Kurunegala,Melsiripura,North Western,1716,9805,11521,68640,392200,460840
12/30/2024,Pradeep Kumara,Kurunegala,Melsiripura,North Western,5023,8403,13426,200920,336120,537040
12/31/2024,Pradeep Kumara,Kurunegala,Melsiripura,North Western,9400,6146,15546,376000,245840,621840
1/1/2025,Pradeep Kumara,Kurunegala,Melsiripura,North Western,6940,1276,8216,277600,51040,328640
1/2/2025,Pradeep Kumara,Kurunegala,Melsiripura,North Western,3426,736,4162,137040,29440,166480
1/3/2025,Pradeep Kumara,Kurunegala,Melsiripura,North Western,4224,2810,7034,168960,112400,281360
1/4/2025,Pradeep Kumara,Kurunegala,Melsiripura,North Western,3968,1920,5888,158720,76800,235520
1/5/2025,Pradeep Kumara,Kurunegala,Melsiripura,North Western,5831,5551,11382,233240,222040,455280
1/6/2025,Pradeep Kumara,Kurunegala,Melsiripura,North Western,8348,8373,16721,333920,334920,668840
1/7/2025,Pradeep Kumara,Kurunegala,Melsiripura,North Western,952,2311,3263,38080,92440,130520
1/8/2025,Pradeep Kumara,Kurunegala,Melsiripura,North Western,1993,4718,6711,79720,188720,268440
1/9/2025,Pradeep Kumara,Kurunegala,Melsiripura,North Western,4006,9904,13910,160240,396160,556400
1/10/2025,Pradeep Kumara,Kurunegala,Melsiripura,North Western,6319,7055,13374,252760,282200,534960
1/11/2025,Pradeep Kumara,Kurunegala,Melsiripura,North Western,7093,3266,10359,283720,130640,414360
1/12/2025,Pradeep Kumara,Kurunegala,Melsiripura,North Western,8989,4597,13586,359560,183880,543440
1/13/2025,Pradeep Kumara,Kurunegala,Melsiripura,North Western,257,9547,9804,10280,381880,392160
1/14/2025,Pradeep Kumara,Kurunegala,Melsiripura,North Western,9953,9053,19006,398120,362120,760240
1/15/2025,Pradeep Kumara,Kurunegala,Melsiripura,North Western,9438,2943,12381,377520,117720,495240
1/16/2025,Pradeep Kumara,Kurunegala,Melsiripura,North Western,9512,4006,13518,380480,160240,540720
1/17/2025,Pradeep Kumara,Kurunegala,Melsiripura,North Western,8487,6188,14675,339480,247520,587000
1/18/2025,Pradeep Kumara,Kurunegala,Melsiripura,North Western,9029,3021,12050,361160,120840,482000
1/19/2025,Pradeep Kumara,Kurunegala,Melsiripura,North Western,3383,1853,5236,135320,74120,209440
1/20/2025,Pradeep Kumara,Kurunegala,Melsiripura,North Western,9274,7993,17267,370960,319720,690680
1/21/2025,Pradeep Kumara,Kurunegala,Melsiripura,North Western,9207,185,9392,368280,7400,375680
1/22/2025,Pradeep Kumara,Kurunegala,Melsiripura,North Western,9592,5890,15482,383680,235600,619280
1/23/2025,Pradeep Kumara,Kurunegala,Melsiripura,North Western,8153,1860,10013,326120,74400,400520
1/24/2025,Pradeep Kumara,Kurunegala,Melsiripura,North Western,7216,1707,8923,288640,68280,356920
1/25/2025,Pradeep Kumara,Kurunegala,Melsiripura,North Western,4793,631,5424,191720,25240,216960
1/26/2025,Pradeep Kumara,Kurunegala,Melsiripura,North Western,1,418,419,40,16720,16760
1/27/2025,Pradeep Kumara,Kurunegala,Melsiripura,North Western,6586,946,7532,263440,37840,301280
1/28/2025,Pradeep Kumara,Kurunegala,Melsiripura,North Western,1020,6864,7884,40800,274560,315360
1/29/2025,Pradeep Kumara,Kurunegala,Melsiripura,North Western,3027,4792,7819,121080,191680,312760
1/30/2025,Pradeep Kumara,Kurunegala,Melsiripura,North Western,886,1213,2099,35440,48520,83960
1/31/2025,Pradeep Kumara,Kurunegala,Melsiripura,North Western,2014,9972,11986,80560,398880,479440
2/1/2025,Pradeep Kumara,Kurunegala,Melsiripura,North Western,5116,9430,14546,204640,377200,581840
2/2/2025,Pradeep Kumara,Kurunegala,Melsiripura,North Western,2205,5259,7464,88200,210360,298560
2/3/2025,Pradeep Kumara,Kurunegala,Melsiripura,North Western,9136,8565,17701,365440,342600,708040
2/4/2025,Pradeep Kumara,Kurunegala,Melsiripura,North Western,1529,5912,7441,61160,236480,297640
2/5/2025,Pradeep Kumara,Kurunegala,Melsiripura,North Western,6795,8126,14921,271800,325040,596840
2/6/2025,Pradeep Kumara,Kurunegala,Melsiripura,North Western,4066,4750,8816,162640,190000,352640
2/7/2025,Pradeep Kumara,Kurunegala,Melsiripura,North Western,8263,2495,10758,330520,99800,430320
2/8/2025,Pradeep Kumara,Kurunegala,Melsiripura,North Western,7375,6868,14243,295000,274720,569720
2/9/2025,Pradeep Kumara,Kurunegala,Melsiripura,North Western,6953,7210,14163,278120,288400,566520
2/10/2025,Pradeep Kumara,Kurunegala,Melsiripura,North Western,5155,7032,12187,206200,281280,487480
2/11/2025,Pradeep Kumara,Kurunegala,Melsiripura,North Western,536,1661,2197,21440,66440,87880
2/12/2025,Pradeep Kumara,Kurunegala,Melsiripura,North Western,2344,1417,3761,93760,56680,150440
2/13/2025,Pradeep Kumara,Kurunegala,Melsiripura,North Western,1557,679,2236,62280,27160,89440
2/14/2025,Pradeep Kumara,Kurunegala,Melsiripura,North Western,4415,199,4614,176600,7960,184560
2/15/2025,Pradeep Kumara,Kurunegala,Melsiripura,North Western,3546,2630,6176,141840,105200,247040
2/16/2025,Pradeep Kumara,Kurunegala,Melsiripura,North Western,958,2440,3398,38320,97600,135920
2/17/2025,Pradeep Kumara,Kurunegala,Melsiripura,North Western,3458,5540,8998,138320,221600,359920
2/18/2025,Pradeep Kumara,Kurunegala,Melsiripura,North Western,4395,7455,11850,175800,298200,474000
2/19/2025,Pradeep Kumara,Kurunegala,Melsiripura,North Western,3019,4530,7549,120760,181200,301960
2/20/2025,Pradeep Kumara,Kurunegala,Melsiripura,North Western,1927,6928,8855,77080,277120,354200
2/21/2025,Pradeep Kumara,Kurunegala,Melsiripura,North Western,6159,5138,11297,246360,205520,451880
2/22/2025,Pradeep Kumara,Kurunegala,Melsiripura,North Western,5801,1641,7442,232040,65640,297680
2/23/2025,Pradeep Kumara,Kurunegala,Melsiripura,North Western,7895,9895,17790,315800,395800,711600
2/24/2025,Pradeep Kumara,Kurunegala,Melsiripura,North Western,5978,1850,7828,239120,74000,313120
2/25/2025,Pradeep Kumara,Kurunegala,Melsiripura,North Western,4302,3550,7852,172080,142000,314080
2/26/2025,Pradeep Kumara,Kurunegala,Melsiripura,North Western,8157,264,8421,326280,10560,336840
2/27/2025,Pradeep Kumara,Kurunegala,Melsiripura,North Western,2329,1235,3564,93160,49400,142560
2/28/2025,Pradeep Kumara,Kurunegala,Melsiripura,North Western,4443,822,5265,177720,32880,210600
3/1/2025,Pradeep Kumara,Kurunegala,Melsiripura,North Western,1737,8209,9946,69480,328360,397840
3/2/2025,Pradeep Kumara,Kurunegala,Melsiripura,North Western,9549,781,10330,381960,31240,413200
3/3/2025,Pradeep Kumara,Kurunegala,Melsiripura,North Western,6728,4168,10896,269120,166720,435840
3/4/2025,Pradeep Kumara,Kurunegala,Melsiripura,North Western,9941,6990,16931,397640,279600,677240
3/5/2025,Pradeep Kumara,Kurunegala,Melsiripura,North Western,2390,5331,7721,95600,213240,308840
3/6/2025,Pradeep Kumara,Kurunegala,Melsiripura,North Western,1415,7403,8818,56600,296120,352720
3/7/2025,Pradeep Kumara,Kurunegala,Melsiripura,North Western,8204,7953,16157,328160,318120,646280
3/8/2025,Pradeep Kumara,Kurunegala,Melsiripura,North Western,1448,4572,6020,57920,182880,240800
3/9/2025,Pradeep Kumara,Kurunegala,Melsiripura,North Western,7856,5494,13350,314240,219760,534000
3/10/2025,Pradeep Kumara,Kurunegala,Melsiripura,North Western,9051,9386,18437,362040,375440,737480
3/11/2025,Pradeep Kumara,Kurunegala,Melsiripura,North Western,2374,3036,5410,94960,121440,216400
3/12/2025,Pradeep Kumara,Kurunegala,Melsiripura,North Western,482,9565,10047,19280,382600,401880
3/13/2025,Pradeep Kumara,Kurunegala,Melsiripura,North Western,7298,7385,14683,291920,295400,587320
3/14/2025,Pradeep Kumara,Kurunegala,Melsiripura,North Western,5798,9901,15699,231920,396040,627960
3/15/2025,Pradeep Kumara,Kurunegala,Melsiripura,North Western,7915,6200,14115,316600,248000,564600
3/16/2025,Pradeep Kumara,Kurunegala,Melsiripura,North Western,2401,1396,3797,96040,55840,151880
3/17/2025,Pradeep Kumara,Kurunegala,Melsiripura,North Western,2094,1460,3554,83760,58400,142160
3/18/2025,Pradeep Kumara,Kurunegala,Melsiripura,North Western,2836,7355,10191,113440,294200,407640
3/19/2025,Pradeep Kumara,Kurunegala,Melsiripura,North Western,877,8600,9477,35080,344000,379080
3/20/2025,Pradeep Kumara,Kurunegala,Melsiripura,North Western,6086,7832,13918,243440,313280,556720
3/21/2025,Pradeep Kumara,Kurunegala,Melsiripura,North Western,9888,7992,17880,395520,319680,715200
3/22/2025,Pradeep Kumara,Kurunegala,Melsiripura,North Western,2777,689,3466,111080,27560,138640
3/23/2025,Pradeep Kumara,Kurunegala,Melsiripura,North Western,4606,2135,6741,184240,85400,269640
3/25/2024,Asela Perera,Anuradhapura,Rambewa,North Central,1896,1787,3683,75840,71480,147320
3/26/2024,Asela Perera,Anuradhapura,Rambewa,North Central,3889,3535,7424,155560,141400,296960
3/27/2024,Asela Perera,Anuradhapura,Rambewa,North Central,8873,5741,14614,354920,229640,584560
3/28/2024,Asela Perera,Anuradhapura,Rambewa,North Central,6077,7758,13835,243080,310320,553400
3/29/2024,Asela Perera,Anuradhapura,Rambewa,North Central,2213,9789,12002,88520,391560,480080
3/30/2024,Asela Perera,Anuradhapura,Rambewa,North Central,9619,8173,17792,384760,326920,711680
3/31/2024,Asela Perera,Anuradhapura,Rambewa,North Central,9598,3626,13224,383920,145040,528960
4/1/2024,Asela Perera,Anuradhapura,Rambewa,North Central,1047,8265,9312,41880,330600,372480
4/2/2024,Asela Perera,Anuradhapura,Rambewa,North Central,7174,6073,13247,286960,242920,529880
4/3/2024,Asela Perera,Anuradhapura,Rambewa,North Central,5970,2704,8674,238800,108160,346960
4/4/2024,Asela Perera,Anuradhapura,Rambewa,North Central,9640,5477,15117,385600,219080,604680
4/5/2024,Asela Perera,Anuradhapura,Rambewa,North Central,5023,8498,13521,200920,339920,540840
4/6/2024,Asela Perera,Anuradhapura,Rambewa,North Central,9155,3367,12522,366200,134680,500880
4/7/2024,Asela Perera,Anuradhapura,Rambewa,North Central,1577,7196,8773,63080,287840,350920
4/8/2024,Asela Perera,Anuradhapura,Rambewa,North Central,5214,4143,9357,208560,165720,374280
4/9/2024,Asela Perera,Anuradhapura,Rambewa,North Central,118,4603,4721,4720,184120,188840
4/10/2024,Asela Perera,Anuradhapura,Rambewa,North Central,9451,302,9753,378040,12080,390120
4/11/2024,Asela Perera,Anuradhapura,Rambewa,North Central,3218,3379,6597,128720,135160,263880
4/19/2024,Asela Perera,Anuradhapura,Rambewa,North Central,5470,9828,15298,218800,393120,611920
4/20/2024,Asela Perera,Anuradhapura,Rambewa,North Central,2259,6719,8978,90360,268760,359120
4/21/2024,Asela Perera,Anuradhapura,Rambewa,North Central,5287,5803,11090,211480,232120,443600
4/22/2024,Asela Perera,Anuradhapura,Rambewa,North Central,639,168,807,25560,6720,32280
4/23/2024,Asela Perera,Anuradhapura,Rambewa,North Central,8374,241,8615,334960,9640,344600
4/24/2024,Asela Perera,Anuradhapura,Rambewa,North Central,6147,4168,10315,245880,166720,412600
4/25/2024,Asela Perera,Anuradhapura,Rambewa,North Central,6185,1999,8184,247400,79960,327360
4/26/2024,Asela Perera,Anuradhapura,Rambewa,North Central,8669,8779,17448,346760,351160,697920
4/27/2024,Asela Perera,Anuradhapura,Rambewa,North Central,8650,1555,10205,346000,62200,408200
4/28/2024,Asela Perera,Anuradhapura,Rambewa,North Central,1935,1551,3486,77400,62040,139440
4/29/2024,Asela Perera,Anuradhapura,Rambewa,North Central,8720,1974,10694,348800,78960,427760
4/30/2024,Asela Perera,Anuradhapura,Rambewa,North Central,4409,6991,11400,176360,279640,456000
5/1/2024,Asela Perera,Anuradhapura,Rambewa,North Central,3195,6935,10130,127800,277400,405200
5/2/2024,Asela Perera,Anuradhapura,Rambewa,North Central,1090,3212,4302,43600,128480,172080
5/3/2024,Asela Perera,Anuradhapura,Rambewa,North Central,299,7644,7943,11960,305760,317720
5/4/2024,Asela Perera,Anuradhapura,Rambewa,North Central,7912,3061,10973,316480,122440,438920
5/5/2024,Asela Perera,Anuradhapura,Rambewa,North Central,3329,1764,5093,133160,70560,203720
5/6/2024,Asela Perera,Anuradhapura,Rambewa,North Central,4436,9983,14419,177440,399320,576760
5/7/2024,Asela Perera,Anuradhapura,Rambewa,North Central,273,3634,3907,10920,145360,156280
5/8/2024,Asela Perera,Anuradhapura,Rambewa,North Central,8588,9435,18023,343520,377400,720920
5/9/2024,Asela Perera,Anuradhapura,Rambewa,North Central,7185,1341,8526,287400,53640,341040
5/10/2024,Asela Perera,Anuradhapura,Rambewa,North Central,2737,2759,5496,109480,110360,219840
5/11/2024,Asela Perera,Anuradhapura,Rambewa,North Central,6796,827,7623,271840,33080,304920
5/12/2024,Asela Perera,Anuradhapura,Rambewa,North Central,6349,5747,12096,253960,229880,483840
5/13/2024,Asela Perera,Anuradhapura,Rambewa,North Central,3027,8766,11793,121080,350640,471720
5/14/2024,Asela Perera,Anuradhapura,Rambewa,North Central,629,4476,5105,25160,179040,204200
5/15/2024,Asela Perera,Anuradhapura,Rambewa,North Central,1114,6553,7667,44560,262120,306680
5/16/2024,Asela Perera,Anuradhapura,Rambewa,North Central,3217,547,3764,128680,21880,150560
5/17/2024,Asela Perera,Anuradhapura,Rambewa,North Central,2352,3966,6318,94080,158640,252720
5/18/2024,Asela Perera,Anuradhapura,Rambewa,North Central,5293,6818,12111,211720,272720,484440
5/19/2024,Asela Perera,Anuradhapura,Rambewa,North Central,4600,5801,10401,184000,232040,416040
5/20/2024,Asela Perera,Anuradhapura,Rambewa,North Central,356,384,740,14240,15360,29600
5/21/2024,Asela Perera,Anuradhapura,Rambewa,North Central,8423,834,9257,336920,33360,370280
5/22/2024,Asela Perera,Anuradhapura,Rambewa,North Central,1661,1174,2835,66440,46960,113400
5/24/2024,Asela Perera,Anuradhapura,Rambewa,North Central,1231,7632,8863,49240,305280,354520
5/25/2024,Asela Perera,Anuradhapura,Rambewa,North Central,3247,6981,10228,129880,279240,409120
5/26/2024,Asela Perera,Anuradhapura,Rambewa,North Central,6224,9974,16198,248960,398960,647920
5/27/2024,Asela Perera,Anuradhapura,Rambewa,North Central,5422,7648,13070,216880,305920,522800
5/28/2024,Asela Perera,Anuradhapura,Rambewa,North Central,6959,3116,10075,278360,124640,403000
5/29/2024,Asela Perera,Anuradhapura,Rambewa,North Central,951,9052,10003,38040,362080,400120
5/30/2024,Asela Perera,Anuradhapura,Rambewa,North Central,882,8941,9823,35280,357640,392920
5/31/2024,Asela Perera,Anuradhapura,Rambewa,North Central,3168,4174,7342,126720,166960,293680
6/1/2024,Asela Perera,Anuradhapura,Rambewa,North Central,1107,5049,6156,44280,201960,246240
6/2/2024,Asela Perera,Anuradhapura,Rambewa,North Central,9660,4665,14325,386400,186600,573000
6/3/2024,Asela Perera,Anuradhapura,Rambewa,North Central,8418,3881,12299,336720,155240,491960
6/4/2024,Asela Perera,Anuradhapura,Rambewa,North Central,1590,4467,6057,63600,178680,242280
6/5/2024,Asela Perera,Anuradhapura,Rambewa,North Central,4124,7479,11603,164960,299160,464120
6/6/2024,Asela Perera,Anuradhapura,Rambewa,North Central,5032,7872,12904,201280,314880,516160
6/7/2024,Asela Perera,Anuradhapura,Rambewa,North Central,7926,6141,14067,317040,245640,562680
6/8/2024,Asela Perera,Anuradhapura,Rambewa,North Central,1174,5813,6987,46960,232520,279480
6/9/2024,Asela Perera,Anuradhapura,Rambewa,North Central,5798,5534,11332,231920,221360,453280
6/10/2024,Asela Perera,Anuradhapura,Rambewa,North Central,6997,2656,9653,279880,106240,386120
6/11/2024,Asela Perera,Anuradhapura,Rambewa,North Central,7960,7263,15223,318400,290520,608920
6/12/2024,Asela Perera,Anuradhapura,Rambewa,North Central,9827,7429,17256,393080,297160,690240
6/13/2024,Asela Perera,Anuradhapura,Rambewa,North Central,8815,5803,14618,352600,232120,584720
6/14/2024,Asela Perera,Anuradhapura,Rambewa,North Central,478,7791,8269,19120,311640,330760
6/15/2024,Asela Perera,Anuradhapura,Rambewa,North Central,4344,3043,7387,173760,121720,295480
6/16/2024,Asela Perera,Anuradhapura,Rambewa,North Central,9412,335,9747,376480,13400,389880
6/17/2024,Asela Perera,Anuradhapura,Rambewa,North Central,3766,4856,8622,150640,194240,344880
6/18/2024,Asela Perera,Anuradhapura,Rambewa,North Central,3875,7615,11490,155000,304600,459600
6/19/2024,Asela Perera,Anuradhapura,Rambewa,North Central,5505,4494,9999,220200,179760,399960
6/20/2024,Asela Perera,Anuradhapura,Rambewa,North Central,3761,4020,7781,150440,160800,311240
6/21/2024,Asela Perera,Anuradhapura,Rambewa,North Central,9855,6216,16071,394200,248640,642840
6/22/2024,Asela Perera,Anuradhapura,Rambewa,North Central,7510,7248,14758,300400,289920,590320
6/23/2024,Asela Perera,Anuradhapura,Rambewa,North Central,3415,1918,5333,136600,76720,213320
6/24/2024,Asela Perera,Anuradhapura,Rambewa,North Central,4313,6236,10549,172520,249440,421960
6/25/2024,Asela Perera,Anuradhapura,Rambewa,North Central,8535,6266,14801,341400,250640,592040
6/26/2024,Asela Perera,Anuradhapura,Rambewa,North Central,3289,9076,12365,131560,363040,494600
6/27/2024,Asela Perera,Anuradhapura,Rambewa,North Central,67,7420,7487,2680,296800,299480
6/28/2024,Asela Perera,Anuradhapura,Rambewa,North Central,6756,4778,11534,270240,191120,461360
6/29/2024,Asela Perera,Anuradhapura,Rambewa,North Central,7887,7177,15064,315480,287080,602560
6/30/2024,Asela Perera,Anuradhapura,Rambewa,North Central,3054,4026,7080,122160,161040,283200
7/1/2024,Asela Perera,Anuradhapura,Rambewa,North Central,8133,1363,9496,325320,54520,379840
7/2/2024,Asela Perera,Anuradhapura,Rambewa,North Central,2707,6882,9589,108280,275280,383560
7/3/2024,Asela Perera,Anuradhapura,Rambewa,North Central,8923,1725,10648,356920,69000,425920
7/4/2024,Asela Perera,Anuradhapura,Rambewa,North Central,129,8580,8709,5160,343200,348360
7/5/2024,Asela Perera,Anuradhapura,Rambewa,North Central,1543,3847,5390,61720,153880,215600
7/6/2024,Asela Perera,Anuradhapura,Rambewa,North Central,4765,1021,5786,190600,40840,231440
7/7/2024,Asela Perera,Anuradhapura,Rambewa,North Central,8337,9942,18279,333480,397680,731160
7/8/2024,Asela Perera,Anuradhapura,Rambewa,North Central,6972,3498,10470,278880,139920,418800
7/9/2024,Asela Perera,Anuradhapura,Rambewa,North Central,2761,4328,7089,110440,173120,283560
7/10/2024,Asela Perera,Anuradhapura,Rambewa,North Central,143,5113,5256,5720,204520,210240
7/11/2024,Asela Perera,Anuradhapura,Rambewa,North Central,4733,6275,11008,189320,251000,440320
7/12/2024,Asela Perera,Anuradhapura,Rambewa,North Central,3468,1188,4656,138720,47520,186240
7/13/2024,Asela Perera,Anuradhapura,Rambewa,North Central,8087,2496,10583,323480,99840,423320
7/14/2024,Asela Perera,Anuradhapura,Rambewa,North Central,8897,1786,10683,355880,71440,427320
7/15/2024,Asela Perera,Anuradhapura,Rambewa,North Central,6943,3122,10065,277720,124880,402600
7/16/2024,Asela Perera,Anuradhapura,Rambewa,North Central,976,7333,8309,39040,293320,332360
7/17/2024,Asela Perera,Anuradhapura,Rambewa,North Central,5241,2484,7725,209640,99360,309000
7/18/2024,Asela Perera,Anuradhapura,Rambewa,North Central,742,5064,5806,29680,202560,232240
7/19/2024,Asela Perera,Anuradhapura,Rambewa,North Central,506,9711,10217,20240,388440,408680
7/20/2024,Asela Perera,Anuradhapura,Rambewa,North Central,5242,9292,14534,209680,371680,581360
7/21/2024,Asela Perera,Anuradhapura,Rambewa,North Central,5264,6721,11985,210560,268840,479400
7/22/2024,Asela Perera,Anuradhapura,Rambewa,North Central,971,5662,6633,38840,226480,265320
7/23/2024,Asela Perera,Anuradhapura,Rambewa,North Central,685,8177,8862,27400,327080,354480
7/24/2024,Asela Perera,Anuradhapura,Rambewa,North Central,573,5645,6218,22920,225800,248720
7/25/2024,Asela Perera,Anuradhapura,Rambewa,North Central,3355,1979,5334,134200,79160,213360
7/26/2024,Asela Perera,Anuradhapura,Rambewa,North Central,1149,2244,3393,45960,89760,135720
7/27/2024,Asela Perera,Anuradhapura,Rambewa,North Central,2820,1887,4707,112800,75480,188280
7/28/2024,Asela Perera,Anuradhapura,Rambewa,North Central,3903,7134,11037,156120,285360,441480
7/29/2024,Asela Perera,Anuradhapura,Rambewa,North Central,6899,9211,16110,275960,368440,644400
7/30/2024,Asela Perera,Anuradhapura,Rambewa,North Central,1769,1402,3171,70760,56080,126840
7/31/2024,Asela Perera,Anuradhapura,Rambewa,North Central,2957,5046,8003,118280,201840,320120
8/1/2024,Asela Perera,Anuradhapura,Rambewa,North Central,4965,4985,9950,198600,199400,398000
8/2/2024,Asela Perera,Anuradhapura,Rambewa,North Central,3997,891,4888,159880,35640,195520
8/3/2024,Asela Perera,Anuradhapura,Rambewa,North Central,9508,3172,12680,380320,126880,507200
8/4/2024,Asela Perera,Anuradhapura,Rambewa,North Central,2475,5038,7513,99000,201520,300520
8/5/2024,Asela Perera,Anuradhapura,Rambewa,North Central,889,6030,6919,35560,241200,276760
8/6/2024,Asela Perera,Anuradhapura,Rambewa,North Central,2739,6238,8977,109560,249520,359080
8/7/2024,Asela Perera,Anuradhapura,Rambewa,North Central,9832,9010,18842,393280,360400,753680
8/8/2024,Asela Perera,Anuradhapura,Rambewa,North Central,8519,9928,18447,340760,397120,737880
8/9/2024,Asela Perera,Anuradhapura,Rambewa,North Central,9796,1537,11333,391840,61480,453320
8/10/2024,Asela Perera,Anuradhapura,Rambewa,North Central,2618,6805,9423,104720,272200,376920
8/11/2024,Asela Perera,Anuradhapura,Rambewa,North Central,2057,822,2879,82280,32880,115160
8/12/2024,Asela Perera,Anuradhapura,Rambewa,North Central,8637,7736,16373,345480,309440,654920
8/13/2024,Asela Perera,Anuradhapura,Rambewa,North Central,5746,7412,13158,229840,296480,526320
8/14/2024,Asela Perera,Anuradhapura,Rambewa,North Central,8712,3967,12679,348480,158680,507160
8/15/2024,Asela Perera,Anuradhapura,Rambewa,North Central,5324,3047,8371,212960,121880,334840
8/16/2024,Asela Perera,Anuradhapura,Rambewa,North Central,5519,1130,6649,220760,45200,265960
8/17/2024,Asela Perera,Anuradhapura,Rambewa,North Central,2452,8324,10776,98080,332960,431040
8/18/2024,Asela Perera,Anuradhapura,Rambewa,North Central,9680,8307,17987,387200,332280,719480
8/19/2024,Asela Perera,Anuradhapura,Rambewa,North Central,3230,3080,6310,129200,123200,252400
8/20/2024,Asela Perera,Anuradhapura,Rambewa,North Central,8927,1382,10309,357080,55280,412360
8/21/2024,Asela Perera,Anuradhapura,Rambewa,North Central,9125,2550,11675,365000,102000,467000
8/22/2024,Asela Perera,Anuradhapura,Rambewa,North Central,3860,4214,8074,154400,168560,322960
8/23/2024,Asela Perera,Anuradhapura,Rambewa,North Central,6359,9306,15665,254360,372240,626600
8/24/2024,Asela Perera,Anuradhapura,Rambewa,North Central,819,2728,3547,32760,109120,141880
8/25/2024,Asela Perera,Anuradhapura,Rambewa,North Central,1328,5053,6381,53120,202120,255240
8/26/2024,Asela Perera,Anuradhapura,Rambewa,North Central,3462,2541,6003,138480,101640,240120
8/27/2024,Asela Perera,Anuradhapura,Rambewa,North Central,5077,9670,14747,203080,386800,589880
8/28/2024,Asela Perera,Anuradhapura,Rambewa,North Central,1208,3392,4600,48320,135680,184000
8/29/2024,Asela Perera,Anuradhapura,Rambewa,North Central,1481,8726,10207,59240,349040,408280
8/30/2024,Asela Perera,Anuradhapura,Rambewa,North Central,1788,201,1989,71520,8040,79560
8/31/2024,Asela Perera,Anuradhapura,Rambewa,North Central,8029,3455,11484,321160,138200,459360
9/1/2024,Asela Perera,Anuradhapura,Rambewa,North Central,3165,7246,10411,126600,289840,416440
9/2/2024,Asela Perera,Anuradhapura,Rambewa,North Central,3519,6981,10500,140760,279240,420000
9/3/2024,Asela Perera,Anuradhapura,Rambewa,North Central,717,6180,6897,28680,247200,275880
9/4/2024,Asela Perera,Anuradhapura,Rambewa,North Central,6767,1424,8191,270680,56960,327640
9/5/2024,Asela Perera,Anuradhapura,Rambewa,North Central,2834,4604,7438,113360,184160,297520
9/6/2024,Asela Perera,Anuradhapura,Rambewa,North Central,6660,3288,9948,266400,131520,397920
9/7/2024,Asela Perera,Anuradhapura,Rambewa,North Central,1720,4547,6267,68800,181880,250680
9/8/2024,Asela Perera,Anuradhapura,Rambewa,North Central,3483,7065,10548,139320,282600,421920
9/9/2024,Asela Perera,Anuradhapura,Rambewa,North Central,1970,4819,6789,78800,192760,271560
9/10/2024,Asela Perera,Anuradhapura,Rambewa,North Central,1111,2715,3826,44440,108600,153040
9/11/2024,Asela Perera,Anuradhapura,Rambewa,North Central,9539,9585,19124,381560,383400,764960
9/12/2024,Asela Perera,Anuradhapura,Rambewa,North Central,7135,7045,14180,285400,281800,567200
9/13/2024,Asela Perera,Anuradhapura,Rambewa,North Central,8443,9362,17805,337720,374480,712200
9/14/2024,Asela Perera,Anuradhapura,Rambewa,North Central,73,8621,8694,2920,344840,347760
9/15/2024,Asela Perera,Anuradhapura,Rambewa,North Central,3505,4662,8167,140200,186480,326680
9/16/2024,Asela Perera,Anuradhapura,Rambewa,North Central,6639,3509,10148,265560,140360,405920
9/17/2024,Asela Perera,Anuradhapura,Rambewa,North Central,1026,1502,2528,41040,60080,101120
9/18/2024,Asela Perera,Anuradhapura,Rambewa,North Central,6966,8336,15302,278640,333440,612080
9/19/2024,Asela Perera,Anuradhapura,Rambewa,North Central,3952,4082,8034,158080,163280,321360
9/20/2024,Asela Perera,Anuradhapura,Rambewa,North Central,4822,3512,8334,192880,140480,333360
9/21/2024,Asela Perera,Anuradhapura,Rambewa,North Central,9074,5896,14970,362960,235840,598800
9/22/2024,Asela Perera,Anuradhapura,Rambewa,North Central,3485,7279,10764,139400,291160,430560
9/23/2024,Asela Perera,Anuradhapura,Rambewa,North Central,5646,8253,13899,225840,330120,555960
9/24/2024,Asela Perera,Anuradhapura,Rambewa,North Central,9731,4668,14399,389240,186720,575960
9/25/2024,Asela Perera,Anuradhapura,Rambewa,North Central,6801,7138,13939,272040,285520,557560
9/26/2024,Asela Perera,Anuradhapura,Rambewa,North Central,7923,8683,16606,316920,347320,664240
9/27/2024,Asela Perera,Anuradhapura,Rambewa,North Central,3524,5281,8805,140960,211240,352200
9/28/2024,Asela Perera,Anuradhapura,Rambewa,North Central,9752,7465,17217,390080,298600,688680
9/29/2024,Asela Perera,Anuradhapura,Rambewa,North Central,9405,8469,17874,376200,338760,714960
9/30/2024,Asela Perera,Anuradhapura,Rambewa,North Central,7348,541,7889,293920,21640,315560
10/1/2024,Asela Perera,Anuradhapura,Rambewa,North Central,6557,6582,13139,262280,263280,525560
10/2/2024,Asela Perera,Anuradhapura,Rambewa,North Central,4727,853,5580,189080,34120,223200
10/3/2024,Asela Perera,Anuradhapura,Rambewa,North Central,1406,7005,8411,56240,280200,336440
10/4/2024,Asela Perera,Anuradhapura,Rambewa,North Central,2764,5841,8605,110560,233640,344200
10/5/2024,Asela Perera,Anuradhapura,Rambewa,North Central,1415,9322,10737,56600,372880,429480
10/6/2024,Asela Perera,Anuradhapura,Rambewa,North Central,851,9782,10633,34040,391280,425320
10/7/2024,Asela Perera,Anuradhapura,Rambewa,North Central,8883,7253,16136,355320,290120,645440
10/8/2024,Asela Perera,Anuradhapura,Rambewa,North Central,2746,4209,6955,109840,168360,278200
10/9/2024,Asela Perera,Anuradhapura,Rambewa,North Central,7608,149,7757,304320,5960,310280
10/10/2024,Asela Perera,Anuradhapura,Rambewa,North Central,4193,8439,12632,167720,337560,505280
10/11/2024,Asela Perera,Anuradhapura,Rambewa,North Central,327,5243,5570,13080,209720,222800
10/12/2024,Asela Perera,Anuradhapura,Rambewa,North Central,8848,122,8970,353920,4880,358800
10/13/2024,Asela Perera,Anuradhapura,Rambewa,North Central,8739,9114,17853,349560,364560,714120
10/14/2024,Asela Perera,Anuradhapura,Rambewa,North Central,5403,459,5862,216120,18360,234480
10/15/2024,Asela Perera,Anuradhapura,Rambewa,North Central,2006,6620,8626,80240,264800,345040
10/16/2024,Asela Perera,Anuradhapura,Rambewa,North Central,7238,121,7359,289520,4840,294360
10/17/2024,Asela Perera,Anuradhapura,Rambewa,North Central,8133,947,9080,325320,37880,363200
10/18/2024,Asela Perera,Anuradhapura,Rambewa,North Central,6878,1545,8423,275120,61800,336920
10/19/2024,Asela Perera,Anuradhapura,Rambewa,North Central,7536,2215,9751,301440,88600,390040
10/20/2024,Asela Perera,Anuradhapura,Rambewa,North Central,9078,7119,16197,363120,284760,647880
10/21/2024,Asela Perera,Anuradhapura,Rambewa,North Central,6873,3444,10317,274920,137760,412680
10/22/2024,Asela Perera,Anuradhapura,Rambewa,North Central,9304,4403,13707,372160,176120,548280
10/23/2024,Asela Perera,Anuradhapura,Rambewa,North Central,9388,1603,10991,375520,64120,439640
10/24/2024,Asela Perera,Anuradhapura,Rambewa,North Central,9487,8694,18181,379480,347760,727240
10/25/2024,Asela Perera,Anuradhapura,Rambewa,North Central,6718,7031,13749,268720,281240,549960
10/26/2024,Asela Perera,Anuradhapura,Rambewa,North Central,5513,3448,8961,220520,137920,358440
10/27/2024,Asela Perera,Anuradhapura,Rambewa,North Central,3756,5265,9021,150240,210600,360840
10/28/2024,Asela Perera,Anuradhapura,Rambewa,North Central,8193,327,8520,327720,13080,340800
10/29/2024,Asela Perera,Anuradhapura,Rambewa,North Central,7485,6282,13767,299400,251280,550680
10/30/2024,Asela Perera,Anuradhapura,Rambewa,North Central,5596,8358,13954,223840,334320,558160
10/31/2024,Asela Perera,Anuradhapura,Rambewa,North Central,3733,3782,7515,149320,151280,300600
11/1/2024,Asela Perera,Anuradhapura,Rambewa,North Central,563,3140,3703,22520,125600,148120
11/2/2024,Asela Perera,Anuradhapura,Rambewa,North Central,8637,2105,10742,345480,84200,429680
11/3/2024,Asela Perera,Anuradhapura,Rambewa,North Central,4368,5572,9940,174720,222880,397600
11/4/2024,Asela Perera,Anuradhapura,Rambewa,North Central,8658,5307,13965,346320,212280,558600
11/5/2024,Asela Perera,Anuradhapura,Rambewa,North Central,7064,6600,13664,282560,264000,546560
11/6/2024,Asela Perera,Anuradhapura,Rambewa,North Central,9664,3411,13075,386560,136440,523000
11/7/2024,Asela Perera,Anuradhapura,Rambewa,North Central,9093,1032,10125,363720,41280,405000
11/8/2024,Asela Perera,Anuradhapura,Rambewa,North Central,2580,8249,10829,103200,329960,433160
11/9/2024,Asela Perera,Anuradhapura,Rambewa,North Central,8595,483,9078,343800,19320,363120
11/10/2024,Asela Perera,Anuradhapura,Rambewa,North Central,3486,5174,8660,139440,206960,346400
11/11/2024,Asela Perera,Anuradhapura,Rambewa,North Central,8746,3451,12197,349840,138040,487880
11/12/2024,Asela Perera,Anuradhapura,Rambewa,North Central,6355,9062,15417,254200,362480,616680
11/13/2024,Asela Perera,Anuradhapura,Rambewa,North Central,7404,3832,11236,296160,153280,449440
11/14/2024,Asela Perera,Anuradhapura,Rambewa,North Central,8277,2097,10374,331080,83880,414960
11/15/2024,Asela Perera,Anuradhapura,Rambewa,North Central,530,3890,4420,21200,155600,176800
11/16/2024,Asela Perera,Anuradhapura,Rambewa,North Central,7651,2764,10415,306040,110560,416600
11/17/2024,Asela Perera,Anuradhapura,Rambewa,North Central,8787,7272,16059,351480,290880,642360
11/18/2024,Asela Perera,Anuradhapura,Rambewa,North Central,3937,9487,13424,157480,379480,536960
11/19/2024,Asela Perera,Anuradhapura,Rambewa,North Central,7351,1704,9055,294040,68160,362200
11/20/2024,Asela Perera,Anuradhapura,Rambewa,North Central,1975,8641,10616,79000,345640,424640
11/21/2024,Asela Perera,Anuradhapura,Rambewa,North Central,1686,5234,6920,67440,209360,276800
11/22/2024,Asela Perera,Anuradhapura,Rambewa,North Central,9191,8939,18130,367640,357560,725200
11/23/2024,Asela Perera,Anuradhapura,Rambewa,North Central,8374,2181,10555,334960,87240,422200
11/24/2024,Asela Perera,Anuradhapura,Rambewa,North Central,537,5708,6245,21480,228320,249800
11/25/2024,Asela Perera,Anuradhapura,Rambewa,North Central,4091,6335,10426,163640,253400,417040
11/26/2024,Asela Perera,Anuradhapura,Rambewa,North Central,5227,4661,9888,209080,186440,395520
11/27/2024,Asela Perera,Anuradhapura,Rambewa,North Central,4210,5130,9340,168400,205200,373600
11/28/2024,Asela Perera,Anuradhapura,Rambewa,North Central,4962,5036,9998,198480,201440,399920
11/29/2024,Asela Perera,Anuradhapura,Rambewa,North Central,4817,9368,14185,192680,374720,567400
11/30/2024,Asela Perera,Anuradhapura,Rambewa,North Central,4327,9688,14015,173080,387520,560600
12/1/2024,Asela Perera,Anuradhapura,Rambewa,North Central,7782,870,8652,311280,34800,346080
12/2/2024,Asela Perera,Anuradhapura,Rambewa,North Central,1710,2764,4474,68400,110560,178960
12/3/2024,Asela Perera,Anuradhapura,Rambewa,North Central,7681,229,7910,307240,9160,316400
12/4/2024,Asela Perera,Anuradhapura,Rambewa,North Central,2325,5205,7530,93000,208200,301200
12/5/2024,Asela Perera,Anuradhapura,Rambewa,North Central,6248,3033,9281,249920,121320,371240
12/6/2024,Asela Perera,Anuradhapura,Rambewa,North Central,2765,708,3473,110600,28320,138920
12/7/2024,Asela Perera,Anuradhapura,Rambewa,North Central,7586,7375,14961,303440,295000,598440
12/8/2024,Asela Perera,Anuradhapura,Rambewa,North Central,3610,3653,7263,144400,146120,290520
12/9/2024,Asela Perera,Anuradhapura,Rambewa,North Central,4624,6726,11350,184960,269040,454000
12/10/2024,Asela Perera,Anuradhapura,Rambewa,North Central,1725,4890,6615,69000,195600,264600
12/11/2024,Asela Perera,Anuradhapura,Rambewa,North Central,8022,9427,17449,320880,377080,697960
12/12/2024,Asela Perera,Anuradhapura,Rambewa,North Central,6629,1094,7723,265160,43760,308920
12/13/2024,Asela Perera,Anuradhapura,Rambewa,North Central,5422,7681,13103,216880,307240,524120
12/14/2024,Asela Perera,Anuradhapura,Rambewa,North Central,8194,1143,9337,327760,45720,373480
12/15/2024,Asela Perera,Anuradhapura,Rambewa,North Central,229,7811,8040,9160,312440,321600
12/16/2024,Asela Perera,Anuradhapura,Rambewa,North Central,5909,9303,15212,236360,372120,608480
12/17/2024,Asela Perera,Anuradhapura,Rambewa,North Central,7075,5347,12422,283000,213880,496880
12/18/2024,Asela Perera,Anuradhapura,Rambewa,North Central,9184,8877,18061,367360,355080,722440
12/19/2024,Asela Perera,Anuradhapura,Rambewa,North Central,224,1619,1843,8960,64760,73720
12/20/2024,Asela Perera,Anuradhapura,Rambewa,North Central,6775,2567,9342,271000,102680,373680
12/21/2024,Asela Perera,Anuradhapura,Rambewa,North Central,8715,6251,14966,348600,250040,598640
12/22/2024,Asela Perera,Anuradhapura,Rambewa,North Central,750,7802,8552,30000,312080,342080
12/23/2024,Asela Perera,Anuradhapura,Rambewa,North Central,8812,7577,16389,352480,303080,655560
12/24/2024,Asela Perera,Anuradhapura,Rambewa,North Central,4553,2601,7154,182120,104040,286160
12/25/2024,Asela Perera,Anuradhapura,Rambewa,North Central,3880,177,4057,155200,7080,162280
12/26/2024,Asela Perera,Anuradhapura,Rambewa,North Central,5007,5232,10239,200280,209280,409560
12/27/2024,Asela Perera,Anuradhapura,Rambewa,North Central,1883,4436,6319,75320,177440,252760
12/28/2024,Asela Perera,Anuradhapura,Rambewa,North Central,5773,8487,14260,230920,339480,570400
12/29/2024,Asela Perera,Anuradhapura,Rambewa,North Central,5241,4856,10097,209640,194240,403880
12/30/2024,Asela Perera,Anuradhapura,Rambewa,North Central,9814,5158,14972,392560,206320,598880
12/31/2024,Asela Perera,Anuradhapura,Rambewa,North Central,8179,5365,13544,327160,214600,541760
1/1/2025,Asela Perera,Anuradhapura,Rambewa,North Central,7390,7525,14915,295600,301000,596600
1/2/2025,Asela Perera,Anuradhapura,Rambewa,North Central,3630,2246,5876,145200,89840,235040
1/3/2025,Asela Perera,Anuradhapura,Rambewa,North Central,3593,905,4498,143720,36200,179920
1/4/2025,Asela Perera,Anuradhapura,Rambewa,North Central,6254,9549,15803,250160,381960,632120
1/5/2025,Asela Perera,Anuradhapura,Rambewa,North Central,2912,8294,11206,116480,331760,448240
1/6/2025,Asela Perera,Anuradhapura,Rambewa,North Central,883,2625,3508,35320,105000,140320
1/7/2025,Asela Perera,Anuradhapura,Rambewa,North Central,4616,7283,11899,184640,291320,475960
1/8/2025,Asela Perera,Anuradhapura,Rambewa,North Central,114,1867,1981,4560,74680,79240
1/9/2025,Asela Perera,Anuradhapura,Rambewa,North Central,9380,3398,12778,375200,135920,511120
1/10/2025,Asela Perera,Anuradhapura,Rambewa,North Central,333,2718,3051,13320,108720,122040
1/11/2025,Asela Perera,Anuradhapura,Rambewa,North Central,3212,4664,7876,128480,186560,315040
1/12/2025,Asela Perera,Anuradhapura,Rambewa,North Central,8812,3317,12129,352480,132680,485160
1/13/2025,Asela Perera,Anuradhapura,Rambewa,North Central,7313,6847,14160,292520,273880,566400
1/14/2025,Asela Perera,Anuradhapura,Rambewa,North Central,735,3780,4515,29400,151200,180600
1/15/2025,Asela Perera,Anuradhapura,Rambewa,North Central,6000,6294,12294,240000,251760,491760
1/16/2025,Asela Perera,Anuradhapura,Rambewa,North Central,8966,7467,16433,358640,298680,657320
1/17/2025,Asela Perera,Anuradhapura,Rambewa,North Central,8917,3813,12730,356680,152520,509200
1/18/2025,Asela Perera,Anuradhapura,Rambewa,North Central,4079,7929,12008,163160,317160,480320
1/19/2025,Asela Perera,Anuradhapura,Rambewa,North Central,6473,2608,9081,258920,104320,363240
1/20/2025,Asela Perera,Anuradhapura,Rambewa,North Central,4427,2611,7038,177080,104440,281520
1/21/2025,Asela Perera,Anuradhapura,Rambewa,North Central,8476,2017,10493,339040,80680,419720
1/22/2025,Asela Perera,Anuradhapura,Rambewa,North Central,5104,2073,7177,204160,82920,287080
1/23/2025,Asela Perera,Anuradhapura,Rambewa,North Central,1668,6258,7926,66720,250320,317040
1/24/2025,Asela Perera,Anuradhapura,Rambewa,North Central,2319,6967,9286,92760,278680,371440
1/25/2025,Asela Perera,Anuradhapura,Rambewa,North Central,6446,9073,15519,257840,362920,620760
1/26/2025,Asela Perera,Anuradhapura,Rambewa,North Central,9883,5834,15717,395320,233360,628680
1/27/2025,Asela Perera,Anuradhapura,Rambewa,North Central,2337,4560,6897,93480,182400,275880
1/28/2025,Asela Perera,Anuradhapura,Rambewa,North Central,4785,8456,13241,191400,338240,529640
1/29/2025,Asela Perera,Anuradhapura,Rambewa,North Central,4976,5939,10915,199040,237560,436600
1/30/2025,Asela Perera,Anuradhapura,Rambewa,North Central,1557,5053,6610,62280,202120,264400
1/31/2025,Asela Perera,Anuradhapura,Rambewa,North Central,2031,4570,6601,81240,182800,264040
2/1/2025,Asela Perera,Anuradhapura,Rambewa,North Central,6651,6544,13195,266040,261760,527800
2/2/2025,Asela Perera,Anuradhapura,Rambewa,North Central,2509,89,2598,100360,3560,103920
2/3/2025,Asela Perera,Anuradhapura,Rambewa,North Central,7005,2481,9486,280200,99240,379440
2/4/2025,Asela Perera,Anuradhapura,Rambewa,North Central,2647,1622,4269,105880,64880,170760
2/5/2025,Asela Perera,Anuradhapura,Rambewa,North Central,18,1199,1217,720,47960,48680
2/6/2025,Asela Perera,Anuradhapura,Rambewa,North Central,9295,9145,18440,371800,365800,737600
2/7/2025,Asela Perera,Anuradhapura,Rambewa,North Central,5736,7545,13281,229440,301800,531240
2/8/2025,Asela Perera,Anuradhapura,Rambewa,North Central,4504,7301,11805,180160,292040,472200
2/9/2025,Asela Perera,Anuradhapura,Rambewa,North Central,6113,4213,10326,244520,168520,413040
2/10/2025,Asela Perera,Anuradhapura,Rambewa,North Central,9935,5178,15113,397400,207120,604520
2/11/2025,Asela Perera,Anuradhapura,Rambewa,North Central,7256,8433,15689,290240,337320,627560
2/12/2025,Asela Perera,Anuradhapura,Rambewa,North Central,6860,1524,8384,274400,60960,335360
2/13/2025,Asela Perera,Anuradhapura,Rambewa,North Central,390,9824,10214,15600,392960,408560
2/14/2025,Asela Perera,Anuradhapura,Rambewa,North Central,1147,4706,5853,45880,188240,234120
2/15/2025,Asela Perera,Anuradhapura,Rambewa,North Central,6296,5966,12262,251840,238640,490480
2/16/2025,Asela Perera,Anuradhapura,Rambewa,North Central,1830,4412,6242,73200,176480,249680
2/17/2025,Asela Perera,Anuradhapura,Rambewa,North Central,7771,9839,17610,310840,393560,704400
2/18/2025,Asela Perera,Anuradhapura,Rambewa,North Central,8519,742,9261,340760,29680,370440
2/19/2025,Asela Perera,Anuradhapura,Rambewa,North Central,2796,9192,11988,111840,367680,479520
2/20/2025,Asela Perera,Anuradhapura,Rambewa,North Central,5141,9234,14375,205640,369360,575000
2/21/2025,Asela Perera,Anuradhapura,Rambewa,North Central,7465,3148,10613,298600,125920,424520
2/22/2025,Asela Perera,Anuradhapura,Rambewa,North Central,8206,6087,14293,328240,243480,571720
2/23/2025,Asela Perera,Anuradhapura,Rambewa,North Central,7664,590,8254,306560,23600,330160
2/24/2025,Asela Perera,Anuradhapura,Rambewa,North Central,4326,2039,6365,173040,81560,254600
2/25/2025,Asela Perera,Anuradhapura,Rambewa,North Central,4566,8311,12877,182640,332440,515080
2/26/2025,Asela Perera,Anuradhapura,Rambewa,North Central,8255,9303,17558,330200,372120,702320
2/27/2025,Asela Perera,Anuradhapura,Rambewa,North Central,2243,9427,11670,89720,377080,466800
2/28/2025,Asela Perera,Anuradhapura,Rambewa,North Central,4954,665,5619,198160,26600,224760
3/1/2025,Asela Perera,Anuradhapura,Rambewa,North Central,562,1491,2053,22480,59640,82120
3/2/2025,Asela Perera,Anuradhapura,Rambewa,North Central,3679,5995,9674,147160,239800,386960
3/3/2025,Asela Perera,Anuradhapura,Rambewa,North Central,7537,2664,10201,301480,106560,408040
3/4/2025,Asela Perera,Anuradhapura,Rambewa,North Central,3184,495,3679,127360,19800,147160
3/5/2025,Asela Perera,Anuradhapura,Rambewa,North Central,577,3539,4116,23080,141560,164640
3/6/2025,Asela Perera,Anuradhapura,Rambewa,North Central,5173,6784,11957,206920,271360,478280
3/7/2025,Asela Perera,Anuradhapura,Rambewa,North Central,1930,3172,5102,77200,126880,204080
3/8/2025,Asela Perera,Anuradhapura,Rambewa,North Central,8376,3260,11636,335040,130400,465440
3/9/2025,Asela Perera,Anuradhapura,Rambewa,North Central,1621,7015,8636,64840,280600,345440
3/10/2025,Asela Perera,Anuradhapura,Rambewa,North Central,4332,5586,9918,173280,223440,396720
3/11/2025,Asela Perera,Anuradhapura,Rambewa,North Central,9436,3312,12748,377440,132480,509920
3/12/2025,Asela Perera,Anuradhapura,Rambewa,North Central,799,1252,2051,31960,50080,82040
3/13/2025,Asela Perera,Anuradhapura,Rambewa,North Central,6225,6909,13134,249000,276360,525360
3/14/2025,Asela Perera,Anuradhapura,Rambewa,North Central,7612,1392,9004,304480,55680,360160
3/15/2025,Asela Perera,Anuradhapura,Rambewa,North Central,396,1930,2326,15840,77200,93040
3/16/2025,Asela Perera,Anuradhapura,Rambewa,North Central,7330,808,8138,293200,32320,325520
3/17/2025,Asela Perera,Anuradhapura,Rambewa,North Central,2896,2080,4976,115840,83200,199040
3/18/2025,Asela Perera,Anuradhapura,Rambewa,North Central,8507,4741,13248,340280,189640,529920
3/19/2025,Asela Perera,Anuradhapura,Rambewa,North Central,4486,9623,14109,179440,384920,564360
3/20/2025,Asela Perera,Anuradhapura,Rambewa,North Central,1284,2968,4252,51360,118720,170080
3/21/2025,Asela Perera,Anuradhapura,Rambewa,North Central,7590,3154,10744,303600,126160,429760
3/22/2025,Asela Perera,Anuradhapura,Rambewa,North Central,4531,2555,7086,181240,102200,283440
3/23/2025,Asela Perera,Anuradhapura,Rambewa,North Central,9690,334,10024,387600,13360,400960
3/25/2024,Kanthi Rathnayake,Mannar,Musali,Northern,4259,8500,12759,170360,340000,510360
3/26/2024,Kanthi Rathnayake,Mannar,Musali,Northern,2609,6181,8790,104360,247240,351600
3/27/2024,Kanthi Rathnayake,Mannar,Musali,Northern,6157,617,6774,246280,24680,270960
3/28/2024,Kanthi Rathnayake,Mannar,Musali,Northern,1292,303,1595,51680,12120,63800
3/29/2024,Kanthi Rathnayake,Mannar,Musali,Northern,224,3992,4216,8960,159680,168640
3/30/2024,Kanthi Rathnayake,Mannar,Musali,Northern,5256,859,6115,210240,34360,244600
3/31/2024,Kanthi Rathnayake,Mannar,Musali,Northern,3521,6977,10498,140840,279080,419920
4/1/2024,Kanthi Rathnayake,Mannar,Musali,Northern,6690,5193,11883,267600,207720,475320
4/2/2024,Kanthi Rathnayake,Mannar,Musali,Northern,9267,9885,19152,370680,395400,766080
4/3/2024,Kanthi Rathnayake,Mannar,Musali,Northern,4960,1463,6423,198400,58520,256920
4/4/2024,Kanthi Rathnayake,Mannar,Musali,Northern,4113,6339,10452,164520,253560,418080
4/5/2024,Kanthi Rathnayake,Mannar,Musali,Northern,4718,8906,13624,188720,356240,544960
4/6/2024,Kanthi Rathnayake,Mannar,Musali,Northern,9983,1593,11576,399320,63720,463040
4/7/2024,Kanthi Rathnayake,Mannar,Musali,Northern,124,1947,2071,4960,77880,82840
4/8/2024,Kanthi Rathnayake,Mannar,Musali,Northern,4767,2962,7729,190680,118480,309160
4/9/2024,Kanthi Rathnayake,Mannar,Musali,Northern,6976,303,7279,279040,12120,291160
4/10/2024,Kanthi Rathnayake,Mannar,Musali,Northern,3131,9832,12963,125240,393280,518520
4/11/2024,Kanthi Rathnayake,Mannar,Musali,Northern,4797,9957,14754,191880,398280,590160
4/19/2024,Kanthi Rathnayake,Mannar,Musali,Northern,8917,391,9308,356680,15640,372320
4/20/2024,Kanthi Rathnayake,Mannar,Musali,Northern,2285,2041,4326,91400,81640,173040
4/21/2024,Kanthi Rathnayake,Mannar,Musali,Northern,7907,9757,17664,316280,390280,706560
4/22/2024,Kanthi Rathnayake,Mannar,Musali,Northern,8731,6053,14784,349240,242120,591360
4/23/2024,Kanthi Rathnayake,Mannar,Musali,Northern,1704,6966,8670,68160,278640,346800
4/24/2024,Kanthi Rathnayake,Mannar,Musali,Northern,5177,3981,9158,207080,159240,366320
4/25/2024,Kanthi Rathnayake,Mannar,Musali,Northern,135,9746,9881,5400,389840,395240
4/26/2024,Kanthi Rathnayake,Mannar,Musali,Northern,6801,6610,13411,272040,264400,536440
4/27/2024,Kanthi Rathnayake,Mannar,Musali,Northern,7806,9970,17776,312240,398800,711040
4/28/2024,Kanthi Rathnayake,Mannar,Musali,Northern,3285,6910,10195,131400,276400,407800
4/29/2024,Kanthi Rathnayake,Mannar,Musali,Northern,7913,9830,17743,316520,393200,709720
4/30/2024,Kanthi Rathnayake,Mannar,Musali,Northern,2793,3816,6609,111720,152640,264360
5/1/2024,Kanthi Rathnayake,Mannar,Musali,Northern,9747,764,10511,389880,30560,420440
5/2/2024,Kanthi Rathnayake,Mannar,Musali,Northern,1376,8356,9732,55040,334240,389280
5/3/2024,Kanthi Rathnayake,Mannar,Musali,Northern,8874,5538,14412,354960,221520,576480
5/4/2024,Kanthi Rathnayake,Mannar,Musali,Northern,2360,2017,4377,94400,80680,175080
5/5/2024,Kanthi Rathnayake,Mannar,Musali,Northern,6972,8492,15464,278880,339680,618560
5/6/2024,Kanthi Rathnayake,Mannar,Musali,Northern,8914,9205,18119,356560,368200,724760
5/7/2024,Kanthi Rathnayake,Mannar,Musali,Northern,6477,9759,16236,259080,390360,649440
5/8/2024,Kanthi Rathnayake,Mannar,Musali,Northern,8347,5574,13921,333880,222960,556840
5/9/2024,Kanthi Rathnayake,Mannar,Musali,Northern,5040,4264,9304,201600,170560,372160
5/10/2024,Kanthi Rathnayake,Mannar,Musali,Northern,6908,3254,10162,276320,130160,406480
5/11/2024,Kanthi Rathnayake,Mannar,Musali,Northern,2459,6799,9258,98360,271960,370320
5/12/2024,Kanthi Rathnayake,Mannar,Musali,Northern,8832,149,8981,353280,5960,359240
5/13/2024,Kanthi Rathnayake,Mannar,Musali,Northern,9336,2018,11354,373440,80720,454160
5/14/2024,Kanthi Rathnayake,Mannar,Musali,Northern,2701,7675,10376,108040,307000,415040
5/15/2024,Kanthi Rathnayake,Mannar,Musali,Northern,7992,6262,14254,319680,250480,570160
5/16/2024,Kanthi Rathnayake,Mannar,Musali,Northern,8329,8798,17127,333160,351920,685080
5/17/2024,Kanthi Rathnayake,Mannar,Musali,Northern,7141,1415,8556,285640,56600,342240
5/18/2024,Kanthi Rathnayake,Mannar,Musali,Northern,2228,8192,10420,89120,327680,416800
5/19/2024,Kanthi Rathnayake,Mannar,Musali,Northern,4370,921,5291,174800,36840,211640
5/20/2024,Kanthi Rathnayake,Mannar,Musali,Northern,4188,8410,12598,167520,336400,503920
5/21/2024,Kanthi Rathnayake,Mannar,Musali,Northern,6159,7503,13662,246360,300120,546480
5/22/2024,Kanthi Rathnayake,Mannar,Musali,Northern,3453,8986,12439,138120,359440,497560
5/24/2024,Kanthi Rathnayake,Mannar,Musali,Northern,7413,9113,16526,296520,364520,661040
5/25/2024,Kanthi Rathnayake,Mannar,Musali,Northern,6009,5728,11737,240360,229120,469480
5/26/2024,Kanthi Rathnayake,Mannar,Musali,Northern,5160,528,5688,206400,21120,227520
5/27/2024,Kanthi Rathnayake,Mannar,Musali,Northern,6907,4442,11349,276280,177680,453960
5/28/2024,Kanthi Rathnayake,Mannar,Musali,Northern,5226,290,5516,209040,11600,220640
5/29/2024,Kanthi Rathnayake,Mannar,Musali,Northern,4109,7140,11249,164360,285600,449960
5/30/2024,Kanthi Rathnayake,Mannar,Musali,Northern,8308,696,9004,332320,27840,360160
5/31/2024,Kanthi Rathnayake,Mannar,Musali,Northern,6411,7590,14001,256440,303600,560040
6/1/2024,Kanthi Rathnayake,Mannar,Musali,Northern,2155,7500,9655,86200,300000,386200
6/2/2024,Kanthi Rathnayake,Mannar,Musali,Northern,8407,6118,14525,336280,244720,581000
6/3/2024,Kanthi Rathnayake,Mannar,Musali,Northern,1608,6531,8139,64320,261240,325560
6/4/2024,Kanthi Rathnayake,Mannar,Musali,Northern,6602,4873,11475,264080,194920,459000
6/5/2024,Kanthi Rathnayake,Mannar,Musali,Northern,9078,3814,12892,363120,152560,515680
6/6/2024,Kanthi Rathnayake,Mannar,Musali,Northern,8307,4625,12932,332280,185000,517280
6/7/2024,Kanthi Rathnayake,Mannar,Musali,Northern,8823,7048,15871,352920,281920,634840
6/8/2024,Kanthi Rathnayake,Mannar,Musali,Northern,8699,8082,16781,347960,323280,671240
6/9/2024,Kanthi Rathnayake,Mannar,Musali,Northern,4113,4957,9070,164520,198280,362800
6/10/2024,Kanthi Rathnayake,Mannar,Musali,Northern,3449,3489,6938,137960,139560,277520
6/11/2024,Kanthi Rathnayake,Mannar,Musali,Northern,6762,1260,8022,270480,50400,320880
6/12/2024,Kanthi Rathnayake,Mannar,Musali,Northern,8315,705,9020,332600,28200,360800
6/13/2024,Kanthi Rathnayake,Mannar,Musali,Northern,8470,9131,17601,338800,365240,704040
6/14/2024,Kanthi Rathnayake,Mannar,Musali,Northern,7759,896,8655,310360,35840,346200
6/15/2024,Kanthi Rathnayake,Mannar,Musali,Northern,6082,8780,14862,243280,351200,594480
6/16/2024,Kanthi Rathnayake,Mannar,Musali,Northern,6121,498,6619,244840,19920,264760
6/17/2024,Kanthi Rathnayake,Mannar,Musali,Northern,72,3855,3927,2880,154200,157080
6/18/2024,Kanthi Rathnayake,Mannar,Musali,Northern,2583,1178,3761,103320,47120,150440
6/19/2024,Kanthi Rathnayake,Mannar,Musali,Northern,3231,4807,8038,129240,192280,321520
6/20/2024,Kanthi Rathnayake,Mannar,Musali,Northern,4948,4571,9519,197920,182840,380760
6/21/2024,Kanthi Rathnayake,Mannar,Musali,Northern,8980,4728,13708,359200,189120,548320
6/22/2024,Kanthi Rathnayake,Mannar,Musali,Northern,7921,3356,11277,316840,134240,451080
6/23/2024,Kanthi Rathnayake,Mannar,Musali,Northern,109,2570,2679,4360,102800,107160
6/24/2024,Kanthi Rathnayake,Mannar,Musali,Northern,3757,7670,11427,150280,306800,457080
6/25/2024,Kanthi Rathnayake,Mannar,Musali,Northern,3895,3017,6912,155800,120680,276480
6/26/2024,Kanthi Rathnayake,Mannar,Musali,Northern,5955,2310,8265,238200,92400,330600
6/27/2024,Kanthi Rathnayake,Mannar,Musali,Northern,5765,5750,11515,230600,230000,460600
6/28/2024,Kanthi Rathnayake,Mannar,Musali,Northern,6630,1672,8302,265200,66880,332080
6/29/2024,Kanthi Rathnayake,Mannar,Musali,Northern,5141,4055,9196,205640,162200,367840
6/30/2024,Kanthi Rathnayake,Mannar,Musali,Northern,7280,8116,15396,291200,324640,615840
7/1/2024,Kanthi Rathnayake,Mannar,Musali,Northern,8301,9543,17844,332040,381720,713760
7/2/2024,Kanthi Rathnayake,Mannar,Musali,Northern,461,8540,9001,18440,341600,360040
7/3/2024,Kanthi Rathnayake,Mannar,Musali,Northern,491,9673,10164,19640,386920,406560
7/4/2024,Kanthi Rathnayake,Mannar,Musali,Northern,465,4381,4846,18600,175240,193840
7/5/2024,Kanthi Rathnayake,Mannar,Musali,Northern,324,6608,6932,12960,264320,277280
7/6/2024,Kanthi Rathnayake,Mannar,Musali,Northern,1232,9714,10946,49280,388560,437840
7/7/2024,Kanthi Rathnayake,Mannar,Musali,Northern,1864,9284,11148,74560,371360,445920
7/8/2024,Kanthi Rathnayake,Mannar,Musali,Northern,4297,2719,7016,171880,108760,280640
7/9/2024,Kanthi Rathnayake,Mannar,Musali,Northern,2639,3769,6408,105560,150760,256320
7/10/2024,Kanthi Rathnayake,Mannar,Musali,Northern,5103,1977,7080,204120,79080,283200
7/11/2024,Kanthi Rathnayake,Mannar,Musali,Northern,4327,5050,9377,173080,202000,375080
7/12/2024,Kanthi Rathnayake,Mannar,Musali,Northern,8037,3263,11300,321480,130520,452000
7/13/2024,Kanthi Rathnayake,Mannar,Musali,Northern,2497,4685,7182,99880,187400,287280
7/14/2024,Kanthi Rathnayake,Mannar,Musali,Northern,2377,3512,5889,95080,140480,235560
7/15/2024,Kanthi Rathnayake,Mannar,Musali,Northern,9741,3455,13196,389640,138200,527840
7/16/2024,Kanthi Rathnayake,Mannar,Musali,Northern,7148,585,7733,285920,23400,309320
7/17/2024,Kanthi Rathnayake,Mannar,Musali,Northern,2638,7950,10588,105520,318000,423520
7/18/2024,Kanthi Rathnayake,Mannar,Musali,Northern,3388,5267,8655,135520,210680,346200
7/19/2024,Kanthi Rathnayake,Mannar,Musali,Northern,9074,5323,14397,362960,212920,575880
7/20/2024,Kanthi Rathnayake,Mannar,Musali,Northern,6144,1434,7578,245760,57360,303120
7/21/2024,Kanthi Rathnayake,Mannar,Musali,Northern,1532,2817,4349,61280,112680,173960
7/22/2024,Kanthi Rathnayake,Mannar,Musali,Northern,5953,8839,14792,238120,353560,591680
7/23/2024,Kanthi Rathnayake,Mannar,Musali,Northern,4129,3552,7681,165160,142080,307240
7/24/2024,Kanthi Rathnayake,Mannar,Musali,Northern,3514,1350,4864,140560,54000,194560
7/25/2024,Kanthi Rathnayake,Mannar,Musali,Northern,9797,5565,15362,391880,222600,614480
7/26/2024,Kanthi Rathnayake,Mannar,Musali,Northern,2887,9009,11896,115480,360360,475840
7/27/2024,Kanthi Rathnayake,Mannar,Musali,Northern,4714,2546,7260,188560,101840,290400
7/28/2024,Kanthi Rathnayake,Mannar,Musali,Northern,4434,2078,6512,177360,83120,260480
7/29/2024,Kanthi Rathnayake,Mannar,Musali,Northern,2205,4538,6743,88200,181520,269720
7/30/2024,Kanthi Rathnayake,Mannar,Musali,Northern,8729,6109,14838,349160,244360,593520
7/31/2024,Kanthi Rathnayake,Mannar,Musali,Northern,1762,2873,4635,70480,114920,185400
8/1/2024,Kanthi Rathnayake,Mannar,Musali,Northern,3771,9135,12906,150840,365400,516240
8/2/2024,Kanthi Rathnayake,Mannar,Musali,Northern,1118,4736,5854,44720,189440,234160
8/3/2024,Kanthi Rathnayake,Mannar,Musali,Northern,130,5453,5583,5200,218120,223320
8/4/2024,Kanthi Rathnayake,Mannar,Musali,Northern,1543,7639,9182,61720,305560,367280
8/5/2024,Kanthi Rathnayake,Mannar,Musali,Northern,8574,6254,14828,342960,250160,593120
8/6/2024,Kanthi Rathnayake,Mannar,Musali,Northern,3991,8681,12672,159640,347240,506880
8/7/2024,Kanthi Rathnayake,Mannar,Musali,Northern,3910,3047,6957,156400,121880,278280
8/8/2024,Kanthi Rathnayake,Mannar,Musali,Northern,2480,5602,8082,99200,224080,323280
8/9/2024,Kanthi Rathnayake,Mannar,Musali,Northern,7683,1119,8802,307320,44760,352080
8/10/2024,Kanthi Rathnayake,Mannar,Musali,Northern,898,7482,8380,35920,299280,335200
8/11/2024,Kanthi Rathnayake,Mannar,Musali,Northern,8207,1726,9933,328280,69040,397320
8/12/2024,Kanthi Rathnayake,Mannar,Musali,Northern,2126,4647,6773,85040,185880,270920
8/13/2024,Kanthi Rathnayake,Mannar,Musali,Northern,3688,710,4398,147520,28400,175920
8/14/2024,Kanthi Rathnayake,Mannar,Musali,Northern,5292,1249,6541,211680,49960,261640
8/15/2024,Kanthi Rathnayake,Mannar,Musali,Northern,5520,3007,8527,220800,120280,341080
8/16/2024,Kanthi Rathnayake,Mannar,Musali,Northern,2837,8227,11064,113480,329080,442560
8/17/2024,Kanthi Rathnayake,Mannar,Musali,Northern,793,2758,3551,31720,110320,142040
8/18/2024,Kanthi Rathnayake,Mannar,Musali,Northern,7057,5214,12271,282280,208560,490840
8/19/2024,Kanthi Rathnayake,Mannar,Musali,Northern,7579,7890,15469,303160,315600,618760
8/20/2024,Kanthi Rathnayake,Mannar,Musali,Northern,1193,2140,3333,47720,85600,133320
8/21/2024,Kanthi Rathnayake,Mannar,Musali,Northern,1531,8899,10430,61240,355960,417200
8/22/2024,Kanthi Rathnayake,Mannar,Musali,Northern,633,9827,10460,25320,393080,418400
8/23/2024,Kanthi Rathnayake,Mannar,Musali,Northern,2304,8712,11016,92160,348480,440640
8/24/2024,Kanthi Rathnayake,Mannar,Musali,Northern,3699,6601,10300,147960,264040,412000
8/25/2024,Kanthi Rathnayake,Mannar,Musali,Northern,9286,8632,17918,371440,345280,716720
8/26/2024,Kanthi Rathnayake,Mannar,Musali,Northern,3217,3040,6257,128680,121600,250280
8/27/2024,Kanthi Rathnayake,Mannar,Musali,Northern,4067,4338,8405,162680,173520,336200
8/28/2024,Kanthi Rathnayake,Mannar,Musali,Northern,3709,1229,4938,148360,49160,197520
8/29/2024,Kanthi Rathnayake,Mannar,Musali,Northern,8719,5285,14004,348760,211400,560160
8/30/2024,Kanthi Rathnayake,Mannar,Musali,Northern,7906,418,8324,316240,16720,332960
8/31/2024,Kanthi Rathnayake,Mannar,Musali,Northern,6229,8773,15002,249160,350920,600080
9/1/2024,Kanthi Rathnayake,Mannar,Musali,Northern,2928,9169,12097,117120,366760,483880
9/2/2024,Kanthi Rathnayake,Mannar,Musali,Northern,7696,9350,17046,307840,374000,681840
9/3/2024,Kanthi Rathnayake,Mannar,Musali,Northern,2466,9441,11907,98640,377640,476280
9/4/2024,Kanthi Rathnayake,Mannar,Musali,Northern,9078,6310,15388,363120,252400,615520
9/5/2024,Kanthi Rathnayake,Mannar,Musali,Northern,6943,6372,13315,277720,254880,532600
9/6/2024,Kanthi Rathnayake,Mannar,Musali,Northern,5033,4076,9109,201320,163040,364360
9/7/2024,Kanthi Rathnayake,Mannar,Musali,Northern,120,6416,6536,4800,256640,261440
9/8/2024,Kanthi Rathnayake,Mannar,Musali,Northern,7099,6573,13672,283960,262920,546880
9/9/2024,Kanthi Rathnayake,Mannar,Musali,Northern,1031,6732,7763,41240,269280,310520
9/10/2024,Kanthi Rathnayake,Mannar,Musali,Northern,4483,5452,9935,179320,218080,397400
9/11/2024,Kanthi Rathnayake,Mannar,Musali,Northern,6307,794,7101,252280,31760,284040
9/12/2024,Kanthi Rathnayake,Mannar,Musali,Northern,3253,6989,10242,130120,279560,409680
9/13/2024,Kanthi Rathnayake,Mannar,Musali,Northern,649,8718,9367,25960,348720,374680
9/14/2024,Kanthi Rathnayake,Mannar,Musali,Northern,134,8744,8878,5360,349760,355120
9/15/2024,Kanthi Rathnayake,Mannar,Musali,Northern,1750,7220,8970,70000,288800,358800
9/16/2024,Kanthi Rathnayake,Mannar,Musali,Northern,3522,8788,12310,140880,351520,492400
9/17/2024,Kanthi Rathnayake,Mannar,Musali,Northern,219,1225,1444,8760,49000,57760
9/18/2024,Kanthi Rathnayake,Mannar,Musali,Northern,2972,9039,12011,118880,361560,480440
9/19/2024,Kanthi Rathnayake,Mannar,Musali,Northern,3937,4370,8307,157480,174800,332280
9/20/2024,Kanthi Rathnayake,Mannar,Musali,Northern,5376,4978,10354,215040,199120,414160
9/21/2024,Kanthi Rathnayake,Mannar,Musali,Northern,5208,5839,11047,208320,233560,441880
9/22/2024,Kanthi Rathnayake,Mannar,Musali,Northern,4926,1023,5949,197040,40920,237960
9/23/2024,Kanthi Rathnayake,Mannar,Musali,Northern,3809,1467,5276,152360,58680,211040
9/24/2024,Kanthi Rathnayake,Mannar,Musali,Northern,6307,817,7124,252280,32680,284960
9/25/2024,Kanthi Rathnayake,Mannar,Musali,Northern,5849,6607,12456,233960,264280,498240
9/26/2024,Kanthi Rathnayake,Mannar,Musali,Northern,5284,2786,8070,211360,111440,322800
9/27/2024,Kanthi Rathnayake,Mannar,Musali,Northern,8928,7105,16033,357120,284200,641320
9/28/2024,Kanthi Rathnayake,Mannar,Musali,Northern,2752,9500,12252,110080,380000,490080
9/29/2024,Kanthi Rathnayake,Mannar,Musali,Northern,7816,8073,15889,312640,322920,635560
9/30/2024,Kanthi Rathnayake,Mannar,Musali,Northern,7400,6073,13473,296000,242920,538920
10/1/2024,Kanthi Rathnayake,Mannar,Musali,Northern,8930,2144,11074,357200,85760,442960
10/2/2024,Kanthi Rathnayake,Mannar,Musali,Northern,2022,459,2481,80880,18360,99240
10/3/2024,Kanthi Rathnayake,Mannar,Musali,Northern,4795,2032,6827,191800,81280,273080
10/4/2024,Kanthi Rathnayake,Mannar,Musali,Northern,5443,6389,11832,217720,255560,473280
10/5/2024,Kanthi Rathnayake,Mannar,Musali,Northern,802,68,870,32080,2720,34800
10/6/2024,Kanthi Rathnayake,Mannar,Musali,Northern,4183,6397,10580,167320,255880,423200
10/7/2024,Kanthi Rathnayake,Mannar,Musali,Northern,3276,886,4162,131040,35440,166480
10/8/2024,Kanthi Rathnayake,Mannar,Musali,Northern,2460,2848,5308,98400,113920,212320
10/9/2024,Kanthi Rathnayake,Mannar,Musali,Northern,4429,4074,8503,177160,162960,340120
10/10/2024,Kanthi Rathnayake,Mannar,Musali,Northern,5415,6479,11894,216600,259160,475760
10/11/2024,Kanthi Rathnayake,Mannar,Musali,Northern,714,3880,4594,28560,155200,183760
10/12/2024,Kanthi Rathnayake,Mannar,Musali,Northern,8505,6459,14964,340200,258360,598560
10/13/2024,Kanthi Rathnayake,Mannar,Musali,Northern,6933,6585,13518,277320,263400,540720
10/14/2024,Kanthi Rathnayake,Mannar,Musali,Northern,1423,8798,10221,56920,351920,408840
10/15/2024,Kanthi Rathnayake,Mannar,Musali,Northern,8381,3933,12314,335240,157320,492560
10/16/2024,Kanthi Rathnayake,Mannar,Musali,Northern,5801,9643,15444,232040,385720,617760
10/17/2024,Kanthi Rathnayake,Mannar,Musali,Northern,4143,670,4813,165720,26800,192520
10/18/2024,Kanthi Rathnayake,Mannar,Musali,Northern,2157,8144,10301,86280,325760,412040
10/19/2024,Kanthi Rathnayake,Mannar,Musali,Northern,7075,747,7822,283000,29880,312880
10/20/2024,Kanthi Rathnayake,Mannar,Musali,Northern,4929,1600,6529,197160,64000,261160
10/21/2024,Kanthi Rathnayake,Mannar,Musali,Northern,4311,4627,8938,172440,185080,357520
10/22/2024,Kanthi Rathnayake,Mannar,Musali,Northern,174,5732,5906,6960,229280,236240
10/23/2024,Kanthi Rathnayake,Mannar,Musali,Northern,44,6963,7007,1760,278520,280280
10/24/2024,Kanthi Rathnayake,Mannar,Musali,Northern,2240,3430,5670,89600,137200,226800
10/25/2024,Kanthi Rathnayake,Mannar,Musali,Northern,7214,5233,12447,288560,209320,497880
10/26/2024,Kanthi Rathnayake,Mannar,Musali,Northern,6195,8150,14345,247800,326000,573800
10/27/2024,Kanthi Rathnayake,Mannar,Musali,Northern,3441,5181,8622,137640,207240,344880
10/28/2024,Kanthi Rathnayake,Mannar,Musali,Northern,13,7445,7458,520,297800,298320
10/29/2024,Kanthi Rathnayake,Mannar,Musali,Northern,514,8362,8876,20560,334480,355040
10/30/2024,Kanthi Rathnayake,Mannar,Musali,Northern,7322,5029,12351,292880,201160,494040
10/31/2024,Kanthi Rathnayake,Mannar,Musali,Northern,1626,8457,10083,65040,338280,403320
11/1/2024,Kanthi Rathnayake,Mannar,Musali,Northern,5157,402,5559,206280,16080,222360
11/2/2024,Kanthi Rathnayake,Mannar,Musali,Northern,735,9429,10164,29400,377160,406560
11/3/2024,Kanthi Rathnayake,Mannar,Musali,Northern,4109,3427,7536,164360,137080,301440
11/4/2024,Kanthi Rathnayake,Mannar,Musali,Northern,2670,4597,7267,106800,183880,290680
11/5/2024,Kanthi Rathnayake,Mannar,Musali,Northern,603,8132,8735,24120,325280,349400
11/6/2024,Kanthi Rathnayake,Mannar,Musali,Northern,9506,4628,14134,380240,185120,565360
11/7/2024,Kanthi Rathnayake,Mannar,Musali,Northern,6841,1544,8385,273640,61760,335400
11/8/2024,Kanthi Rathnayake,Mannar,Musali,Northern,6273,8288,14561,250920,331520,582440
11/9/2024,Kanthi Rathnayake,Mannar,Musali,Northern,5372,6724,12096,214880,268960,483840
11/10/2024,Kanthi Rathnayake,Mannar,Musali,Northern,7594,5659,13253,303760,226360,530120
11/11/2024,Kanthi Rathnayake,Mannar,Musali,Northern,1284,465,1749,51360,18600,69960
11/12/2024,Kanthi Rathnayake,Mannar,Musali,Northern,8430,3023,11453,337200,120920,458120
11/13/2024,Kanthi Rathnayake,Mannar,Musali,Northern,6007,687,6694,240280,27480,267760
11/14/2024,Kanthi Rathnayake,Mannar,Musali,Northern,3953,1485,5438,158120,59400,217520
11/15/2024,Kanthi Rathnayake,Mannar,Musali,Northern,5320,7251,12571,212800,290040,502840
11/16/2024,Kanthi Rathnayake,Mannar,Musali,Northern,3323,2837,6160,132920,113480,246400
11/17/2024,Kanthi Rathnayake,Mannar,Musali,Northern,997,5349,6346,39880,213960,253840
11/18/2024,Kanthi Rathnayake,Mannar,Musali,Northern,5465,1262,6727,218600,50480,269080
11/19/2024,Kanthi Rathnayake,Mannar,Musali,Northern,2723,3241,5964,108920,129640,238560
11/20/2024,Kanthi Rathnayake,Mannar,Musali,Northern,5056,3960,9016,202240,158400,360640
11/21/2024,Kanthi Rathnayake,Mannar,Musali,Northern,4801,7870,12671,192040,314800,506840
11/22/2024,Kanthi Rathnayake,Mannar,Musali,Northern,8772,7461,16233,350880,298440,649320
11/23/2024,Kanthi Rathnayake,Mannar,Musali,Northern,1563,8933,10496,62520,357320,419840
11/24/2024,Kanthi Rathnayake,Mannar,Musali,Northern,4509,8482,12991,180360,339280,519640
11/25/2024,Kanthi Rathnayake,Mannar,Musali,Northern,2610,2568,5178,104400,102720,207120
11/26/2024,Kanthi Rathnayake,Mannar,Musali,Northern,2881,4898,7779,115240,195920,311160
11/27/2024,Kanthi Rathnayake,Mannar,Musali,Northern,9218,9451,18669,368720,378040,746760
11/28/2024,Kanthi Rathnayake,Mannar,Musali,Northern,6620,886,7506,264800,35440,300240
11/29/2024,Kanthi Rathnayake,Mannar,Musali,Northern,930,4122,5052,37200,164880,202080
11/30/2024,Kanthi Rathnayake,Mannar,Musali,Northern,3075,531,3606,123000,21240,144240
12/1/2024,Kanthi Rathnayake,Mannar,Musali,Northern,9363,7445,16808,374520,297800,672320
12/2/2024,Kanthi Rathnayake,Mannar,Musali,Northern,2770,1830,4600,110800,73200,184000
12/3/2024,Kanthi Rathnayake,Mannar,Musali,Northern,5291,6145,11436,211640,245800,457440
12/4/2024,Kanthi Rathnayake,Mannar,Musali,Northern,3774,11,3785,150960,440,151400
12/5/2024,Kanthi Rathnayake,Mannar,Musali,Northern,9585,6753,16338,383400,270120,653520
12/6/2024,Kanthi Rathnayake,Mannar,Musali,Northern,1816,2918,4734,72640,116720,189360
12/7/2024,Kanthi Rathnayake,Mannar,Musali,Northern,2562,2028,4590,102480,81120,183600
12/8/2024,Kanthi Rathnayake,Mannar,Musali,Northern,3543,3626,7169,141720,145040,286760
12/9/2024,Kanthi Rathnayake,Mannar,Musali,Northern,9075,3602,12677,363000,144080,507080
12/10/2024,Kanthi Rathnayake,Mannar,Musali,Northern,987,5387,6374,39480,215480,254960
12/11/2024,Kanthi Rathnayake,Mannar,Musali,Northern,8614,5170,13784,344560,206800,551360
12/12/2024,Kanthi Rathnayake,Mannar,Musali,Northern,8386,2713,11099,335440,108520,443960
12/13/2024,Kanthi Rathnayake,Mannar,Musali,Northern,9604,9513,19117,384160,380520,764680
12/14/2024,Kanthi Rathnayake,Mannar,Musali,Northern,6323,4977,11300,252920,199080,452000
12/15/2024,Kanthi Rathnayake,Mannar,Musali,Northern,5162,7229,12391,206480,289160,495640
12/16/2024,Kanthi Rathnayake,Mannar,Musali,Northern,6949,6485,13434,277960,259400,537360
12/17/2024,Kanthi Rathnayake,Mannar,Musali,Northern,5663,5735,11398,226520,229400,455920
12/18/2024,Kanthi Rathnayake,Mannar,Musali,Northern,8418,8672,17090,336720,346880,683600
12/19/2024,Kanthi Rathnayake,Mannar,Musali,Northern,5095,2668,7763,203800,106720,310520
12/20/2024,Kanthi Rathnayake,Mannar,Musali,Northern,3127,7299,10426,125080,291960,417040
12/21/2024,Kanthi Rathnayake,Mannar,Musali,Northern,5754,4984,10738,230160,199360,429520
12/22/2024,Kanthi Rathnayake,Mannar,Musali,Northern,3008,3666,6674,120320,146640,266960
12/23/2024,Kanthi Rathnayake,Mannar,Musali,Northern,8579,8642,17221,343160,345680,688840
12/24/2024,Kanthi Rathnayake,Mannar,Musali,Northern,2469,9289,11758,98760,371560,470320
12/25/2024,Kanthi Rathnayake,Mannar,Musali,Northern,5679,1352,7031,227160,54080,281240
12/26/2024,Kanthi Rathnayake,Mannar,Musali,Northern,6997,6899,13896,279880,275960,555840
12/27/2024,Kanthi Rathnayake,Mannar,Musali,Northern,3641,3199,6840,145640,127960,273600
12/28/2024,Kanthi Rathnayake,Mannar,Musali,Northern,5431,2825,8256,217240,113000,330240
12/29/2024,Kanthi Rathnayake,Mannar,Musali,Northern,6809,3135,9944,272360,125400,397760
12/30/2024,Kanthi Rathnayake,Mannar,Musali,Northern,5624,3178,8802,224960,127120,352080
12/31/2024,Kanthi Rathnayake,Mannar,Musali,Northern,313,9273,9586,12520,370920,383440
1/1/2025,Kanthi Rathnayake,Mannar,Musali,Northern,3763,2431,6194,150520,97240,247760
1/2/2025,Kanthi Rathnayake,Mannar,Musali,Northern,8890,8431,17321,355600,337240,692840
1/3/2025,Kanthi Rathnayake,Mannar,Musali,Northern,603,5027,5630,24120,201080,225200
1/4/2025,Kanthi Rathnayake,Mannar,Musali,Northern,274,4613,4887,10960,184520,195480
1/5/2025,Kanthi Rathnayake,Mannar,Musali,Northern,1377,747,2124,55080,29880,84960
1/6/2025,Kanthi Rathnayake,Mannar,Musali,Northern,1549,5707,7256,61960,228280,290240
1/7/2025,Kanthi Rathnayake,Mannar,Musali,Northern,9894,5370,15264,395760,214800,610560
1/8/2025,Kanthi Rathnayake,Mannar,Musali,Northern,6981,2093,9074,279240,83720,362960
1/9/2025,Kanthi Rathnayake,Mannar,Musali,Northern,6324,7148,13472,252960,285920,538880
1/10/2025,Kanthi Rathnayake,Mannar,Musali,Northern,8509,554,9063,340360,22160,362520
1/11/2025,Kanthi Rathnayake,Mannar,Musali,Northern,4233,7601,11834,169320,304040,473360
1/12/2025,Kanthi Rathnayake,Mannar,Musali,Northern,4463,8763,13226,178520,350520,529040
1/13/2025,Kanthi Rathnayake,Mannar,Musali,Northern,8201,2550,10751,328040,102000,430040
1/14/2025,Kanthi Rathnayake,Mannar,Musali,Northern,1387,3734,5121,55480,149360,204840
1/15/2025,Kanthi Rathnayake,Mannar,Musali,Northern,5497,3933,9430,219880,157320,377200
1/16/2025,Kanthi Rathnayake,Mannar,Musali,Northern,3489,8453,11942,139560,338120,477680
1/17/2025,Kanthi Rathnayake,Mannar,Musali,Northern,9305,2056,11361,372200,82240,454440
1/18/2025,Kanthi Rathnayake,Mannar,Musali,Northern,1347,2199,3546,53880,87960,141840
1/19/2025,Kanthi Rathnayake,Mannar,Musali,Northern,7634,7976,15610,305360,319040,624400
1/20/2025,Kanthi Rathnayake,Mannar,Musali,Northern,3666,4476,8142,146640,179040,325680
1/21/2025,Kanthi Rathnayake,Mannar,Musali,Northern,8344,9467,17811,333760,378680,712440
1/22/2025,Kanthi Rathnayake,Mannar,Musali,Northern,6396,8957,15353,255840,358280,614120
1/23/2025,Kanthi Rathnayake,Mannar,Musali,Northern,8492,646,9138,339680,25840,365520
1/24/2025,Kanthi Rathnayake,Mannar,Musali,Northern,8139,7607,15746,325560,304280,629840
1/25/2025,Kanthi Rathnayake,Mannar,Musali,Northern,3134,8922,12056,125360,356880,482240
1/26/2025,Kanthi Rathnayake,Mannar,Musali,Northern,6736,9002,15738,269440,360080,629520
1/27/2025,Kanthi Rathnayake,Mannar,Musali,Northern,6404,2998,9402,256160,119920,376080
1/28/2025,Kanthi Rathnayake,Mannar,Musali,Northern,4229,9847,14076,169160,393880,563040
1/29/2025,Kanthi Rathnayake,Mannar,Musali,Northern,2630,77,2707,105200,3080,108280
1/30/2025,Kanthi Rathnayake,Mannar,Musali,Northern,3679,9922,13601,147160,396880,544040
1/31/2025,Kanthi Rathnayake,Mannar,Musali,Northern,9542,7651,17193,381680,306040,687720
2/1/2025,Kanthi Rathnayake,Mannar,Musali,Northern,8756,824,9580,350240,32960,383200
2/2/2025,Kanthi Rathnayake,Mannar,Musali,Northern,2456,8513,10969,98240,340520,438760
2/3/2025,Kanthi Rathnayake,Mannar,Musali,Northern,4874,8065,12939,194960,322600,517560
2/4/2025,Kanthi Rathnayake,Mannar,Musali,Northern,937,660,1597,37480,26400,63880
2/5/2025,Kanthi Rathnayake,Mannar,Musali,Northern,3681,5238,8919,147240,209520,356760
2/6/2025,Kanthi Rathnayake,Mannar,Musali,Northern,9307,7874,17181,372280,314960,687240
2/7/2025,Kanthi Rathnayake,Mannar,Musali,Northern,3394,3837,7231,135760,153480,289240
2/8/2025,Kanthi Rathnayake,Mannar,Musali,Northern,8879,5343,14222,355160,213720,568880
2/9/2025,Kanthi Rathnayake,Mannar,Musali,Northern,983,9609,10592,39320,384360,423680
2/10/2025,Kanthi Rathnayake,Mannar,Musali,Northern,7294,4590,11884,291760,183600,475360
2/11/2025,Kanthi Rathnayake,Mannar,Musali,Northern,3695,4583,8278,147800,183320,331120
2/12/2025,Kanthi Rathnayake,Mannar,Musali,Northern,7859,528,8387,314360,21120,335480
2/13/2025,Kanthi Rathnayake,Mannar,Musali,Northern,1635,9148,10783,65400,365920,431320
2/14/2025,Kanthi Rathnayake,Mannar,Musali,Northern,2815,884,3699,112600,35360,147960
2/15/2025,Kanthi Rathnayake,Mannar,Musali,Northern,4049,9132,13181,161960,365280,527240
2/16/2025,Kanthi Rathnayake,Mannar,Musali,Northern,4961,804,5765,198440,32160,230600
2/17/2025,Kanthi Rathnayake,Mannar,Musali,Northern,6709,9886,16595,268360,395440,663800
2/18/2025,Kanthi Rathnayake,Mannar,Musali,Northern,5619,881,6500,224760,35240,260000
2/19/2025,Kanthi Rathnayake,Mannar,Musali,Northern,4862,9223,14085,194480,368920,563400
2/20/2025,Kanthi Rathnayake,Mannar,Musali,Northern,7071,5158,12229,282840,206320,489160
2/21/2025,Kanthi Rathnayake,Mannar,Musali,Northern,8280,7426,15706,331200,297040,628240
2/22/2025,Kanthi Rathnayake,Mannar,Musali,Northern,8489,6460,14949,339560,258400,597960
2/23/2025,Kanthi Rathnayake,Mannar,Musali,Northern,79,5732,5811,3160,229280,232440
2/24/2025,Kanthi Rathnayake,Mannar,Musali,Northern,4093,6824,10917,163720,272960,436680
2/25/2025,Kanthi Rathnayake,Mannar,Musali,Northern,6525,6902,13427,261000,276080,537080
2/26/2025,Kanthi Rathnayake,Mannar,Musali,Northern,4298,8032,12330,171920,321280,493200
2/27/2025,Kanthi Rathnayake,Mannar,Musali,Northern,4425,6457,10882,177000,258280,435280
2/28/2025,Kanthi Rathnayake,Mannar,Musali,Northern,8522,2746,11268,340880,109840,450720
3/1/2025,Kanthi Rathnayake,Mannar,Musali,Northern,9518,9113,18631,380720,364520,745240
3/2/2025,Kanthi Rathnayake,Mannar,Musali,Northern,1081,5783,6864,43240,231320,274560
3/3/2025,Kanthi Rathnayake,Mannar,Musali,Northern,9819,1804,11623,392760,72160,464920
3/4/2025,Kanthi Rathnayake,Mannar,Musali,Northern,8729,4110,12839,349160,164400,513560
3/5/2025,Kanthi Rathnayake,Mannar,Musali,Northern,3970,3203,7173,158800,128120,286920
3/6/2025,Kanthi Rathnayake,Mannar,Musali,Northern,6108,9907,16015,244320,396280,640600
3/7/2025,Kanthi Rathnayake,Mannar,Musali,Northern,1264,606,1870,50560,24240,74800
3/8/2025,Kanthi Rathnayake,Mannar,Musali,Northern,5551,6363,11914,222040,254520,476560
3/9/2025,Kanthi Rathnayake,Mannar,Musali,Northern,1983,2477,4460,79320,99080,178400
3/10/2025,Kanthi Rathnayake,Mannar,Musali,Northern,2723,6811,9534,108920,272440,381360
3/11/2025,Kanthi Rathnayake,Mannar,Musali,Northern,7039,8839,15878,281560,353560,635120
3/12/2025,Kanthi Rathnayake,Mannar,Musali,Northern,1576,117,1693,63040,4680,67720
3/13/2025,Kanthi Rathnayake,Mannar,Musali,Northern,8611,5663,14274,344440,226520,570960
3/14/2025,Kanthi Rathnayake,Mannar,Musali,Northern,8306,1476,9782,332240,59040,391280
3/15/2025,Kanthi Rathnayake,Mannar,Musali,Northern,5123,8699,13822,204920,347960,552880
3/16/2025,Kanthi Rathnayake,Mannar,Musali,Northern,1264,5497,6761,50560,219880,270440
3/17/2025,Kanthi Rathnayake,Mannar,Musali,Northern,8223,570,8793,328920,22800,351720
3/18/2025,Kanthi Rathnayake,Mannar,Musali,Northern,5278,9495,14773,211120,379800,590920
3/19/2025,Kanthi Rathnayake,Mannar,Musali,Northern,8896,7578,16474,355840,303120,658960
3/20/2025,Kanthi Rathnayake,Mannar,Musali,Northern,4038,194,4232,161520,7760,169280
3/21/2025,Kanthi Rathnayake,Mannar,Musali,Northern,686,1656,2342,27440,66240,93680
3/22/2025,Kanthi Rathnayake,Mannar,Musali,Northern,8428,502,8930,337120,20080,357200
3/23/2025,Kanthi Rathnayake,Mannar,Musali,Northern,7500,4651,12151,300000,186040,486040
3/25/2024,Piumi Rajapaksha,Jaffna,Manipay,Northern,3081,1712,4793,123240,68480,191720
3/26/2024,Piumi Rajapaksha,Jaffna,Manipay,Northern,6279,6555,12834,251160,262200,513360
3/27/2024,Piumi Rajapaksha,Jaffna,Manipay,Northern,3502,256,3758,140080,10240,150320
3/28/2024,Piumi Rajapaksha,Jaffna,Manipay,Northern,3582,7609,11191,143280,304360,447640
3/29/2024,Piumi Rajapaksha,Jaffna,Manipay,Northern,1201,6796,7997,48040,271840,319880
3/30/2024,Piumi Rajapaksha,Jaffna,Manipay,Northern,6292,1636,7928,251680,65440,317120
3/31/2024,Piumi Rajapaksha,Jaffna,Manipay,Northern,7521,8222,15743,300840,328880,629720
4/1/2024,Piumi Rajapaksha,Jaffna,Manipay,Northern,3159,2589,5748,126360,103560,229920
4/2/2024,Piumi Rajapaksha,Jaffna,Manipay,Northern,5974,5991,11965,238960,239640,478600
4/3/2024,Piumi Rajapaksha,Jaffna,Manipay,Northern,7136,3993,11129,285440,159720,445160
4/4/2024,Piumi Rajapaksha,Jaffna,Manipay,Northern,7267,2873,10140,290680,114920,405600
4/5/2024,Piumi Rajapaksha,Jaffna,Manipay,Northern,593,5780,6373,23720,231200,254920
4/6/2024,Piumi Rajapaksha,Jaffna,Manipay,Northern,4686,6673,11359,187440,266920,454360
4/7/2024,Piumi Rajapaksha,Jaffna,Manipay,Northern,95,3795,3890,3800,151800,155600
4/8/2024,Piumi Rajapaksha,Jaffna,Manipay,Northern,2954,6780,9734,118160,271200,389360
4/9/2024,Piumi Rajapaksha,Jaffna,Manipay,Northern,6296,9719,16015,251840,388760,640600
4/10/2024,Piumi Rajapaksha,Jaffna,Manipay,Northern,3925,1703,5628,157000,68120,225120
4/11/2024,Piumi Rajapaksha,Jaffna,Manipay,Northern,9506,2289,11795,380240,91560,471800
4/19/2024,Piumi Rajapaksha,Jaffna,Manipay,Northern,8108,5853,13961,324320,234120,558440
4/20/2024,Piumi Rajapaksha,Jaffna,Manipay,Northern,6327,9233,15560,253080,369320,622400
4/21/2024,Piumi Rajapaksha,Jaffna,Manipay,Northern,4372,3867,8239,174880,154680,329560
4/22/2024,Piumi Rajapaksha,Jaffna,Manipay,Northern,8987,3152,12139,359480,126080,485560
4/23/2024,Piumi Rajapaksha,Jaffna,Manipay,Northern,1772,2118,3890,70880,84720,155600
4/24/2024,Piumi Rajapaksha,Jaffna,Manipay,Northern,4857,1775,6632,194280,71000,265280
4/25/2024,Piumi Rajapaksha,Jaffna,Manipay,Northern,7647,9348,16995,305880,373920,679800
4/26/2024,Piumi Rajapaksha,Jaffna,Manipay,Northern,5563,8860,14423,222520,354400,576920
4/27/2024,Piumi Rajapaksha,Jaffna,Manipay,Northern,6521,4596,11117,260840,183840,444680
4/28/2024,Piumi Rajapaksha,Jaffna,Manipay,Northern,7035,5121,12156,281400,204840,486240
4/29/2024,Piumi Rajapaksha,Jaffna,Manipay,Northern,4974,7409,12383,198960,296360,495320
4/30/2024,Piumi Rajapaksha,Jaffna,Manipay,Northern,5402,987,6389,216080,39480,255560
5/1/2024,Piumi Rajapaksha,Jaffna,Manipay,Northern,4056,6053,10109,162240,242120,404360
5/2/2024,Piumi Rajapaksha,Jaffna,Manipay,Northern,7622,787,8409,304880,31480,336360
5/3/2024,Piumi Rajapaksha,Jaffna,Manipay,Northern,168,6821,6989,6720,272840,279560
5/4/2024,Piumi Rajapaksha,Jaffna,Manipay,Northern,5885,7423,13308,235400,296920,532320
5/5/2024,Piumi Rajapaksha,Jaffna,Manipay,Northern,8774,8596,17370,350960,343840,694800
5/6/2024,Piumi Rajapaksha,Jaffna,Manipay,Northern,247,8129,8376,9880,325160,335040
5/7/2024,Piumi Rajapaksha,Jaffna,Manipay,Northern,7299,1045,8344,291960,41800,333760
5/8/2024,Piumi Rajapaksha,Jaffna,Manipay,Northern,8062,4922,12984,322480,196880,519360
5/9/2024,Piumi Rajapaksha,Jaffna,Manipay,Northern,8660,7772,16432,346400,310880,657280
5/10/2024,Piumi Rajapaksha,Jaffna,Manipay,Northern,7756,2065,9821,310240,82600,392840
5/11/2024,Piumi Rajapaksha,Jaffna,Manipay,Northern,6289,2599,8888,251560,103960,355520
5/12/2024,Piumi Rajapaksha,Jaffna,Manipay,Northern,6093,3429,9522,243720,137160,380880
5/13/2024,Piumi Rajapaksha,Jaffna,Manipay,Northern,2094,9426,11520,83760,377040,460800
5/14/2024,Piumi Rajapaksha,Jaffna,Manipay,Northern,912,8032,8944,36480,321280,357760
5/15/2024,Piumi Rajapaksha,Jaffna,Manipay,Northern,4705,5637,10342,188200,225480,413680
5/16/2024,Piumi Rajapaksha,Jaffna,Manipay,Northern,2628,2155,4783,105120,86200,191320
5/17/2024,Piumi Rajapaksha,Jaffna,Manipay,Northern,4189,5474,9663,167560,218960,386520
5/18/2024,Piumi Rajapaksha,Jaffna,Manipay,Northern,5531,1390,6921,221240,55600,276840
5/19/2024,Piumi Rajapaksha,Jaffna,Manipay,Northern,2856,2977,5833,114240,119080,233320
5/20/2024,Piumi Rajapaksha,Jaffna,Manipay,Northern,2919,8455,11374,116760,338200,454960
5/21/2024,Piumi Rajapaksha,Jaffna,Manipay,Northern,9768,2011,11779,390720,80440,471160
5/22/2024,Piumi Rajapaksha,Jaffna,Manipay,Northern,2244,2412,4656,89760,96480,186240
5/24/2024,Piumi Rajapaksha,Jaffna,Manipay,Northern,8489,1045,9534,339560,41800,381360
5/25/2024,Piumi Rajapaksha,Jaffna,Manipay,Northern,4769,4529,9298,190760,181160,371920
5/26/2024,Piumi Rajapaksha,Jaffna,Manipay,Northern,4805,1644,6449,192200,65760,257960
5/27/2024,Piumi Rajapaksha,Jaffna,Manipay,Northern,933,9696,10629,37320,387840,425160
5/28/2024,Piumi Rajapaksha,Jaffna,Manipay,Northern,2118,6117,8235,84720,244680,329400
5/29/2024,Piumi Rajapaksha,Jaffna,Manipay,Northern,1689,7572,9261,67560,302880,370440
5/30/2024,Piumi Rajapaksha,Jaffna,Manipay,Northern,8966,3321,12287,358640,132840,491480
5/31/2024,Piumi Rajapaksha,Jaffna,Manipay,Northern,7911,5534,13445,316440,221360,537800
6/1/2024,Piumi Rajapaksha,Jaffna,Manipay,Northern,5767,6221,11988,230680,248840,479520
6/2/2024,Piumi Rajapaksha,Jaffna,Manipay,Northern,826,8223,9049,33040,328920,361960
6/3/2024,Piumi Rajapaksha,Jaffna,Manipay,Northern,3507,1746,5253,140280,69840,210120
6/4/2024,Piumi Rajapaksha,Jaffna,Manipay,Northern,2337,1517,3854,93480,60680,154160
6/5/2024,Piumi Rajapaksha,Jaffna,Manipay,Northern,4925,1215,6140,197000,48600,245600
6/6/2024,Piumi Rajapaksha,Jaffna,Manipay,Northern,1660,539,2199,66400,21560,87960
6/7/2024,Piumi Rajapaksha,Jaffna,Manipay,Northern,1410,5766,7176,56400,230640,287040
6/8/2024,Piumi Rajapaksha,Jaffna,Manipay,Northern,2374,2166,4540,94960,86640,181600
6/9/2024,Piumi Rajapaksha,Jaffna,Manipay,Northern,3719,2133,5852,148760,85320,234080
6/10/2024,Piumi Rajapaksha,Jaffna,Manipay,Northern,7193,2082,9275,287720,83280,371000
6/11/2024,Piumi Rajapaksha,Jaffna,Manipay,Northern,5452,2138,7590,218080,85520,303600
6/12/2024,Piumi Rajapaksha,Jaffna,Manipay,Northern,2019,7004,9023,80760,280160,360920
6/13/2024,Piumi Rajapaksha,Jaffna,Manipay,Northern,6924,5801,12725,276960,232040,509000
6/14/2024,Piumi Rajapaksha,Jaffna,Manipay,Northern,7018,6916,13934,280720,276640,557360
6/15/2024,Piumi Rajapaksha,Jaffna,Manipay,Northern,4633,9214,13847,185320,368560,553880
6/16/2024,Piumi Rajapaksha,Jaffna,Manipay,Northern,8383,6757,15140,335320,270280,605600
6/17/2024,Piumi Rajapaksha,Jaffna,Manipay,Northern,9942,8742,18684,397680,349680,747360
6/18/2024,Piumi Rajapaksha,Jaffna,Manipay,Northern,2294,1731,4025,91760,69240,161000
6/19/2024,Piumi Rajapaksha,Jaffna,Manipay,Northern,9341,551,9892,373640,22040,395680
6/20/2024,Piumi Rajapaksha,Jaffna,Manipay,Northern,7353,1874,9227,294120,74960,369080
6/21/2024,Piumi Rajapaksha,Jaffna,Manipay,Northern,1607,4589,6196,64280,183560,247840
6/22/2024,Piumi Rajapaksha,Jaffna,Manipay,Northern,7557,6083,13640,302280,243320,545600
6/23/2024,Piumi Rajapaksha,Jaffna,Manipay,Northern,5352,3690,9042,214080,147600,361680
6/24/2024,Piumi Rajapaksha,Jaffna,Manipay,Northern,2011,1908,3919,80440,76320,156760
6/25/2024,Piumi Rajapaksha,Jaffna,Manipay,Northern,513,5841,6354,20520,233640,254160
6/26/2024,Piumi Rajapaksha,Jaffna,Manipay,Northern,1621,3672,5293,64840,146880,211720
6/27/2024,Piumi Rajapaksha,Jaffna,Manipay,Northern,804,5363,6167,32160,214520,246680
6/28/2024,Piumi Rajapaksha,Jaffna,Manipay,Northern,6670,7027,13697,266800,281080,547880
6/29/2024,Piumi Rajapaksha,Jaffna,Manipay,Northern,4191,1459,5650,167640,58360,226000
6/30/2024,Piumi Rajapaksha,Jaffna,Manipay,Northern,1509,9697,11206,60360,387880,448240
7/1/2024,Piumi Rajapaksha,Jaffna,Manipay,Northern,8246,981,9227,329840,39240,369080
7/2/2024,Piumi Rajapaksha,Jaffna,Manipay,Northern,2513,2058,4571,100520,82320,182840
7/3/2024,Piumi Rajapaksha,Jaffna,Manipay,Northern,7652,26,7678,306080,1040,307120
7/4/2024,Piumi Rajapaksha,Jaffna,Manipay,Northern,3009,7100,10109,120360,284000,404360
7/5/2024,Piumi Rajapaksha,Jaffna,Manipay,Northern,7548,2396,9944,301920,95840,397760
7/6/2024,Piumi Rajapaksha,Jaffna,Manipay,Northern,3518,6732,10250,140720,269280,410000
7/7/2024,Piumi Rajapaksha,Jaffna,Manipay,Northern,1318,3574,4892,52720,142960,195680
7/8/2024,Piumi Rajapaksha,Jaffna,Manipay,Northern,3162,7334,10496,126480,293360,419840
7/9/2024,Piumi Rajapaksha,Jaffna,Manipay,Northern,249,2455,2704,9960,98200,108160
7/10/2024,Piumi Rajapaksha,Jaffna,Manipay,Northern,8852,929,9781,354080,37160,391240
7/11/2024,Piumi Rajapaksha,Jaffna,Manipay,Northern,6351,9367,15718,254040,374680,628720
7/12/2024,Piumi Rajapaksha,Jaffna,Manipay,Northern,4187,7493,11680,167480,299720,467200
7/13/2024,Piumi Rajapaksha,Jaffna,Manipay,Northern,8113,7334,15447,324520,293360,617880
7/14/2024,Piumi Rajapaksha,Jaffna,Manipay,Northern,6703,1095,7798,268120,43800,311920
7/15/2024,Piumi Rajapaksha,Jaffna,Manipay,Northern,9362,9819,19181,374480,392760,767240
7/16/2024,Piumi Rajapaksha,Jaffna,Manipay,Northern,1813,4711,6524,72520,188440,260960
7/17/2024,Piumi Rajapaksha,Jaffna,Manipay,Northern,8239,290,8529,329560,11600,341160
7/18/2024,Piumi Rajapaksha,Jaffna,Manipay,Northern,3625,5785,9410,145000,231400,376400
7/19/2024,Piumi Rajapaksha,Jaffna,Manipay,Northern,9204,767,9971,368160,30680,398840
7/20/2024,Piumi Rajapaksha,Jaffna,Manipay,Northern,9463,4429,13892,378520,177160,555680
7/21/2024,Piumi Rajapaksha,Jaffna,Manipay,Northern,1652,6455,8107,66080,258200,324280
7/22/2024,Piumi Rajapaksha,Jaffna,Manipay,Northern,2972,6117,9089,118880,244680,363560
7/23/2024,Piumi Rajapaksha,Jaffna,Manipay,Northern,5938,2592,8530,237520,103680,341200
7/24/2024,Piumi Rajapaksha,Jaffna,Manipay,Northern,8125,5539,13664,325000,221560,546560
7/25/2024,Piumi Rajapaksha,Jaffna,Manipay,Northern,3778,3362,7140,151120,134480,285600
7/26/2024,Piumi Rajapaksha,Jaffna,Manipay,Northern,3592,3855,7447,143680,154200,297880
7/27/2024,Piumi Rajapaksha,Jaffna,Manipay,Northern,1670,4148,5818,66800,165920,232720
7/28/2024,Piumi Rajapaksha,Jaffna,Manipay,Northern,7540,9197,16737,301600,367880,669480
7/29/2024,Piumi Rajapaksha,Jaffna,Manipay,Northern,2690,1382,4072,107600,55280,162880
7/30/2024,Piumi Rajapaksha,Jaffna,Manipay,Northern,9831,7267,17098,393240,290680,683920
7/31/2024,Piumi Rajapaksha,Jaffna,Manipay,Northern,8253,9733,17986,330120,389320,719440
8/1/2024,Piumi Rajapaksha,Jaffna,Manipay,Northern,8850,9343,18193,354000,373720,727720
8/2/2024,Piumi Rajapaksha,Jaffna,Manipay,Northern,8391,7092,15483,335640,283680,619320
8/3/2024,Piumi Rajapaksha,Jaffna,Manipay,Northern,7077,7248,14325,283080,289920,573000
8/4/2024,Piumi Rajapaksha,Jaffna,Manipay,Northern,5120,3779,8899,204800,151160,355960
8/5/2024,Piumi Rajapaksha,Jaffna,Manipay,Northern,8867,8885,17752,354680,355400,710080
8/6/2024,Piumi Rajapaksha,Jaffna,Manipay,Northern,9839,6300,16139,393560,252000,645560
8/7/2024,Piumi Rajapaksha,Jaffna,Manipay,Northern,5445,4414,9859,217800,176560,394360
8/8/2024,Piumi Rajapaksha,Jaffna,Manipay,Northern,560,5819,6379,22400,232760,255160
8/9/2024,Piumi Rajapaksha,Jaffna,Manipay,Northern,9389,1906,11295,375560,76240,451800
8/10/2024,Piumi Rajapaksha,Jaffna,Manipay,Northern,2620,9956,12576,104800,398240,503040
8/11/2024,Piumi Rajapaksha,Jaffna,Manipay,Northern,9004,8464,17468,360160,338560,698720
8/12/2024,Piumi Rajapaksha,Jaffna,Manipay,Northern,3928,5334,9262,157120,213360,370480
8/13/2024,Piumi Rajapaksha,Jaffna,Manipay,Northern,3833,2355,6188,153320,94200,247520
8/14/2024,Piumi Rajapaksha,Jaffna,Manipay,Northern,7260,9267,16527,290400,370680,661080
8/15/2024,Piumi Rajapaksha,Jaffna,Manipay,Northern,4820,6014,10834,192800,240560,433360
8/16/2024,Piumi Rajapaksha,Jaffna,Manipay,Northern,4894,9170,14064,195760,366800,562560
8/17/2024,Piumi Rajapaksha,Jaffna,Manipay,Northern,4328,7602,11930,173120,304080,477200
8/18/2024,Piumi Rajapaksha,Jaffna,Manipay,Northern,1003,3009,4012,40120,120360,160480
8/19/2024,Piumi Rajapaksha,Jaffna,Manipay,Northern,5485,4013,9498,219400,160520,379920
8/20/2024,Piumi Rajapaksha,Jaffna,Manipay,Northern,6966,8929,15895,278640,357160,635800
8/21/2024,Piumi Rajapaksha,Jaffna,Manipay,Northern,2557,3967,6524,102280,158680,260960
8/22/2024,Piumi Rajapaksha,Jaffna,Manipay,Northern,7994,1731,9725,319760,69240,389000
8/23/2024,Piumi Rajapaksha,Jaffna,Manipay,Northern,1963,3884,5847,78520,155360,233880
8/24/2024,Piumi Rajapaksha,Jaffna,Manipay,Northern,7261,5559,12820,290440,222360,512800
8/25/2024,Piumi Rajapaksha,Jaffna,Manipay,Northern,6914,7673,14587,276560,306920,583480
8/26/2024,Piumi Rajapaksha,Jaffna,Manipay,Northern,9594,1051,10645,383760,42040,425800
8/27/2024,Piumi Rajapaksha,Jaffna,Manipay,Northern,8332,6454,14786,333280,258160,591440
8/28/2024,Piumi Rajapaksha,Jaffna,Manipay,Northern,412,5761,6173,16480,230440,246920
8/29/2024,Piumi Rajapaksha,Jaffna,Manipay,Northern,2990,2022,5012,119600,80880,200480
8/30/2024,Piumi Rajapaksha,Jaffna,Manipay,Northern,9856,3903,13759,394240,156120,550360
8/31/2024,Piumi Rajapaksha,Jaffna,Manipay,Northern,530,5521,6051,21200,220840,242040
9/1/2024,Piumi Rajapaksha,Jaffna,Manipay,Northern,4591,2301,6892,183640,92040,275680
9/2/2024,Piumi Rajapaksha,Jaffna,Manipay,Northern,5628,8211,13839,225120,328440,553560
9/3/2024,Piumi Rajapaksha,Jaffna,Manipay,Northern,3072,9964,13036,122880,398560,521440
9/4/2024,Piumi Rajapaksha,Jaffna,Manipay,Northern,288,696,984,11520,27840,39360
9/5/2024,Piumi Rajapaksha,Jaffna,Manipay,Northern,1304,4059,5363,52160,162360,214520
9/6/2024,Piumi Rajapaksha,Jaffna,Manipay,Northern,6158,9534,15692,246320,381360,627680
9/7/2024,Piumi Rajapaksha,Jaffna,Manipay,Northern,8311,4269,12580,332440,170760,503200
9/8/2024,Piumi Rajapaksha,Jaffna,Manipay,Northern,7710,4855,12565,308400,194200,502600
9/9/2024,Piumi Rajapaksha,Jaffna,Manipay,Northern,2294,4798,7092,91760,191920,283680
9/10/2024,Piumi Rajapaksha,Jaffna,Manipay,Northern,4663,3033,7696,186520,121320,307840
9/11/2024,Piumi Rajapaksha,Jaffna,Manipay,Northern,5462,445,5907,218480,17800,236280
9/12/2024,Piumi Rajapaksha,Jaffna,Manipay,Northern,4272,6948,11220,170880,277920,448800
9/13/2024,Piumi Rajapaksha,Jaffna,Manipay,Northern,9147,2094,11241,365880,83760,449640
9/14/2024,Piumi Rajapaksha,Jaffna,Manipay,Northern,3461,3099,6560,138440,123960,262400
9/15/2024,Piumi Rajapaksha,Jaffna,Manipay,Northern,2468,6809,9277,98720,272360,371080
9/16/2024,Piumi Rajapaksha,Jaffna,Manipay,Northern,4466,352,4818,178640,14080,192720
9/17/2024,Piumi Rajapaksha,Jaffna,Manipay,Northern,6236,5487,11723,249440,219480,468920
9/18/2024,Piumi Rajapaksha,Jaffna,Manipay,Northern,5111,8465,13576,204440,338600,543040
9/19/2024,Piumi Rajapaksha,Jaffna,Manipay,Northern,4344,613,4957,173760,24520,198280
9/20/2024,Piumi Rajapaksha,Jaffna,Manipay,Northern,7288,3582,10870,291520,143280,434800
9/21/2024,Piumi Rajapaksha,Jaffna,Manipay,Northern,3619,6754,10373,144760,270160,414920
9/22/2024,Piumi Rajapaksha,Jaffna,Manipay,Northern,1206,34,1240,48240,1360,49600
9/23/2024,Piumi Rajapaksha,Jaffna,Manipay,Northern,4949,9385,14334,197960,375400,573360
9/24/2024,Piumi Rajapaksha,Jaffna,Manipay,Northern,4231,57,4288,169240,2280,171520
9/25/2024,Piumi Rajapaksha,Jaffna,Manipay,Northern,4482,890,5372,179280,35600,214880
9/26/2024,Piumi Rajapaksha,Jaffna,Manipay,Northern,1042,6403,7445,41680,256120,297800
9/27/2024,Piumi Rajapaksha,Jaffna,Manipay,Northern,3127,6085,9212,125080,243400,368480
9/28/2024,Piumi Rajapaksha,Jaffna,Manipay,Northern,8466,2896,11362,338640,115840,454480
9/29/2024,Piumi Rajapaksha,Jaffna,Manipay,Northern,6861,3203,10064,274440,128120,402560
9/30/2024,Piumi Rajapaksha,Jaffna,Manipay,Northern,8812,3700,12512,352480,148000,500480
10/1/2024,Piumi Rajapaksha,Jaffna,Manipay,Northern,9486,4329,13815,379440,173160,552600
10/2/2024,Piumi Rajapaksha,Jaffna,Manipay,Northern,8466,5228,13694,338640,209120,547760
10/3/2024,Piumi Rajapaksha,Jaffna,Manipay,Northern,4932,5951,10883,197280,238040,435320
10/4/2024,Piumi Rajapaksha,Jaffna,Manipay,Northern,4481,9481,13962,179240,379240,558480
10/5/2024,Piumi Rajapaksha,Jaffna,Manipay,Northern,6772,3990,10762,270880,159600,430480
10/6/2024,Piumi Rajapaksha,Jaffna,Manipay,Northern,623,2504,3127,24920,100160,125080
10/7/2024,Piumi Rajapaksha,Jaffna,Manipay,Northern,5176,7802,12978,207040,312080,519120
10/8/2024,Piumi Rajapaksha,Jaffna,Manipay,Northern,375,9124,9499,15000,364960,379960
10/9/2024,Piumi Rajapaksha,Jaffna,Manipay,Northern,7427,8717,16144,297080,348680,645760
10/10/2024,Piumi Rajapaksha,Jaffna,Manipay,Northern,4676,3093,7769,187040,123720,310760
10/11/2024,Piumi Rajapaksha,Jaffna,Manipay,Northern,6984,861,7845,279360,34440,313800
10/12/2024,Piumi Rajapaksha,Jaffna,Manipay,Northern,6590,2034,8624,263600,81360,344960
10/13/2024,Piumi Rajapaksha,Jaffna,Manipay,Northern,7386,4243,11629,295440,169720,465160
10/14/2024,Piumi Rajapaksha,Jaffna,Manipay,Northern,7653,7949,15602,306120,317960,624080
10/15/2024,Piumi Rajapaksha,Jaffna,Manipay,Northern,3104,3362,6466,124160,134480,258640
10/16/2024,Piumi Rajapaksha,Jaffna,Manipay,Northern,9451,4162,13613,378040,166480,544520
10/17/2024,Piumi Rajapaksha,Jaffna,Manipay,Northern,9322,9176,18498,372880,367040,739920
10/18/2024,Piumi Rajapaksha,Jaffna,Manipay,Northern,86,3366,3452,3440,134640,138080
10/19/2024,Piumi Rajapaksha,Jaffna,Manipay,Northern,5910,4044,9954,236400,161760,398160
10/20/2024,Piumi Rajapaksha,Jaffna,Manipay,Northern,6252,625,6877,250080,25000,275080
10/21/2024,Piumi Rajapaksha,Jaffna,Manipay,Northern,2479,2772,5251,99160,110880,210040
10/22/2024,Piumi Rajapaksha,Jaffna,Manipay,Northern,1724,5217,6941,68960,208680,277640
10/23/2024,Piumi Rajapaksha,Jaffna,Manipay,Northern,7179,288,7467,287160,11520,298680
10/24/2024,Piumi Rajapaksha,Jaffna,Manipay,Northern,9665,696,10361,386600,27840,414440
10/25/2024,Piumi Rajapaksha,Jaffna,Manipay,Northern,5904,7256,13160,236160,290240,526400
10/26/2024,Piumi Rajapaksha,Jaffna,Manipay,Northern,345,4156,4501,13800,166240,180040
10/27/2024,Piumi Rajapaksha,Jaffna,Manipay,Northern,4207,8302,12509,168280,332080,500360
10/28/2024,Piumi Rajapaksha,Jaffna,Manipay,Northern,8166,3984,12150,326640,159360,486000
10/29/2024,Piumi Rajapaksha,Jaffna,Manipay,Northern,9600,7647,17247,384000,305880,689880
10/30/2024,Piumi Rajapaksha,Jaffna,Manipay,Northern,8208,6605,14813,328320,264200,592520
10/31/2024,Piumi Rajapaksha,Jaffna,Manipay,Northern,7257,6769,14026,290280,270760,561040
11/1/2024,Piumi Rajapaksha,Jaffna,Manipay,Northern,2882,7606,10488,115280,304240,419520
11/2/2024,Piumi Rajapaksha,Jaffna,Manipay,Northern,2550,129,2679,102000,5160,107160
11/3/2024,Piumi Rajapaksha,Jaffna,Manipay,Northern,1422,2111,3533,56880,84440,141320
11/4/2024,Piumi Rajapaksha,Jaffna,Manipay,Northern,6288,1291,7579,251520,51640,303160
11/5/2024,Piumi Rajapaksha,Jaffna,Manipay,Northern,2826,8231,11057,113040,329240,442280
11/6/2024,Piumi Rajapaksha,Jaffna,Manipay,Northern,1253,3573,4826,50120,142920,193040
11/7/2024,Piumi Rajapaksha,Jaffna,Manipay,Northern,1504,3556,5060,60160,142240,202400
11/8/2024,Piumi Rajapaksha,Jaffna,Manipay,Northern,2633,3921,6554,105320,156840,262160
11/9/2024,Piumi Rajapaksha,Jaffna,Manipay,Northern,4016,6654,10670,160640,266160,426800
11/10/2024,Piumi Rajapaksha,Jaffna,Manipay,Northern,3970,9083,13053,158800,363320,522120
11/11/2024,Piumi Rajapaksha,Jaffna,Manipay,Northern,600,4179,4779,24000,167160,191160
11/12/2024,Piumi Rajapaksha,Jaffna,Manipay,Northern,6458,265,6723,258320,10600,268920
11/13/2024,Piumi Rajapaksha,Jaffna,Manipay,Northern,9483,9569,19052,379320,382760,762080
11/14/2024,Piumi Rajapaksha,Jaffna,Manipay,Northern,1883,4875,6758,75320,195000,270320
11/15/2024,Piumi Rajapaksha,Jaffna,Manipay,Northern,1717,2548,4265,68680,101920,170600
11/16/2024,Piumi Rajapaksha,Jaffna,Manipay,Northern,8910,3600,12510,356400,144000,500400
11/17/2024,Piumi Rajapaksha,Jaffna,Manipay,Northern,6831,2211,9042,273240,88440,361680
11/18/2024,Piumi Rajapaksha,Jaffna,Manipay,Northern,8524,6207,14731,340960,248280,589240
11/19/2024,Piumi Rajapaksha,Jaffna,Manipay,Northern,4593,7132,11725,183720,285280,469000
11/20/2024,Piumi Rajapaksha,Jaffna,Manipay,Northern,6738,4550,11288,269520,182000,451520
11/21/2024,Piumi Rajapaksha,Jaffna,Manipay,Northern,648,7759,8407,25920,310360,336280
11/22/2024,Piumi Rajapaksha,Jaffna,Manipay,Northern,7533,1227,8760,301320,49080,350400
11/23/2024,Piumi Rajapaksha,Jaffna,Manipay,Northern,5851,9195,15046,234040,367800,601840
11/24/2024,Piumi Rajapaksha,Jaffna,Manipay,Northern,787,965,1752,31480,38600,70080
11/25/2024,Piumi Rajapaksha,Jaffna,Manipay,Northern,5023,6335,11358,200920,253400,454320
11/26/2024,Piumi Rajapaksha,Jaffna,Manipay,Northern,7367,485,7852,294680,19400,314080
11/27/2024,Piumi Rajapaksha,Jaffna,Manipay,Northern,5105,3834,8939,204200,153360,357560
11/28/2024,Piumi Rajapaksha,Jaffna,Manipay,Northern,8481,5986,14467,339240,239440,578680
11/29/2024,Piumi Rajapaksha,Jaffna,Manipay,Northern,2904,1221,4125,116160,48840,165000
11/30/2024,Piumi Rajapaksha,Jaffna,Manipay,Northern,1999,3204,5203,79960,128160,208120
12/1/2024,Piumi Rajapaksha,Jaffna,Manipay,Northern,6357,3104,9461,254280,124160,378440
12/2/2024,Piumi Rajapaksha,Jaffna,Manipay,Northern,2231,4340,6571,89240,173600,262840
12/3/2024,Piumi Rajapaksha,Jaffna,Manipay,Northern,8963,2418,11381,358520,96720,455240
12/4/2024,Piumi Rajapaksha,Jaffna,Manipay,Northern,8783,1483,10266,351320,59320,410640
12/5/2024,Piumi Rajapaksha,Jaffna,Manipay,Northern,6719,6501,13220,268760,260040,528800
12/6/2024,Piumi Rajapaksha,Jaffna,Manipay,Northern,279,4808,5087,11160,192320,203480
12/7/2024,Piumi Rajapaksha,Jaffna,Manipay,Northern,6073,6884,12957,242920,275360,518280
12/8/2024,Piumi Rajapaksha,Jaffna,Manipay,Northern,5312,9456,14768,212480,378240,590720
12/9/2024,Piumi Rajapaksha,Jaffna,Manipay,Northern,7504,6055,13559,300160,242200,542360
12/10/2024,Piumi Rajapaksha,Jaffna,Manipay,Northern,6019,4795,10814,240760,191800,432560
12/11/2024,Piumi Rajapaksha,Jaffna,Manipay,Northern,5926,914,6840,237040,36560,273600
12/12/2024,Piumi Rajapaksha,Jaffna,Manipay,Northern,300,6730,7030,12000,269200,281200
12/13/2024,Piumi Rajapaksha,Jaffna,Manipay,Northern,424,7688,8112,16960,307520,324480
12/14/2024,Piumi Rajapaksha,Jaffna,Manipay,Northern,8089,6275,14364,323560,251000,574560
12/15/2024,Piumi Rajapaksha,Jaffna,Manipay,Northern,7467,4142,11609,298680,165680,464360
12/16/2024,Piumi Rajapaksha,Jaffna,Manipay,Northern,2488,9528,12016,99520,381120,480640
12/17/2024,Piumi Rajapaksha,Jaffna,Manipay,Northern,8111,9710,17821,324440,388400,712840
12/18/2024,Piumi Rajapaksha,Jaffna,Manipay,Northern,7243,2274,9517,289720,90960,380680
12/19/2024,Piumi Rajapaksha,Jaffna,Manipay,Northern,7472,7011,14483,298880,280440,579320
12/20/2024,Piumi Rajapaksha,Jaffna,Manipay,Northern,7346,7107,14453,293840,284280,578120
12/21/2024,Piumi Rajapaksha,Jaffna,Manipay,Northern,2037,9180,11217,81480,367200,448680
12/22/2024,Piumi Rajapaksha,Jaffna,Manipay,Northern,3832,6509,10341,153280,260360,413640
12/23/2024,Piumi Rajapaksha,Jaffna,Manipay,Northern,1759,4664,6423,70360,186560,256920
12/24/2024,Piumi Rajapaksha,Jaffna,Manipay,Northern,2523,379,2902,100920,15160,116080
12/25/2024,Piumi Rajapaksha,Jaffna,Manipay,Northern,2443,4157,6600,97720,166280,264000
12/26/2024,Piumi Rajapaksha,Jaffna,Manipay,Northern,1143,9449,10592,45720,377960,423680
12/27/2024,Piumi Rajapaksha,Jaffna,Manipay,Northern,4758,4127,8885,190320,165080,355400
12/28/2024,Piumi Rajapaksha,Jaffna,Manipay,Northern,3772,8473,12245,150880,338920,489800
12/29/2024,Piumi Rajapaksha,Jaffna,Manipay,Northern,4922,879,5801,196880,35160,232040
12/30/2024,Piumi Rajapaksha,Jaffna,Manipay,Northern,4779,8857,13636,191160,354280,545440
12/31/2024,Piumi Rajapaksha,Jaffna,Manipay,Northern,4983,6756,11739,199320,270240,469560
1/1/2025,Piumi Rajapaksha,Jaffna,Manipay,Northern,5747,4670,10417,229880,186800,416680
1/2/2025,Piumi Rajapaksha,Jaffna,Manipay,Northern,6508,4586,11094,260320,183440,443760
1/3/2025,Piumi Rajapaksha,Jaffna,Manipay,Northern,6331,1619,7950,253240,64760,318000
1/4/2025,Piumi Rajapaksha,Jaffna,Manipay,Northern,2513,4994,7507,100520,199760,300280
1/5/2025,Piumi Rajapaksha,Jaffna,Manipay,Northern,4358,6689,11047,174320,267560,441880
1/6/2025,Piumi Rajapaksha,Jaffna,Manipay,Northern,8518,3862,12380,340720,154480,495200
1/7/2025,Piumi Rajapaksha,Jaffna,Manipay,Northern,5154,9406,14560,206160,376240,582400
1/8/2025,Piumi Rajapaksha,Jaffna,Manipay,Northern,2796,6802,9598,111840,272080,383920
1/9/2025,Piumi Rajapaksha,Jaffna,Manipay,Northern,2449,6425,8874,97960,257000,354960
1/10/2025,Piumi Rajapaksha,Jaffna,Manipay,Northern,9341,8917,18258,373640,356680,730320
1/11/2025,Piumi Rajapaksha,Jaffna,Manipay,Northern,5780,8130,13910,231200,325200,556400
1/12/2025,Piumi Rajapaksha,Jaffna,Manipay,Northern,9566,8220,17786,382640,328800,711440
1/13/2025,Piumi Rajapaksha,Jaffna,Manipay,Northern,5504,4009,9513,220160,160360,380520
1/14/2025,Piumi Rajapaksha,Jaffna,Manipay,Northern,1906,9386,11292,76240,375440,451680
1/15/2025,Piumi Rajapaksha,Jaffna,Manipay,Northern,5881,3632,9513,235240,145280,380520
1/16/2025,Piumi Rajapaksha,Jaffna,Manipay,Northern,9911,6405,16316,396440,256200,652640
1/17/2025,Piumi Rajapaksha,Jaffna,Manipay,Northern,5797,1371,7168,231880,54840,286720
1/18/2025,Piumi Rajapaksha,Jaffna,Manipay,Northern,3108,956,4064,124320,38240,162560
1/19/2025,Piumi Rajapaksha,Jaffna,Manipay,Northern,1574,2901,4475,62960,116040,179000
1/20/2025,Piumi Rajapaksha,Jaffna,Manipay,Northern,4527,1498,6025,181080,59920,241000
1/21/2025,Piumi Rajapaksha,Jaffna,Manipay,Northern,3979,1828,5807,159160,73120,232280
1/22/2025,Piumi Rajapaksha,Jaffna,Manipay,Northern,2047,7213,9260,81880,288520,370400
1/23/2025,Piumi Rajapaksha,Jaffna,Manipay,Northern,1018,4278,5296,40720,171120,211840
1/24/2025,Piumi Rajapaksha,Jaffna,Manipay,Northern,566,2721,3287,22640,108840,131480
1/25/2025,Piumi Rajapaksha,Jaffna,Manipay,Northern,4741,1734,6475,189640,69360,259000
1/26/2025,Piumi Rajapaksha,Jaffna,Manipay,Northern,965,8714,9679,38600,348560,387160
1/27/2025,Piumi Rajapaksha,Jaffna,Manipay,Northern,4994,6694,11688,199760,267760,467520
1/28/2025,Piumi Rajapaksha,Jaffna,Manipay,Northern,9479,5417,14896,379160,216680,595840
1/29/2025,Piumi Rajapaksha,Jaffna,Manipay,Northern,2056,3560,5616,82240,142400,224640
1/30/2025,Piumi Rajapaksha,Jaffna,Manipay,Northern,6246,6221,12467,249840,248840,498680
1/31/2025,Piumi Rajapaksha,Jaffna,Manipay,Northern,2921,6622,9543,116840,264880,381720
2/1/2025,Piumi Rajapaksha,Jaffna,Manipay,Northern,1996,527,2523,79840,21080,100920
2/2/2025,Piumi Rajapaksha,Jaffna,Manipay,Northern,3455,9945,13400,138200,397800,536000
2/3/2025,Piumi Rajapaksha,Jaffna,Manipay,Northern,2186,8740,10926,87440,349600,437040
2/4/2025,Piumi Rajapaksha,Jaffna,Manipay,Northern,6502,9960,16462,260080,398400,658480
2/5/2025,Piumi Rajapaksha,Jaffna,Manipay,Northern,29,8580,8609,1160,343200,344360
2/6/2025,Piumi Rajapaksha,Jaffna,Manipay,Northern,8939,9322,18261,357560,372880,730440
2/7/2025,Piumi Rajapaksha,Jaffna,Manipay,Northern,3303,7134,10437,132120,285360,417480
2/8/2025,Piumi Rajapaksha,Jaffna,Manipay,Northern,8868,8763,17631,354720,350520,705240
2/9/2025,Piumi Rajapaksha,Jaffna,Manipay,Northern,5034,1711,6745,201360,68440,269800
2/10/2025,Piumi Rajapaksha,Jaffna,Manipay,Northern,9793,6289,16082,391720,251560,643280
2/11/2025,Piumi Rajapaksha,Jaffna,Manipay,Northern,9102,4543,13645,364080,181720,545800
2/12/2025,Piumi Rajapaksha,Jaffna,Manipay,Northern,225,5864,6089,9000,234560,243560
2/13/2025,Piumi Rajapaksha,Jaffna,Manipay,Northern,4728,7866,12594,189120,314640,503760
2/14/2025,Piumi Rajapaksha,Jaffna,Manipay,Northern,1881,9594,11475,75240,383760,459000
2/15/2025,Piumi Rajapaksha,Jaffna,Manipay,Northern,9592,7626,17218,383680,305040,688720
2/16/2025,Piumi Rajapaksha,Jaffna,Manipay,Northern,104,9183,9287,4160,367320,371480
2/17/2025,Piumi Rajapaksha,Jaffna,Manipay,Northern,7305,8561,15866,292200,342440,634640
2/18/2025,Piumi Rajapaksha,Jaffna,Manipay,Northern,4603,1794,6397,184120,71760,255880
2/19/2025,Piumi Rajapaksha,Jaffna,Manipay,Northern,1948,7656,9604,77920,306240,384160
2/20/2025,Piumi Rajapaksha,Jaffna,Manipay,Northern,8660,9156,17816,346400,366240,712640
2/21/2025,Piumi Rajapaksha,Jaffna,Manipay,Northern,3825,5948,9773,153000,237920,390920
2/22/2025,Piumi Rajapaksha,Jaffna,Manipay,Northern,1025,6180,7205,41000,247200,288200
2/23/2025,Piumi Rajapaksha,Jaffna,Manipay,Northern,1461,6172,7633,58440,246880,305320
2/24/2025,Piumi Rajapaksha,Jaffna,Manipay,Northern,3163,3701,6864,126520,148040,274560
2/25/2025,Piumi Rajapaksha,Jaffna,Manipay,Northern,777,9925,10702,31080,397000,428080
2/26/2025,Piumi Rajapaksha,Jaffna,Manipay,Northern,971,1693,2664,38840,67720,106560
2/27/2025,Piumi Rajapaksha,Jaffna,Manipay,Northern,8726,3204,11930,349040,128160,477200
2/28/2025,Piumi Rajapaksha,Jaffna,Manipay,Northern,5723,255,5978,228920,10200,239120
3/1/2025,Piumi Rajapaksha,Jaffna,Manipay,Northern,1963,3820,5783,78520,152800,231320
3/2/2025,Piumi Rajapaksha,Jaffna,Manipay,Northern,6455,5173,11628,258200,206920,465120
3/3/2025,Piumi Rajapaksha,Jaffna,Manipay,Northern,9275,6884,16159,371000,275360,646360
3/4/2025,Piumi Rajapaksha,Jaffna,Manipay,Northern,4879,6996,11875,195160,279840,475000
3/5/2025,Piumi Rajapaksha,Jaffna,Manipay,Northern,1929,237,2166,77160,9480,86640
3/6/2025,Piumi Rajapaksha,Jaffna,Manipay,Northern,1942,5048,6990,77680,201920,279600
3/7/2025,Piumi Rajapaksha,Jaffna,Manipay,Northern,336,1099,1435,13440,43960,57400
3/8/2025,Piumi Rajapaksha,Jaffna,Manipay,Northern,6109,5703,11812,244360,228120,472480
3/9/2025,Piumi Rajapaksha,Jaffna,Manipay,Northern,9564,3725,13289,382560,149000,531560
3/10/2025,Piumi Rajapaksha,Jaffna,Manipay,Northern,566,4686,5252,22640,187440,210080
3/11/2025,Piumi Rajapaksha,Jaffna,Manipay,Northern,6143,7781,13924,245720,311240,556960
3/12/2025,Piumi Rajapaksha,Jaffna,Manipay,Northern,9338,9866,19204,373520,394640,768160
3/13/2025,Piumi Rajapaksha,Jaffna,Manipay,Northern,3008,1253,4261,120320,50120,170440
3/14/2025,Piumi Rajapaksha,Jaffna,Manipay,Northern,3782,9506,13288,151280,380240,531520
3/15/2025,Piumi Rajapaksha,Jaffna,Manipay,Northern,828,4160,4988,33120,166400,199520
3/16/2025,Piumi Rajapaksha,Jaffna,Manipay,Northern,297,7912,8209,11880,316480,328360
3/17/2025,Piumi Rajapaksha,Jaffna,Manipay,Northern,7583,2539,10122,303320,101560,404880
3/18/2025,Piumi Rajapaksha,Jaffna,Manipay,Northern,8903,7778,16681,356120,311120,667240
3/19/2025,Piumi Rajapaksha,Jaffna,Manipay,Northern,8704,7560,16264,348160,302400,650560
3/20/2025,Piumi Rajapaksha,Jaffna,Manipay,Northern,7834,9559,17393,313360,382360,695720
3/21/2025,Piumi Rajapaksha,Jaffna,Manipay,Northern,1464,5163,6627,58560,206520,265080
3/22/2025,Piumi Rajapaksha,Jaffna,Manipay,Northern,4037,2671,6708,161480,106840,268320
3/23/2025,Piumi Rajapaksha,Jaffna,Manipay,Northern,7424,3702,11126,296960,148080,445040
3/25/2024,Tharanga Lakmal,Puttalam,Marawila,North Western,1371,3356,4727,54840,134240,189080
3/26/2024,Tharanga Lakmal,Puttalam,Marawila,North Western,2311,8021,10332,92440,320840,413280
3/27/2024,Tharanga Lakmal,Puttalam,Marawila,North Western,2038,2239,4277,81520,89560,171080
3/28/2024,Tharanga Lakmal,Puttalam,Marawila,North Western,5304,2092,7396,212160,83680,295840
3/29/2024,Tharanga Lakmal,Puttalam,Marawila,North Western,8688,6973,15661,347520,278920,626440
3/30/2024,Tharanga Lakmal,Puttalam,Marawila,North Western,1924,9569,11493,76960,382760,459720
3/31/2024,Tharanga Lakmal,Puttalam,Marawila,North Western,2063,2630,4693,82520,105200,187720
4/1/2024,Tharanga Lakmal,Puttalam,Marawila,North Western,6386,682,7068,255440,27280,282720
4/2/2024,Tharanga Lakmal,Puttalam,Marawila,North Western,9466,7107,16573,378640,284280,662920
4/3/2024,Tharanga Lakmal,Puttalam,Marawila,North Western,5355,864,6219,214200,34560,248760
4/4/2024,Tharanga Lakmal,Puttalam,Marawila,North Western,7243,7087,14330,289720,283480,573200
4/5/2024,Tharanga Lakmal,Puttalam,Marawila,North Western,9674,9641,19315,386960,385640,772600
4/6/2024,Tharanga Lakmal,Puttalam,Marawila,North Western,8171,9606,17777,326840,384240,711080
4/7/2024,Tharanga Lakmal,Puttalam,Marawila,North Western,5318,6212,11530,212720,248480,461200
4/8/2024,Tharanga Lakmal,Puttalam,Marawila,North Western,6745,3150,9895,269800,126000,395800
4/9/2024,Tharanga Lakmal,Puttalam,Marawila,North Western,8093,7486,15579,323720,299440,623160
4/10/2024,Tharanga Lakmal,Puttalam,Marawila,North Western,4432,1387,5819,177280,55480,232760
4/11/2024,Tharanga Lakmal,Puttalam,Marawila,North Western,9089,1802,10891,363560,72080,435640
4/19/2024,Tharanga Lakmal,Puttalam,Marawila,North Western,3896,2025,5921,155840,81000,236840
4/20/2024,Tharanga Lakmal,Puttalam,Marawila,North Western,5123,5538,10661,204920,221520,426440
4/21/2024,Tharanga Lakmal,Puttalam,Marawila,North Western,8728,7543,16271,349120,301720,650840
4/22/2024,Tharanga Lakmal,Puttalam,Marawila,North Western,2927,3170,6097,117080,126800,243880
4/23/2024,Tharanga Lakmal,Puttalam,Marawila,North Western,6940,2439,9379,277600,97560,375160
4/24/2024,Tharanga Lakmal,Puttalam,Marawila,North Western,2163,7395,9558,86520,295800,382320
4/25/2024,Tharanga Lakmal,Puttalam,Marawila,North Western,7399,3264,10663,295960,130560,426520
4/26/2024,Tharanga Lakmal,Puttalam,Marawila,North Western,4734,5046,9780,189360,201840,391200
4/27/2024,Tharanga Lakmal,Puttalam,Marawila,North Western,7706,1356,9062,308240,54240,362480
4/28/2024,Tharanga Lakmal,Puttalam,Marawila,North Western,144,3017,3161,5760,120680,126440
4/29/2024,Tharanga Lakmal,Puttalam,Marawila,North Western,4027,1007,5034,161080,40280,201360
4/30/2024,Tharanga Lakmal,Puttalam,Marawila,North Western,3206,620,3826,128240,24800,153040
5/1/2024,Tharanga Lakmal,Puttalam,Marawila,North Western,6298,670,6968,251920,26800,278720
5/2/2024,Tharanga Lakmal,Puttalam,Marawila,North Western,8639,9821,18460,345560,392840,738400
5/3/2024,Tharanga Lakmal,Puttalam,Marawila,North Western,1582,9104,10686,63280,364160,427440
5/4/2024,Tharanga Lakmal,Puttalam,Marawila,North Western,1285,5424,6709,51400,216960,268360
5/5/2024,Tharanga Lakmal,Puttalam,Marawila,North Western,2757,8369,11126,110280,334760,445040
5/6/2024,Tharanga Lakmal,Puttalam,Marawila,North Western,2004,6609,8613,80160,264360,344520
5/7/2024,Tharanga Lakmal,Puttalam,Marawila,North Western,1277,2630,3907,51080,105200,156280
5/8/2024,Tharanga Lakmal,Puttalam,Marawila,North Western,5737,68,5805,229480,2720,232200
5/9/2024,Tharanga Lakmal,Puttalam,Marawila,North Western,6684,9765,16449,267360,390600,657960
5/10/2024,Tharanga Lakmal,Puttalam,Marawila,North Western,6668,7459,14127,266720,298360,565080
5/11/2024,Tharanga Lakmal,Puttalam,Marawila,North Western,3262,6324,9586,130480,252960,383440
5/12/2024,Tharanga Lakmal,Puttalam,Marawila,North Western,5178,3799,8977,207120,151960,359080
5/13/2024,Tharanga Lakmal,Puttalam,Marawila,North Western,9911,1831,11742,396440,73240,469680
5/14/2024,Tharanga Lakmal,Puttalam,Marawila,North Western,961,3175,4136,38440,127000,165440
5/15/2024,Tharanga Lakmal,Puttalam,Marawila,North Western,4503,4112,8615,180120,164480,344600
5/16/2024,Tharanga Lakmal,Puttalam,Marawila,North Western,1311,5960,7271,52440,238400,290840
5/17/2024,Tharanga Lakmal,Puttalam,Marawila,North Western,6770,4286,11056,270800,171440,442240
5/18/2024,Tharanga Lakmal,Puttalam,Marawila,North Western,1635,3649,5284,65400,145960,211360
5/19/2024,Tharanga Lakmal,Puttalam,Marawila,North Western,6302,8350,14652,252080,334000,586080
5/20/2024,Tharanga Lakmal,Puttalam,Marawila,North Western,3979,4755,8734,159160,190200,349360
5/21/2024,Tharanga Lakmal,Puttalam,Marawila,North Western,7465,7006,14471,298600,280240,578840
5/22/2024,Tharanga Lakmal,Puttalam,Marawila,North Western,4006,9413,13419,160240,376520,536760
5/24/2024,Tharanga Lakmal,Puttalam,Marawila,North Western,3970,304,4274,158800,12160,170960
5/25/2024,Tharanga Lakmal,Puttalam,Marawila,North Western,6130,6024,12154,245200,240960,486160
5/26/2024,Tharanga Lakmal,Puttalam,Marawila,North Western,7112,4377,11489,284480,175080,459560
5/27/2024,Tharanga Lakmal,Puttalam,Marawila,North Western,7560,7621,15181,302400,304840,607240
5/28/2024,Tharanga Lakmal,Puttalam,Marawila,North Western,4794,3989,8783,191760,159560,351320
5/29/2024,Tharanga Lakmal,Puttalam,Marawila,North Western,5781,6792,12573,231240,271680,502920
5/30/2024,Tharanga Lakmal,Puttalam,Marawila,North Western,722,9633,10355,28880,385320,414200
5/31/2024,Tharanga Lakmal,Puttalam,Marawila,North Western,8487,6784,15271,339480,271360,610840
6/1/2024,Tharanga Lakmal,Puttalam,Marawila,North Western,8176,4056,12232,327040,162240,489280
6/2/2024,Tharanga Lakmal,Puttalam,Marawila,North Western,8780,9505,18285,351200,380200,731400
6/3/2024,Tharanga Lakmal,Puttalam,Marawila,North Western,7657,77,7734,306280,3080,309360
6/4/2024,Tharanga Lakmal,Puttalam,Marawila,North Western,5032,4647,9679,201280,185880,387160
6/5/2024,Tharanga Lakmal,Puttalam,Marawila,North Western,8625,6908,15533,345000,276320,621320
6/6/2024,Tharanga Lakmal,Puttalam,Marawila,North Western,7324,5681,13005,292960,227240,520200
6/7/2024,Tharanga Lakmal,Puttalam,Marawila,North Western,593,499,1092,23720,19960,43680
6/8/2024,Tharanga Lakmal,Puttalam,Marawila,North Western,6259,7289,13548,250360,291560,541920
6/9/2024,Tharanga Lakmal,Puttalam,Marawila,North Western,3301,984,4285,132040,39360,171400
6/10/2024,Tharanga Lakmal,Puttalam,Marawila,North Western,5469,8220,13689,218760,328800,547560
6/11/2024,Tharanga Lakmal,Puttalam,Marawila,North Western,5106,9215,14321,204240,368600,572840
6/12/2024,Tharanga Lakmal,Puttalam,Marawila,North Western,1209,5429,6638,48360,217160,265520
6/13/2024,Tharanga Lakmal,Puttalam,Marawila,North Western,4759,9256,14015,190360,370240,560600
6/14/2024,Tharanga Lakmal,Puttalam,Marawila,North Western,785,2492,3277,31400,99680,131080
6/15/2024,Tharanga Lakmal,Puttalam,Marawila,North Western,5906,8465,14371,236240,338600,574840
6/16/2024,Tharanga Lakmal,Puttalam,Marawila,North Western,2185,1174,3359,87400,46960,134360
6/17/2024,Tharanga Lakmal,Puttalam,Marawila,North Western,3549,2195,5744,141960,87800,229760
6/18/2024,Tharanga Lakmal,Puttalam,Marawila,North Western,6142,2323,8465,245680,92920,338600
6/19/2024,Tharanga Lakmal,Puttalam,Marawila,North Western,2482,6845,9327,99280,273800,373080
6/20/2024,Tharanga Lakmal,Puttalam,Marawila,North Western,2522,6741,9263,100880,269640,370520
6/21/2024,Tharanga Lakmal,Puttalam,Marawila,North Western,3747,9472,13219,149880,378880,528760
6/22/2024,Tharanga Lakmal,Puttalam,Marawila,North Western,8929,3388,12317,357160,135520,492680
6/23/2024,Tharanga Lakmal,Puttalam,Marawila,North Western,1118,2339,3457,44720,93560,138280
6/24/2024,Tharanga Lakmal,Puttalam,Marawila,North Western,8894,1166,10060,355760,46640,402400
6/25/2024,Tharanga Lakmal,Puttalam,Marawila,North Western,2837,355,3192,113480,14200,127680
6/26/2024,Tharanga Lakmal,Puttalam,Marawila,North Western,2245,1038,3283,89800,41520,131320
6/27/2024,Tharanga Lakmal,Puttalam,Marawila,North Western,727,1113,1840,29080,44520,73600
6/28/2024,Tharanga Lakmal,Puttalam,Marawila,North Western,3107,3646,6753,124280,145840,270120
6/29/2024,Tharanga Lakmal,Puttalam,Marawila,North Western,8918,8299,17217,356720,331960,688680
6/30/2024,Tharanga Lakmal,Puttalam,Marawila,North Western,4780,2245,7025,191200,89800,281000
7/1/2024,Tharanga Lakmal,Puttalam,Marawila,North Western,4827,7707,12534,193080,308280,501360
7/2/2024,Tharanga Lakmal,Puttalam,Marawila,North Western,1015,7261,8276,40600,290440,331040
7/3/2024,Tharanga Lakmal,Puttalam,Marawila,North Western,2925,1480,4405,117000,59200,176200
7/4/2024,Tharanga Lakmal,Puttalam,Marawila,North Western,2684,1573,4257,107360,62920,170280
7/5/2024,Tharanga Lakmal,Puttalam,Marawila,North Western,870,9052,9922,34800,362080,396880
7/6/2024,Tharanga Lakmal,Puttalam,Marawila,North Western,9424,9751,19175,376960,390040,767000
7/7/2024,Tharanga Lakmal,Puttalam,Marawila,North Western,5229,8382,13611,209160,335280,544440
7/8/2024,Tharanga Lakmal,Puttalam,Marawila,North Western,1173,8516,9689,46920,340640,387560
7/9/2024,Tharanga Lakmal,Puttalam,Marawila,North Western,8431,4945,13376,337240,197800,535040
7/10/2024,Tharanga Lakmal,Puttalam,Marawila,North Western,1618,3578,5196,64720,143120,207840
7/11/2024,Tharanga Lakmal,Puttalam,Marawila,North Western,8658,4150,12808,346320,166000,512320
7/12/2024,Tharanga Lakmal,Puttalam,Marawila,North Western,422,4572,4994,16880,182880,199760
7/13/2024,Tharanga Lakmal,Puttalam,Marawila,North Western,3716,9222,12938,148640,368880,517520
7/14/2024,Tharanga Lakmal,Puttalam,Marawila,North Western,214,8790,9004,8560,351600,360160
7/15/2024,Tharanga Lakmal,Puttalam,Marawila,North Western,8929,3363,12292,357160,134520,491680
7/16/2024,Tharanga Lakmal,Puttalam,Marawila,North Western,2912,3307,6219,116480,132280,248760
7/17/2024,Tharanga Lakmal,Puttalam,Marawila,North Western,3557,9322,12879,142280,372880,515160
7/18/2024,Tharanga Lakmal,Puttalam,Marawila,North Western,8817,9114,17931,352680,364560,717240
7/19/2024,Tharanga Lakmal,Puttalam,Marawila,North Western,1004,3428,4432,40160,137120,177280
7/20/2024,Tharanga Lakmal,Puttalam,Marawila,North Western,7713,9148,16861,308520,365920,674440
7/21/2024,Tharanga Lakmal,Puttalam,Marawila,North Western,2881,8739,11620,115240,349560,464800
7/22/2024,Tharanga Lakmal,Puttalam,Marawila,North Western,2488,1369,3857,99520,54760,154280
7/23/2024,Tharanga Lakmal,Puttalam,Marawila,North Western,1001,2351,3352,40040,94040,134080
7/24/2024,Tharanga Lakmal,Puttalam,Marawila,North Western,9603,9497,19100,384120,379880,764000
7/25/2024,Tharanga Lakmal,Puttalam,Marawila,North Western,9672,714,10386,386880,28560,415440
7/26/2024,Tharanga Lakmal,Puttalam,Marawila,North Western,5707,4833,10540,228280,193320,421600
7/27/2024,Tharanga Lakmal,Puttalam,Marawila,North Western,9813,7919,17732,392520,316760,709280
7/28/2024,Tharanga Lakmal,Puttalam,Marawila,North Western,1910,470,2380,76400,18800,95200
7/29/2024,Tharanga Lakmal,Puttalam,Marawila,North Western,1812,4370,6182,72480,174800,247280
7/30/2024,Tharanga Lakmal,Puttalam,Marawila,North Western,9857,709,10566,394280,28360,422640
7/31/2024,Tharanga Lakmal,Puttalam,Marawila,North Western,9007,9239,18246,360280,369560,729840
8/1/2024,Tharanga Lakmal,Puttalam,Marawila,North Western,818,2915,3733,32720,116600,149320
8/2/2024,Tharanga Lakmal,Puttalam,Marawila,North Western,7492,3689,11181,299680,147560,447240
8/3/2024,Tharanga Lakmal,Puttalam,Marawila,North Western,4075,7010,11085,163000,280400,443400
8/4/2024,Tharanga Lakmal,Puttalam,Marawila,North Western,2594,7279,9873,103760,291160,394920
8/5/2024,Tharanga Lakmal,Puttalam,Marawila,North Western,8247,661,8908,329880,26440,356320
8/6/2024,Tharanga Lakmal,Puttalam,Marawila,North Western,7826,4284,12110,313040,171360,484400
8/7/2024,Tharanga Lakmal,Puttalam,Marawila,North Western,4094,8620,12714,163760,344800,508560
8/8/2024,Tharanga Lakmal,Puttalam,Marawila,North Western,8260,6409,14669,330400,256360,586760
8/9/2024,Tharanga Lakmal,Puttalam,Marawila,North Western,338,8284,8622,13520,331360,344880
8/10/2024,Tharanga Lakmal,Puttalam,Marawila,North Western,7761,8031,15792,310440,321240,631680
8/11/2024,Tharanga Lakmal,Puttalam,Marawila,North Western,7495,5327,12822,299800,213080,512880
8/12/2024,Tharanga Lakmal,Puttalam,Marawila,North Western,1278,9821,11099,51120,392840,443960
8/13/2024,Tharanga Lakmal,Puttalam,Marawila,North Western,7715,387,8102,308600,15480,324080
8/14/2024,Tharanga Lakmal,Puttalam,Marawila,North Western,2514,1363,3877,100560,54520,155080
8/15/2024,Tharanga Lakmal,Puttalam,Marawila,North Western,3961,4031,7992,158440,161240,319680
8/16/2024,Tharanga Lakmal,Puttalam,Marawila,North Western,1092,909,2001,43680,36360,80040
8/17/2024,Tharanga Lakmal,Puttalam,Marawila,North Western,5472,5952,11424,218880,238080,456960
8/18/2024,Tharanga Lakmal,Puttalam,Marawila,North Western,3244,7582,10826,129760,303280,433040
8/19/2024,Tharanga Lakmal,Puttalam,Marawila,North Western,5380,4397,9777,215200,175880,391080
8/20/2024,Tharanga Lakmal,Puttalam,Marawila,North Western,7582,1426,9008,303280,57040,360320
8/21/2024,Tharanga Lakmal,Puttalam,Marawila,North Western,9365,297,9662,374600,11880,386480
8/22/2024,Tharanga Lakmal,Puttalam,Marawila,North Western,6409,1702,8111,256360,68080,324440
8/23/2024,Tharanga Lakmal,Puttalam,Marawila,North Western,732,2604,3336,29280,104160,133440
8/24/2024,Tharanga Lakmal,Puttalam,Marawila,North Western,3131,3192,6323,125240,127680,252920
8/25/2024,Tharanga Lakmal,Puttalam,Marawila,North Western,7330,4663,11993,293200,186520,479720
8/26/2024,Tharanga Lakmal,Puttalam,Marawila,North Western,9455,2313,11768,378200,92520,470720
8/27/2024,Tharanga Lakmal,Puttalam,Marawila,North Western,8060,1689,9749,322400,67560,389960
8/28/2024,Tharanga Lakmal,Puttalam,Marawila,North Western,2307,9801,12108,92280,392040,484320
8/29/2024,Tharanga Lakmal,Puttalam,Marawila,North Western,4197,4757,8954,167880,190280,358160
8/30/2024,Tharanga Lakmal,Puttalam,Marawila,North Western,5801,7717,13518,232040,308680,540720
8/31/2024,Tharanga Lakmal,Puttalam,Marawila,North Western,9208,7293,16501,368320,291720,660040
9/1/2024,Tharanga Lakmal,Puttalam,Marawila,North Western,4578,8818,13396,183120,352720,535840
9/2/2024,Tharanga Lakmal,Puttalam,Marawila,North Western,1916,5400,7316,76640,216000,292640
9/3/2024,Tharanga Lakmal,Puttalam,Marawila,North Western,2603,2712,5315,104120,108480,212600
9/4/2024,Tharanga Lakmal,Puttalam,Marawila,North Western,7909,8564,16473,316360,342560,658920
9/5/2024,Tharanga Lakmal,Puttalam,Marawila,North Western,861,9287,10148,34440,371480,405920
9/6/2024,Tharanga Lakmal,Puttalam,Marawila,North Western,5556,1221,6777,222240,48840,271080
9/7/2024,Tharanga Lakmal,Puttalam,Marawila,North Western,4604,6938,11542,184160,277520,461680
9/8/2024,Tharanga Lakmal,Puttalam,Marawila,North Western,4473,1034,5507,178920,41360,220280
9/9/2024,Tharanga Lakmal,Puttalam,Marawila,North Western,1697,76,1773,67880,3040,70920
9/10/2024,Tharanga Lakmal,Puttalam,Marawila,North Western,8619,5238,13857,344760,209520,554280
9/11/2024,Tharanga Lakmal,Puttalam,Marawila,North Western,8008,1785,9793,320320,71400,391720
9/12/2024,Tharanga Lakmal,Puttalam,Marawila,North Western,6815,9520,16335,272600,380800,653400
9/13/2024,Tharanga Lakmal,Puttalam,Marawila,North Western,3533,7237,10770,141320,289480,430800
9/14/2024,Tharanga Lakmal,Puttalam,Marawila,North Western,8118,9116,17234,324720,364640,689360
9/15/2024,Tharanga Lakmal,Puttalam,Marawila,North Western,7072,9161,16233,282880,366440,649320
9/16/2024,Tharanga Lakmal,Puttalam,Marawila,North Western,9748,2199,11947,389920,87960,477880
9/17/2024,Tharanga Lakmal,Puttalam,Marawila,North Western,7554,7194,14748,302160,287760,589920
9/18/2024,Tharanga Lakmal,Puttalam,Marawila,North Western,1158,6741,7899,46320,269640,315960
9/19/2024,Tharanga Lakmal,Puttalam,Marawila,North Western,9306,5584,14890,372240,223360,595600
9/20/2024,Tharanga Lakmal,Puttalam,Marawila,North Western,8641,320,8961,345640,12800,358440
9/21/2024,Tharanga Lakmal,Puttalam,Marawila,North Western,4674,8317,12991,186960,332680,519640
9/22/2024,Tharanga Lakmal,Puttalam,Marawila,North Western,5156,8809,13965,206240,352360,558600
9/23/2024,Tharanga Lakmal,Puttalam,Marawila,North Western,7711,9242,16953,308440,369680,678120
9/24/2024,Tharanga Lakmal,Puttalam,Marawila,North Western,3216,679,3895,128640,27160,155800
9/25/2024,Tharanga Lakmal,Puttalam,Marawila,North Western,7551,2580,10131,302040,103200,405240
9/26/2024,Tharanga Lakmal,Puttalam,Marawila,North Western,3867,1211,5078,154680,48440,203120
9/27/2024,Tharanga Lakmal,Puttalam,Marawila,North Western,1604,6293,7897,64160,251720,315880
9/28/2024,Tharanga Lakmal,Puttalam,Marawila,North Western,7221,8146,15367,288840,325840,614680
9/29/2024,Tharanga Lakmal,Puttalam,Marawila,North Western,3974,5844,9818,158960,233760,392720
9/30/2024,Tharanga Lakmal,Puttalam,Marawila,North Western,3693,135,3828,147720,5400,153120
10/1/2024,Tharanga Lakmal,Puttalam,Marawila,North Western,8176,3345,11521,327040,133800,460840
10/2/2024,Tharanga Lakmal,Puttalam,Marawila,North Western,1505,7723,9228,60200,308920,369120
10/3/2024,Tharanga Lakmal,Puttalam,Marawila,North Western,7237,2398,9635,289480,95920,385400
10/4/2024,Tharanga Lakmal,Puttalam,Marawila,North Western,8918,5630,14548,356720,225200,581920
10/5/2024,Tharanga Lakmal,Puttalam,Marawila,North Western,4781,108,4889,191240,4320,195560
10/6/2024,Tharanga Lakmal,Puttalam,Marawila,North Western,5029,3255,8284,201160,130200,331360
10/7/2024,Tharanga Lakmal,Puttalam,Marawila,North Western,8621,4984,13605,344840,199360,544200
10/8/2024,Tharanga Lakmal,Puttalam,Marawila,North Western,9862,395,10257,394480,15800,410280
10/9/2024,Tharanga Lakmal,Puttalam,Marawila,North Western,340,6217,6557,13600,248680,262280
10/10/2024,Tharanga Lakmal,Puttalam,Marawila,North Western,5255,232,5487,210200,9280,219480
10/11/2024,Tharanga Lakmal,Puttalam,Marawila,North Western,5130,4509,9639,205200,180360,385560
10/12/2024,Tharanga Lakmal,Puttalam,Marawila,North Western,5195,9686,14881,207800,387440,595240
10/13/2024,Tharanga Lakmal,Puttalam,Marawila,North Western,577,1044,1621,23080,41760,64840
10/14/2024,Tharanga Lakmal,Puttalam,Marawila,North Western,111,3107,3218,4440,124280,128720
10/15/2024,Tharanga Lakmal,Puttalam,Marawila,North Western,1135,4177,5312,45400,167080,212480
10/16/2024,Tharanga Lakmal,Puttalam,Marawila,North Western,2187,2428,4615,87480,97120,184600
10/17/2024,Tharanga Lakmal,Puttalam,Marawila,North Western,3986,9080,13066,159440,363200,522640
10/18/2024,Tharanga Lakmal,Puttalam,Marawila,North Western,3547,4601,8148,141880,184040,325920
10/19/2024,Tharanga Lakmal,Puttalam,Marawila,North Western,6257,7559,13816,250280,302360,552640
10/20/2024,Tharanga Lakmal,Puttalam,Marawila,North Western,391,6807,7198,15640,272280,287920
10/21/2024,Tharanga Lakmal,Puttalam,Marawila,North Western,5361,6984,12345,214440,279360,493800
10/22/2024,Tharanga Lakmal,Puttalam,Marawila,North Western,9905,7156,17061,396200,286240,682440
10/23/2024,Tharanga Lakmal,Puttalam,Marawila,North Western,1067,7814,8881,42680,312560,355240
10/24/2024,Tharanga Lakmal,Puttalam,Marawila,North Western,9626,8600,18226,385040,344000,729040
10/25/2024,Tharanga Lakmal,Puttalam,Marawila,North Western,3629,7055,10684,145160,282200,427360
10/26/2024,Tharanga Lakmal,Puttalam,Marawila,North Western,5680,257,5937,227200,10280,237480
10/27/2024,Tharanga Lakmal,Puttalam,Marawila,North Western,6299,6534,12833,251960,261360,513320
10/28/2024,Tharanga Lakmal,Puttalam,Marawila,North Western,2143,757,2900,85720,30280,116000
10/29/2024,Tharanga Lakmal,Puttalam,Marawila,North Western,4032,682,4714,161280,27280,188560
10/30/2024,Tharanga Lakmal,Puttalam,Marawila,North Western,5909,5677,11586,236360,227080,463440
10/31/2024,Tharanga Lakmal,Puttalam,Marawila,North Western,5348,4026,9374,213920,161040,374960
11/1/2024,Tharanga Lakmal,Puttalam,Marawila,North Western,7662,29,7691,306480,1160,307640
11/2/2024,Tharanga Lakmal,Puttalam,Marawila,North Western,4047,8444,12491,161880,337760,499640
11/3/2024,Tharanga Lakmal,Puttalam,Marawila,North Western,8851,7940,16791,354040,317600,671640
11/4/2024,Tharanga Lakmal,Puttalam,Marawila,North Western,6718,3334,10052,268720,133360,402080
11/5/2024,Tharanga Lakmal,Puttalam,Marawila,North Western,6444,7086,13530,257760,283440,541200
11/6/2024,Tharanga Lakmal,Puttalam,Marawila,North Western,3037,2200,5237,121480,88000,209480
11/7/2024,Tharanga Lakmal,Puttalam,Marawila,North Western,6065,4538,10603,242600,181520,424120
11/8/2024,Tharanga Lakmal,Puttalam,Marawila,North Western,1410,2472,3882,56400,98880,155280
11/9/2024,Tharanga Lakmal,Puttalam,Marawila,North Western,1430,1406,2836,57200,56240,113440
11/10/2024,Tharanga Lakmal,Puttalam,Marawila,North Western,508,2753,3261,20320,110120,130440
11/11/2024,Tharanga Lakmal,Puttalam,Marawila,North Western,8339,8523,16862,333560,340920,674480
11/12/2024,Tharanga Lakmal,Puttalam,Marawila,North Western,4067,2534,6601,162680,101360,264040
11/13/2024,Tharanga Lakmal,Puttalam,Marawila,North Western,2611,972,3583,104440,38880,143320
11/14/2024,Tharanga Lakmal,Puttalam,Marawila,North Western,6248,4484,10732,249920,179360,429280
11/15/2024,Tharanga Lakmal,Puttalam,Marawila,North Western,4716,8352,13068,188640,334080,522720
11/16/2024,Tharanga Lakmal,Puttalam,Marawila,North Western,8811,6048,14859,352440,241920,594360
11/17/2024,Tharanga Lakmal,Puttalam,Marawila,North Western,787,1892,2679,31480,75680,107160
11/18/2024,Tharanga Lakmal,Puttalam,Marawila,North Western,9102,2070,11172,364080,82800,446880
11/19/2024,Tharanga Lakmal,Puttalam,Marawila,North Western,7580,1523,9103,303200,60920,364120
11/20/2024,Tharanga Lakmal,Puttalam,Marawila,North Western,2662,4082,6744,106480,163280,269760
11/21/2024,Tharanga Lakmal,Puttalam,Marawila,North Western,2437,7675,10112,97480,307000,404480
11/22/2024,Tharanga Lakmal,Puttalam,Marawila,North Western,4297,79,4376,171880,3160,175040
11/23/2024,Tharanga Lakmal,Puttalam,Marawila,North Western,7902,1021,8923,316080,40840,356920
11/24/2024,Tharanga Lakmal,Puttalam,Marawila,North Western,7179,9504,16683,287160,380160,667320
11/25/2024,Tharanga Lakmal,Puttalam,Marawila,North Western,6030,8322,14352,241200,332880,574080
11/26/2024,Tharanga Lakmal,Puttalam,Marawila,North Western,4492,1451,5943,179680,58040,237720
11/27/2024,Tharanga Lakmal,Puttalam,Marawila,North Western,5384,2600,7984,215360,104000,319360
11/28/2024,Tharanga Lakmal,Puttalam,Marawila,North Western,2209,5268,7477,88360,210720,299080
11/29/2024,Tharanga Lakmal,Puttalam,Marawila,North Western,2727,3755,6482,109080,150200,259280
11/30/2024,Tharanga Lakmal,Puttalam,Marawila,North Western,1524,4137,5661,60960,165480,226440
12/1/2024,Tharanga Lakmal,Puttalam,Marawila,North Western,620,8468,9088,24800,338720,363520
12/2/2024,Tharanga Lakmal,Puttalam,Marawila,North Western,3303,656,3959,132120,26240,158360
12/3/2024,Tharanga Lakmal,Puttalam,Marawila,North Western,7993,5548,13541,319720,221920,541640
12/4/2024,Tharanga Lakmal,Puttalam,Marawila,North Western,2668,8568,11236,106720,342720,449440
12/5/2024,Tharanga Lakmal,Puttalam,Marawila,North Western,6968,8383,15351,278720,335320,614040
12/6/2024,Tharanga Lakmal,Puttalam,Marawila,North Western,6217,4531,10748,248680,181240,429920
12/7/2024,Tharanga Lakmal,Puttalam,Marawila,North Western,9705,4918,14623,388200,196720,584920
12/8/2024,Tharanga Lakmal,Puttalam,Marawila,North Western,9224,2885,12109,368960,115400,484360
12/9/2024,Tharanga Lakmal,Puttalam,Marawila,North Western,837,4233,5070,33480,169320,202800
12/10/2024,Tharanga Lakmal,Puttalam,Marawila,North Western,7369,6024,13393,294760,240960,535720
12/11/2024,Tharanga Lakmal,Puttalam,Marawila,North Western,3110,1278,4388,124400,51120,175520
12/12/2024,Tharanga Lakmal,Puttalam,Marawila,North Western,8954,8742,17696,358160,349680,707840
12/13/2024,Tharanga Lakmal,Puttalam,Marawila,North Western,9836,1177,11013,393440,47080,440520
12/14/2024,Tharanga Lakmal,Puttalam,Marawila,North Western,5987,2511,8498,239480,100440,339920
12/15/2024,Tharanga Lakmal,Puttalam,Marawila,North Western,8720,5738,14458,348800,229520,578320
12/16/2024,Tharanga Lakmal,Puttalam,Marawila,North Western,5939,4807,10746,237560,192280,429840
12/17/2024,Tharanga Lakmal,Puttalam,Marawila,North Western,1010,2764,3774,40400,110560,150960
12/18/2024,Tharanga Lakmal,Puttalam,Marawila,North Western,8283,8342,16625,331320,333680,665000
12/19/2024,Tharanga Lakmal,Puttalam,Marawila,North Western,1802,1734,3536,72080,69360,141440
12/20/2024,Tharanga Lakmal,Puttalam,Marawila,North Western,9725,6991,16716,389000,279640,668640
12/21/2024,Tharanga Lakmal,Puttalam,Marawila,North Western,7832,5198,13030,313280,207920,521200
12/22/2024,Tharanga Lakmal,Puttalam,Marawila,North Western,5858,1217,7075,234320,48680,283000
12/23/2024,Tharanga Lakmal,Puttalam,Marawila,North Western,6211,7519,13730,248440,300760,549200
12/24/2024,Tharanga Lakmal,Puttalam,Marawila,North Western,8924,9916,18840,356960,396640,753600
12/25/2024,Tharanga Lakmal,Puttalam,Marawila,North Western,6248,2006,8254,249920,80240,330160
12/26/2024,Tharanga Lakmal,Puttalam,Marawila,North Western,4579,5482,10061,183160,219280,402440
12/27/2024,Tharanga Lakmal,Puttalam,Marawila,North Western,3879,5208,9087,155160,208320,363480
12/28/2024,Tharanga Lakmal,Puttalam,Marawila,North Western,4593,3179,7772,183720,127160,310880
12/29/2024,Tharanga Lakmal,Puttalam,Marawila,North Western,3210,8309,11519,128400,332360,460760
12/30/2024,Tharanga Lakmal,Puttalam,Marawila,North Western,5800,5492,11292,232000,219680,451680
12/31/2024,Tharanga Lakmal,Puttalam,Marawila,North Western,8572,4522,13094,342880,180880,523760
1/1/2025,Tharanga Lakmal,Puttalam,Marawila,North Western,9768,6519,16287,390720,260760,651480
1/2/2025,Tharanga Lakmal,Puttalam,Marawila,North Western,4460,9816,14276,178400,392640,571040
1/3/2025,Tharanga Lakmal,Puttalam,Marawila,North Western,1204,2127,3331,48160,85080,133240
1/4/2025,Tharanga Lakmal,Puttalam,Marawila,North Western,722,3482,4204,28880,139280,168160
1/5/2025,Tharanga Lakmal,Puttalam,Marawila,North Western,1973,4791,6764,78920,191640,270560
1/6/2025,Tharanga Lakmal,Puttalam,Marawila,North Western,5855,9143,14998,234200,365720,599920
1/7/2025,Tharanga Lakmal,Puttalam,Marawila,North Western,3175,1957,5132,127000,78280,205280
1/8/2025,Tharanga Lakmal,Puttalam,Marawila,North Western,3516,2748,6264,140640,109920,250560
1/9/2025,Tharanga Lakmal,Puttalam,Marawila,North Western,1904,2238,4142,76160,89520,165680
1/10/2025,Tharanga Lakmal,Puttalam,Marawila,North Western,9915,4195,14110,396600,167800,564400
1/11/2025,Tharanga Lakmal,Puttalam,Marawila,North Western,3479,3852,7331,139160,154080,293240
1/12/2025,Tharanga Lakmal,Puttalam,Marawila,North Western,5306,8944,14250,212240,357760,570000
1/13/2025,Tharanga Lakmal,Puttalam,Marawila,North Western,2484,6521,9005,99360,260840,360200
1/14/2025,Tharanga Lakmal,Puttalam,Marawila,North Western,8284,3851,12135,331360,154040,485400
1/15/2025,Tharanga Lakmal,Puttalam,Marawila,North Western,6673,9395,16068,266920,375800,642720
1/16/2025,Tharanga Lakmal,Puttalam,Marawila,North Western,2003,8223,10226,80120,328920,409040
1/17/2025,Tharanga Lakmal,Puttalam,Marawila,North Western,2721,9045,11766,108840,361800,470640
1/18/2025,Tharanga Lakmal,Puttalam,Marawila,North Western,8323,4673,12996,332920,186920,519840
1/19/2025,Tharanga Lakmal,Puttalam,Marawila,North Western,5714,9964,15678,228560,398560,627120
1/20/2025,Tharanga Lakmal,Puttalam,Marawila,North Western,5894,5831,11725,235760,233240,469000
1/21/2025,Tharanga Lakmal,Puttalam,Marawila,North Western,8059,1206,9265,322360,48240,370600
1/22/2025,Tharanga Lakmal,Puttalam,Marawila,North Western,4149,7751,11900,165960,310040,476000
1/23/2025,Tharanga Lakmal,Puttalam,Marawila,North Western,7854,5594,13448,314160,223760,537920
1/24/2025,Tharanga Lakmal,Puttalam,Marawila,North Western,4357,9822,14179,174280,392880,567160
1/25/2025,Tharanga Lakmal,Puttalam,Marawila,North Western,8291,4590,12881,331640,183600,515240
1/26/2025,Tharanga Lakmal,Puttalam,Marawila,North Western,269,7159,7428,10760,286360,297120
1/27/2025,Tharanga Lakmal,Puttalam,Marawila,North Western,5069,7117,12186,202760,284680,487440
1/28/2025,Tharanga Lakmal,Puttalam,Marawila,North Western,3302,9601,12903,132080,384040,516120
1/29/2025,Tharanga Lakmal,Puttalam,Marawila,North Western,6483,5926,12409,259320,237040,496360
1/30/2025,Tharanga Lakmal,Puttalam,Marawila,North Western,3297,8324,11621,131880,332960,464840
1/31/2025,Tharanga Lakmal,Puttalam,Marawila,North Western,973,2130,3103,38920,85200,124120
2/1/2025,Tharanga Lakmal,Puttalam,Marawila,North Western,1929,4943,6872,77160,197720,274880
2/2/2025,Tharanga Lakmal,Puttalam,Marawila,North Western,2651,6171,8822,106040,246840,352880
2/3/2025,Tharanga Lakmal,Puttalam,Marawila,North Western,5544,7335,12879,221760,293400,515160
2/4/2025,Tharanga Lakmal,Puttalam,Marawila,North Western,6858,6806,13664,274320,272240,546560
2/5/2025,Tharanga Lakmal,Puttalam,Marawila,North Western,6578,6508,13086,263120,260320,523440
2/6/2025,Tharanga Lakmal,Puttalam,Marawila,North Western,8878,672,9550,355120,26880,382000
2/7/2025,Tharanga Lakmal,Puttalam,Marawila,North Western,7870,3774,11644,314800,150960,465760
2/8/2025,Tharanga Lakmal,Puttalam,Marawila,North Western,738,2112,2850,29520,84480,114000
2/9/2025,Tharanga Lakmal,Puttalam,Marawila,North Western,422,6429,6851,16880,257160,274040
2/10/2025,Tharanga Lakmal,Puttalam,Marawila,North Western,238,5658,5896,9520,226320,235840
2/11/2025,Tharanga Lakmal,Puttalam,Marawila,North Western,2079,2023,4102,83160,80920,164080
2/12/2025,Tharanga Lakmal,Puttalam,Marawila,North Western,5982,3786,9768,239280,151440,390720
2/13/2025,Tharanga Lakmal,Puttalam,Marawila,North Western,7846,644,8490,313840,25760,339600
2/14/2025,Tharanga Lakmal,Puttalam,Marawila,North Western,4470,2738,7208,178800,109520,288320
2/15/2025,Tharanga Lakmal,Puttalam,Marawila,North Western,7351,1494,8845,294040,59760,353800
2/16/2025,Tharanga Lakmal,Puttalam,Marawila,North Western,8536,479,9015,341440,19160,360600
2/17/2025,Tharanga Lakmal,Puttalam,Marawila,North Western,9626,1749,11375,385040,69960,455000
2/18/2025,Tharanga Lakmal,Puttalam,Marawila,North Western,134,7879,8013,5360,315160,320520
2/19/2025,Tharanga Lakmal,Puttalam,Marawila,North Western,8719,7305,16024,348760,292200,640960
2/20/2025,Tharanga Lakmal,Puttalam,Marawila,North Western,626,1259,1885,25040,50360,75400
2/21/2025,Tharanga Lakmal,Puttalam,Marawila,North Western,4952,3409,8361,198080,136360,334440
2/22/2025,Tharanga Lakmal,Puttalam,Marawila,North Western,5370,2244,7614,214800,89760,304560
2/23/2025,Tharanga Lakmal,Puttalam,Marawila,North Western,4759,4347,9106,190360,173880,364240
2/24/2025,Tharanga Lakmal,Puttalam,Marawila,North Western,4550,7095,11645,182000,283800,465800
2/25/2025,Tharanga Lakmal,Puttalam,Marawila,North Western,4784,8034,12818,191360,321360,512720
2/26/2025,Tharanga Lakmal,Puttalam,Marawila,North Western,1205,8588,9793,48200,343520,391720
2/27/2025,Tharanga Lakmal,Puttalam,Marawila,North Western,2051,3942,5993,82040,157680,239720
2/28/2025,Tharanga Lakmal,Puttalam,Marawila,North Western,9662,9053,18715,386480,362120,748600
3/1/2025,Tharanga Lakmal,Puttalam,Marawila,North Western,9879,8165,18044,395160,326600,721760
3/2/2025,Tharanga Lakmal,Puttalam,Marawila,North Western,7409,7956,15365,296360,318240,614600
3/3/2025,Tharanga Lakmal,Puttalam,Marawila,North Western,7909,3759,11668,316360,150360,466720
3/4/2025,Tharanga Lakmal,Puttalam,Marawila,North Western,1638,774,2412,65520,30960,96480
3/5/2025,Tharanga Lakmal,Puttalam,Marawila,North Western,5150,1351,6501,206000,54040,260040
3/6/2025,Tharanga Lakmal,Puttalam,Marawila,North Western,3908,9033,12941,156320,361320,517640
3/7/2025,Tharanga Lakmal,Puttalam,Marawila,North Western,6713,1045,7758,268520,41800,310320
3/8/2025,Tharanga Lakmal,Puttalam,Marawila,North Western,6569,7995,14564,262760,319800,582560
3/9/2025,Tharanga Lakmal,Puttalam,Marawila,North Western,2248,5680,7928,89920,227200,317120
3/10/2025,Tharanga Lakmal,Puttalam,Marawila,North Western,3856,4742,8598,154240,189680,343920
3/11/2025,Tharanga Lakmal,Puttalam,Marawila,North Western,4522,856,5378,180880,34240,215120
3/12/2025,Tharanga Lakmal,Puttalam,Marawila,North Western,778,6492,7270,31120,259680,290800
3/13/2025,Tharanga Lakmal,Puttalam,Marawila,North Western,9189,1121,10310,367560,44840,412400
3/14/2025,Tharanga Lakmal,Puttalam,Marawila,North Western,6038,8113,14151,241520,324520,566040
3/15/2025,Tharanga Lakmal,Puttalam,Marawila,North Western,5102,7374,12476,204080,294960,499040
3/16/2025,Tharanga Lakmal,Puttalam,Marawila,North Western,656,6555,7211,26240,262200,288440
3/17/2025,Tharanga Lakmal,Puttalam,Marawila,North Western,9750,2296,12046,390000,91840,481840
3/18/2025,Tharanga Lakmal,Puttalam,Marawila,North Western,7117,2669,9786,284680,106760,391440
3/19/2025,Tharanga Lakmal,Puttalam,Marawila,North Western,837,2463,3300,33480,98520,132000
3/20/2025,Tharanga Lakmal,Puttalam,Marawila,North Western,4308,5252,9560,172320,210080,382400
3/21/2025,Tharanga Lakmal,Puttalam,Marawila,North Western,989,3791,4780,39560,151640,191200
3/22/2025,Tharanga Lakmal,Puttalam,Marawila,North Western,8306,6738,15044,332240,269520,601760
3/23/2025,Tharanga Lakmal,Puttalam,Marawila,North Western,9995,7749,17744,399800,309960,709760
3/25/2024,Dinesh Rajapakse,Ampara,Uhana,Eastern,3677,2060,5737,147080,82400,229480
3/26/2024,Dinesh Rajapakse,Ampara,Uhana,Eastern,727,4018,4745,29080,160720,189800
3/27/2024,Dinesh Rajapakse,Ampara,Uhana,Eastern,7062,4075,11137,282480,163000,445480
3/28/2024,Dinesh Rajapakse,Ampara,Uhana,Eastern,8890,7606,16496,355600,304240,659840
3/29/2024,Dinesh Rajapakse,Ampara,Uhana,Eastern,270,7615,7885,10800,304600,315400
3/30/2024,Dinesh Rajapakse,Ampara,Uhana,Eastern,5252,5965,11217,210080,238600,448680
3/31/2024,Dinesh Rajapakse,Ampara,Uhana,Eastern,1862,2636,4498,74480,105440,179920
4/1/2024,Dinesh Rajapakse,Ampara,Uhana,Eastern,570,6372,6942,22800,254880,277680
4/2/2024,Dinesh Rajapakse,Ampara,Uhana,Eastern,8311,6159,14470,332440,246360,578800
4/3/2024,Dinesh Rajapakse,Ampara,Uhana,Eastern,9960,8757,18717,398400,350280,748680
4/4/2024,Dinesh Rajapakse,Ampara,Uhana,Eastern,6854,3035,9889,274160,121400,395560
4/5/2024,Dinesh Rajapakse,Ampara,Uhana,Eastern,2776,841,3617,111040,33640,144680
4/6/2024,Dinesh Rajapakse,Ampara,Uhana,Eastern,8864,5221,14085,354560,208840,563400
4/7/2024,Dinesh Rajapakse,Ampara,Uhana,Eastern,4946,8056,13002,197840,322240,520080
4/8/2024,Dinesh Rajapakse,Ampara,Uhana,Eastern,6950,6694,13644,278000,267760,545760
4/9/2024,Dinesh Rajapakse,Ampara,Uhana,Eastern,9475,3722,13197,379000,148880,527880
4/10/2024,Dinesh Rajapakse,Ampara,Uhana,Eastern,3072,1388,4460,122880,55520,178400
4/11/2024,Dinesh Rajapakse,Ampara,Uhana,Eastern,4360,8499,12859,174400,339960,514360
4/19/2024,Dinesh Rajapakse,Ampara,Uhana,Eastern,568,4981,5549,22720,199240,221960
4/20/2024,Dinesh Rajapakse,Ampara,Uhana,Eastern,7814,7373,15187,312560,294920,607480
4/21/2024,Dinesh Rajapakse,Ampara,Uhana,Eastern,2247,1951,4198,89880,78040,167920
4/22/2024,Dinesh Rajapakse,Ampara,Uhana,Eastern,5629,9131,14760,225160,365240,590400
4/23/2024,Dinesh Rajapakse,Ampara,Uhana,Eastern,8703,3615,12318,348120,144600,492720
4/24/2024,Dinesh Rajapakse,Ampara,Uhana,Eastern,106,2674,2780,4240,106960,111200
4/25/2024,Dinesh Rajapakse,Ampara,Uhana,Eastern,6471,8971,15442,258840,358840,617680
4/26/2024,Dinesh Rajapakse,Ampara,Uhana,Eastern,2698,6406,9104,107920,256240,364160
4/27/2024,Dinesh Rajapakse,Ampara,Uhana,Eastern,6973,5076,12049,278920,203040,481960
4/28/2024,Dinesh Rajapakse,Ampara,Uhana,Eastern,3927,2004,5931,157080,80160,237240
4/29/2024,Dinesh Rajapakse,Ampara,Uhana,Eastern,8252,9672,17924,330080,386880,716960
4/30/2024,Dinesh Rajapakse,Ampara,Uhana,Eastern,5082,4990,10072,203280,199600,402880
5/1/2024,Dinesh Rajapakse,Ampara,Uhana,Eastern,2324,5284,7608,92960,211360,304320
5/2/2024,Dinesh Rajapakse,Ampara,Uhana,Eastern,3089,2945,6034,123560,117800,241360
5/3/2024,Dinesh Rajapakse,Ampara,Uhana,Eastern,9646,5051,14697,385840,202040,587880
5/4/2024,Dinesh Rajapakse,Ampara,Uhana,Eastern,6667,834,7501,266680,33360,300040
5/5/2024,Dinesh Rajapakse,Ampara,Uhana,Eastern,7122,4950,12072,284880,198000,482880
5/6/2024,Dinesh Rajapakse,Ampara,Uhana,Eastern,4164,3425,7589,166560,137000,303560
5/7/2024,Dinesh Rajapakse,Ampara,Uhana,Eastern,3193,8859,12052,127720,354360,482080
5/8/2024,Dinesh Rajapakse,Ampara,Uhana,Eastern,2093,3264,5357,83720,130560,214280
5/9/2024,Dinesh Rajapakse,Ampara,Uhana,Eastern,9207,5250,14457,368280,210000,578280
5/10/2024,Dinesh Rajapakse,Ampara,Uhana,Eastern,3345,7919,11264,133800,316760,450560
5/11/2024,Dinesh Rajapakse,Ampara,Uhana,Eastern,291,7580,7871,11640,303200,314840
5/12/2024,Dinesh Rajapakse,Ampara,Uhana,Eastern,2844,3144,5988,113760,125760,239520
5/13/2024,Dinesh Rajapakse,Ampara,Uhana,Eastern,4459,9125,13584,178360,365000,543360
5/14/2024,Dinesh Rajapakse,Ampara,Uhana,Eastern,3434,1219,4653,137360,48760,186120
5/15/2024,Dinesh Rajapakse,Ampara,Uhana,Eastern,7147,6363,13510,285880,254520,540400
5/16/2024,Dinesh Rajapakse,Ampara,Uhana,Eastern,3420,3784,7204,136800,151360,288160
5/17/2024,Dinesh Rajapakse,Ampara,Uhana,Eastern,7413,5787,13200,296520,231480,528000
5/18/2024,Dinesh Rajapakse,Ampara,Uhana,Eastern,2784,9984,12768,111360,399360,510720
5/19/2024,Dinesh Rajapakse,Ampara,Uhana,Eastern,6116,1732,7848,244640,69280,313920
5/20/2024,Dinesh Rajapakse,Ampara,Uhana,Eastern,9650,3246,12896,386000,129840,515840
5/21/2024,Dinesh Rajapakse,Ampara,Uhana,Eastern,9496,7211,16707,379840,288440,668280
5/22/2024,Dinesh Rajapakse,Ampara,Uhana,Eastern,5654,7713,13367,226160,308520,534680
5/24/2024,Dinesh Rajapakse,Ampara,Uhana,Eastern,5967,8083,14050,238680,323320,562000
5/25/2024,Dinesh Rajapakse,Ampara,Uhana,Eastern,7224,8643,15867,288960,345720,634680
5/26/2024,Dinesh Rajapakse,Ampara,Uhana,Eastern,304,9154,9458,12160,366160,378320
5/27/2024,Dinesh Rajapakse,Ampara,Uhana,Eastern,5643,2884,8527,225720,115360,341080
5/28/2024,Dinesh Rajapakse,Ampara,Uhana,Eastern,6294,9834,16128,251760,393360,645120
5/29/2024,Dinesh Rajapakse,Ampara,Uhana,Eastern,5898,4304,10202,235920,172160,408080
5/30/2024,Dinesh Rajapakse,Ampara,Uhana,Eastern,9093,8883,17976,363720,355320,719040
5/31/2024,Dinesh Rajapakse,Ampara,Uhana,Eastern,6930,889,7819,277200,35560,312760
6/1/2024,Dinesh Rajapakse,Ampara,Uhana,Eastern,4936,2017,6953,197440,80680,278120
6/2/2024,Dinesh Rajapakse,Ampara,Uhana,Eastern,1275,1810,3085,51000,72400,123400
6/3/2024,Dinesh Rajapakse,Ampara,Uhana,Eastern,9807,3512,13319,392280,140480,532760
6/4/2024,Dinesh Rajapakse,Ampara,Uhana,Eastern,875,8763,9638,35000,350520,385520
6/5/2024,Dinesh Rajapakse,Ampara,Uhana,Eastern,6650,4950,11600,266000,198000,464000
6/6/2024,Dinesh Rajapakse,Ampara,Uhana,Eastern,6861,5266,12127,274440,210640,485080
6/7/2024,Dinesh Rajapakse,Ampara,Uhana,Eastern,3807,1767,5574,152280,70680,222960
6/8/2024,Dinesh Rajapakse,Ampara,Uhana,Eastern,2860,3705,6565,114400,148200,262600
6/9/2024,Dinesh Rajapakse,Ampara,Uhana,Eastern,4917,9541,14458,196680,381640,578320
6/10/2024,Dinesh Rajapakse,Ampara,Uhana,Eastern,5736,6162,11898,229440,246480,475920
6/11/2024,Dinesh Rajapakse,Ampara,Uhana,Eastern,4161,4944,9105,166440,197760,364200
6/12/2024,Dinesh Rajapakse,Ampara,Uhana,Eastern,3619,1115,4734,144760,44600,189360
6/13/2024,Dinesh Rajapakse,Ampara,Uhana,Eastern,6558,5835,12393,262320,233400,495720
6/14/2024,Dinesh Rajapakse,Ampara,Uhana,Eastern,9146,5194,14340,365840,207760,573600
6/15/2024,Dinesh Rajapakse,Ampara,Uhana,Eastern,1971,4767,6738,78840,190680,269520
6/16/2024,Dinesh Rajapakse,Ampara,Uhana,Eastern,1364,4740,6104,54560,189600,244160
6/17/2024,Dinesh Rajapakse,Ampara,Uhana,Eastern,414,6412,6826,16560,256480,273040
6/18/2024,Dinesh Rajapakse,Ampara,Uhana,Eastern,6637,5601,12238,265480,224040,489520
6/19/2024,Dinesh Rajapakse,Ampara,Uhana,Eastern,1580,92,1672,63200,3680,66880
6/20/2024,Dinesh Rajapakse,Ampara,Uhana,Eastern,2538,7704,10242,101520,308160,409680
6/21/2024,Dinesh Rajapakse,Ampara,Uhana,Eastern,3904,4833,8737,156160,193320,349480
6/22/2024,Dinesh Rajapakse,Ampara,Uhana,Eastern,6745,6045,12790,269800,241800,511600
6/23/2024,Dinesh Rajapakse,Ampara,Uhana,Eastern,9270,1100,10370,370800,44000,414800
6/24/2024,Dinesh Rajapakse,Ampara,Uhana,Eastern,7103,6464,13567,284120,258560,542680
6/25/2024,Dinesh Rajapakse,Ampara,Uhana,Eastern,750,7701,8451,30000,308040,338040
6/26/2024,Dinesh Rajapakse,Ampara,Uhana,Eastern,8356,211,8567,334240,8440,342680
6/27/2024,Dinesh Rajapakse,Ampara,Uhana,Eastern,4815,1171,5986,192600,46840,239440
6/28/2024,Dinesh Rajapakse,Ampara,Uhana,Eastern,3036,7294,10330,121440,291760,413200
6/29/2024,Dinesh Rajapakse,Ampara,Uhana,Eastern,5401,9016,14417,216040,360640,576680
6/30/2024,Dinesh Rajapakse,Ampara,Uhana,Eastern,5252,4357,9609,210080,174280,384360
7/1/2024,Dinesh Rajapakse,Ampara,Uhana,Eastern,150,414,564,6000,16560,22560
7/2/2024,Dinesh Rajapakse,Ampara,Uhana,Eastern,2750,763,3513,110000,30520,140520
7/3/2024,Dinesh Rajapakse,Ampara,Uhana,Eastern,2763,9633,12396,110520,385320,495840
7/4/2024,Dinesh Rajapakse,Ampara,Uhana,Eastern,1356,552,1908,54240,22080,76320
7/5/2024,Dinesh Rajapakse,Ampara,Uhana,Eastern,3591,8164,11755,143640,326560,470200
7/6/2024,Dinesh Rajapakse,Ampara,Uhana,Eastern,1134,6215,7349,45360,248600,293960
7/7/2024,Dinesh Rajapakse,Ampara,Uhana,Eastern,3235,1004,4239,129400,40160,169560
7/8/2024,Dinesh Rajapakse,Ampara,Uhana,Eastern,6786,4431,11217,271440,177240,448680
7/9/2024,Dinesh Rajapakse,Ampara,Uhana,Eastern,8991,46,9037,359640,1840,361480
7/10/2024,Dinesh Rajapakse,Ampara,Uhana,Eastern,8081,536,8617,323240,21440,344680
7/11/2024,Dinesh Rajapakse,Ampara,Uhana,Eastern,1185,4923,6108,47400,196920,244320
7/12/2024,Dinesh Rajapakse,Ampara,Uhana,Eastern,4635,9619,14254,185400,384760,570160
7/13/2024,Dinesh Rajapakse,Ampara,Uhana,Eastern,3972,5736,9708,158880,229440,388320
7/14/2024,Dinesh Rajapakse,Ampara,Uhana,Eastern,4500,4026,8526,180000,161040,341040
7/15/2024,Dinesh Rajapakse,Ampara,Uhana,Eastern,5802,8438,14240,232080,337520,569600
7/16/2024,Dinesh Rajapakse,Ampara,Uhana,Eastern,3523,5370,8893,140920,214800,355720
7/17/2024,Dinesh Rajapakse,Ampara,Uhana,Eastern,7751,5997,13748,310040,239880,549920
7/18/2024,Dinesh Rajapakse,Ampara,Uhana,Eastern,2810,4983,7793,112400,199320,311720
7/19/2024,Dinesh Rajapakse,Ampara,Uhana,Eastern,4425,1183,5608,177000,47320,224320
7/20/2024,Dinesh Rajapakse,Ampara,Uhana,Eastern,2361,4374,6735,94440,174960,269400
7/21/2024,Dinesh Rajapakse,Ampara,Uhana,Eastern,7803,9957,17760,312120,398280,710400
7/22/2024,Dinesh Rajapakse,Ampara,Uhana,Eastern,2057,7839,9896,82280,313560,395840
7/23/2024,Dinesh Rajapakse,Ampara,Uhana,Eastern,5968,5380,11348,238720,215200,453920
7/24/2024,Dinesh Rajapakse,Ampara,Uhana,Eastern,1243,780,2023,49720,31200,80920
7/25/2024,Dinesh Rajapakse,Ampara,Uhana,Eastern,8503,2699,11202,340120,107960,448080
7/26/2024,Dinesh Rajapakse,Ampara,Uhana,Eastern,8296,2406,10702,331840,96240,428080
7/27/2024,Dinesh Rajapakse,Ampara,Uhana,Eastern,3324,1654,4978,132960,66160,199120
7/28/2024,Dinesh Rajapakse,Ampara,Uhana,Eastern,5437,5987,11424,217480,239480,456960
7/29/2024,Dinesh Rajapakse,Ampara,Uhana,Eastern,3252,3706,6958,130080,148240,278320
7/30/2024,Dinesh Rajapakse,Ampara,Uhana,Eastern,6703,1460,8163,268120,58400,326520
7/31/2024,Dinesh Rajapakse,Ampara,Uhana,Eastern,3508,1970,5478,140320,78800,219120
8/1/2024,Dinesh Rajapakse,Ampara,Uhana,Eastern,603,8925,9528,24120,357000,381120
8/2/2024,Dinesh Rajapakse,Ampara,Uhana,Eastern,4944,4303,9247,197760,172120,369880
8/3/2024,Dinesh Rajapakse,Ampara,Uhana,Eastern,4825,8827,13652,193000,353080,546080
8/4/2024,Dinesh Rajapakse,Ampara,Uhana,Eastern,8626,9131,17757,345040,365240,710280
8/5/2024,Dinesh Rajapakse,Ampara,Uhana,Eastern,2328,3697,6025,93120,147880,241000
8/6/2024,Dinesh Rajapakse,Ampara,Uhana,Eastern,7924,4143,12067,316960,165720,482680
8/7/2024,Dinesh Rajapakse,Ampara,Uhana,Eastern,953,6955,7908,38120,278200,316320
8/8/2024,Dinesh Rajapakse,Ampara,Uhana,Eastern,436,9591,10027,17440,383640,401080
8/9/2024,Dinesh Rajapakse,Ampara,Uhana,Eastern,6987,5402,12389,279480,216080,495560
8/10/2024,Dinesh Rajapakse,Ampara,Uhana,Eastern,961,8147,9108,38440,325880,364320
8/11/2024,Dinesh Rajapakse,Ampara,Uhana,Eastern,7350,943,8293,294000,37720,331720
8/12/2024,Dinesh Rajapakse,Ampara,Uhana,Eastern,231,6550,6781,9240,262000,271240
8/13/2024,Dinesh Rajapakse,Ampara,Uhana,Eastern,9635,2411,12046,385400,96440,481840
8/14/2024,Dinesh Rajapakse,Ampara,Uhana,Eastern,3704,7395,11099,148160,295800,443960
8/15/2024,Dinesh Rajapakse,Ampara,Uhana,Eastern,4081,9141,13222,163240,365640,528880
8/16/2024,Dinesh Rajapakse,Ampara,Uhana,Eastern,8855,507,9362,354200,20280,374480
8/17/2024,Dinesh Rajapakse,Ampara,Uhana,Eastern,337,9612,9949,13480,384480,397960
8/18/2024,Dinesh Rajapakse,Ampara,Uhana,Eastern,4064,843,4907,162560,33720,196280
8/19/2024,Dinesh Rajapakse,Ampara,Uhana,Eastern,6783,3631,10414,271320,145240,416560
8/20/2024,Dinesh Rajapakse,Ampara,Uhana,Eastern,9069,2277,11346,362760,91080,453840
8/21/2024,Dinesh Rajapakse,Ampara,Uhana,Eastern,3102,1986,5088,124080,79440,203520
8/22/2024,Dinesh Rajapakse,Ampara,Uhana,Eastern,3476,6562,10038,139040,262480,401520
8/23/2024,Dinesh Rajapakse,Ampara,Uhana,Eastern,7480,4548,12028,299200,181920,481120
8/24/2024,Dinesh Rajapakse,Ampara,Uhana,Eastern,3992,6728,10720,159680,269120,428800
8/25/2024,Dinesh Rajapakse,Ampara,Uhana,Eastern,8817,5273,14090,352680,210920,563600
8/26/2024,Dinesh Rajapakse,Ampara,Uhana,Eastern,999,3562,4561,39960,142480,182440
8/27/2024,Dinesh Rajapakse,Ampara,Uhana,Eastern,9114,3250,12364,364560,130000,494560
8/28/2024,Dinesh Rajapakse,Ampara,Uhana,Eastern,3882,2092,5974,155280,83680,238960
8/29/2024,Dinesh Rajapakse,Ampara,Uhana,Eastern,730,9390,10120,29200,375600,404800
8/30/2024,Dinesh Rajapakse,Ampara,Uhana,Eastern,3192,9714,12906,127680,388560,516240
8/31/2024,Dinesh Rajapakse,Ampara,Uhana,Eastern,3668,6520,10188,146720,260800,407520
9/1/2024,Dinesh Rajapakse,Ampara,Uhana,Eastern,5876,7880,13756,235040,315200,550240
9/2/2024,Dinesh Rajapakse,Ampara,Uhana,Eastern,413,5897,6310,16520,235880,252400
9/3/2024,Dinesh Rajapakse,Ampara,Uhana,Eastern,8211,9495,17706,328440,379800,708240
9/4/2024,Dinesh Rajapakse,Ampara,Uhana,Eastern,6117,3477,9594,244680,139080,383760
9/5/2024,Dinesh Rajapakse,Ampara,Uhana,Eastern,9511,7616,17127,380440,304640,685080
9/6/2024,Dinesh Rajapakse,Ampara,Uhana,Eastern,1028,5864,6892,41120,234560,275680
9/7/2024,Dinesh Rajapakse,Ampara,Uhana,Eastern,3630,9233,12863,145200,369320,514520
9/8/2024,Dinesh Rajapakse,Ampara,Uhana,Eastern,1205,7853,9058,48200,314120,362320
9/9/2024,Dinesh Rajapakse,Ampara,Uhana,Eastern,9176,1379,10555,367040,55160,422200
9/10/2024,Dinesh Rajapakse,Ampara,Uhana,Eastern,6365,1932,8297,254600,77280,331880
9/11/2024,Dinesh Rajapakse,Ampara,Uhana,Eastern,1500,415,1915,60000,16600,76600
9/12/2024,Dinesh Rajapakse,Ampara,Uhana,Eastern,7909,8982,16891,316360,359280,675640
9/13/2024,Dinesh Rajapakse,Ampara,Uhana,Eastern,8317,4682,12999,332680,187280,519960
9/14/2024,Dinesh Rajapakse,Ampara,Uhana,Eastern,2892,4343,7235,115680,173720,289400
9/15/2024,Dinesh Rajapakse,Ampara,Uhana,Eastern,3818,525,4343,152720,21000,173720
9/16/2024,Dinesh Rajapakse,Ampara,Uhana,Eastern,2481,6625,9106,99240,265000,364240
9/17/2024,Dinesh Rajapakse,Ampara,Uhana,Eastern,2664,1007,3671,106560,40280,146840
9/18/2024,Dinesh Rajapakse,Ampara,Uhana,Eastern,2712,776,3488,108480,31040,139520
9/19/2024,Dinesh Rajapakse,Ampara,Uhana,Eastern,242,6690,6932,9680,267600,277280
9/20/2024,Dinesh Rajapakse,Ampara,Uhana,Eastern,2737,1432,4169,109480,57280,166760
9/21/2024,Dinesh Rajapakse,Ampara,Uhana,Eastern,4814,7289,12103,192560,291560,484120
9/22/2024,Dinesh Rajapakse,Ampara,Uhana,Eastern,1383,9042,10425,55320,361680,417000
9/23/2024,Dinesh Rajapakse,Ampara,Uhana,Eastern,7372,5178,12550,294880,207120,502000
9/24/2024,Dinesh Rajapakse,Ampara,Uhana,Eastern,5551,7032,12583,222040,281280,503320
9/25/2024,Dinesh Rajapakse,Ampara,Uhana,Eastern,8889,7198,16087,355560,287920,643480
9/26/2024,Dinesh Rajapakse,Ampara,Uhana,Eastern,9361,4012,13373,374440,160480,534920
9/27/2024,Dinesh Rajapakse,Ampara,Uhana,Eastern,8197,9665,17862,327880,386600,714480
9/28/2024,Dinesh Rajapakse,Ampara,Uhana,Eastern,2136,9509,11645,85440,380360,465800
9/29/2024,Dinesh Rajapakse,Ampara,Uhana,Eastern,8862,8927,17789,354480,357080,711560
9/30/2024,Dinesh Rajapakse,Ampara,Uhana,Eastern,5388,3166,8554,215520,126640,342160
10/1/2024,Dinesh Rajapakse,Ampara,Uhana,Eastern,1958,4782,6740,78320,191280,269600
10/2/2024,Dinesh Rajapakse,Ampara,Uhana,Eastern,4375,4662,9037,175000,186480,361480
10/3/2024,Dinesh Rajapakse,Ampara,Uhana,Eastern,4866,8356,13222,194640,334240,528880
10/4/2024,Dinesh Rajapakse,Ampara,Uhana,Eastern,5862,7794,13656,234480,311760,546240
10/5/2024,Dinesh Rajapakse,Ampara,Uhana,Eastern,7659,8762,16421,306360,350480,656840
10/6/2024,Dinesh Rajapakse,Ampara,Uhana,Eastern,3703,7850,11553,148120,314000,462120
10/7/2024,Dinesh Rajapakse,Ampara,Uhana,Eastern,8548,3359,11907,341920,134360,476280
10/8/2024,Dinesh Rajapakse,Ampara,Uhana,Eastern,166,821,987,6640,32840,39480
10/9/2024,Dinesh Rajapakse,Ampara,Uhana,Eastern,614,8899,9513,24560,355960,380520
10/10/2024,Dinesh Rajapakse,Ampara,Uhana,Eastern,936,9546,10482,37440,381840,419280
10/11/2024,Dinesh Rajapakse,Ampara,Uhana,Eastern,2171,7713,9884,86840,308520,395360
10/12/2024,Dinesh Rajapakse,Ampara,Uhana,Eastern,6867,1245,8112,274680,49800,324480
10/13/2024,Dinesh Rajapakse,Ampara,Uhana,Eastern,6983,7568,14551,279320,302720,582040
10/14/2024,Dinesh Rajapakse,Ampara,Uhana,Eastern,1667,4816,6483,66680,192640,259320
10/15/2024,Dinesh Rajapakse,Ampara,Uhana,Eastern,9488,373,9861,379520,14920,394440
10/16/2024,Dinesh Rajapakse,Ampara,Uhana,Eastern,211,9055,9266,8440,362200,370640
10/17/2024,Dinesh Rajapakse,Ampara,Uhana,Eastern,5337,5401,10738,213480,216040,429520
10/18/2024,Dinesh Rajapakse,Ampara,Uhana,Eastern,7912,2490,10402,316480,99600,416080
10/19/2024,Dinesh Rajapakse,Ampara,Uhana,Eastern,340,9402,9742,13600,376080,389680
10/20/2024,Dinesh Rajapakse,Ampara,Uhana,Eastern,8623,2731,11354,344920,109240,454160
10/21/2024,Dinesh Rajapakse,Ampara,Uhana,Eastern,6562,7049,13611,262480,281960,544440
10/22/2024,Dinesh Rajapakse,Ampara,Uhana,Eastern,9110,2363,11473,364400,94520,458920
10/23/2024,Dinesh Rajapakse,Ampara,Uhana,Eastern,1896,3844,5740,75840,153760,229600
10/24/2024,Dinesh Rajapakse,Ampara,Uhana,Eastern,7650,6228,13878,306000,249120,555120
10/25/2024,Dinesh Rajapakse,Ampara,Uhana,Eastern,5947,7097,13044,237880,283880,521760
10/26/2024,Dinesh Rajapakse,Ampara,Uhana,Eastern,4199,4039,8238,167960,161560,329520
10/27/2024,Dinesh Rajapakse,Ampara,Uhana,Eastern,7218,4079,11297,288720,163160,451880
10/28/2024,Dinesh Rajapakse,Ampara,Uhana,Eastern,5466,8316,13782,218640,332640,551280
10/29/2024,Dinesh Rajapakse,Ampara,Uhana,Eastern,8946,9291,18237,357840,371640,729480
10/30/2024,Dinesh Rajapakse,Ampara,Uhana,Eastern,9552,7456,17008,382080,298240,680320
10/31/2024,Dinesh Rajapakse,Ampara,Uhana,Eastern,3766,256,4022,150640,10240,160880
11/1/2024,Dinesh Rajapakse,Ampara,Uhana,Eastern,2984,286,3270,119360,11440,130800
11/2/2024,Dinesh Rajapakse,Ampara,Uhana,Eastern,2222,3017,5239,88880,120680,209560
11/3/2024,Dinesh Rajapakse,Ampara,Uhana,Eastern,1684,3817,5501,67360,152680,220040
11/4/2024,Dinesh Rajapakse,Ampara,Uhana,Eastern,316,2785,3101,12640,111400,124040
11/5/2024,Dinesh Rajapakse,Ampara,Uhana,Eastern,5275,4020,9295,211000,160800,371800
11/6/2024,Dinesh Rajapakse,Ampara,Uhana,Eastern,3866,1822,5688,154640,72880,227520
11/7/2024,Dinesh Rajapakse,Ampara,Uhana,Eastern,6225,5586,11811,249000,223440,472440
11/8/2024,Dinesh Rajapakse,Ampara,Uhana,Eastern,4545,3380,7925,181800,135200,317000
11/9/2024,Dinesh Rajapakse,Ampara,Uhana,Eastern,8944,4843,13787,357760,193720,551480
11/10/2024,Dinesh Rajapakse,Ampara,Uhana,Eastern,2673,6322,8995,106920,252880,359800
11/11/2024,Dinesh Rajapakse,Ampara,Uhana,Eastern,4329,8107,12436,173160,324280,497440
11/12/2024,Dinesh Rajapakse,Ampara,Uhana,Eastern,9730,276,10006,389200,11040,400240
11/13/2024,Dinesh Rajapakse,Ampara,Uhana,Eastern,3529,5255,8784,141160,210200,351360
11/14/2024,Dinesh Rajapakse,Ampara,Uhana,Eastern,3164,1847,5011,126560,73880,200440
11/15/2024,Dinesh Rajapakse,Ampara,Uhana,Eastern,7930,540,8470,317200,21600,338800
11/16/2024,Dinesh Rajapakse,Ampara,Uhana,Eastern,9110,7642,16752,364400,305680,670080
11/17/2024,Dinesh Rajapakse,Ampara,Uhana,Eastern,1369,5979,7348,54760,239160,293920
11/18/2024,Dinesh Rajapakse,Ampara,Uhana,Eastern,8379,72,8451,335160,2880,338040
11/19/2024,Dinesh Rajapakse,Ampara,Uhana,Eastern,6704,9540,16244,268160,381600,649760
11/20/2024,Dinesh Rajapakse,Ampara,Uhana,Eastern,288,116,404,11520,4640,16160
11/21/2024,Dinesh Rajapakse,Ampara,Uhana,Eastern,913,8138,9051,36520,325520,362040
11/22/2024,Dinesh Rajapakse,Ampara,Uhana,Eastern,2345,4038,6383,93800,161520,255320
11/23/2024,Dinesh Rajapakse,Ampara,Uhana,Eastern,4881,8840,13721,195240,353600,548840
11/24/2024,Dinesh Rajapakse,Ampara,Uhana,Eastern,3470,229,3699,138800,9160,147960
11/25/2024,Dinesh Rajapakse,Ampara,Uhana,Eastern,3227,3285,6512,129080,131400,260480
11/26/2024,Dinesh Rajapakse,Ampara,Uhana,Eastern,3792,2638,6430,151680,105520,257200
11/27/2024,Dinesh Rajapakse,Ampara,Uhana,Eastern,5796,71,5867,231840,2840,234680
11/28/2024,Dinesh Rajapakse,Ampara,Uhana,Eastern,8786,3598,12384,351440,143920,495360
11/29/2024,Dinesh Rajapakse,Ampara,Uhana,Eastern,9880,200,10080,395200,8000,403200
11/30/2024,Dinesh Rajapakse,Ampara,Uhana,Eastern,3915,5391,9306,156600,215640,372240
12/1/2024,Dinesh Rajapakse,Ampara,Uhana,Eastern,6554,1744,8298,262160,69760,331920
12/2/2024,Dinesh Rajapakse,Ampara,Uhana,Eastern,5658,5256,10914,226320,210240,436560
12/3/2024,Dinesh Rajapakse,Ampara,Uhana,Eastern,122,8183,8305,4880,327320,332200
12/4/2024,Dinesh Rajapakse,Ampara,Uhana,Eastern,5391,4279,9670,215640,171160,386800
12/5/2024,Dinesh Rajapakse,Ampara,Uhana,Eastern,6210,3571,9781,248400,142840,391240
12/6/2024,Dinesh Rajapakse,Ampara,Uhana,Eastern,1400,71,1471,56000,2840,58840
12/7/2024,Dinesh Rajapakse,Ampara,Uhana,Eastern,9823,6636,16459,392920,265440,658360
12/8/2024,Dinesh Rajapakse,Ampara,Uhana,Eastern,4196,2062,6258,167840,82480,250320
12/9/2024,Dinesh Rajapakse,Ampara,Uhana,Eastern,2595,2209,4804,103800,88360,192160
12/10/2024,Dinesh Rajapakse,Ampara,Uhana,Eastern,3833,4225,8058,153320,169000,322320
12/11/2024,Dinesh Rajapakse,Ampara,Uhana,Eastern,8242,4950,13192,329680,198000,527680
12/12/2024,Dinesh Rajapakse,Ampara,Uhana,Eastern,2661,9330,11991,106440,373200,479640
12/13/2024,Dinesh Rajapakse,Ampara,Uhana,Eastern,7361,7260,14621,294440,290400,584840
12/14/2024,Dinesh Rajapakse,Ampara,Uhana,Eastern,7289,1535,8824,291560,61400,352960
12/15/2024,Dinesh Rajapakse,Ampara,Uhana,Eastern,385,9499,9884,15400,379960,395360
12/16/2024,Dinesh Rajapakse,Ampara,Uhana,Eastern,9359,8476,17835,374360,339040,713400
12/17/2024,Dinesh Rajapakse,Ampara,Uhana,Eastern,9695,6509,16204,387800,260360,648160
12/18/2024,Dinesh Rajapakse,Ampara,Uhana,Eastern,399,8527,8926,15960,341080,357040
12/19/2024,Dinesh Rajapakse,Ampara,Uhana,Eastern,1322,5094,6416,52880,203760,256640
12/20/2024,Dinesh Rajapakse,Ampara,Uhana,Eastern,1521,8174,9695,60840,326960,387800
12/21/2024,Dinesh Rajapakse,Ampara,Uhana,Eastern,3601,6799,10400,144040,271960,416000
12/22/2024,Dinesh Rajapakse,Ampara,Uhana,Eastern,6642,7850,14492,265680,314000,579680
12/23/2024,Dinesh Rajapakse,Ampara,Uhana,Eastern,3621,5427,9048,144840,217080,361920
12/24/2024,Dinesh Rajapakse,Ampara,Uhana,Eastern,8633,8667,17300,345320,346680,692000
12/25/2024,Dinesh Rajapakse,Ampara,Uhana,Eastern,8453,6951,15404,338120,278040,616160
12/26/2024,Dinesh Rajapakse,Ampara,Uhana,Eastern,5059,4124,9183,202360,164960,367320
12/27/2024,Dinesh Rajapakse,Ampara,Uhana,Eastern,4531,5350,9881,181240,214000,395240
12/28/2024,Dinesh Rajapakse,Ampara,Uhana,Eastern,8906,5794,14700,356240,231760,588000
12/29/2024,Dinesh Rajapakse,Ampara,Uhana,Eastern,9584,9333,18917,383360,373320,756680
12/30/2024,Dinesh Rajapakse,Ampara,Uhana,Eastern,8880,870,9750,355200,34800,390000
12/31/2024,Dinesh Rajapakse,Ampara,Uhana,Eastern,7219,3096,10315,288760,123840,412600
1/1/2025,Dinesh Rajapakse,Ampara,Uhana,Eastern,6746,3217,9963,269840,128680,398520
1/2/2025,Dinesh Rajapakse,Ampara,Uhana,Eastern,1029,329,1358,41160,13160,54320
1/3/2025,Dinesh Rajapakse,Ampara,Uhana,Eastern,4378,8268,12646,175120,330720,505840
1/4/2025,Dinesh Rajapakse,Ampara,Uhana,Eastern,9874,5335,15209,394960,213400,608360
1/5/2025,Dinesh Rajapakse,Ampara,Uhana,Eastern,4821,9232,14053,192840,369280,562120
1/6/2025,Dinesh Rajapakse,Ampara,Uhana,Eastern,4573,5478,10051,182920,219120,402040
1/7/2025,Dinesh Rajapakse,Ampara,Uhana,Eastern,4690,8937,13627,187600,357480,545080
1/8/2025,Dinesh Rajapakse,Ampara,Uhana,Eastern,7723,9223,16946,308920,368920,677840
1/9/2025,Dinesh Rajapakse,Ampara,Uhana,Eastern,928,7436,8364,37120,297440,334560
1/10/2025,Dinesh Rajapakse,Ampara,Uhana,Eastern,8472,906,9378,338880,36240,375120
1/11/2025,Dinesh Rajapakse,Ampara,Uhana,Eastern,2545,5216,7761,101800,208640,310440
1/12/2025,Dinesh Rajapakse,Ampara,Uhana,Eastern,6703,1068,7771,268120,42720,310840
1/13/2025,Dinesh Rajapakse,Ampara,Uhana,Eastern,2224,3874,6098,88960,154960,243920
1/14/2025,Dinesh Rajapakse,Ampara,Uhana,Eastern,2922,7822,10744,116880,312880,429760
1/15/2025,Dinesh Rajapakse,Ampara,Uhana,Eastern,5374,2291,7665,214960,91640,306600
1/16/2025,Dinesh Rajapakse,Ampara,Uhana,Eastern,8009,9566,17575,320360,382640,703000
1/17/2025,Dinesh Rajapakse,Ampara,Uhana,Eastern,8687,8631,17318,347480,345240,692720
1/18/2025,Dinesh Rajapakse,Ampara,Uhana,Eastern,4812,5956,10768,192480,238240,430720
1/19/2025,Dinesh Rajapakse,Ampara,Uhana,Eastern,6885,8888,15773,275400,355520,630920
1/20/2025,Dinesh Rajapakse,Ampara,Uhana,Eastern,7431,4424,11855,297240,176960,474200
1/21/2025,Dinesh Rajapakse,Ampara,Uhana,Eastern,8803,7806,16609,352120,312240,664360
1/22/2025,Dinesh Rajapakse,Ampara,Uhana,Eastern,4023,623,4646,160920,24920,185840
1/23/2025,Dinesh Rajapakse,Ampara,Uhana,Eastern,7019,5609,12628,280760,224360,505120
1/24/2025,Dinesh Rajapakse,Ampara,Uhana,Eastern,3204,8072,11276,128160,322880,451040
1/25/2025,Dinesh Rajapakse,Ampara,Uhana,Eastern,2697,1954,4651,107880,78160,186040
1/26/2025,Dinesh Rajapakse,Ampara,Uhana,Eastern,7542,3308,10850,301680,132320,434000
1/27/2025,Dinesh Rajapakse,Ampara,Uhana,Eastern,8158,8657,16815,326320,346280,672600
1/28/2025,Dinesh Rajapakse,Ampara,Uhana,Eastern,5428,7020,12448,217120,280800,497920
1/29/2025,Dinesh Rajapakse,Ampara,Uhana,Eastern,7410,4083,11493,296400,163320,459720
1/30/2025,Dinesh Rajapakse,Ampara,Uhana,Eastern,3240,6299,9539,129600,251960,381560
1/31/2025,Dinesh Rajapakse,Ampara,Uhana,Eastern,6126,279,6405,245040,11160,256200
2/1/2025,Dinesh Rajapakse,Ampara,Uhana,Eastern,1631,1456,3087,65240,58240,123480
2/2/2025,Dinesh Rajapakse,Ampara,Uhana,Eastern,5937,8110,14047,237480,324400,561880
2/3/2025,Dinesh Rajapakse,Ampara,Uhana,Eastern,2465,398,2863,98600,15920,114520
2/4/2025,Dinesh Rajapakse,Ampara,Uhana,Eastern,5980,2934,8914,239200,117360,356560
2/5/2025,Dinesh Rajapakse,Ampara,Uhana,Eastern,9438,7473,16911,377520,298920,676440
2/6/2025,Dinesh Rajapakse,Ampara,Uhana,Eastern,2904,3858,6762,116160,154320,270480
2/7/2025,Dinesh Rajapakse,Ampara,Uhana,Eastern,4778,7071,11849,191120,282840,473960
2/8/2025,Dinesh Rajapakse,Ampara,Uhana,Eastern,2664,5692,8356,106560,227680,334240
2/9/2025,Dinesh Rajapakse,Ampara,Uhana,Eastern,1186,3271,4457,47440,130840,178280
2/10/2025,Dinesh Rajapakse,Ampara,Uhana,Eastern,5134,4243,9377,205360,169720,375080
2/11/2025,Dinesh Rajapakse,Ampara,Uhana,Eastern,1528,1213,2741,61120,48520,109640
2/12/2025,Dinesh Rajapakse,Ampara,Uhana,Eastern,6689,6786,13475,267560,271440,539000
2/13/2025,Dinesh Rajapakse,Ampara,Uhana,Eastern,9920,5047,14967,396800,201880,598680
2/14/2025,Dinesh Rajapakse,Ampara,Uhana,Eastern,2876,6303,9179,115040,252120,367160
2/15/2025,Dinesh Rajapakse,Ampara,Uhana,Eastern,6915,568,7483,276600,22720,299320
2/16/2025,Dinesh Rajapakse,Ampara,Uhana,Eastern,5252,461,5713,210080,18440,228520
2/17/2025,Dinesh Rajapakse,Ampara,Uhana,Eastern,8323,2783,11106,332920,111320,444240
2/18/2025,Dinesh Rajapakse,Ampara,Uhana,Eastern,2621,9575,12196,104840,383000,487840
2/19/2025,Dinesh Rajapakse,Ampara,Uhana,Eastern,2840,3388,6228,113600,135520,249120
2/20/2025,Dinesh Rajapakse,Ampara,Uhana,Eastern,5434,6972,12406,217360,278880,496240
2/21/2025,Dinesh Rajapakse,Ampara,Uhana,Eastern,181,972,1153,7240,38880,46120
2/22/2025,Dinesh Rajapakse,Ampara,Uhana,Eastern,4599,4270,8869,183960,170800,354760
2/23/2025,Dinesh Rajapakse,Ampara,Uhana,Eastern,3975,5984,9959,159000,239360,398360
2/24/2025,Dinesh Rajapakse,Ampara,Uhana,Eastern,9759,9398,19157,390360,375920,766280
2/25/2025,Dinesh Rajapakse,Ampara,Uhana,Eastern,8531,7498,16029,341240,299920,641160
2/26/2025,Dinesh Rajapakse,Ampara,Uhana,Eastern,7690,6246,13936,307600,249840,557440
2/27/2025,Dinesh Rajapakse,Ampara,Uhana,Eastern,2071,5445,7516,82840,217800,300640
2/28/2025,Dinesh Rajapakse,Ampara,Uhana,Eastern,1929,1614,3543,77160,64560,141720
3/1/2025,Dinesh Rajapakse,Ampara,Uhana,Eastern,8292,5055,13347,331680,202200,533880
3/2/2025,Dinesh Rajapakse,Ampara,Uhana,Eastern,5413,469,5882,216520,18760,235280
3/3/2025,Dinesh Rajapakse,Ampara,Uhana,Eastern,5784,9104,14888,231360,364160,595520
3/4/2025,Dinesh Rajapakse,Ampara,Uhana,Eastern,4215,7260,11475,168600,290400,459000
3/5/2025,Dinesh Rajapakse,Ampara,Uhana,Eastern,7657,2690,10347,306280,107600,413880
3/6/2025,Dinesh Rajapakse,Ampara,Uhana,Eastern,5710,9213,14923,228400,368520,596920
3/7/2025,Dinesh Rajapakse,Ampara,Uhana,Eastern,1011,2515,3526,40440,100600,141040
3/8/2025,Dinesh Rajapakse,Ampara,Uhana,Eastern,9493,310,9803,379720,12400,392120
3/9/2025,Dinesh Rajapakse,Ampara,Uhana,Eastern,4072,9047,13119,162880,361880,524760
3/10/2025,Dinesh Rajapakse,Ampara,Uhana,Eastern,1434,2904,4338,57360,116160,173520
3/11/2025,Dinesh Rajapakse,Ampara,Uhana,Eastern,2855,2563,5418,114200,102520,216720
3/12/2025,Dinesh Rajapakse,Ampara,Uhana,Eastern,4787,4265,9052,191480,170600,362080
3/13/2025,Dinesh Rajapakse,Ampara,Uhana,Eastern,3300,1681,4981,132000,67240,199240
3/14/2025,Dinesh Rajapakse,Ampara,Uhana,Eastern,5757,9195,14952,230280,367800,598080
3/15/2025,Dinesh Rajapakse,Ampara,Uhana,Eastern,4169,6480,10649,166760,259200,425960
3/16/2025,Dinesh Rajapakse,Ampara,Uhana,Eastern,6932,2662,9594,277280,106480,383760
3/17/2025,Dinesh Rajapakse,Ampara,Uhana,Eastern,676,2898,3574,27040,115920,142960
3/18/2025,Dinesh Rajapakse,Ampara,Uhana,Eastern,6233,7280,13513,249320,291200,540520
3/19/2025,Dinesh Rajapakse,Ampara,Uhana,Eastern,5375,1963,7338,215000,78520,293520
3/20/2025,Dinesh Rajapakse,Ampara,Uhana,Eastern,4590,9717,14307,183600,388680,572280
3/21/2025,Dinesh Rajapakse,Ampara,Uhana,Eastern,6343,7466,13809,253720,298640,552360
3/22/2025,Dinesh Rajapakse,Ampara,Uhana,Eastern,9377,5952,15329,375080,238080,613160
3/23/2025,Dinesh Rajapakse,Ampara,Uhana,Eastern,4502,7687,12189,180080,307480,487560
3/25/2024,Muthumani Rajapaksha,Kurunegala,Ibbagamuwa,North Western,4371,8588,12959,174840,343520,518360
3/26/2024,Muthumani Rajapaksha,Kurunegala,Ibbagamuwa,North Western,5135,6922,12057,205400,276880,482280
3/27/2024,Muthumani Rajapaksha,Kurunegala,Ibbagamuwa,North Western,2843,6533,9376,113720,261320,375040
3/28/2024,Muthumani Rajapaksha,Kurunegala,Ibbagamuwa,North Western,8474,2586,11060,338960,103440,442400
3/29/2024,Muthumani Rajapaksha,Kurunegala,Ibbagamuwa,North Western,7971,6745,14716,318840,269800,588640
3/30/2024,Muthumani Rajapaksha,Kurunegala,Ibbagamuwa,North Western,1783,5888,7671,71320,235520,306840
3/31/2024,Muthumani Rajapaksha,Kurunegala,Ibbagamuwa,North Western,5562,3146,8708,222480,125840,348320
4/1/2024,Muthumani Rajapaksha,Kurunegala,Ibbagamuwa,North Western,9978,7009,16987,399120,280360,679480
4/2/2024,Muthumani Rajapaksha,Kurunegala,Ibbagamuwa,North Western,1379,5902,7281,55160,236080,291240
4/3/2024,Muthumani Rajapaksha,Kurunegala,Ibbagamuwa,North Western,2401,5740,8141,96040,229600,325640
4/4/2024,Muthumani Rajapaksha,Kurunegala,Ibbagamuwa,North Western,877,8956,9833,35080,358240,393320
4/5/2024,Muthumani Rajapaksha,Kurunegala,Ibbagamuwa,North Western,6977,24,7001,279080,960,280040
4/6/2024,Muthumani Rajapaksha,Kurunegala,Ibbagamuwa,North Western,5386,4777,10163,215440,191080,406520
4/7/2024,Muthumani Rajapaksha,Kurunegala,Ibbagamuwa,North Western,436,9403,9839,17440,376120,393560
4/8/2024,Muthumani Rajapaksha,Kurunegala,Ibbagamuwa,North Western,5372,7375,12747,214880,295000,509880
4/9/2024,Muthumani Rajapaksha,Kurunegala,Ibbagamuwa,North Western,9612,9291,18903,384480,371640,756120
4/10/2024,Muthumani Rajapaksha,Kurunegala,Ibbagamuwa,North Western,4654,1332,5986,186160,53280,239440
4/11/2024,Muthumani Rajapaksha,Kurunegala,Ibbagamuwa,North Western,2321,5226,7547,92840,209040,301880
4/19/2024,Muthumani Rajapaksha,Kurunegala,Ibbagamuwa,North Western,4177,7743,11920,167080,309720,476800
4/20/2024,Muthumani Rajapaksha,Kurunegala,Ibbagamuwa,North Western,9704,2568,12272,388160,102720,490880
4/21/2024,Muthumani Rajapaksha,Kurunegala,Ibbagamuwa,North Western,9001,3228,12229,360040,129120,489160
4/22/2024,Muthumani Rajapaksha,Kurunegala,Ibbagamuwa,North Western,5886,5255,11141,235440,210200,445640
4/23/2024,Muthumani Rajapaksha,Kurunegala,Ibbagamuwa,North Western,5104,1294,6398,204160,51760,255920
4/24/2024,Muthumani Rajapaksha,Kurunegala,Ibbagamuwa,North Western,3002,4570,7572,120080,182800,302880
4/25/2024,Muthumani Rajapaksha,Kurunegala,Ibbagamuwa,North Western,392,8893,9285,15680,355720,371400
4/26/2024,Muthumani Rajapaksha,Kurunegala,Ibbagamuwa,North Western,3456,1506,4962,138240,60240,198480
4/27/2024,Muthumani Rajapaksha,Kurunegala,Ibbagamuwa,North Western,5586,3618,9204,223440,144720,368160
4/28/2024,Muthumani Rajapaksha,Kurunegala,Ibbagamuwa,North Western,1441,285,1726,57640,11400,69040
4/29/2024,Muthumani Rajapaksha,Kurunegala,Ibbagamuwa,North Western,6142,4308,10450,245680,172320,418000
4/30/2024,Muthumani Rajapaksha,Kurunegala,Ibbagamuwa,North Western,7813,4705,12518,312520,188200,500720
5/1/2024,Muthumani Rajapaksha,Kurunegala,Ibbagamuwa,North Western,3992,733,4725,159680,29320,189000
5/2/2024,Muthumani Rajapaksha,Kurunegala,Ibbagamuwa,North Western,5283,4197,9480,211320,167880,379200
5/3/2024,Muthumani Rajapaksha,Kurunegala,Ibbagamuwa,North Western,427,8213,8640,17080,328520,345600
5/4/2024,Muthumani Rajapaksha,Kurunegala,Ibbagamuwa,North Western,4202,895,5097,168080,35800,203880
5/5/2024,Muthumani Rajapaksha,Kurunegala,Ibbagamuwa,North Western,9018,7925,16943,360720,317000,677720
5/6/2024,Muthumani Rajapaksha,Kurunegala,Ibbagamuwa,North Western,4675,3613,8288,187000,144520,331520
5/7/2024,Muthumani Rajapaksha,Kurunegala,Ibbagamuwa,North Western,4380,9637,14017,175200,385480,560680
5/8/2024,Muthumani Rajapaksha,Kurunegala,Ibbagamuwa,North Western,2118,6725,8843,84720,269000,353720
5/9/2024,Muthumani Rajapaksha,Kurunegala,Ibbagamuwa,North Western,1022,8302,9324,40880,332080,372960
5/10/2024,Muthumani Rajapaksha,Kurunegala,Ibbagamuwa,North Western,3495,8784,12279,139800,351360,491160
5/11/2024,Muthumani Rajapaksha,Kurunegala,Ibbagamuwa,North Western,7349,7487,14836,293960,299480,593440
5/12/2024,Muthumani Rajapaksha,Kurunegala,Ibbagamuwa,North Western,4696,4532,9228,187840,181280,369120
5/13/2024,Muthumani Rajapaksha,Kurunegala,Ibbagamuwa,North Western,6801,7878,14679,272040,315120,587160
5/14/2024,Muthumani Rajapaksha,Kurunegala,Ibbagamuwa,North Western,1110,1019,2129,44400,40760,85160
5/15/2024,Muthumani Rajapaksha,Kurunegala,Ibbagamuwa,North Western,8539,8860,17399,341560,354400,695960
5/16/2024,Muthumani Rajapaksha,Kurunegala,Ibbagamuwa,North Western,9196,5352,14548,367840,214080,581920
5/17/2024,Muthumani Rajapaksha,Kurunegala,Ibbagamuwa,North Western,4048,4305,8353,161920,172200,334120
5/18/2024,Muthumani Rajapaksha,Kurunegala,Ibbagamuwa,North Western,4158,8339,12497,166320,333560,499880
5/19/2024,Muthumani Rajapaksha,Kurunegala,Ibbagamuwa,North Western,5160,4882,10042,206400,195280,401680
5/20/2024,Muthumani Rajapaksha,Kurunegala,Ibbagamuwa,North Western,6446,4182,10628,257840,167280,425120
5/21/2024,Muthumani Rajapaksha,Kurunegala,Ibbagamuwa,North Western,1255,5610,6865,50200,224400,274600
5/22/2024,Muthumani Rajapaksha,Kurunegala,Ibbagamuwa,North Western,512,4938,5450,20480,197520,218000
5/24/2024,Muthumani Rajapaksha,Kurunegala,Ibbagamuwa,North Western,6495,6979,13474,259800,279160,538960
5/25/2024,Muthumani Rajapaksha,Kurunegala,Ibbagamuwa,North Western,1036,1736,2772,41440,69440,110880
5/26/2024,Muthumani Rajapaksha,Kurunegala,Ibbagamuwa,North Western,8242,8372,16614,329680,334880,664560
5/27/2024,Muthumani Rajapaksha,Kurunegala,Ibbagamuwa,North Western,7298,7843,15141,291920,313720,605640
5/28/2024,Muthumani Rajapaksha,Kurunegala,Ibbagamuwa,North Western,8949,6108,15057,357960,244320,602280
5/29/2024,Muthumani Rajapaksha,Kurunegala,Ibbagamuwa,North Western,4223,3267,7490,168920,130680,299600
5/30/2024,Muthumani Rajapaksha,Kurunegala,Ibbagamuwa,North Western,4510,6941,11451,180400,277640,458040
5/31/2024,Muthumani Rajapaksha,Kurunegala,Ibbagamuwa,North Western,428,8564,8992,17120,342560,359680
6/1/2024,Muthumani Rajapaksha,Kurunegala,Ibbagamuwa,North Western,6023,1144,7167,240920,45760,286680
6/2/2024,Muthumani Rajapaksha,Kurunegala,Ibbagamuwa,North Western,5991,8849,14840,239640,353960,593600
6/3/2024,Muthumani Rajapaksha,Kurunegala,Ibbagamuwa,North Western,6119,5260,11379,244760,210400,455160
6/4/2024,Muthumani Rajapaksha,Kurunegala,Ibbagamuwa,North Western,1426,6149,7575,57040,245960,303000
6/5/2024,Muthumani Rajapaksha,Kurunegala,Ibbagamuwa,North Western,5521,8404,13925,220840,336160,557000
6/6/2024,Muthumani Rajapaksha,Kurunegala,Ibbagamuwa,North Western,1950,8964,10914,78000,358560,436560
6/7/2024,Muthumani Rajapaksha,Kurunegala,Ibbagamuwa,North Western,519,6606,7125,20760,264240,285000
6/8/2024,Muthumani Rajapaksha,Kurunegala,Ibbagamuwa,North Western,3315,8718,12033,132600,348720,481320
6/9/2024,Muthumani Rajapaksha,Kurunegala,Ibbagamuwa,North Western,8490,33,8523,339600,1320,340920
6/10/2024,Muthumani Rajapaksha,Kurunegala,Ibbagamuwa,North Western,805,8867,9672,32200,354680,386880
6/11/2024,Muthumani Rajapaksha,Kurunegala,Ibbagamuwa,North Western,9392,7352,16744,375680,294080,669760
6/12/2024,Muthumani Rajapaksha,Kurunegala,Ibbagamuwa,North Western,2136,2752,4888,85440,110080,195520
6/13/2024,Muthumani Rajapaksha,Kurunegala,Ibbagamuwa,North Western,6534,5480,12014,261360,219200,480560
6/14/2024,Muthumani Rajapaksha,Kurunegala,Ibbagamuwa,North Western,6874,4537,11411,274960,181480,456440
6/15/2024,Muthumani Rajapaksha,Kurunegala,Ibbagamuwa,North Western,960,2813,3773,38400,112520,150920
6/16/2024,Muthumani Rajapaksha,Kurunegala,Ibbagamuwa,North Western,8149,9926,18075,325960,397040,723000
6/17/2024,Muthumani Rajapaksha,Kurunegala,Ibbagamuwa,North Western,3351,4912,8263,134040,196480,330520
6/18/2024,Muthumani Rajapaksha,Kurunegala,Ibbagamuwa,North Western,8767,6844,15611,350680,273760,624440
6/19/2024,Muthumani Rajapaksha,Kurunegala,Ibbagamuwa,North Western,1103,6947,8050,44120,277880,322000
6/20/2024,Muthumani Rajapaksha,Kurunegala,Ibbagamuwa,North Western,4069,7131,11200,162760,285240,448000
6/21/2024,Muthumani Rajapaksha,Kurunegala,Ibbagamuwa,North Western,2326,7501,9827,93040,300040,393080
6/22/2024,Muthumani Rajapaksha,Kurunegala,Ibbagamuwa,North Western,3059,1401,4460,122360,56040,178400
6/23/2024,Muthumani Rajapaksha,Kurunegala,Ibbagamuwa,North Western,5110,6465,11575,204400,258600,463000
6/24/2024,Muthumani Rajapaksha,Kurunegala,Ibbagamuwa,North Western,5794,4239,10033,231760,169560,401320
6/25/2024,Muthumani Rajapaksha,Kurunegala,Ibbagamuwa,North Western,2385,4407,6792,95400,176280,271680
6/26/2024,Muthumani Rajapaksha,Kurunegala,Ibbagamuwa,North Western,9056,4611,13667,362240,184440,546680
6/27/2024,Muthumani Rajapaksha,Kurunegala,Ibbagamuwa,North Western,6322,1426,7748,252880,57040,309920
6/28/2024,Muthumani Rajapaksha,Kurunegala,Ibbagamuwa,North Western,3024,7409,10433,120960,296360,417320
6/29/2024,Muthumani Rajapaksha,Kurunegala,Ibbagamuwa,North Western,9467,9591,19058,378680,383640,762320
6/30/2024,Muthumani Rajapaksha,Kurunegala,Ibbagamuwa,North Western,3191,3014,6205,127640,120560,248200
7/1/2024,Muthumani Rajapaksha,Kurunegala,Ibbagamuwa,North Western,7228,1015,8243,289120,40600,329720
7/2/2024,Muthumani Rajapaksha,Kurunegala,Ibbagamuwa,North Western,6882,3428,10310,275280,137120,412400
7/3/2024,Muthumani Rajapaksha,Kurunegala,Ibbagamuwa,North Western,9682,2594,12276,387280,103760,491040
7/4/2024,Muthumani Rajapaksha,Kurunegala,Ibbagamuwa,North Western,6449,2540,8989,257960,101600,359560
7/5/2024,Muthumani Rajapaksha,Kurunegala,Ibbagamuwa,North Western,7584,3014,10598,303360,120560,423920
7/6/2024,Muthumani Rajapaksha,Kurunegala,Ibbagamuwa,North Western,4574,5151,9725,182960,206040,389000
7/7/2024,Muthumani Rajapaksha,Kurunegala,Ibbagamuwa,North Western,3189,6720,9909,127560,268800,396360
7/8/2024,Muthumani Rajapaksha,Kurunegala,Ibbagamuwa,North Western,4613,7764,12377,184520,310560,495080
7/9/2024,Muthumani Rajapaksha,Kurunegala,Ibbagamuwa,North Western,7265,7162,14427,290600,286480,577080
7/10/2024,Muthumani Rajapaksha,Kurunegala,Ibbagamuwa,North Western,1306,2828,4134,52240,113120,165360
7/11/2024,Muthumani Rajapaksha,Kurunegala,Ibbagamuwa,North Western,6381,9194,15575,255240,367760,623000
7/12/2024,Muthumani Rajapaksha,Kurunegala,Ibbagamuwa,North Western,8576,2810,11386,343040,112400,455440
7/13/2024,Muthumani Rajapaksha,Kurunegala,Ibbagamuwa,North Western,1761,4778,6539,70440,191120,261560
7/14/2024,Muthumani Rajapaksha,Kurunegala,Ibbagamuwa,North Western,3533,6757,10290,141320,270280,411600
7/15/2024,Muthumani Rajapaksha,Kurunegala,Ibbagamuwa,North Western,8607,6219,14826,344280,248760,593040
7/16/2024,Muthumani Rajapaksha,Kurunegala,Ibbagamuwa,North Western,7739,6524,14263,309560,260960,570520
7/17/2024,Muthumani Rajapaksha,Kurunegala,Ibbagamuwa,North Western,8121,3046,11167,324840,121840,446680
7/18/2024,Muthumani Rajapaksha,Kurunegala,Ibbagamuwa,North Western,236,2706,2942,9440,108240,117680
7/19/2024,Muthumani Rajapaksha,Kurunegala,Ibbagamuwa,North Western,6025,360,6385,241000,14400,255400
7/20/2024,Muthumani Rajapaksha,Kurunegala,Ibbagamuwa,North Western,2544,451,2995,101760,18040,119800
7/21/2024,Muthumani Rajapaksha,Kurunegala,Ibbagamuwa,North Western,2656,2650,5306,106240,106000,212240
7/22/2024,Muthumani Rajapaksha,Kurunegala,Ibbagamuwa,North Western,2805,8038,10843,112200,321520,433720
7/23/2024,Muthumani Rajapaksha,Kurunegala,Ibbagamuwa,North Western,2497,5719,8216,99880,228760,328640
7/24/2024,Muthumani Rajapaksha,Kurunegala,Ibbagamuwa,North Western,6036,2758,8794,241440,110320,351760
7/25/2024,Muthumani Rajapaksha,Kurunegala,Ibbagamuwa,North Western,3029,899,3928,121160,35960,157120
7/26/2024,Muthumani Rajapaksha,Kurunegala,Ibbagamuwa,North Western,2250,7352,9602,90000,294080,384080
7/27/2024,Muthumani Rajapaksha,Kurunegala,Ibbagamuwa,North Western,236,1264,1500,9440,50560,60000
7/28/2024,Muthumani Rajapaksha,Kurunegala,Ibbagamuwa,North Western,7822,8779,16601,312880,351160,664040
7/29/2024,Muthumani Rajapaksha,Kurunegala,Ibbagamuwa,North Western,8970,5474,14444,358800,218960,577760
7/30/2024,Muthumani Rajapaksha,Kurunegala,Ibbagamuwa,North Western,8753,4401,13154,350120,176040,526160
7/31/2024,Muthumani Rajapaksha,Kurunegala,Ibbagamuwa,North Western,6716,7965,14681,268640,318600,587240
8/1/2024,Muthumani Rajapaksha,Kurunegala,Ibbagamuwa,North Western,2890,7379,10269,115600,295160,410760
8/2/2024,Muthumani Rajapaksha,Kurunegala,Ibbagamuwa,North Western,5055,6165,11220,202200,246600,448800
8/3/2024,Muthumani Rajapaksha,Kurunegala,Ibbagamuwa,North Western,2153,8371,10524,86120,334840,420960
8/4/2024,Muthumani Rajapaksha,Kurunegala,Ibbagamuwa,North Western,7969,3966,11935,318760,158640,477400
8/5/2024,Muthumani Rajapaksha,Kurunegala,Ibbagamuwa,North Western,5998,8173,14171,239920,326920,566840
8/6/2024,Muthumani Rajapaksha,Kurunegala,Ibbagamuwa,North Western,9453,8082,17535,378120,323280,701400
8/7/2024,Muthumani Rajapaksha,Kurunegala,Ibbagamuwa,North Western,6409,9846,16255,256360,393840,650200
8/8/2024,Muthumani Rajapaksha,Kurunegala,Ibbagamuwa,North Western,3376,683,4059,135040,27320,162360
8/9/2024,Muthumani Rajapaksha,Kurunegala,Ibbagamuwa,North Western,6825,8584,15409,273000,343360,616360
8/10/2024,Muthumani Rajapaksha,Kurunegala,Ibbagamuwa,North Western,7919,3329,11248,316760,133160,449920
8/11/2024,Muthumani Rajapaksha,Kurunegala,Ibbagamuwa,North Western,7986,8487,16473,319440,339480,658920
8/12/2024,Muthumani Rajapaksha,Kurunegala,Ibbagamuwa,North Western,5748,3797,9545,229920,151880,381800
8/13/2024,Muthumani Rajapaksha,Kurunegala,Ibbagamuwa,North Western,3661,8186,11847,146440,327440,473880
8/14/2024,Muthumani Rajapaksha,Kurunegala,Ibbagamuwa,North Western,4621,5830,10451,184840,233200,418040
8/15/2024,Muthumani Rajapaksha,Kurunegala,Ibbagamuwa,North Western,656,4543,5199,26240,181720,207960
8/16/2024,Muthumani Rajapaksha,Kurunegala,Ibbagamuwa,North Western,699,4387,5086,27960,175480,203440
8/17/2024,Muthumani Rajapaksha,Kurunegala,Ibbagamuwa,North Western,5208,1449,6657,208320,57960,266280
8/18/2024,Muthumani Rajapaksha,Kurunegala,Ibbagamuwa,North Western,3527,4033,7560,141080,161320,302400
8/19/2024,Muthumani Rajapaksha,Kurunegala,Ibbagamuwa,North Western,4815,2625,7440,192600,105000,297600
8/20/2024,Muthumani Rajapaksha,Kurunegala,Ibbagamuwa,North Western,3152,9023,12175,126080,360920,487000
8/21/2024,Muthumani Rajapaksha,Kurunegala,Ibbagamuwa,North Western,9761,2081,11842,390440,83240,473680
8/22/2024,Muthumani Rajapaksha,Kurunegala,Ibbagamuwa,North Western,9813,137,9950,392520,5480,398000
8/23/2024,Muthumani Rajapaksha,Kurunegala,Ibbagamuwa,North Western,9470,276,9746,378800,11040,389840
8/24/2024,Muthumani Rajapaksha,Kurunegala,Ibbagamuwa,North Western,7514,69,7583,300560,2760,303320
8/25/2024,Muthumani Rajapaksha,Kurunegala,Ibbagamuwa,North Western,5165,2804,7969,206600,112160,318760
8/26/2024,Muthumani Rajapaksha,Kurunegala,Ibbagamuwa,North Western,8431,9972,18403,337240,398880,736120
8/27/2024,Muthumani Rajapaksha,Kurunegala,Ibbagamuwa,North Western,8944,3267,12211,357760,130680,488440
8/28/2024,Muthumani Rajapaksha,Kurunegala,Ibbagamuwa,North Western,7530,2385,9915,301200,95400,396600
8/29/2024,Muthumani Rajapaksha,Kurunegala,Ibbagamuwa,North Western,2664,5699,8363,106560,227960,334520
8/30/2024,Muthumani Rajapaksha,Kurunegala,Ibbagamuwa,North Western,2206,1849,4055,88240,73960,162200
8/31/2024,Muthumani Rajapaksha,Kurunegala,Ibbagamuwa,North Western,2881,1691,4572,115240,67640,182880
9/1/2024,Muthumani Rajapaksha,Kurunegala,Ibbagamuwa,North Western,8805,5571,14376,352200,222840,575040
9/2/2024,Muthumani Rajapaksha,Kurunegala,Ibbagamuwa,North Western,8569,7637,16206,342760,305480,648240
9/3/2024,Muthumani Rajapaksha,Kurunegala,Ibbagamuwa,North Western,4056,4848,8904,162240,193920,356160
9/4/2024,Muthumani Rajapaksha,Kurunegala,Ibbagamuwa,North Western,3944,1689,5633,157760,67560,225320
9/5/2024,Muthumani Rajapaksha,Kurunegala,Ibbagamuwa,North Western,861,5875,6736,34440,235000,269440
9/6/2024,Muthumani Rajapaksha,Kurunegala,Ibbagamuwa,North Western,2139,1037,3176,85560,41480,127040
9/7/2024,Muthumani Rajapaksha,Kurunegala,Ibbagamuwa,North Western,4480,3031,7511,179200,121240,300440
9/8/2024,Muthumani Rajapaksha,Kurunegala,Ibbagamuwa,North Western,1159,1043,2202,46360,41720,88080
9/9/2024,Muthumani Rajapaksha,Kurunegala,Ibbagamuwa,North Western,1603,317,1920,64120,12680,76800
9/10/2024,Muthumani Rajapaksha,Kurunegala,Ibbagamuwa,North Western,6170,9075,15245,246800,363000,609800
9/11/2024,Muthumani Rajapaksha,Kurunegala,Ibbagamuwa,North Western,6928,6235,13163,277120,249400,526520
9/12/2024,Muthumani Rajapaksha,Kurunegala,Ibbagamuwa,North Western,4416,2237,6653,176640,89480,266120
9/13/2024,Muthumani Rajapaksha,Kurunegala,Ibbagamuwa,North Western,4438,2123,6561,177520,84920,262440
9/14/2024,Muthumani Rajapaksha,Kurunegala,Ibbagamuwa,North Western,784,3866,4650,31360,154640,186000
9/15/2024,Muthumani Rajapaksha,Kurunegala,Ibbagamuwa,North Western,4365,7507,11872,174600,300280,474880
9/16/2024,Muthumani Rajapaksha,Kurunegala,Ibbagamuwa,North Western,3184,1285,4469,127360,51400,178760
9/17/2024,Muthumani Rajapaksha,Kurunegala,Ibbagamuwa,North Western,4962,266,5228,198480,10640,209120
9/18/2024,Muthumani Rajapaksha,Kurunegala,Ibbagamuwa,North Western,9549,2640,12189,381960,105600,487560
9/19/2024,Muthumani Rajapaksha,Kurunegala,Ibbagamuwa,North Western,8784,1280,10064,351360,51200,402560
9/20/2024,Muthumani Rajapaksha,Kurunegala,Ibbagamuwa,North Western,1279,7289,8568,51160,291560,342720
9/21/2024,Muthumani Rajapaksha,Kurunegala,Ibbagamuwa,North Western,2336,746,3082,93440,29840,123280
9/22/2024,Muthumani Rajapaksha,Kurunegala,Ibbagamuwa,North Western,1162,2192,3354,46480,87680,134160
9/23/2024,Muthumani Rajapaksha,Kurunegala,Ibbagamuwa,North Western,6848,4884,11732,273920,195360,469280
9/24/2024,Muthumani Rajapaksha,Kurunegala,Ibbagamuwa,North Western,963,4422,5385,38520,176880,215400
9/25/2024,Muthumani Rajapaksha,Kurunegala,Ibbagamuwa,North Western,9839,9476,19315,393560,379040,772600
9/26/2024,Muthumani Rajapaksha,Kurunegala,Ibbagamuwa,North Western,3200,7382,10582,128000,295280,423280
9/27/2024,Muthumani Rajapaksha,Kurunegala,Ibbagamuwa,North Western,8881,4968,13849,355240,198720,553960
9/28/2024,Muthumani Rajapaksha,Kurunegala,Ibbagamuwa,North Western,5934,295,6229,237360,11800,249160
9/29/2024,Muthumani Rajapaksha,Kurunegala,Ibbagamuwa,North Western,5142,4839,9981,205680,193560,399240
9/30/2024,Muthumani Rajapaksha,Kurunegala,Ibbagamuwa,North Western,1332,1748,3080,53280,69920,123200
10/1/2024,Muthumani Rajapaksha,Kurunegala,Ibbagamuwa,North Western,9518,4330,13848,380720,173200,553920
10/2/2024,Muthumani Rajapaksha,Kurunegala,Ibbagamuwa,North Western,9054,1464,10518,362160,58560,420720
10/3/2024,Muthumani Rajapaksha,Kurunegala,Ibbagamuwa,North Western,2859,791,3650,114360,31640,146000
10/4/2024,Muthumani Rajapaksha,Kurunegala,Ibbagamuwa,North Western,2116,5840,7956,84640,233600,318240
10/5/2024,Muthumani Rajapaksha,Kurunegala,Ibbagamuwa,North Western,6720,5087,11807,268800,203480,472280
10/6/2024,Muthumani Rajapaksha,Kurunegala,Ibbagamuwa,North Western,3271,1127,4398,130840,45080,175920
10/7/2024,Muthumani Rajapaksha,Kurunegala,Ibbagamuwa,North Western,4094,6042,10136,163760,241680,405440
10/8/2024,Muthumani Rajapaksha,Kurunegala,Ibbagamuwa,North Western,6206,9625,15831,248240,385000,633240
10/9/2024,Muthumani Rajapaksha,Kurunegala,Ibbagamuwa,North Western,6980,7037,14017,279200,281480,560680
10/10/2024,Muthumani Rajapaksha,Kurunegala,Ibbagamuwa,North Western,6428,1416,7844,257120,56640,313760
10/11/2024,Muthumani Rajapaksha,Kurunegala,Ibbagamuwa,North Western,9380,6924,16304,375200,276960,652160
10/12/2024,Muthumani Rajapaksha,Kurunegala,Ibbagamuwa,North Western,786,7747,8533,31440,309880,341320
10/13/2024,Muthumani Rajapaksha,Kurunegala,Ibbagamuwa,North Western,9297,2416,11713,371880,96640,468520
10/14/2024,Muthumani Rajapaksha,Kurunegala,Ibbagamuwa,North Western,5187,451,5638,207480,18040,225520
10/15/2024,Muthumani Rajapaksha,Kurunegala,Ibbagamuwa,North Western,7975,771,8746,319000,30840,349840
10/16/2024,Muthumani Rajapaksha,Kurunegala,Ibbagamuwa,North Western,254,6830,7084,10160,273200,283360
10/17/2024,Muthumani Rajapaksha,Kurunegala,Ibbagamuwa,North Western,1776,7032,8808,71040,281280,352320
10/18/2024,Muthumani Rajapaksha,Kurunegala,Ibbagamuwa,North Western,3280,627,3907,131200,25080,156280
10/19/2024,Muthumani Rajapaksha,Kurunegala,Ibbagamuwa,North Western,4195,1972,6167,167800,78880,246680
10/20/2024,Muthumani Rajapaksha,Kurunegala,Ibbagamuwa,North Western,3971,3960,7931,158840,158400,317240
10/21/2024,Muthumani Rajapaksha,Kurunegala,Ibbagamuwa,North Western,7212,8813,16025,288480,352520,641000
10/22/2024,Muthumani Rajapaksha,Kurunegala,Ibbagamuwa,North Western,8206,7353,15559,328240,294120,622360
10/23/2024,Muthumani Rajapaksha,Kurunegala,Ibbagamuwa,North Western,3460,1535,4995,138400,61400,199800
10/24/2024,Muthumani Rajapaksha,Kurunegala,Ibbagamuwa,North Western,777,2765,3542,31080,110600,141680
10/25/2024,Muthumani Rajapaksha,Kurunegala,Ibbagamuwa,North Western,2615,7964,10579,104600,318560,423160
10/26/2024,Muthumani Rajapaksha,Kurunegala,Ibbagamuwa,North Western,9011,7987,16998,360440,319480,679920
10/27/2024,Muthumani Rajapaksha,Kurunegala,Ibbagamuwa,North Western,6224,1281,7505,248960,51240,300200
10/28/2024,Muthumani Rajapaksha,Kurunegala,Ibbagamuwa,North Western,4243,3076,7319,169720,123040,292760
10/29/2024,Muthumani Rajapaksha,Kurunegala,Ibbagamuwa,North Western,2639,5649,8288,105560,225960,331520
10/30/2024,Muthumani Rajapaksha,Kurunegala,Ibbagamuwa,North Western,4316,79,4395,172640,3160,175800
10/31/2024,Muthumani Rajapaksha,Kurunegala,Ibbagamuwa,North Western,249,5363,5612,9960,214520,224480
11/1/2024,Muthumani Rajapaksha,Kurunegala,Ibbagamuwa,North Western,3088,5337,8425,123520,213480,337000
11/2/2024,Muthumani Rajapaksha,Kurunegala,Ibbagamuwa,North Western,1651,8282,9933,66040,331280,397320
11/3/2024,Muthumani Rajapaksha,Kurunegala,Ibbagamuwa,North Western,4929,2381,7310,197160,95240,292400
11/4/2024,Muthumani Rajapaksha,Kurunegala,Ibbagamuwa,North Western,2899,8798,11697,115960,351920,467880
11/5/2024,Muthumani Rajapaksha,Kurunegala,Ibbagamuwa,North Western,9208,7541,16749,368320,301640,669960
11/6/2024,Muthumani Rajapaksha,Kurunegala,Ibbagamuwa,North Western,7192,913,8105,287680,36520,324200
11/7/2024,Muthumani Rajapaksha,Kurunegala,Ibbagamuwa,North Western,1749,6291,8040,69960,251640,321600
11/8/2024,Muthumani Rajapaksha,Kurunegala,Ibbagamuwa,North Western,3912,1259,5171,156480,50360,206840
11/9/2024,Muthumani Rajapaksha,Kurunegala,Ibbagamuwa,North Western,2501,3653,6154,100040,146120,246160
11/10/2024,Muthumani Rajapaksha,Kurunegala,Ibbagamuwa,North Western,8107,3253,11360,324280,130120,454400
11/11/2024,Muthumani Rajapaksha,Kurunegala,Ibbagamuwa,North Western,7383,9295,16678,295320,371800,667120
11/12/2024,Muthumani Rajapaksha,Kurunegala,Ibbagamuwa,North Western,4974,8123,13097,198960,324920,523880
11/13/2024,Muthumani Rajapaksha,Kurunegala,Ibbagamuwa,North Western,1536,5524,7060,61440,220960,282400
11/14/2024,Muthumani Rajapaksha,Kurunegala,Ibbagamuwa,North Western,623,4390,5013,24920,175600,200520
11/15/2024,Muthumani Rajapaksha,Kurunegala,Ibbagamuwa,North Western,4161,6973,11134,166440,278920,445360
11/16/2024,Muthumani Rajapaksha,Kurunegala,Ibbagamuwa,North Western,6274,4962,11236,250960,198480,449440
11/17/2024,Muthumani Rajapaksha,Kurunegala,Ibbagamuwa,North Western,151,247,398,6040,9880,15920
11/18/2024,Muthumani Rajapaksha,Kurunegala,Ibbagamuwa,North Western,5953,652,6605,238120,26080,264200
11/19/2024,Muthumani Rajapaksha,Kurunegala,Ibbagamuwa,North Western,9876,6201,16077,395040,248040,643080
11/20/2024,Muthumani Rajapaksha,Kurunegala,Ibbagamuwa,North Western,913,6051,6964,36520,242040,278560
11/21/2024,Muthumani Rajapaksha,Kurunegala,Ibbagamuwa,North Western,1691,9393,11084,67640,375720,443360
11/22/2024,Muthumani Rajapaksha,Kurunegala,Ibbagamuwa,North Western,1912,9102,11014,76480,364080,440560
11/23/2024,Muthumani Rajapaksha,Kurunegala,Ibbagamuwa,North Western,3359,8870,12229,134360,354800,489160
11/24/2024,Muthumani Rajapaksha,Kurunegala,Ibbagamuwa,North Western,7204,8580,15784,288160,343200,631360
11/25/2024,Muthumani Rajapaksha,Kurunegala,Ibbagamuwa,North Western,5608,2629,8237,224320,105160,329480
11/26/2024,Muthumani Rajapaksha,Kurunegala,Ibbagamuwa,North Western,9845,8830,18675,393800,353200,747000
11/27/2024,Muthumani Rajapaksha,Kurunegala,Ibbagamuwa,North Western,6090,4870,10960,243600,194800,438400
11/28/2024,Muthumani Rajapaksha,Kurunegala,Ibbagamuwa,North Western,7860,4943,12803,314400,197720,512120
11/29/2024,Muthumani Rajapaksha,Kurunegala,Ibbagamuwa,North Western,4768,2155,6923,190720,86200,276920
11/30/2024,Muthumani Rajapaksha,Kurunegala,Ibbagamuwa,North Western,6285,258,6543,251400,10320,261720
12/1/2024,Muthumani Rajapaksha,Kurunegala,Ibbagamuwa,North Western,7885,1370,9255,315400,54800,370200
12/2/2024,Muthumani Rajapaksha,Kurunegala,Ibbagamuwa,North Western,2524,218,2742,100960,8720,109680
12/3/2024,Muthumani Rajapaksha,Kurunegala,Ibbagamuwa,North Western,1269,2354,3623,50760,94160,144920
12/4/2024,Muthumani Rajapaksha,Kurunegala,Ibbagamuwa,North Western,6528,2627,9155,261120,105080,366200
12/5/2024,Muthumani Rajapaksha,Kurunegala,Ibbagamuwa,North Western,6368,3107,9475,254720,124280,379000
12/6/2024,Muthumani Rajapaksha,Kurunegala,Ibbagamuwa,North Western,8918,8252,17170,356720,330080,686800
12/7/2024,Muthumani Rajapaksha,Kurunegala,Ibbagamuwa,North Western,2731,6541,9272,109240,261640,370880
12/8/2024,Muthumani Rajapaksha,Kurunegala,Ibbagamuwa,North Western,6831,6544,13375,273240,261760,535000
12/9/2024,Muthumani Rajapaksha,Kurunegala,Ibbagamuwa,North Western,8406,2313,10719,336240,92520,428760
12/10/2024,Muthumani Rajapaksha,Kurunegala,Ibbagamuwa,North Western,2935,5860,8795,117400,234400,351800
12/11/2024,Muthumani Rajapaksha,Kurunegala,Ibbagamuwa,North Western,2539,887,3426,101560,35480,137040
12/12/2024,Muthumani Rajapaksha,Kurunegala,Ibbagamuwa,North Western,2339,8593,10932,93560,343720,437280
12/13/2024,Muthumani Rajapaksha,Kurunegala,Ibbagamuwa,North Western,4666,9687,14353,186640,387480,574120
12/14/2024,Muthumani Rajapaksha,Kurunegala,Ibbagamuwa,North Western,9807,7708,17515,392280,308320,700600
12/15/2024,Muthumani Rajapaksha,Kurunegala,Ibbagamuwa,North Western,8695,136,8831,347800,5440,353240
12/16/2024,Muthumani Rajapaksha,Kurunegala,Ibbagamuwa,North Western,7598,7099,14697,303920,283960,587880
12/17/2024,Muthumani Rajapaksha,Kurunegala,Ibbagamuwa,North Western,7953,6854,14807,318120,274160,592280
12/18/2024,Muthumani Rajapaksha,Kurunegala,Ibbagamuwa,North Western,3455,1205,4660,138200,48200,186400
12/19/2024,Muthumani Rajapaksha,Kurunegala,Ibbagamuwa,North Western,7956,9061,17017,318240,362440,680680
12/20/2024,Muthumani Rajapaksha,Kurunegala,Ibbagamuwa,North Western,9592,7252,16844,383680,290080,673760
12/21/2024,Muthumani Rajapaksha,Kurunegala,Ibbagamuwa,North Western,4588,6071,10659,183520,242840,426360
12/22/2024,Muthumani Rajapaksha,Kurunegala,Ibbagamuwa,North Western,4485,7540,12025,179400,301600,481000
12/23/2024,Muthumani Rajapaksha,Kurunegala,Ibbagamuwa,North Western,4417,6345,10762,176680,253800,430480
12/24/2024,Muthumani Rajapaksha,Kurunegala,Ibbagamuwa,North Western,2556,9942,12498,102240,397680,499920
12/25/2024,Muthumani Rajapaksha,Kurunegala,Ibbagamuwa,North Western,1313,1049,2362,52520,41960,94480
12/26/2024,Muthumani Rajapaksha,Kurunegala,Ibbagamuwa,North Western,3292,5129,8421,131680,205160,336840
12/27/2024,Muthumani Rajapaksha,Kurunegala,Ibbagamuwa,North Western,5496,9765,15261,219840,390600,610440
12/28/2024,Muthumani Rajapaksha,Kurunegala,Ibbagamuwa,North Western,5010,7256,12266,200400,290240,490640
12/29/2024,Muthumani Rajapaksha,Kurunegala,Ibbagamuwa,North Western,3633,1300,4933,145320,52000,197320
12/30/2024,Muthumani Rajapaksha,Kurunegala,Ibbagamuwa,North Western,8089,8394,16483,323560,335760,659320
12/31/2024,Muthumani Rajapaksha,Kurunegala,Ibbagamuwa,North Western,2605,5375,7980,104200,215000,319200
1/1/2025,Muthumani Rajapaksha,Kurunegala,Ibbagamuwa,North Western,1608,1590,3198,64320,63600,127920
1/2/2025,Muthumani Rajapaksha,Kurunegala,Ibbagamuwa,North Western,6787,1810,8597,271480,72400,343880
1/3/2025,Muthumani Rajapaksha,Kurunegala,Ibbagamuwa,North Western,669,844,1513,26760,33760,60520
1/4/2025,Muthumani Rajapaksha,Kurunegala,Ibbagamuwa,North Western,5618,2690,8308,224720,107600,332320
1/5/2025,Muthumani Rajapaksha,Kurunegala,Ibbagamuwa,North Western,1162,8540,9702,46480,341600,388080
1/6/2025,Muthumani Rajapaksha,Kurunegala,Ibbagamuwa,North Western,8739,5037,13776,349560,201480,551040
1/7/2025,Muthumani Rajapaksha,Kurunegala,Ibbagamuwa,North Western,6867,8268,15135,274680,330720,605400
1/8/2025,Muthumani Rajapaksha,Kurunegala,Ibbagamuwa,North Western,8041,3785,11826,321640,151400,473040
1/9/2025,Muthumani Rajapaksha,Kurunegala,Ibbagamuwa,North Western,4076,8013,12089,163040,320520,483560
1/10/2025,Muthumani Rajapaksha,Kurunegala,Ibbagamuwa,North Western,4695,2285,6980,187800,91400,279200
1/11/2025,Muthumani Rajapaksha,Kurunegala,Ibbagamuwa,North Western,9854,5366,15220,394160,214640,608800
1/12/2025,Muthumani Rajapaksha,Kurunegala,Ibbagamuwa,North Western,4207,7140,11347,168280,285600,453880
1/13/2025,Muthumani Rajapaksha,Kurunegala,Ibbagamuwa,North Western,6645,9840,16485,265800,393600,659400
1/14/2025,Muthumani Rajapaksha,Kurunegala,Ibbagamuwa,North Western,6499,1683,8182,259960,67320,327280
1/15/2025,Muthumani Rajapaksha,Kurunegala,Ibbagamuwa,North Western,1355,3239,4594,54200,129560,183760
1/16/2025,Muthumani Rajapaksha,Kurunegala,Ibbagamuwa,North Western,4315,4,4319,172600,160,172760
1/17/2025,Muthumani Rajapaksha,Kurunegala,Ibbagamuwa,North Western,5336,2675,8011,213440,107000,320440
1/18/2025,Muthumani Rajapaksha,Kurunegala,Ibbagamuwa,North Western,7575,6088,13663,303000,243520,546520
1/19/2025,Muthumani Rajapaksha,Kurunegala,Ibbagamuwa,North Western,7263,4498,11761,290520,179920,470440
1/20/2025,Muthumani Rajapaksha,Kurunegala,Ibbagamuwa,North Western,636,6921,7557,25440,276840,302280
1/21/2025,Muthumani Rajapaksha,Kurunegala,Ibbagamuwa,North Western,2633,8068,10701,105320,322720,428040
1/22/2025,Muthumani Rajapaksha,Kurunegala,Ibbagamuwa,North Western,2826,9413,12239,113040,376520,489560
1/23/2025,Muthumani Rajapaksha,Kurunegala,Ibbagamuwa,North Western,5150,1945,7095,206000,77800,283800
1/24/2025,Muthumani Rajapaksha,Kurunegala,Ibbagamuwa,North Western,2523,3232,5755,100920,129280,230200
1/25/2025,Muthumani Rajapaksha,Kurunegala,Ibbagamuwa,North Western,3533,2315,5848,141320,92600,233920
1/26/2025,Muthumani Rajapaksha,Kurunegala,Ibbagamuwa,North Western,2608,9714,12322,104320,388560,492880
1/27/2025,Muthumani Rajapaksha,Kurunegala,Ibbagamuwa,North Western,6303,9700,16003,252120,388000,640120
1/28/2025,Muthumani Rajapaksha,Kurunegala,Ibbagamuwa,North Western,6136,5172,11308,245440,206880,452320
1/29/2025,Muthumani Rajapaksha,Kurunegala,Ibbagamuwa,North Western,7007,3510,10517,280280,140400,420680
1/30/2025,Muthumani Rajapaksha,Kurunegala,Ibbagamuwa,North Western,1250,8586,9836,50000,343440,393440
1/31/2025,Muthumani Rajapaksha,Kurunegala,Ibbagamuwa,North Western,9301,6997,16298,372040,279880,651920
2/1/2025,Muthumani Rajapaksha,Kurunegala,Ibbagamuwa,North Western,1009,6768,7777,40360,270720,311080
2/2/2025,Muthumani Rajapaksha,Kurunegala,Ibbagamuwa,North Western,4777,3509,8286,191080,140360,331440
2/3/2025,Muthumani Rajapaksha,Kurunegala,Ibbagamuwa,North Western,2699,1296,3995,107960,51840,159800
2/4/2025,Muthumani Rajapaksha,Kurunegala,Ibbagamuwa,North Western,9768,8003,17771,390720,320120,710840
2/5/2025,Muthumani Rajapaksha,Kurunegala,Ibbagamuwa,North Western,3925,7569,11494,157000,302760,459760
2/6/2025,Muthumani Rajapaksha,Kurunegala,Ibbagamuwa,North Western,6165,6697,12862,246600,267880,514480
2/7/2025,Muthumani Rajapaksha,Kurunegala,Ibbagamuwa,North Western,4659,8388,13047,186360,335520,521880
2/8/2025,Muthumani Rajapaksha,Kurunegala,Ibbagamuwa,North Western,8378,4296,12674,335120,171840,506960
2/9/2025,Muthumani Rajapaksha,Kurunegala,Ibbagamuwa,North Western,3948,1438,5386,157920,57520,215440
2/10/2025,Muthumani Rajapaksha,Kurunegala,Ibbagamuwa,North Western,3531,6076,9607,141240,243040,384280
2/11/2025,Muthumani Rajapaksha,Kurunegala,Ibbagamuwa,North Western,7159,9622,16781,286360,384880,671240
2/12/2025,Muthumani Rajapaksha,Kurunegala,Ibbagamuwa,North Western,9862,438,10300,394480,17520,412000
2/13/2025,Muthumani Rajapaksha,Kurunegala,Ibbagamuwa,North Western,6790,2271,9061,271600,90840,362440
2/14/2025,Muthumani Rajapaksha,Kurunegala,Ibbagamuwa,North Western,7106,1399,8505,284240,55960,340200
2/15/2025,Muthumani Rajapaksha,Kurunegala,Ibbagamuwa,North Western,2886,3972,6858,115440,158880,274320
2/16/2025,Muthumani Rajapaksha,Kurunegala,Ibbagamuwa,North Western,1099,5733,6832,43960,229320,273280
2/17/2025,Muthumani Rajapaksha,Kurunegala,Ibbagamuwa,North Western,4135,7467,11602,165400,298680,464080
2/18/2025,Muthumani Rajapaksha,Kurunegala,Ibbagamuwa,North Western,1288,8597,9885,51520,343880,395400
2/19/2025,Muthumani Rajapaksha,Kurunegala,Ibbagamuwa,North Western,3726,324,4050,149040,12960,162000
2/20/2025,Muthumani Rajapaksha,Kurunegala,Ibbagamuwa,North Western,9909,1964,11873,396360,78560,474920
2/21/2025,Muthumani Rajapaksha,Kurunegala,Ibbagamuwa,North Western,3012,9554,12566,120480,382160,502640
2/22/2025,Muthumani Rajapaksha,Kurunegala,Ibbagamuwa,North Western,1378,779,2157,55120,31160,86280
2/23/2025,Muthumani Rajapaksha,Kurunegala,Ibbagamuwa,North Western,8951,8438,17389,358040,337520,695560
2/24/2025,Muthumani Rajapaksha,Kurunegala,Ibbagamuwa,North Western,4339,1585,5924,173560,63400,236960
2/25/2025,Muthumani Rajapaksha,Kurunegala,Ibbagamuwa,North Western,9958,7875,17833,398320,315000,713320
2/26/2025,Muthumani Rajapaksha,Kurunegala,Ibbagamuwa,North Western,1231,5302,6533,49240,212080,261320
2/27/2025,Muthumani Rajapaksha,Kurunegala,Ibbagamuwa,North Western,1993,5899,7892,79720,235960,315680
2/28/2025,Muthumani Rajapaksha,Kurunegala,Ibbagamuwa,North Western,9749,6969,16718,389960,278760,668720
3/1/2025,Muthumani Rajapaksha,Kurunegala,Ibbagamuwa,North Western,3970,1091,5061,158800,43640,202440
3/2/2025,Muthumani Rajapaksha,Kurunegala,Ibbagamuwa,North Western,7526,1321,8847,301040,52840,353880
3/3/2025,Muthumani Rajapaksha,Kurunegala,Ibbagamuwa,North Western,3340,9301,12641,133600,372040,505640
3/4/2025,Muthumani Rajapaksha,Kurunegala,Ibbagamuwa,North Western,3404,5477,8881,136160,219080,355240
3/5/2025,Muthumani Rajapaksha,Kurunegala,Ibbagamuwa,North Western,7372,9596,16968,294880,383840,678720
3/6/2025,Muthumani Rajapaksha,Kurunegala,Ibbagamuwa,North Western,9620,9642,19262,384800,385680,770480
3/7/2025,Muthumani Rajapaksha,Kurunegala,Ibbagamuwa,North Western,9838,6022,15860,393520,240880,634400
3/8/2025,Muthumani Rajapaksha,Kurunegala,Ibbagamuwa,North Western,3942,5848,9790,157680,233920,391600
3/9/2025,Muthumani Rajapaksha,Kurunegala,Ibbagamuwa,North Western,249,7924,8173,9960,316960,326920
3/10/2025,Muthumani Rajapaksha,Kurunegala,Ibbagamuwa,North Western,2423,921,3344,96920,36840,133760
3/11/2025,Muthumani Rajapaksha,Kurunegala,Ibbagamuwa,North Western,8032,4086,12118,321280,163440,484720
3/12/2025,Muthumani Rajapaksha,Kurunegala,Ibbagamuwa,North Western,5527,9415,14942,221080,376600,597680
3/13/2025,Muthumani Rajapaksha,Kurunegala,Ibbagamuwa,North Western,8872,5620,14492,354880,224800,579680
3/14/2025,Muthumani Rajapaksha,Kurunegala,Ibbagamuwa,North Western,4328,5639,9967,173120,225560,398680
3/15/2025,Muthumani Rajapaksha,Kurunegala,Ibbagamuwa,North Western,5303,6057,11360,212120,242280,454400
3/16/2025,Muthumani Rajapaksha,Kurunegala,Ibbagamuwa,North Western,1775,3595,5370,71000,143800,214800
3/17/2025,Muthumani Rajapaksha,Kurunegala,Ibbagamuwa,North Western,5986,9682,15668,239440,387280,626720
3/18/2025,Muthumani Rajapaksha,Kurunegala,Ibbagamuwa,North Western,2051,2197,4248,82040,87880,169920
3/19/2025,Muthumani Rajapaksha,Kurunegala,Ibbagamuwa,North Western,9212,2355,11567,368480,94200,462680
3/20/2025,Muthumani Rajapaksha,Kurunegala,Ibbagamuwa,North Western,9950,1284,11234,398000,51360,449360
3/21/2025,Muthumani Rajapaksha,Kurunegala,Ibbagamuwa,North Western,4531,4851,9382,181240,194040,375280
3/22/2025,Muthumani Rajapaksha,Kurunegala,Ibbagamuwa,North Western,6369,4257,10626,254760,170280,425040
3/23/2025,Muthumani Rajapaksha,Kurunegala,Ibbagamuwa,North Western,8843,1043,9886,353720,41720,395440
3/25/2024,Ariyanayaka Perera,Kandy,Hunnasgiriya,Central,6143,798,6941,245720,31920,277640
3/26/2024,Ariyanayaka Perera,Kandy,Hunnasgiriya,Central,7217,6390,13607,288680,255600,544280
3/27/2024,Ariyanayaka Perera,Kandy,Hunnasgiriya,Central,7264,5910,13174,290560,236400,526960
3/28/2024,Ariyanayaka Perera,Kandy,Hunnasgiriya,Central,5607,1599,7206,224280,63960,288240
3/29/2024,Ariyanayaka Perera,Kandy,Hunnasgiriya,Central,8730,3615,12345,349200,144600,493800
3/30/2024,Ariyanayaka Perera,Kandy,Hunnasgiriya,Central,7503,8902,16405,300120,356080,656200
3/31/2024,Ariyanayaka Perera,Kandy,Hunnasgiriya,Central,100,1006,1106,4000,40240,44240
4/1/2024,Ariyanayaka Perera,Kandy,Hunnasgiriya,Central,6782,1928,8710,271280,77120,348400
4/2/2024,Ariyanayaka Perera,Kandy,Hunnasgiriya,Central,1874,5734,7608,74960,229360,304320
4/3/2024,Ariyanayaka Perera,Kandy,Hunnasgiriya,Central,8280,3649,11929,331200,145960,477160
4/4/2024,Ariyanayaka Perera,Kandy,Hunnasgiriya,Central,1320,7977,9297,52800,319080,371880
4/5/2024,Ariyanayaka Perera,Kandy,Hunnasgiriya,Central,7221,3158,10379,288840,126320,415160
4/6/2024,Ariyanayaka Perera,Kandy,Hunnasgiriya,Central,1499,5260,6759,59960,210400,270360
4/7/2024,Ariyanayaka Perera,Kandy,Hunnasgiriya,Central,7277,9405,16682,291080,376200,667280
4/8/2024,Ariyanayaka Perera,Kandy,Hunnasgiriya,Central,8759,3928,12687,350360,157120,507480
4/9/2024,Ariyanayaka Perera,Kandy,Hunnasgiriya,Central,4655,3743,8398,186200,149720,335920
4/10/2024,Ariyanayaka Perera,Kandy,Hunnasgiriya,Central,1366,3521,4887,54640,140840,195480
4/11/2024,Ariyanayaka Perera,Kandy,Hunnasgiriya,Central,8220,1907,10127,328800,76280,405080
4/19/2024,Ariyanayaka Perera,Kandy,Hunnasgiriya,Central,7207,6620,13827,288280,264800,553080
4/20/2024,Ariyanayaka Perera,Kandy,Hunnasgiriya,Central,1824,4985,6809,72960,199400,272360
4/21/2024,Ariyanayaka Perera,Kandy,Hunnasgiriya,Central,2205,5719,7924,88200,228760,316960
4/22/2024,Ariyanayaka Perera,Kandy,Hunnasgiriya,Central,2098,2233,4331,83920,89320,173240
4/23/2024,Ariyanayaka Perera,Kandy,Hunnasgiriya,Central,2222,8523,10745,88880,340920,429800
4/24/2024,Ariyanayaka Perera,Kandy,Hunnasgiriya,Central,4103,4364,8467,164120,174560,338680
4/25/2024,Ariyanayaka Perera,Kandy,Hunnasgiriya,Central,717,2382,3099,28680,95280,123960
4/26/2024,Ariyanayaka Perera,Kandy,Hunnasgiriya,Central,1992,1991,3983,79680,79640,159320
4/27/2024,Ariyanayaka Perera,Kandy,Hunnasgiriya,Central,7104,2414,9518,284160,96560,380720
4/28/2024,Ariyanayaka Perera,Kandy,Hunnasgiriya,Central,165,5768,5933,6600,230720,237320
4/29/2024,Ariyanayaka Perera,Kandy,Hunnasgiriya,Central,3627,5724,9351,145080,228960,374040
4/30/2024,Ariyanayaka Perera,Kandy,Hunnasgiriya,Central,4621,6196,10817,184840,247840,432680
5/1/2024,Ariyanayaka Perera,Kandy,Hunnasgiriya,Central,7834,2358,10192,313360,94320,407680
5/2/2024,Ariyanayaka Perera,Kandy,Hunnasgiriya,Central,3227,3552,6779,129080,142080,271160
5/3/2024,Ariyanayaka Perera,Kandy,Hunnasgiriya,Central,8313,9363,17676,332520,374520,707040
5/4/2024,Ariyanayaka Perera,Kandy,Hunnasgiriya,Central,1005,4377,5382,40200,175080,215280
5/5/2024,Ariyanayaka Perera,Kandy,Hunnasgiriya,Central,5888,6373,12261,235520,254920,490440
5/6/2024,Ariyanayaka Perera,Kandy,Hunnasgiriya,Central,4439,3754,8193,177560,150160,327720
5/7/2024,Ariyanayaka Perera,Kandy,Hunnasgiriya,Central,6300,6647,12947,252000,265880,517880
5/8/2024,Ariyanayaka Perera,Kandy,Hunnasgiriya,Central,7433,8766,16199,297320,350640,647960
5/9/2024,Ariyanayaka Perera,Kandy,Hunnasgiriya,Central,346,5475,5821,13840,219000,232840
5/10/2024,Ariyanayaka Perera,Kandy,Hunnasgiriya,Central,5942,536,6478,237680,21440,259120
5/11/2024,Ariyanayaka Perera,Kandy,Hunnasgiriya,Central,1965,4458,6423,78600,178320,256920
5/12/2024,Ariyanayaka Perera,Kandy,Hunnasgiriya,Central,6158,3772,9930,246320,150880,397200
5/13/2024,Ariyanayaka Perera,Kandy,Hunnasgiriya,Central,8812,9845,18657,352480,393800,746280
5/14/2024,Ariyanayaka Perera,Kandy,Hunnasgiriya,Central,3856,8027,11883,154240,321080,475320
5/15/2024,Ariyanayaka Perera,Kandy,Hunnasgiriya,Central,9068,4679,13747,362720,187160,549880
5/16/2024,Ariyanayaka Perera,Kandy,Hunnasgiriya,Central,6865,1956,8821,274600,78240,352840
5/17/2024,Ariyanayaka Perera,Kandy,Hunnasgiriya,Central,8365,8782,17147,334600,351280,685880
5/18/2024,Ariyanayaka Perera,Kandy,Hunnasgiriya,Central,9724,7500,17224,388960,300000,688960
5/19/2024,Ariyanayaka Perera,Kandy,Hunnasgiriya,Central,9422,836,10258,376880,33440,410320
5/20/2024,Ariyanayaka Perera,Kandy,Hunnasgiriya,Central,3168,8901,12069,126720,356040,482760
5/21/2024,Ariyanayaka Perera,Kandy,Hunnasgiriya,Central,8399,6208,14607,335960,248320,584280
5/22/2024,Ariyanayaka Perera,Kandy,Hunnasgiriya,Central,6399,2476,8875,255960,99040,355000
5/24/2024,Ariyanayaka Perera,Kandy,Hunnasgiriya,Central,174,9661,9835,6960,386440,393400
5/25/2024,Ariyanayaka Perera,Kandy,Hunnasgiriya,Central,1390,6085,7475,55600,243400,299000
5/26/2024,Ariyanayaka Perera,Kandy,Hunnasgiriya,Central,1387,3483,4870,55480,139320,194800
5/27/2024,Ariyanayaka Perera,Kandy,Hunnasgiriya,Central,7772,2245,10017,310880,89800,400680
5/28/2024,Ariyanayaka Perera,Kandy,Hunnasgiriya,Central,5916,2303,8219,236640,92120,328760
5/29/2024,Ariyanayaka Perera,Kandy,Hunnasgiriya,Central,3428,4123,7551,137120,164920,302040
5/30/2024,Ariyanayaka Perera,Kandy,Hunnasgiriya,Central,8821,1340,10161,352840,53600,406440
5/31/2024,Ariyanayaka Perera,Kandy,Hunnasgiriya,Central,6429,9142,15571,257160,365680,622840
6/1/2024,Ariyanayaka Perera,Kandy,Hunnasgiriya,Central,6243,5872,12115,249720,234880,484600
6/2/2024,Ariyanayaka Perera,Kandy,Hunnasgiriya,Central,7508,6848,14356,300320,273920,574240
6/3/2024,Ariyanayaka Perera,Kandy,Hunnasgiriya,Central,4221,8540,12761,168840,341600,510440
6/4/2024,Ariyanayaka Perera,Kandy,Hunnasgiriya,Central,9250,9768,19018,370000,390720,760720
6/5/2024,Ariyanayaka Perera,Kandy,Hunnasgiriya,Central,9202,7119,16321,368080,284760,652840
6/6/2024,Ariyanayaka Perera,Kandy,Hunnasgiriya,Central,395,2822,3217,15800,112880,128680
6/7/2024,Ariyanayaka Perera,Kandy,Hunnasgiriya,Central,883,9309,10192,35320,372360,407680
6/8/2024,Ariyanayaka Perera,Kandy,Hunnasgiriya,Central,7145,5996,13141,285800,239840,525640
6/9/2024,Ariyanayaka Perera,Kandy,Hunnasgiriya,Central,8306,2192,10498,332240,87680,419920
6/10/2024,Ariyanayaka Perera,Kandy,Hunnasgiriya,Central,3622,9415,13037,144880,376600,521480
6/11/2024,Ariyanayaka Perera,Kandy,Hunnasgiriya,Central,5063,3391,8454,202520,135640,338160
6/12/2024,Ariyanayaka Perera,Kandy,Hunnasgiriya,Central,2835,7542,10377,113400,301680,415080
6/13/2024,Ariyanayaka Perera,Kandy,Hunnasgiriya,Central,9689,4842,14531,387560,193680,581240
6/14/2024,Ariyanayaka Perera,Kandy,Hunnasgiriya,Central,8872,8495,17367,354880,339800,694680
6/15/2024,Ariyanayaka Perera,Kandy,Hunnasgiriya,Central,1614,1137,2751,64560,45480,110040
6/16/2024,Ariyanayaka Perera,Kandy,Hunnasgiriya,Central,9066,1322,10388,362640,52880,415520
6/17/2024,Ariyanayaka Perera,Kandy,Hunnasgiriya,Central,9620,7127,16747,384800,285080,669880
6/18/2024,Ariyanayaka Perera,Kandy,Hunnasgiriya,Central,7571,3415,10986,302840,136600,439440
6/19/2024,Ariyanayaka Perera,Kandy,Hunnasgiriya,Central,1644,5590,7234,65760,223600,289360
6/20/2024,Ariyanayaka Perera,Kandy,Hunnasgiriya,Central,433,4393,4826,17320,175720,193040
6/21/2024,Ariyanayaka Perera,Kandy,Hunnasgiriya,Central,7495,1572,9067,299800,62880,362680
6/22/2024,Ariyanayaka Perera,Kandy,Hunnasgiriya,Central,3935,4459,8394,157400,178360,335760
6/23/2024,Ariyanayaka Perera,Kandy,Hunnasgiriya,Central,9981,2315,12296,399240,92600,491840
6/24/2024,Ariyanayaka Perera,Kandy,Hunnasgiriya,Central,2812,4467,7279,112480,178680,291160
6/25/2024,Ariyanayaka Perera,Kandy,Hunnasgiriya,Central,9707,2778,12485,388280,111120,499400
6/26/2024,Ariyanayaka Perera,Kandy,Hunnasgiriya,Central,4619,1792,6411,184760,71680,256440
6/27/2024,Ariyanayaka Perera,Kandy,Hunnasgiriya,Central,7826,3165,10991,313040,126600,439640
6/28/2024,Ariyanayaka Perera,Kandy,Hunnasgiriya,Central,5829,3379,9208,233160,135160,368320
6/29/2024,Ariyanayaka Perera,Kandy,Hunnasgiriya,Central,3041,4527,7568,121640,181080,302720
6/30/2024,Ariyanayaka Perera,Kandy,Hunnasgiriya,Central,665,1635,2300,26600,65400,92000
7/1/2024,Ariyanayaka Perera,Kandy,Hunnasgiriya,Central,3231,9514,12745,129240,380560,509800
7/2/2024,Ariyanayaka Perera,Kandy,Hunnasgiriya,Central,6640,525,7165,265600,21000,286600
7/3/2024,Ariyanayaka Perera,Kandy,Hunnasgiriya,Central,2009,3508,5517,80360,140320,220680
7/4/2024,Ariyanayaka Perera,Kandy,Hunnasgiriya,Central,8555,125,8680,342200,5000,347200
7/5/2024,Ariyanayaka Perera,Kandy,Hunnasgiriya,Central,2366,3341,5707,94640,133640,228280
7/6/2024,Ariyanayaka Perera,Kandy,Hunnasgiriya,Central,3533,5217,8750,141320,208680,350000
7/7/2024,Ariyanayaka Perera,Kandy,Hunnasgiriya,Central,838,467,1305,33520,18680,52200
7/8/2024,Ariyanayaka Perera,Kandy,Hunnasgiriya,Central,6258,6853,13111,250320,274120,524440
7/9/2024,Ariyanayaka Perera,Kandy,Hunnasgiriya,Central,5243,6661,11904,209720,266440,476160
7/10/2024,Ariyanayaka Perera,Kandy,Hunnasgiriya,Central,6395,5816,12211,255800,232640,488440
7/11/2024,Ariyanayaka Perera,Kandy,Hunnasgiriya,Central,802,2668,3470,32080,106720,138800
7/12/2024,Ariyanayaka Perera,Kandy,Hunnasgiriya,Central,4275,8020,12295,171000,320800,491800
7/13/2024,Ariyanayaka Perera,Kandy,Hunnasgiriya,Central,4930,9035,13965,197200,361400,558600
7/14/2024,Ariyanayaka Perera,Kandy,Hunnasgiriya,Central,5329,8231,13560,213160,329240,542400
7/15/2024,Ariyanayaka Perera,Kandy,Hunnasgiriya,Central,1007,3774,4781,40280,150960,191240
7/16/2024,Ariyanayaka Perera,Kandy,Hunnasgiriya,Central,1666,3899,5565,66640,155960,222600
7/17/2024,Ariyanayaka Perera,Kandy,Hunnasgiriya,Central,310,3933,4243,12400,157320,169720
7/18/2024,Ariyanayaka Perera,Kandy,Hunnasgiriya,Central,117,5618,5735,4680,224720,229400
7/19/2024,Ariyanayaka Perera,Kandy,Hunnasgiriya,Central,6122,8447,14569,244880,337880,582760
7/20/2024,Ariyanayaka Perera,Kandy,Hunnasgiriya,Central,6557,2455,9012,262280,98200,360480
7/21/2024,Ariyanayaka Perera,Kandy,Hunnasgiriya,Central,2536,9027,11563,101440,361080,462520
7/22/2024,Ariyanayaka Perera,Kandy,Hunnasgiriya,Central,4710,1776,6486,188400,71040,259440
7/23/2024,Ariyanayaka Perera,Kandy,Hunnasgiriya,Central,6088,3149,9237,243520,125960,369480
7/24/2024,Ariyanayaka Perera,Kandy,Hunnasgiriya,Central,1617,3116,4733,64680,124640,189320
7/25/2024,Ariyanayaka Perera,Kandy,Hunnasgiriya,Central,4867,2469,7336,194680,98760,293440
7/26/2024,Ariyanayaka Perera,Kandy,Hunnasgiriya,Central,6312,2729,9041,252480,109160,361640
7/27/2024,Ariyanayaka Perera,Kandy,Hunnasgiriya,Central,2532,611,3143,101280,24440,125720
7/28/2024,Ariyanayaka Perera,Kandy,Hunnasgiriya,Central,5737,5126,10863,229480,205040,434520
7/29/2024,Ariyanayaka Perera,Kandy,Hunnasgiriya,Central,8960,2205,11165,358400,88200,446600
7/30/2024,Ariyanayaka Perera,Kandy,Hunnasgiriya,Central,7445,7289,14734,297800,291560,589360
7/31/2024,Ariyanayaka Perera,Kandy,Hunnasgiriya,Central,7454,7729,15183,298160,309160,607320
8/1/2024,Ariyanayaka Perera,Kandy,Hunnasgiriya,Central,4820,8756,13576,192800,350240,543040
8/2/2024,Ariyanayaka Perera,Kandy,Hunnasgiriya,Central,4939,2737,7676,197560,109480,307040
8/3/2024,Ariyanayaka Perera,Kandy,Hunnasgiriya,Central,4902,4836,9738,196080,193440,389520
8/4/2024,Ariyanayaka Perera,Kandy,Hunnasgiriya,Central,9353,2355,11708,374120,94200,468320
8/5/2024,Ariyanayaka Perera,Kandy,Hunnasgiriya,Central,5102,6270,11372,204080,250800,454880
8/6/2024,Ariyanayaka Perera,Kandy,Hunnasgiriya,Central,3154,7669,10823,126160,306760,432920
8/7/2024,Ariyanayaka Perera,Kandy,Hunnasgiriya,Central,8298,5546,13844,331920,221840,553760
8/8/2024,Ariyanayaka Perera,Kandy,Hunnasgiriya,Central,6025,4292,10317,241000,171680,412680
8/9/2024,Ariyanayaka Perera,Kandy,Hunnasgiriya,Central,6262,3186,9448,250480,127440,377920
8/10/2024,Ariyanayaka Perera,Kandy,Hunnasgiriya,Central,1670,4277,5947,66800,171080,237880
8/11/2024,Ariyanayaka Perera,Kandy,Hunnasgiriya,Central,7478,9123,16601,299120,364920,664040
8/12/2024,Ariyanayaka Perera,Kandy,Hunnasgiriya,Central,4601,8312,12913,184040,332480,516520
8/13/2024,Ariyanayaka Perera,Kandy,Hunnasgiriya,Central,7857,2918,10775,314280,116720,431000
8/14/2024,Ariyanayaka Perera,Kandy,Hunnasgiriya,Central,6581,4750,11331,263240,190000,453240
8/15/2024,Ariyanayaka Perera,Kandy,Hunnasgiriya,Central,1663,2531,4194,66520,101240,167760
8/16/2024,Ariyanayaka Perera,Kandy,Hunnasgiriya,Central,8682,285,8967,347280,11400,358680
8/17/2024,Ariyanayaka Perera,Kandy,Hunnasgiriya,Central,6959,671,7630,278360,26840,305200
8/18/2024,Ariyanayaka Perera,Kandy,Hunnasgiriya,Central,1121,8421,9542,44840,336840,381680
8/19/2024,Ariyanayaka Perera,Kandy,Hunnasgiriya,Central,4254,711,4965,170160,28440,198600
8/20/2024,Ariyanayaka Perera,Kandy,Hunnasgiriya,Central,4621,1737,6358,184840,69480,254320
8/21/2024,Ariyanayaka Perera,Kandy,Hunnasgiriya,Central,8235,2358,10593,329400,94320,423720
8/22/2024,Ariyanayaka Perera,Kandy,Hunnasgiriya,Central,667,4002,4669,26680,160080,186760
8/23/2024,Ariyanayaka Perera,Kandy,Hunnasgiriya,Central,6417,1529,7946,256680,61160,317840
8/24/2024,Ariyanayaka Perera,Kandy,Hunnasgiriya,Central,6657,3014,9671,266280,120560,386840
8/25/2024,Ariyanayaka Perera,Kandy,Hunnasgiriya,Central,3284,2758,6042,131360,110320,241680
8/26/2024,Ariyanayaka Perera,Kandy,Hunnasgiriya,Central,1352,2366,3718,54080,94640,148720
8/27/2024,Ariyanayaka Perera,Kandy,Hunnasgiriya,Central,246,5950,6196,9840,238000,247840
8/28/2024,Ariyanayaka Perera,Kandy,Hunnasgiriya,Central,214,5011,5225,8560,200440,209000
8/29/2024,Ariyanayaka Perera,Kandy,Hunnasgiriya,Central,2299,621,2920,91960,24840,116800
8/30/2024,Ariyanayaka Perera,Kandy,Hunnasgiriya,Central,8132,6405,14537,325280,256200,581480
8/31/2024,Ariyanayaka Perera,Kandy,Hunnasgiriya,Central,2568,6291,8859,102720,251640,354360
9/1/2024,Ariyanayaka Perera,Kandy,Hunnasgiriya,Central,3863,2333,6196,154520,93320,247840
9/2/2024,Ariyanayaka Perera,Kandy,Hunnasgiriya,Central,2843,1396,4239,113720,55840,169560
9/3/2024,Ariyanayaka Perera,Kandy,Hunnasgiriya,Central,2516,6044,8560,100640,241760,342400
9/4/2024,Ariyanayaka Perera,Kandy,Hunnasgiriya,Central,3075,5180,8255,123000,207200,330200
9/5/2024,Ariyanayaka Perera,Kandy,Hunnasgiriya,Central,3577,449,4026,143080,17960,161040
9/6/2024,Ariyanayaka Perera,Kandy,Hunnasgiriya,Central,5480,3408,8888,219200,136320,355520
9/7/2024,Ariyanayaka Perera,Kandy,Hunnasgiriya,Central,3734,5774,9508,149360,230960,380320
9/8/2024,Ariyanayaka Perera,Kandy,Hunnasgiriya,Central,5409,779,6188,216360,31160,247520
9/9/2024,Ariyanayaka Perera,Kandy,Hunnasgiriya,Central,5523,9107,14630,220920,364280,585200
9/10/2024,Ariyanayaka Perera,Kandy,Hunnasgiriya,Central,9632,7052,16684,385280,282080,667360
9/11/2024,Ariyanayaka Perera,Kandy,Hunnasgiriya,Central,2353,6607,8960,94120,264280,358400
9/12/2024,Ariyanayaka Perera,Kandy,Hunnasgiriya,Central,6504,3458,9962,260160,138320,398480
9/13/2024,Ariyanayaka Perera,Kandy,Hunnasgiriya,Central,209,4722,4931,8360,188880,197240
9/14/2024,Ariyanayaka Perera,Kandy,Hunnasgiriya,Central,9046,9915,18961,361840,396600,758440
9/15/2024,Ariyanayaka Perera,Kandy,Hunnasgiriya,Central,73,6813,6886,2920,272520,275440
9/16/2024,Ariyanayaka Perera,Kandy,Hunnasgiriya,Central,9672,6199,15871,386880,247960,634840
9/17/2024,Ariyanayaka Perera,Kandy,Hunnasgiriya,Central,6333,5429,11762,253320,217160,470480
9/18/2024,Ariyanayaka Perera,Kandy,Hunnasgiriya,Central,9204,2540,11744,368160,101600,469760
9/19/2024,Ariyanayaka Perera,Kandy,Hunnasgiriya,Central,4511,8338,12849,180440,333520,513960
9/20/2024,Ariyanayaka Perera,Kandy,Hunnasgiriya,Central,1989,77,2066,79560,3080,82640
9/21/2024,Ariyanayaka Perera,Kandy,Hunnasgiriya,Central,2187,7105,9292,87480,284200,371680
9/22/2024,Ariyanayaka Perera,Kandy,Hunnasgiriya,Central,8150,9419,17569,326000,376760,702760
9/23/2024,Ariyanayaka Perera,Kandy,Hunnasgiriya,Central,9146,641,9787,365840,25640,391480
9/24/2024,Ariyanayaka Perera,Kandy,Hunnasgiriya,Central,8117,7818,15935,324680,312720,637400
9/25/2024,Ariyanayaka Perera,Kandy,Hunnasgiriya,Central,3814,3071,6885,152560,122840,275400
9/26/2024,Ariyanayaka Perera,Kandy,Hunnasgiriya,Central,7355,1376,8731,294200,55040,349240
9/27/2024,Ariyanayaka Perera,Kandy,Hunnasgiriya,Central,5505,869,6374,220200,34760,254960
9/28/2024,Ariyanayaka Perera,Kandy,Hunnasgiriya,Central,813,7623,8436,32520,304920,337440
9/29/2024,Ariyanayaka Perera,Kandy,Hunnasgiriya,Central,7398,5208,12606,295920,208320,504240
9/30/2024,Ariyanayaka Perera,Kandy,Hunnasgiriya,Central,8314,8632,16946,332560,345280,677840
10/1/2024,Ariyanayaka Perera,Kandy,Hunnasgiriya,Central,1590,912,2502,63600,36480,100080
10/2/2024,Ariyanayaka Perera,Kandy,Hunnasgiriya,Central,8336,9774,18110,333440,390960,724400
10/3/2024,Ariyanayaka Perera,Kandy,Hunnasgiriya,Central,5433,767,6200,217320,30680,248000
10/4/2024,Ariyanayaka Perera,Kandy,Hunnasgiriya,Central,7649,8980,16629,305960,359200,665160
10/5/2024,Ariyanayaka Perera,Kandy,Hunnasgiriya,Central,7247,9781,17028,289880,391240,681120
10/6/2024,Ariyanayaka Perera,Kandy,Hunnasgiriya,Central,6694,3003,9697,267760,120120,387880
10/7/2024,Ariyanayaka Perera,Kandy,Hunnasgiriya,Central,3316,9083,12399,132640,363320,495960
10/8/2024,Ariyanayaka Perera,Kandy,Hunnasgiriya,Central,1822,9659,11481,72880,386360,459240
10/9/2024,Ariyanayaka Perera,Kandy,Hunnasgiriya,Central,8681,66,8747,347240,2640,349880
10/10/2024,Ariyanayaka Perera,Kandy,Hunnasgiriya,Central,9698,7477,17175,387920,299080,687000
10/11/2024,Ariyanayaka Perera,Kandy,Hunnasgiriya,Central,7120,5436,12556,284800,217440,502240
10/12/2024,Ariyanayaka Perera,Kandy,Hunnasgiriya,Central,5454,9585,15039,218160,383400,601560
10/13/2024,Ariyanayaka Perera,Kandy,Hunnasgiriya,Central,6185,9705,15890,247400,388200,635600
10/14/2024,Ariyanayaka Perera,Kandy,Hunnasgiriya,Central,8405,1960,10365,336200,78400,414600
10/15/2024,Ariyanayaka Perera,Kandy,Hunnasgiriya,Central,7722,4192,11914,308880,167680,476560
10/16/2024,Ariyanayaka Perera,Kandy,Hunnasgiriya,Central,3689,3011,6700,147560,120440,268000
10/17/2024,Ariyanayaka Perera,Kandy,Hunnasgiriya,Central,7784,6158,13942,311360,246320,557680
10/18/2024,Ariyanayaka Perera,Kandy,Hunnasgiriya,Central,6777,606,7383,271080,24240,295320
10/19/2024,Ariyanayaka Perera,Kandy,Hunnasgiriya,Central,182,1675,1857,7280,67000,74280
10/20/2024,Ariyanayaka Perera,Kandy,Hunnasgiriya,Central,1394,1927,3321,55760,77080,132840
10/21/2024,Ariyanayaka Perera,Kandy,Hunnasgiriya,Central,8833,7912,16745,353320,316480,669800
10/22/2024,Ariyanayaka Perera,Kandy,Hunnasgiriya,Central,7467,5112,12579,298680,204480,503160
10/23/2024,Ariyanayaka Perera,Kandy,Hunnasgiriya,Central,9995,2403,12398,399800,96120,495920
10/24/2024,Ariyanayaka Perera,Kandy,Hunnasgiriya,Central,7523,2696,10219,300920,107840,408760
10/25/2024,Ariyanayaka Perera,Kandy,Hunnasgiriya,Central,4207,9789,13996,168280,391560,559840
10/26/2024,Ariyanayaka Perera,Kandy,Hunnasgiriya,Central,6974,5267,12241,278960,210680,489640
10/27/2024,Ariyanayaka Perera,Kandy,Hunnasgiriya,Central,2161,9631,11792,86440,385240,471680
10/28/2024,Ariyanayaka Perera,Kandy,Hunnasgiriya,Central,261,3568,3829,10440,142720,153160
10/29/2024,Ariyanayaka Perera,Kandy,Hunnasgiriya,Central,7858,4281,12139,314320,171240,485560
10/30/2024,Ariyanayaka Perera,Kandy,Hunnasgiriya,Central,9150,1767,10917,366000,70680,436680
10/31/2024,Ariyanayaka Perera,Kandy,Hunnasgiriya,Central,5425,7231,12656,217000,289240,506240
11/1/2024,Ariyanayaka Perera,Kandy,Hunnasgiriya,Central,3921,2992,6913,156840,119680,276520
11/2/2024,Ariyanayaka Perera,Kandy,Hunnasgiriya,Central,518,6710,7228,20720,268400,289120
11/3/2024,Ariyanayaka Perera,Kandy,Hunnasgiriya,Central,289,8823,9112,11560,352920,364480
11/4/2024,Ariyanayaka Perera,Kandy,Hunnasgiriya,Central,2005,8610,10615,80200,344400,424600
11/5/2024,Ariyanayaka Perera,Kandy,Hunnasgiriya,Central,128,2040,2168,5120,81600,86720
11/6/2024,Ariyanayaka Perera,Kandy,Hunnasgiriya,Central,3297,2252,5549,131880,90080,221960
11/7/2024,Ariyanayaka Perera,Kandy,Hunnasgiriya,Central,6979,9707,16686,279160,388280,667440
11/8/2024,Ariyanayaka Perera,Kandy,Hunnasgiriya,Central,1994,1218,3212,79760,48720,128480
11/9/2024,Ariyanayaka Perera,Kandy,Hunnasgiriya,Central,7186,8170,15356,287440,326800,614240
11/10/2024,Ariyanayaka Perera,Kandy,Hunnasgiriya,Central,5005,9858,14863,200200,394320,594520
11/11/2024,Ariyanayaka Perera,Kandy,Hunnasgiriya,Central,2730,9766,12496,109200,390640,499840
11/12/2024,Ariyanayaka Perera,Kandy,Hunnasgiriya,Central,8027,42,8069,321080,1680,322760
11/13/2024,Ariyanayaka Perera,Kandy,Hunnasgiriya,Central,2688,3577,6265,107520,143080,250600
11/14/2024,Ariyanayaka Perera,Kandy,Hunnasgiriya,Central,9428,1198,10626,377120,47920,425040
11/15/2024,Ariyanayaka Perera,Kandy,Hunnasgiriya,Central,8572,8892,17464,342880,355680,698560
11/16/2024,Ariyanayaka Perera,Kandy,Hunnasgiriya,Central,3126,4630,7756,125040,185200,310240
11/17/2024,Ariyanayaka Perera,Kandy,Hunnasgiriya,Central,1534,3095,4629,61360,123800,185160
11/18/2024,Ariyanayaka Perera,Kandy,Hunnasgiriya,Central,4171,8625,12796,166840,345000,511840
11/19/2024,Ariyanayaka Perera,Kandy,Hunnasgiriya,Central,255,3804,4059,10200,152160,162360
11/20/2024,Ariyanayaka Perera,Kandy,Hunnasgiriya,Central,693,7247,7940,27720,289880,317600
11/21/2024,Ariyanayaka Perera,Kandy,Hunnasgiriya,Central,764,6898,7662,30560,275920,306480
11/22/2024,Ariyanayaka Perera,Kandy,Hunnasgiriya,Central,2763,6951,9714,110520,278040,388560
11/23/2024,Ariyanayaka Perera,Kandy,Hunnasgiriya,Central,6657,5905,12562,266280,236200,502480
11/24/2024,Ariyanayaka Perera,Kandy,Hunnasgiriya,Central,1597,8821,10418,63880,352840,416720
11/25/2024,Ariyanayaka Perera,Kandy,Hunnasgiriya,Central,4259,5958,10217,170360,238320,408680
11/26/2024,Ariyanayaka Perera,Kandy,Hunnasgiriya,Central,5770,8565,14335,230800,342600,573400
11/27/2024,Ariyanayaka Perera,Kandy,Hunnasgiriya,Central,3150,1590,4740,126000,63600,189600
11/28/2024,Ariyanayaka Perera,Kandy,Hunnasgiriya,Central,1161,2692,3853,46440,107680,154120
11/29/2024,Ariyanayaka Perera,Kandy,Hunnasgiriya,Central,6595,7484,14079,263800,299360,563160
11/30/2024,Ariyanayaka Perera,Kandy,Hunnasgiriya,Central,8668,8866,17534,346720,354640,701360
12/1/2024,Ariyanayaka Perera,Kandy,Hunnasgiriya,Central,6590,1047,7637,263600,41880,305480
12/2/2024,Ariyanayaka Perera,Kandy,Hunnasgiriya,Central,223,9043,9266,8920,361720,370640
12/3/2024,Ariyanayaka Perera,Kandy,Hunnasgiriya,Central,5962,3928,9890,238480,157120,395600
12/4/2024,Ariyanayaka Perera,Kandy,Hunnasgiriya,Central,8297,2924,11221,331880,116960,448840
12/5/2024,Ariyanayaka Perera,Kandy,Hunnasgiriya,Central,8283,1397,9680,331320,55880,387200
12/6/2024,Ariyanayaka Perera,Kandy,Hunnasgiriya,Central,4517,7669,12186,180680,306760,487440
12/7/2024,Ariyanayaka Perera,Kandy,Hunnasgiriya,Central,6815,9836,16651,272600,393440,666040
12/8/2024,Ariyanayaka Perera,Kandy,Hunnasgiriya,Central,5072,1592,6664,202880,63680,266560
12/9/2024,Ariyanayaka Perera,Kandy,Hunnasgiriya,Central,2583,6185,8768,103320,247400,350720
12/10/2024,Ariyanayaka Perera,Kandy,Hunnasgiriya,Central,393,8493,8886,15720,339720,355440
12/11/2024,Ariyanayaka Perera,Kandy,Hunnasgiriya,Central,7346,6643,13989,293840,265720,559560
12/12/2024,Ariyanayaka Perera,Kandy,Hunnasgiriya,Central,7947,6982,14929,317880,279280,597160
12/13/2024,Ariyanayaka Perera,Kandy,Hunnasgiriya,Central,9057,2554,11611,362280,102160,464440
12/14/2024,Ariyanayaka Perera,Kandy,Hunnasgiriya,Central,3942,4778,8720,157680,191120,348800
12/15/2024,Ariyanayaka Perera,Kandy,Hunnasgiriya,Central,896,2649,3545,35840,105960,141800
12/16/2024,Ariyanayaka Perera,Kandy,Hunnasgiriya,Central,3527,8490,12017,141080,339600,480680
12/17/2024,Ariyanayaka Perera,Kandy,Hunnasgiriya,Central,1628,8174,9802,65120,326960,392080
12/18/2024,Ariyanayaka Perera,Kandy,Hunnasgiriya,Central,9354,1340,10694,374160,53600,427760
12/19/2024,Ariyanayaka Perera,Kandy,Hunnasgiriya,Central,6202,8209,14411,248080,328360,576440
12/20/2024,Ariyanayaka Perera,Kandy,Hunnasgiriya,Central,7563,9993,17556,302520,399720,702240
12/21/2024,Ariyanayaka Perera,Kandy,Hunnasgiriya,Central,2236,6897,9133,89440,275880,365320
12/22/2024,Ariyanayaka Perera,Kandy,Hunnasgiriya,Central,4083,4126,8209,163320,165040,328360
12/23/2024,Ariyanayaka Perera,Kandy,Hunnasgiriya,Central,8633,9255,17888,345320,370200,715520
12/24/2024,Ariyanayaka Perera,Kandy,Hunnasgiriya,Central,5134,5444,10578,205360,217760,423120
12/25/2024,Ariyanayaka Perera,Kandy,Hunnasgiriya,Central,2500,7280,9780,100000,291200,391200
12/26/2024,Ariyanayaka Perera,Kandy,Hunnasgiriya,Central,102,7853,7955,4080,314120,318200
12/27/2024,Ariyanayaka Perera,Kandy,Hunnasgiriya,Central,5301,908,6209,212040,36320,248360
12/28/2024,Ariyanayaka Perera,Kandy,Hunnasgiriya,Central,3765,8581,12346,150600,343240,493840
12/29/2024,Ariyanayaka Perera,Kandy,Hunnasgiriya,Central,4507,8560,13067,180280,342400,522680
12/30/2024,Ariyanayaka Perera,Kandy,Hunnasgiriya,Central,6321,8304,14625,252840,332160,585000
12/31/2024,Ariyanayaka Perera,Kandy,Hunnasgiriya,Central,9552,7919,17471,382080,316760,698840
1/1/2025,Ariyanayaka Perera,Kandy,Hunnasgiriya,Central,5738,1519,7257,229520,60760,290280
1/2/2025,Ariyanayaka Perera,Kandy,Hunnasgiriya,Central,9510,9999,19509,380400,399960,780360
1/3/2025,Ariyanayaka Perera,Kandy,Hunnasgiriya,Central,4970,2110,7080,198800,84400,283200
1/4/2025,Ariyanayaka Perera,Kandy,Hunnasgiriya,Central,2349,3468,5817,93960,138720,232680
1/5/2025,Ariyanayaka Perera,Kandy,Hunnasgiriya,Central,7191,9283,16474,287640,371320,658960
1/6/2025,Ariyanayaka Perera,Kandy,Hunnasgiriya,Central,8066,9607,17673,322640,384280,706920
1/7/2025,Ariyanayaka Perera,Kandy,Hunnasgiriya,Central,9178,7593,16771,367120,303720,670840
1/8/2025,Ariyanayaka Perera,Kandy,Hunnasgiriya,Central,9367,3410,12777,374680,136400,511080
1/9/2025,Ariyanayaka Perera,Kandy,Hunnasgiriya,Central,4226,3753,7979,169040,150120,319160
1/10/2025,Ariyanayaka Perera,Kandy,Hunnasgiriya,Central,5804,2726,8530,232160,109040,341200
1/11/2025,Ariyanayaka Perera,Kandy,Hunnasgiriya,Central,1629,1986,3615,65160,79440,144600
1/12/2025,Ariyanayaka Perera,Kandy,Hunnasgiriya,Central,8375,1488,9863,335000,59520,394520
1/13/2025,Ariyanayaka Perera,Kandy,Hunnasgiriya,Central,9136,488,9624,365440,19520,384960
1/14/2025,Ariyanayaka Perera,Kandy,Hunnasgiriya,Central,9559,9669,19228,382360,386760,769120
1/15/2025,Ariyanayaka Perera,Kandy,Hunnasgiriya,Central,4178,6649,10827,167120,265960,433080
1/16/2025,Ariyanayaka Perera,Kandy,Hunnasgiriya,Central,3988,3079,7067,159520,123160,282680
1/17/2025,Ariyanayaka Perera,Kandy,Hunnasgiriya,Central,4445,171,4616,177800,6840,184640
1/18/2025,Ariyanayaka Perera,Kandy,Hunnasgiriya,Central,3881,4255,8136,155240,170200,325440
1/19/2025,Ariyanayaka Perera,Kandy,Hunnasgiriya,Central,3612,985,4597,144480,39400,183880
1/20/2025,Ariyanayaka Perera,Kandy,Hunnasgiriya,Central,5911,5261,11172,236440,210440,446880
1/21/2025,Ariyanayaka Perera,Kandy,Hunnasgiriya,Central,1980,2898,4878,79200,115920,195120
1/22/2025,Ariyanayaka Perera,Kandy,Hunnasgiriya,Central,3282,1691,4973,131280,67640,198920
1/23/2025,Ariyanayaka Perera,Kandy,Hunnasgiriya,Central,3752,2778,6530,150080,111120,261200
1/24/2025,Ariyanayaka Perera,Kandy,Hunnasgiriya,Central,6610,9957,16567,264400,398280,662680
1/25/2025,Ariyanayaka Perera,Kandy,Hunnasgiriya,Central,1701,5868,7569,68040,234720,302760
1/26/2025,Ariyanayaka Perera,Kandy,Hunnasgiriya,Central,9012,456,9468,360480,18240,378720
1/27/2025,Ariyanayaka Perera,Kandy,Hunnasgiriya,Central,1815,4765,6580,72600,190600,263200
1/28/2025,Ariyanayaka Perera,Kandy,Hunnasgiriya,Central,7032,9842,16874,281280,393680,674960
1/29/2025,Ariyanayaka Perera,Kandy,Hunnasgiriya,Central,6158,8416,14574,246320,336640,582960
1/30/2025,Ariyanayaka Perera,Kandy,Hunnasgiriya,Central,4160,841,5001,166400,33640,200040
1/31/2025,Ariyanayaka Perera,Kandy,Hunnasgiriya,Central,4082,6612,10694,163280,264480,427760
2/1/2025,Ariyanayaka Perera,Kandy,Hunnasgiriya,Central,7537,684,8221,301480,27360,328840
2/2/2025,Ariyanayaka Perera,Kandy,Hunnasgiriya,Central,7192,2320,9512,287680,92800,380480
2/3/2025,Ariyanayaka Perera,Kandy,Hunnasgiriya,Central,1286,619,1905,51440,24760,76200
2/4/2025,Ariyanayaka Perera,Kandy,Hunnasgiriya,Central,6668,8006,14674,266720,320240,586960
2/5/2025,Ariyanayaka Perera,Kandy,Hunnasgiriya,Central,7352,930,8282,294080,37200,331280
2/6/2025,Ariyanayaka Perera,Kandy,Hunnasgiriya,Central,2544,1852,4396,101760,74080,175840
2/7/2025,Ariyanayaka Perera,Kandy,Hunnasgiriya,Central,6003,4185,10188,240120,167400,407520
2/8/2025,Ariyanayaka Perera,Kandy,Hunnasgiriya,Central,5775,9738,15513,231000,389520,620520
2/9/2025,Ariyanayaka Perera,Kandy,Hunnasgiriya,Central,6797,9491,16288,271880,379640,651520
2/10/2025,Ariyanayaka Perera,Kandy,Hunnasgiriya,Central,9519,4807,14326,380760,192280,573040
2/11/2025,Ariyanayaka Perera,Kandy,Hunnasgiriya,Central,8344,3993,12337,333760,159720,493480
2/12/2025,Ariyanayaka Perera,Kandy,Hunnasgiriya,Central,8391,4456,12847,335640,178240,513880
2/13/2025,Ariyanayaka Perera,Kandy,Hunnasgiriya,Central,3716,3480,7196,148640,139200,287840
2/14/2025,Ariyanayaka Perera,Kandy,Hunnasgiriya,Central,1656,158,1814,66240,6320,72560
2/15/2025,Ariyanayaka Perera,Kandy,Hunnasgiriya,Central,7583,7748,15331,303320,309920,613240
2/16/2025,Ariyanayaka Perera,Kandy,Hunnasgiriya,Central,356,536,892,14240,21440,35680
2/17/2025,Ariyanayaka Perera,Kandy,Hunnasgiriya,Central,3435,8548,11983,137400,341920,479320
2/18/2025,Ariyanayaka Perera,Kandy,Hunnasgiriya,Central,8923,4433,13356,356920,177320,534240
2/19/2025,Ariyanayaka Perera,Kandy,Hunnasgiriya,Central,2768,1507,4275,110720,60280,171000
2/20/2025,Ariyanayaka Perera,Kandy,Hunnasgiriya,Central,4721,1060,5781,188840,42400,231240
2/21/2025,Ariyanayaka Perera,Kandy,Hunnasgiriya,Central,1459,630,2089,58360,25200,83560
2/22/2025,Ariyanayaka Perera,Kandy,Hunnasgiriya,Central,5346,5804,11150,213840,232160,446000
2/23/2025,Ariyanayaka Perera,Kandy,Hunnasgiriya,Central,8000,7476,15476,320000,299040,619040
2/24/2025,Ariyanayaka Perera,Kandy,Hunnasgiriya,Central,8954,3710,12664,358160,148400,506560
2/25/2025,Ariyanayaka Perera,Kandy,Hunnasgiriya,Central,5770,2071,7841,230800,82840,313640
2/26/2025,Ariyanayaka Perera,Kandy,Hunnasgiriya,Central,2531,3027,5558,101240,121080,222320
2/27/2025,Ariyanayaka Perera,Kandy,Hunnasgiriya,Central,1337,9625,10962,53480,385000,438480
2/28/2025,Ariyanayaka Perera,Kandy,Hunnasgiriya,Central,1710,4368,6078,68400,174720,243120
3/1/2025,Ariyanayaka Perera,Kandy,Hunnasgiriya,Central,6863,3026,9889,274520,121040,395560
3/2/2025,Ariyanayaka Perera,Kandy,Hunnasgiriya,Central,9040,6698,15738,361600,267920,629520
3/3/2025,Ariyanayaka Perera,Kandy,Hunnasgiriya,Central,794,8975,9769,31760,359000,390760
3/4/2025,Ariyanayaka Perera,Kandy,Hunnasgiriya,Central,9235,2700,11935,369400,108000,477400
3/5/2025,Ariyanayaka Perera,Kandy,Hunnasgiriya,Central,6125,4199,10324,245000,167960,412960
3/6/2025,Ariyanayaka Perera,Kandy,Hunnasgiriya,Central,2415,4026,6441,96600,161040,257640
3/7/2025,Ariyanayaka Perera,Kandy,Hunnasgiriya,Central,9790,4819,14609,391600,192760,584360
3/8/2025,Ariyanayaka Perera,Kandy,Hunnasgiriya,Central,2005,4964,6969,80200,198560,278760
3/9/2025,Ariyanayaka Perera,Kandy,Hunnasgiriya,Central,2054,2744,4798,82160,109760,191920
3/10/2025,Ariyanayaka Perera,Kandy,Hunnasgiriya,Central,8053,8378,16431,322120,335120,657240
3/11/2025,Ariyanayaka Perera,Kandy,Hunnasgiriya,Central,4883,7117,12000,195320,284680,480000
3/12/2025,Ariyanayaka Perera,Kandy,Hunnasgiriya,Central,7969,9308,17277,318760,372320,691080
3/13/2025,Ariyanayaka Perera,Kandy,Hunnasgiriya,Central,8255,4282,12537,330200,171280,501480
3/14/2025,Ariyanayaka Perera,Kandy,Hunnasgiriya,Central,4779,2422,7201,191160,96880,288040
3/15/2025,Ariyanayaka Perera,Kandy,Hunnasgiriya,Central,6457,6178,12635,258280,247120,505400
3/16/2025,Ariyanayaka Perera,Kandy,Hunnasgiriya,Central,1142,9109,10251,45680,364360,410040
3/17/2025,Ariyanayaka Perera,Kandy,Hunnasgiriya,Central,5007,677,5684,200280,27080,227360
3/18/2025,Ariyanayaka Perera,Kandy,Hunnasgiriya,Central,5287,3202,8489,211480,128080,339560
3/19/2025,Ariyanayaka Perera,Kandy,Hunnasgiriya,Central,6491,9337,15828,259640,373480,633120
3/20/2025,Ariyanayaka Perera,Kandy,Hunnasgiriya,Central,4045,3630,7675,161800,145200,307000
3/21/2025,Ariyanayaka Perera,Kandy,Hunnasgiriya,Central,9100,594,9694,364000,23760,387760
3/22/2025,Ariyanayaka Perera,Kandy,Hunnasgiriya,Central,4107,7359,11466,164280,294360,458640
3/23/2025,Ariyanayaka Perera,Kandy,Hunnasgiriya,Central,981,2967,3948,39240,118680,157920
3/25/2024,Indrajith Abeykoon,Kalutara,Dodangoda,Western,4341,9037,13378,173640,361480,535120
3/26/2024,Indrajith Abeykoon,Kalutara,Dodangoda,Western,1850,1065,2915,74000,42600,116600
3/27/2024,Indrajith Abeykoon,Kalutara,Dodangoda,Western,8707,6062,14769,348280,242480,590760
3/28/2024,Indrajith Abeykoon,Kalutara,Dodangoda,Western,4080,6355,10435,163200,254200,417400
3/29/2024,Indrajith Abeykoon,Kalutara,Dodangoda,Western,5277,7980,13257,211080,319200,530280
3/30/2024,Indrajith Abeykoon,Kalutara,Dodangoda,Western,2331,1599,3930,93240,63960,157200
3/31/2024,Indrajith Abeykoon,Kalutara,Dodangoda,Western,6658,6045,12703,266320,241800,508120
4/1/2024,Indrajith Abeykoon,Kalutara,Dodangoda,Western,3154,1703,4857,126160,68120,194280
4/2/2024,Indrajith Abeykoon,Kalutara,Dodangoda,Western,5955,2434,8389,238200,97360,335560
4/3/2024,Indrajith Abeykoon,Kalutara,Dodangoda,Western,4996,4433,9429,199840,177320,377160
4/4/2024,Indrajith Abeykoon,Kalutara,Dodangoda,Western,3504,9198,12702,140160,367920,508080
4/5/2024,Indrajith Abeykoon,Kalutara,Dodangoda,Western,2558,9945,12503,102320,397800,500120
4/6/2024,Indrajith Abeykoon,Kalutara,Dodangoda,Western,2324,1930,4254,92960,77200,170160
4/7/2024,Indrajith Abeykoon,Kalutara,Dodangoda,Western,5058,7964,13022,202320,318560,520880
4/8/2024,Indrajith Abeykoon,Kalutara,Dodangoda,Western,9086,2289,11375,363440,91560,455000
4/9/2024,Indrajith Abeykoon,Kalutara,Dodangoda,Western,7601,3921,11522,304040,156840,460880
4/10/2024,Indrajith Abeykoon,Kalutara,Dodangoda,Western,3466,3044,6510,138640,121760,260400
4/11/2024,Indrajith Abeykoon,Kalutara,Dodangoda,Western,5014,8566,13580,200560,342640,543200
4/19/2024,Indrajith Abeykoon,Kalutara,Dodangoda,Western,2600,7103,9703,104000,284120,388120
4/20/2024,Indrajith Abeykoon,Kalutara,Dodangoda,Western,7016,6149,13165,280640,245960,526600
4/21/2024,Indrajith Abeykoon,Kalutara,Dodangoda,Western,6876,6779,13655,275040,271160,546200
4/22/2024,Indrajith Abeykoon,Kalutara,Dodangoda,Western,5854,9643,15497,234160,385720,619880
4/23/2024,Indrajith Abeykoon,Kalutara,Dodangoda,Western,9028,3578,12606,361120,143120,504240
4/24/2024,Indrajith Abeykoon,Kalutara,Dodangoda,Western,5508,6285,11793,220320,251400,471720
4/25/2024,Indrajith Abeykoon,Kalutara,Dodangoda,Western,7004,9832,16836,280160,393280,673440
4/26/2024,Indrajith Abeykoon,Kalutara,Dodangoda,Western,474,6389,6863,18960,255560,274520
4/27/2024,Indrajith Abeykoon,Kalutara,Dodangoda,Western,8575,5417,13992,343000,216680,559680
4/28/2024,Indrajith Abeykoon,Kalutara,Dodangoda,Western,2278,5037,7315,91120,201480,292600
4/29/2024,Indrajith Abeykoon,Kalutara,Dodangoda,Western,7931,7451,15382,317240,298040,615280
4/30/2024,Indrajith Abeykoon,Kalutara,Dodangoda,Western,5453,4814,10267,218120,192560,410680
5/1/2024,Indrajith Abeykoon,Kalutara,Dodangoda,Western,6268,9817,16085,250720,392680,643400
5/2/2024,Indrajith Abeykoon,Kalutara,Dodangoda,Western,4322,7502,11824,172880,300080,472960
5/3/2024,Indrajith Abeykoon,Kalutara,Dodangoda,Western,261,7620,7881,10440,304800,315240
5/4/2024,Indrajith Abeykoon,Kalutara,Dodangoda,Western,5886,3604,9490,235440,144160,379600
5/5/2024,Indrajith Abeykoon,Kalutara,Dodangoda,Western,2357,3592,5949,94280,143680,237960
5/6/2024,Indrajith Abeykoon,Kalutara,Dodangoda,Western,9092,4954,14046,363680,198160,561840
5/7/2024,Indrajith Abeykoon,Kalutara,Dodangoda,Western,6426,7608,14034,257040,304320,561360
5/8/2024,Indrajith Abeykoon,Kalutara,Dodangoda,Western,8313,6972,15285,332520,278880,611400
5/9/2024,Indrajith Abeykoon,Kalutara,Dodangoda,Western,9564,2379,11943,382560,95160,477720
5/10/2024,Indrajith Abeykoon,Kalutara,Dodangoda,Western,5162,3069,8231,206480,122760,329240
5/11/2024,Indrajith Abeykoon,Kalutara,Dodangoda,Western,7321,8196,15517,292840,327840,620680
5/12/2024,Indrajith Abeykoon,Kalutara,Dodangoda,Western,2963,6917,9880,118520,276680,395200
5/13/2024,Indrajith Abeykoon,Kalutara,Dodangoda,Western,2378,3299,5677,95120,131960,227080
5/14/2024,Indrajith Abeykoon,Kalutara,Dodangoda,Western,4443,8627,13070,177720,345080,522800
5/15/2024,Indrajith Abeykoon,Kalutara,Dodangoda,Western,1252,7566,8818,50080,302640,352720
5/16/2024,Indrajith Abeykoon,Kalutara,Dodangoda,Western,6683,297,6980,267320,11880,279200
5/17/2024,Indrajith Abeykoon,Kalutara,Dodangoda,Western,4303,4017,8320,172120,160680,332800
5/18/2024,Indrajith Abeykoon,Kalutara,Dodangoda,Western,4679,1794,6473,187160,71760,258920
5/19/2024,Indrajith Abeykoon,Kalutara,Dodangoda,Western,4406,8620,13026,176240,344800,521040
5/20/2024,Indrajith Abeykoon,Kalutara,Dodangoda,Western,9580,2484,12064,383200,99360,482560
5/21/2024,Indrajith Abeykoon,Kalutara,Dodangoda,Western,3738,5356,9094,149520,214240,363760
5/22/2024,Indrajith Abeykoon,Kalutara,Dodangoda,Western,8831,6938,15769,353240,277520,630760
5/24/2024,Indrajith Abeykoon,Kalutara,Dodangoda,Western,3498,3353,6851,139920,134120,274040
5/25/2024,Indrajith Abeykoon,Kalutara,Dodangoda,Western,9428,3167,12595,377120,126680,503800
5/26/2024,Indrajith Abeykoon,Kalutara,Dodangoda,Western,5734,271,6005,229360,10840,240200
5/27/2024,Indrajith Abeykoon,Kalutara,Dodangoda,Western,8706,2388,11094,348240,95520,443760
5/28/2024,Indrajith Abeykoon,Kalutara,Dodangoda,Western,4050,4478,8528,162000,179120,341120
5/29/2024,Indrajith Abeykoon,Kalutara,Dodangoda,Western,6679,2544,9223,267160,101760,368920
5/30/2024,Indrajith Abeykoon,Kalutara,Dodangoda,Western,1295,4015,5310,51800,160600,212400
5/31/2024,Indrajith Abeykoon,Kalutara,Dodangoda,Western,3294,3231,6525,131760,129240,261000
6/1/2024,Indrajith Abeykoon,Kalutara,Dodangoda,Western,8496,5075,13571,339840,203000,542840
6/2/2024,Indrajith Abeykoon,Kalutara,Dodangoda,Western,4851,9685,14536,194040,387400,581440
6/3/2024,Indrajith Abeykoon,Kalutara,Dodangoda,Western,6218,237,6455,248720,9480,258200
6/4/2024,Indrajith Abeykoon,Kalutara,Dodangoda,Western,3842,2455,6297,153680,98200,251880
6/5/2024,Indrajith Abeykoon,Kalutara,Dodangoda,Western,3044,8217,11261,121760,328680,450440
6/6/2024,Indrajith Abeykoon,Kalutara,Dodangoda,Western,3586,9963,13549,143440,398520,541960
6/7/2024,Indrajith Abeykoon,Kalutara,Dodangoda,Western,4761,6642,11403,190440,265680,456120
6/8/2024,Indrajith Abeykoon,Kalutara,Dodangoda,Western,7837,8126,15963,313480,325040,638520
6/9/2024,Indrajith Abeykoon,Kalutara,Dodangoda,Western,3080,2029,5109,123200,81160,204360
6/10/2024,Indrajith Abeykoon,Kalutara,Dodangoda,Western,3102,7173,10275,124080,286920,411000
6/11/2024,Indrajith Abeykoon,Kalutara,Dodangoda,Western,3528,6581,10109,141120,263240,404360
6/12/2024,Indrajith Abeykoon,Kalutara,Dodangoda,Western,5394,2337,7731,215760,93480,309240
6/13/2024,Indrajith Abeykoon,Kalutara,Dodangoda,Western,3939,1766,5705,157560,70640,228200
6/14/2024,Indrajith Abeykoon,Kalutara,Dodangoda,Western,8733,2185,10918,349320,87400,436720
6/15/2024,Indrajith Abeykoon,Kalutara,Dodangoda,Western,6935,1947,8882,277400,77880,355280
6/16/2024,Indrajith Abeykoon,Kalutara,Dodangoda,Western,3934,2544,6478,157360,101760,259120
6/17/2024,Indrajith Abeykoon,Kalutara,Dodangoda,Western,298,6927,7225,11920,277080,289000
6/18/2024,Indrajith Abeykoon,Kalutara,Dodangoda,Western,4037,9097,13134,161480,363880,525360
6/19/2024,Indrajith Abeykoon,Kalutara,Dodangoda,Western,4722,5121,9843,188880,204840,393720
6/20/2024,Indrajith Abeykoon,Kalutara,Dodangoda,Western,6203,3089,9292,248120,123560,371680
6/21/2024,Indrajith Abeykoon,Kalutara,Dodangoda,Western,2021,9369,11390,80840,374760,455600
6/22/2024,Indrajith Abeykoon,Kalutara,Dodangoda,Western,2423,6878,9301,96920,275120,372040
6/23/2024,Indrajith Abeykoon,Kalutara,Dodangoda,Western,2007,1258,3265,80280,50320,130600
6/24/2024,Indrajith Abeykoon,Kalutara,Dodangoda,Western,1018,7993,9011,40720,319720,360440
6/25/2024,Indrajith Abeykoon,Kalutara,Dodangoda,Western,5160,2377,7537,206400,95080,301480
6/26/2024,Indrajith Abeykoon,Kalutara,Dodangoda,Western,6630,841,7471,265200,33640,298840
6/27/2024,Indrajith Abeykoon,Kalutara,Dodangoda,Western,897,1130,2027,35880,45200,81080
6/28/2024,Indrajith Abeykoon,Kalutara,Dodangoda,Western,5439,7480,12919,217560,299200,516760
6/29/2024,Indrajith Abeykoon,Kalutara,Dodangoda,Western,4351,3866,8217,174040,154640,328680
6/30/2024,Indrajith Abeykoon,Kalutara,Dodangoda,Western,9734,904,10638,389360,36160,425520
7/1/2024,Indrajith Abeykoon,Kalutara,Dodangoda,Western,9538,5026,14564,381520,201040,582560
7/2/2024,Indrajith Abeykoon,Kalutara,Dodangoda,Western,3917,2977,6894,156680,119080,275760
7/3/2024,Indrajith Abeykoon,Kalutara,Dodangoda,Western,54,4428,4482,2160,177120,179280
7/4/2024,Indrajith Abeykoon,Kalutara,Dodangoda,Western,5149,5216,10365,205960,208640,414600
7/5/2024,Indrajith Abeykoon,Kalutara,Dodangoda,Western,9840,9061,18901,393600,362440,756040
7/6/2024,Indrajith Abeykoon,Kalutara,Dodangoda,Western,9400,5574,14974,376000,222960,598960
7/7/2024,Indrajith Abeykoon,Kalutara,Dodangoda,Western,1524,3152,4676,60960,126080,187040
7/8/2024,Indrajith Abeykoon,Kalutara,Dodangoda,Western,1898,7363,9261,75920,294520,370440
7/9/2024,Indrajith Abeykoon,Kalutara,Dodangoda,Western,2422,9085,11507,96880,363400,460280
7/10/2024,Indrajith Abeykoon,Kalutara,Dodangoda,Western,9093,5940,15033,363720,237600,601320
7/11/2024,Indrajith Abeykoon,Kalutara,Dodangoda,Western,7490,1291,8781,299600,51640,351240
7/12/2024,Indrajith Abeykoon,Kalutara,Dodangoda,Western,2343,1706,4049,93720,68240,161960
7/13/2024,Indrajith Abeykoon,Kalutara,Dodangoda,Western,3253,7853,11106,130120,314120,444240
7/14/2024,Indrajith Abeykoon,Kalutara,Dodangoda,Western,9461,4216,13677,378440,168640,547080
7/15/2024,Indrajith Abeykoon,Kalutara,Dodangoda,Western,547,8479,9026,21880,339160,361040
7/16/2024,Indrajith Abeykoon,Kalutara,Dodangoda,Western,7944,5548,13492,317760,221920,539680
7/17/2024,Indrajith Abeykoon,Kalutara,Dodangoda,Western,3625,865,4490,145000,34600,179600
7/18/2024,Indrajith Abeykoon,Kalutara,Dodangoda,Western,7957,3709,11666,318280,148360,466640
7/19/2024,Indrajith Abeykoon,Kalutara,Dodangoda,Western,9413,1065,10478,376520,42600,419120
7/20/2024,Indrajith Abeykoon,Kalutara,Dodangoda,Western,1710,9660,11370,68400,386400,454800
7/21/2024,Indrajith Abeykoon,Kalutara,Dodangoda,Western,9756,8454,18210,390240,338160,728400
7/22/2024,Indrajith Abeykoon,Kalutara,Dodangoda,Western,6988,63,7051,279520,2520,282040
7/23/2024,Indrajith Abeykoon,Kalutara,Dodangoda,Western,9719,4331,14050,388760,173240,562000
7/24/2024,Indrajith Abeykoon,Kalutara,Dodangoda,Western,7148,9132,16280,285920,365280,651200
7/25/2024,Indrajith Abeykoon,Kalutara,Dodangoda,Western,1841,4398,6239,73640,175920,249560
7/26/2024,Indrajith Abeykoon,Kalutara,Dodangoda,Western,9066,9373,18439,362640,374920,737560
7/27/2024,Indrajith Abeykoon,Kalutara,Dodangoda,Western,307,5507,5814,12280,220280,232560
7/28/2024,Indrajith Abeykoon,Kalutara,Dodangoda,Western,4562,9998,14560,182480,399920,582400
7/29/2024,Indrajith Abeykoon,Kalutara,Dodangoda,Western,1230,6686,7916,49200,267440,316640
7/30/2024,Indrajith Abeykoon,Kalutara,Dodangoda,Western,7159,9292,16451,286360,371680,658040
7/31/2024,Indrajith Abeykoon,Kalutara,Dodangoda,Western,1550,2931,4481,62000,117240,179240
8/1/2024,Indrajith Abeykoon,Kalutara,Dodangoda,Western,2649,2262,4911,105960,90480,196440
8/2/2024,Indrajith Abeykoon,Kalutara,Dodangoda,Western,5762,2899,8661,230480,115960,346440
8/3/2024,Indrajith Abeykoon,Kalutara,Dodangoda,Western,6828,6398,13226,273120,255920,529040
8/4/2024,Indrajith Abeykoon,Kalutara,Dodangoda,Western,5341,7315,12656,213640,292600,506240
8/5/2024,Indrajith Abeykoon,Kalutara,Dodangoda,Western,5992,8758,14750,239680,350320,590000
8/6/2024,Indrajith Abeykoon,Kalutara,Dodangoda,Western,241,6947,7188,9640,277880,287520
8/7/2024,Indrajith Abeykoon,Kalutara,Dodangoda,Western,1253,604,1857,50120,24160,74280
8/8/2024,Indrajith Abeykoon,Kalutara,Dodangoda,Western,7835,3673,11508,313400,146920,460320
8/9/2024,Indrajith Abeykoon,Kalutara,Dodangoda,Western,9790,5399,15189,391600,215960,607560
8/10/2024,Indrajith Abeykoon,Kalutara,Dodangoda,Western,6404,6254,12658,256160,250160,506320
8/11/2024,Indrajith Abeykoon,Kalutara,Dodangoda,Western,1145,7434,8579,45800,297360,343160
8/12/2024,Indrajith Abeykoon,Kalutara,Dodangoda,Western,2695,1679,4374,107800,67160,174960
8/13/2024,Indrajith Abeykoon,Kalutara,Dodangoda,Western,6469,7150,13619,258760,286000,544760
8/14/2024,Indrajith Abeykoon,Kalutara,Dodangoda,Western,877,2677,3554,35080,107080,142160
8/15/2024,Indrajith Abeykoon,Kalutara,Dodangoda,Western,1521,684,2205,60840,27360,88200
8/16/2024,Indrajith Abeykoon,Kalutara,Dodangoda,Western,1244,2624,3868,49760,104960,154720
8/17/2024,Indrajith Abeykoon,Kalutara,Dodangoda,Western,7515,7132,14647,300600,285280,585880
8/18/2024,Indrajith Abeykoon,Kalutara,Dodangoda,Western,9714,6926,16640,388560,277040,665600
8/19/2024,Indrajith Abeykoon,Kalutara,Dodangoda,Western,9419,8469,17888,376760,338760,715520
8/20/2024,Indrajith Abeykoon,Kalutara,Dodangoda,Western,7207,6165,13372,288280,246600,534880
8/21/2024,Indrajith Abeykoon,Kalutara,Dodangoda,Western,7810,1717,9527,312400,68680,381080
8/22/2024,Indrajith Abeykoon,Kalutara,Dodangoda,Western,1384,4923,6307,55360,196920,252280
8/23/2024,Indrajith Abeykoon,Kalutara,Dodangoda,Western,8083,6674,14757,323320,266960,590280
8/24/2024,Indrajith Abeykoon,Kalutara,Dodangoda,Western,4312,6327,10639,172480,253080,425560
8/25/2024,Indrajith Abeykoon,Kalutara,Dodangoda,Western,5909,8265,14174,236360,330600,566960
8/26/2024,Indrajith Abeykoon,Kalutara,Dodangoda,Western,616,295,911,24640,11800,36440
8/27/2024,Indrajith Abeykoon,Kalutara,Dodangoda,Western,8971,7601,16572,358840,304040,662880
8/28/2024,Indrajith Abeykoon,Kalutara,Dodangoda,Western,1548,7704,9252,61920,308160,370080
8/29/2024,Indrajith Abeykoon,Kalutara,Dodangoda,Western,2196,1524,3720,87840,60960,148800
8/30/2024,Indrajith Abeykoon,Kalutara,Dodangoda,Western,3684,1976,5660,147360,79040,226400
8/31/2024,Indrajith Abeykoon,Kalutara,Dodangoda,Western,3841,4641,8482,153640,185640,339280
9/1/2024,Indrajith Abeykoon,Kalutara,Dodangoda,Western,5435,524,5959,217400,20960,238360
9/2/2024,Indrajith Abeykoon,Kalutara,Dodangoda,Western,7722,3319,11041,308880,132760,441640
9/3/2024,Indrajith Abeykoon,Kalutara,Dodangoda,Western,8628,9424,18052,345120,376960,722080
9/4/2024,Indrajith Abeykoon,Kalutara,Dodangoda,Western,4676,1437,6113,187040,57480,244520
9/5/2024,Indrajith Abeykoon,Kalutara,Dodangoda,Western,9853,2367,12220,394120,94680,488800
9/6/2024,Indrajith Abeykoon,Kalutara,Dodangoda,Western,3005,4635,7640,120200,185400,305600
9/7/2024,Indrajith Abeykoon,Kalutara,Dodangoda,Western,8934,9870,18804,357360,394800,752160
9/8/2024,Indrajith Abeykoon,Kalutara,Dodangoda,Western,9431,6920,16351,377240,276800,654040
9/9/2024,Indrajith Abeykoon,Kalutara,Dodangoda,Western,8596,9113,17709,343840,364520,708360
9/10/2024,Indrajith Abeykoon,Kalutara,Dodangoda,Western,6949,2160,9109,277960,86400,364360
9/11/2024,Indrajith Abeykoon,Kalutara,Dodangoda,Western,5043,4389,9432,201720,175560,377280
9/12/2024,Indrajith Abeykoon,Kalutara,Dodangoda,Western,5,9674,9679,200,386960,387160
9/13/2024,Indrajith Abeykoon,Kalutara,Dodangoda,Western,3729,8315,12044,149160,332600,481760
9/14/2024,Indrajith Abeykoon,Kalutara,Dodangoda,Western,2837,9894,12731,113480,395760,509240
9/15/2024,Indrajith Abeykoon,Kalutara,Dodangoda,Western,5866,4629,10495,234640,185160,419800
9/16/2024,Indrajith Abeykoon,Kalutara,Dodangoda,Western,8178,8530,16708,327120,341200,668320
9/17/2024,Indrajith Abeykoon,Kalutara,Dodangoda,Western,5496,4502,9998,219840,180080,399920
9/18/2024,Indrajith Abeykoon,Kalutara,Dodangoda,Western,1174,4751,5925,46960,190040,237000
9/19/2024,Indrajith Abeykoon,Kalutara,Dodangoda,Western,5609,2996,8605,224360,119840,344200
9/20/2024,Indrajith Abeykoon,Kalutara,Dodangoda,Western,5606,9865,15471,224240,394600,618840
9/21/2024,Indrajith Abeykoon,Kalutara,Dodangoda,Western,430,593,1023,17200,23720,40920
9/22/2024,Indrajith Abeykoon,Kalutara,Dodangoda,Western,6515,373,6888,260600,14920,275520
9/23/2024,Indrajith Abeykoon,Kalutara,Dodangoda,Western,5496,2771,8267,219840,110840,330680
9/24/2024,Indrajith Abeykoon,Kalutara,Dodangoda,Western,9518,3483,13001,380720,139320,520040
9/25/2024,Indrajith Abeykoon,Kalutara,Dodangoda,Western,501,807,1308,20040,32280,52320
9/26/2024,Indrajith Abeykoon,Kalutara,Dodangoda,Western,985,3490,4475,39400,139600,179000
9/27/2024,Indrajith Abeykoon,Kalutara,Dodangoda,Western,1771,4503,6274,70840,180120,250960
9/28/2024,Indrajith Abeykoon,Kalutara,Dodangoda,Western,9596,1608,11204,383840,64320,448160
9/29/2024,Indrajith Abeykoon,Kalutara,Dodangoda,Western,9229,5139,14368,369160,205560,574720
9/30/2024,Indrajith Abeykoon,Kalutara,Dodangoda,Western,9321,6011,15332,372840,240440,613280
10/1/2024,Indrajith Abeykoon,Kalutara,Dodangoda,Western,5114,4201,9315,204560,168040,372600
10/2/2024,Indrajith Abeykoon,Kalutara,Dodangoda,Western,6184,8981,15165,247360,359240,606600
10/3/2024,Indrajith Abeykoon,Kalutara,Dodangoda,Western,7494,3184,10678,299760,127360,427120
10/4/2024,Indrajith Abeykoon,Kalutara,Dodangoda,Western,659,8439,9098,26360,337560,363920
10/5/2024,Indrajith Abeykoon,Kalutara,Dodangoda,Western,1683,8636,10319,67320,345440,412760
10/6/2024,Indrajith Abeykoon,Kalutara,Dodangoda,Western,572,8798,9370,22880,351920,374800
10/7/2024,Indrajith Abeykoon,Kalutara,Dodangoda,Western,6950,205,7155,278000,8200,286200
10/8/2024,Indrajith Abeykoon,Kalutara,Dodangoda,Western,616,6287,6903,24640,251480,276120
10/9/2024,Indrajith Abeykoon,Kalutara,Dodangoda,Western,1156,7652,8808,46240,306080,352320
10/10/2024,Indrajith Abeykoon,Kalutara,Dodangoda,Western,1714,7549,9263,68560,301960,370520
10/11/2024,Indrajith Abeykoon,Kalutara,Dodangoda,Western,7487,8631,16118,299480,345240,644720
10/12/2024,Indrajith Abeykoon,Kalutara,Dodangoda,Western,3335,817,4152,133400,32680,166080
10/13/2024,Indrajith Abeykoon,Kalutara,Dodangoda,Western,866,2700,3566,34640,108000,142640
10/14/2024,Indrajith Abeykoon,Kalutara,Dodangoda,Western,1199,6957,8156,47960,278280,326240
10/15/2024,Indrajith Abeykoon,Kalutara,Dodangoda,Western,3958,7209,11167,158320,288360,446680
10/16/2024,Indrajith Abeykoon,Kalutara,Dodangoda,Western,6857,5143,12000,274280,205720,480000
10/17/2024,Indrajith Abeykoon,Kalutara,Dodangoda,Western,3488,3390,6878,139520,135600,275120
10/18/2024,Indrajith Abeykoon,Kalutara,Dodangoda,Western,4279,1084,5363,171160,43360,214520
10/19/2024,Indrajith Abeykoon,Kalutara,Dodangoda,Western,615,7606,8221,24600,304240,328840
10/20/2024,Indrajith Abeykoon,Kalutara,Dodangoda,Western,8426,9396,17822,337040,375840,712880
10/21/2024,Indrajith Abeykoon,Kalutara,Dodangoda,Western,806,1922,2728,32240,76880,109120
10/22/2024,Indrajith Abeykoon,Kalutara,Dodangoda,Western,1597,8556,10153,63880,342240,406120
10/23/2024,Indrajith Abeykoon,Kalutara,Dodangoda,Western,974,9257,10231,38960,370280,409240
10/24/2024,Indrajith Abeykoon,Kalutara,Dodangoda,Western,7660,3194,10854,306400,127760,434160
10/25/2024,Indrajith Abeykoon,Kalutara,Dodangoda,Western,1397,6970,8367,55880,278800,334680
10/26/2024,Indrajith Abeykoon,Kalutara,Dodangoda,Western,8797,6301,15098,351880,252040,603920
10/27/2024,Indrajith Abeykoon,Kalutara,Dodangoda,Western,6630,8330,14960,265200,333200,598400
10/28/2024,Indrajith Abeykoon,Kalutara,Dodangoda,Western,946,7570,8516,37840,302800,340640
10/29/2024,Indrajith Abeykoon,Kalutara,Dodangoda,Western,1575,6498,8073,63000,259920,322920
10/30/2024,Indrajith Abeykoon,Kalutara,Dodangoda,Western,9468,7446,16914,378720,297840,676560
10/31/2024,Indrajith Abeykoon,Kalutara,Dodangoda,Western,1441,3317,4758,57640,132680,190320
11/1/2024,Indrajith Abeykoon,Kalutara,Dodangoda,Western,2207,5174,7381,88280,206960,295240
11/2/2024,Indrajith Abeykoon,Kalutara,Dodangoda,Western,1038,4891,5929,41520,195640,237160
11/3/2024,Indrajith Abeykoon,Kalutara,Dodangoda,Western,2038,53,2091,81520,2120,83640
11/4/2024,Indrajith Abeykoon,Kalutara,Dodangoda,Western,6145,6850,12995,245800,274000,519800
11/5/2024,Indrajith Abeykoon,Kalutara,Dodangoda,Western,3126,1620,4746,125040,64800,189840
11/6/2024,Indrajith Abeykoon,Kalutara,Dodangoda,Western,6437,694,7131,257480,27760,285240
11/7/2024,Indrajith Abeykoon,Kalutara,Dodangoda,Western,3412,4214,7626,136480,168560,305040
11/8/2024,Indrajith Abeykoon,Kalutara,Dodangoda,Western,5610,6657,12267,224400,266280,490680
11/9/2024,Indrajith Abeykoon,Kalutara,Dodangoda,Western,4179,6687,10866,167160,267480,434640
11/10/2024,Indrajith Abeykoon,Kalutara,Dodangoda,Western,7785,5305,13090,311400,212200,523600
11/11/2024,Indrajith Abeykoon,Kalutara,Dodangoda,Western,7425,4296,11721,297000,171840,468840
11/12/2024,Indrajith Abeykoon,Kalutara,Dodangoda,Western,3162,1989,5151,126480,79560,206040
11/13/2024,Indrajith Abeykoon,Kalutara,Dodangoda,Western,6916,6449,13365,276640,257960,534600
11/14/2024,Indrajith Abeykoon,Kalutara,Dodangoda,Western,4108,5169,9277,164320,206760,371080
11/15/2024,Indrajith Abeykoon,Kalutara,Dodangoda,Western,6067,9926,15993,242680,397040,639720
11/16/2024,Indrajith Abeykoon,Kalutara,Dodangoda,Western,8929,5891,14820,357160,235640,592800
11/17/2024,Indrajith Abeykoon,Kalutara,Dodangoda,Western,28,6193,6221,1120,247720,248840
11/18/2024,Indrajith Abeykoon,Kalutara,Dodangoda,Western,6144,1994,8138,245760,79760,325520
11/19/2024,Indrajith Abeykoon,Kalutara,Dodangoda,Western,5216,1770,6986,208640,70800,279440
11/20/2024,Indrajith Abeykoon,Kalutara,Dodangoda,Western,879,3788,4667,35160,151520,186680
11/21/2024,Indrajith Abeykoon,Kalutara,Dodangoda,Western,5739,3478,9217,229560,139120,368680
11/22/2024,Indrajith Abeykoon,Kalutara,Dodangoda,Western,7975,5978,13953,319000,239120,558120
11/23/2024,Indrajith Abeykoon,Kalutara,Dodangoda,Western,2217,1728,3945,88680,69120,157800
11/24/2024,Indrajith Abeykoon,Kalutara,Dodangoda,Western,3423,4738,8161,136920,189520,326440
11/25/2024,Indrajith Abeykoon,Kalutara,Dodangoda,Western,2673,8050,10723,106920,322000,428920
11/26/2024,Indrajith Abeykoon,Kalutara,Dodangoda,Western,9213,7262,16475,368520,290480,659000
11/27/2024,Indrajith Abeykoon,Kalutara,Dodangoda,Western,7397,2584,9981,295880,103360,399240
11/28/2024,Indrajith Abeykoon,Kalutara,Dodangoda,Western,7724,6357,14081,308960,254280,563240
11/29/2024,Indrajith Abeykoon,Kalutara,Dodangoda,Western,8823,2659,11482,352920,106360,459280
11/30/2024,Indrajith Abeykoon,Kalutara,Dodangoda,Western,4592,9379,13971,183680,375160,558840
12/1/2024,Indrajith Abeykoon,Kalutara,Dodangoda,Western,7036,7866,14902,281440,314640,596080
12/2/2024,Indrajith Abeykoon,Kalutara,Dodangoda,Western,1825,3198,5023,73000,127920,200920
12/3/2024,Indrajith Abeykoon,Kalutara,Dodangoda,Western,3342,5721,9063,133680,228840,362520
12/4/2024,Indrajith Abeykoon,Kalutara,Dodangoda,Western,9853,4858,14711,394120,194320,588440
12/5/2024,Indrajith Abeykoon,Kalutara,Dodangoda,Western,8231,1003,9234,329240,40120,369360
12/6/2024,Indrajith Abeykoon,Kalutara,Dodangoda,Western,7687,2865,10552,307480,114600,422080
12/7/2024,Indrajith Abeykoon,Kalutara,Dodangoda,Western,5235,4369,9604,209400,174760,384160
12/8/2024,Indrajith Abeykoon,Kalutara,Dodangoda,Western,2655,2067,4722,106200,82680,188880
12/9/2024,Indrajith Abeykoon,Kalutara,Dodangoda,Western,2492,6724,9216,99680,268960,368640
12/10/2024,Indrajith Abeykoon,Kalutara,Dodangoda,Western,5032,3598,8630,201280,143920,345200
12/11/2024,Indrajith Abeykoon,Kalutara,Dodangoda,Western,7173,6196,13369,286920,247840,534760
12/12/2024,Indrajith Abeykoon,Kalutara,Dodangoda,Western,5031,35,5066,201240,1400,202640
12/13/2024,Indrajith Abeykoon,Kalutara,Dodangoda,Western,9400,341,9741,376000,13640,389640
12/14/2024,Indrajith Abeykoon,Kalutara,Dodangoda,Western,5113,4560,9673,204520,182400,386920
12/15/2024,Indrajith Abeykoon,Kalutara,Dodangoda,Western,5762,5909,11671,230480,236360,466840
12/16/2024,Indrajith Abeykoon,Kalutara,Dodangoda,Western,1431,3551,4982,57240,142040,199280
12/17/2024,Indrajith Abeykoon,Kalutara,Dodangoda,Western,6773,5103,11876,270920,204120,475040
12/18/2024,Indrajith Abeykoon,Kalutara,Dodangoda,Western,7624,9865,17489,304960,394600,699560
12/19/2024,Indrajith Abeykoon,Kalutara,Dodangoda,Western,7281,9544,16825,291240,381760,673000
12/20/2024,Indrajith Abeykoon,Kalutara,Dodangoda,Western,5902,8715,14617,236080,348600,584680
12/21/2024,Indrajith Abeykoon,Kalutara,Dodangoda,Western,9609,4380,13989,384360,175200,559560
12/22/2024,Indrajith Abeykoon,Kalutara,Dodangoda,Western,9463,4563,14026,378520,182520,561040
12/23/2024,Indrajith Abeykoon,Kalutara,Dodangoda,Western,4315,1423,5738,172600,56920,229520
12/24/2024,Indrajith Abeykoon,Kalutara,Dodangoda,Western,4972,7804,12776,198880,312160,511040
12/25/2024,Indrajith Abeykoon,Kalutara,Dodangoda,Western,4536,6335,10871,181440,253400,434840
12/26/2024,Indrajith Abeykoon,Kalutara,Dodangoda,Western,6274,1057,7331,250960,42280,293240
12/27/2024,Indrajith Abeykoon,Kalutara,Dodangoda,Western,3414,3926,7340,136560,157040,293600
12/28/2024,Indrajith Abeykoon,Kalutara,Dodangoda,Western,7851,9150,17001,314040,366000,680040
12/29/2024,Indrajith Abeykoon,Kalutara,Dodangoda,Western,1587,8000,9587,63480,320000,383480
12/30/2024,Indrajith Abeykoon,Kalutara,Dodangoda,Western,4198,3822,8020,167920,152880,320800
12/31/2024,Indrajith Abeykoon,Kalutara,Dodangoda,Western,5265,1726,6991,210600,69040,279640
1/1/2025,Indrajith Abeykoon,Kalutara,Dodangoda,Western,3216,8643,11859,128640,345720,474360
1/2/2025,Indrajith Abeykoon,Kalutara,Dodangoda,Western,6957,3858,10815,278280,154320,432600
1/3/2025,Indrajith Abeykoon,Kalutara,Dodangoda,Western,37,7459,7496,1480,298360,299840
1/4/2025,Indrajith Abeykoon,Kalutara,Dodangoda,Western,2273,4752,7025,90920,190080,281000
1/5/2025,Indrajith Abeykoon,Kalutara,Dodangoda,Western,6917,5619,12536,276680,224760,501440
1/6/2025,Indrajith Abeykoon,Kalutara,Dodangoda,Western,1520,4821,6341,60800,192840,253640
1/7/2025,Indrajith Abeykoon,Kalutara,Dodangoda,Western,4226,1464,5690,169040,58560,227600
1/8/2025,Indrajith Abeykoon,Kalutara,Dodangoda,Western,3697,3564,7261,147880,142560,290440
1/9/2025,Indrajith Abeykoon,Kalutara,Dodangoda,Western,1792,9579,11371,71680,383160,454840
1/10/2025,Indrajith Abeykoon,Kalutara,Dodangoda,Western,740,9966,10706,29600,398640,428240
1/11/2025,Indrajith Abeykoon,Kalutara,Dodangoda,Western,3946,1572,5518,157840,62880,220720
1/12/2025,Indrajith Abeykoon,Kalutara,Dodangoda,Western,5212,4840,10052,208480,193600,402080
1/13/2025,Indrajith Abeykoon,Kalutara,Dodangoda,Western,7902,4237,12139,316080,169480,485560
1/14/2025,Indrajith Abeykoon,Kalutara,Dodangoda,Western,1081,9696,10777,43240,387840,431080
1/15/2025,Indrajith Abeykoon,Kalutara,Dodangoda,Western,7065,9989,17054,282600,399560,682160
1/16/2025,Indrajith Abeykoon,Kalutara,Dodangoda,Western,7321,5135,12456,292840,205400,498240
1/17/2025,Indrajith Abeykoon,Kalutara,Dodangoda,Western,4157,1342,5499,166280,53680,219960
1/18/2025,Indrajith Abeykoon,Kalutara,Dodangoda,Western,6313,1999,8312,252520,79960,332480
1/19/2025,Indrajith Abeykoon,Kalutara,Dodangoda,Western,4727,6535,11262,189080,261400,450480
1/20/2025,Indrajith Abeykoon,Kalutara,Dodangoda,Western,9609,4475,14084,384360,179000,563360
1/21/2025,Indrajith Abeykoon,Kalutara,Dodangoda,Western,6657,7930,14587,266280,317200,583480
1/22/2025,Indrajith Abeykoon,Kalutara,Dodangoda,Western,1821,3562,5383,72840,142480,215320
1/23/2025,Indrajith Abeykoon,Kalutara,Dodangoda,Western,3290,8781,12071,131600,351240,482840
1/24/2025,Indrajith Abeykoon,Kalutara,Dodangoda,Western,9952,5388,15340,398080,215520,613600
1/25/2025,Indrajith Abeykoon,Kalutara,Dodangoda,Western,8429,1576,10005,337160,63040,400200
1/26/2025,Indrajith Abeykoon,Kalutara,Dodangoda,Western,400,4218,4618,16000,168720,184720
1/27/2025,Indrajith Abeykoon,Kalutara,Dodangoda,Western,5329,8856,14185,213160,354240,567400
1/28/2025,Indrajith Abeykoon,Kalutara,Dodangoda,Western,6785,9512,16297,271400,380480,651880
1/29/2025,Indrajith Abeykoon,Kalutara,Dodangoda,Western,2562,9434,11996,102480,377360,479840
1/30/2025,Indrajith Abeykoon,Kalutara,Dodangoda,Western,423,1853,2276,16920,74120,91040
1/31/2025,Indrajith Abeykoon,Kalutara,Dodangoda,Western,8538,5251,13789,341520,210040,551560
2/1/2025,Indrajith Abeykoon,Kalutara,Dodangoda,Western,3869,3867,7736,154760,154680,309440
2/2/2025,Indrajith Abeykoon,Kalutara,Dodangoda,Western,6527,658,7185,261080,26320,287400
2/3/2025,Indrajith Abeykoon,Kalutara,Dodangoda,Western,1765,4546,6311,70600,181840,252440
2/4/2025,Indrajith Abeykoon,Kalutara,Dodangoda,Western,9432,1308,10740,377280,52320,429600
2/5/2025,Indrajith Abeykoon,Kalutara,Dodangoda,Western,394,7595,7989,15760,303800,319560
2/6/2025,Indrajith Abeykoon,Kalutara,Dodangoda,Western,9300,8410,17710,372000,336400,708400
2/7/2025,Indrajith Abeykoon,Kalutara,Dodangoda,Western,7784,5059,12843,311360,202360,513720
2/8/2025,Indrajith Abeykoon,Kalutara,Dodangoda,Western,5168,9871,15039,206720,394840,601560
2/9/2025,Indrajith Abeykoon,Kalutara,Dodangoda,Western,1968,7727,9695,78720,309080,387800
2/10/2025,Indrajith Abeykoon,Kalutara,Dodangoda,Western,4557,6211,10768,182280,248440,430720
2/11/2025,Indrajith Abeykoon,Kalutara,Dodangoda,Western,3604,3322,6926,144160,132880,277040
2/12/2025,Indrajith Abeykoon,Kalutara,Dodangoda,Western,1733,581,2314,69320,23240,92560
2/13/2025,Indrajith Abeykoon,Kalutara,Dodangoda,Western,9631,5088,14719,385240,203520,588760
2/14/2025,Indrajith Abeykoon,Kalutara,Dodangoda,Western,1154,6260,7414,46160,250400,296560
2/15/2025,Indrajith Abeykoon,Kalutara,Dodangoda,Western,7043,327,7370,281720,13080,294800
2/16/2025,Indrajith Abeykoon,Kalutara,Dodangoda,Western,846,9218,10064,33840,368720,402560
2/17/2025,Indrajith Abeykoon,Kalutara,Dodangoda,Western,9036,810,9846,361440,32400,393840
2/18/2025,Indrajith Abeykoon,Kalutara,Dodangoda,Western,6205,4167,10372,248200,166680,414880
2/19/2025,Indrajith Abeykoon,Kalutara,Dodangoda,Western,3677,8518,12195,147080,340720,487800
2/20/2025,Indrajith Abeykoon,Kalutara,Dodangoda,Western,4734,5052,9786,189360,202080,391440
2/21/2025,Indrajith Abeykoon,Kalutara,Dodangoda,Western,2616,5424,8040,104640,216960,321600
2/22/2025,Indrajith Abeykoon,Kalutara,Dodangoda,Western,6950,5082,12032,278000,203280,481280
2/23/2025,Indrajith Abeykoon,Kalutara,Dodangoda,Western,4579,9117,13696,183160,364680,547840
2/24/2025,Indrajith Abeykoon,Kalutara,Dodangoda,Western,1257,8011,9268,50280,320440,370720
2/25/2025,Indrajith Abeykoon,Kalutara,Dodangoda,Western,9073,9265,18338,362920,370600,733520
2/26/2025,Indrajith Abeykoon,Kalutara,Dodangoda,Western,713,6729,7442,28520,269160,297680
2/27/2025,Indrajith Abeykoon,Kalutara,Dodangoda,Western,152,1390,1542,6080,55600,61680
2/28/2025,Indrajith Abeykoon,Kalutara,Dodangoda,Western,4710,550,5260,188400,22000,210400
3/1/2025,Indrajith Abeykoon,Kalutara,Dodangoda,Western,4881,3468,8349,195240,138720,333960
3/2/2025,Indrajith Abeykoon,Kalutara,Dodangoda,Western,9644,86,9730,385760,3440,389200
3/3/2025,Indrajith Abeykoon,Kalutara,Dodangoda,Western,1224,7306,8530,48960,292240,341200
3/4/2025,Indrajith Abeykoon,Kalutara,Dodangoda,Western,8517,6769,15286,340680,270760,611440
3/5/2025,Indrajith Abeykoon,Kalutara,Dodangoda,Western,3531,5508,9039,141240,220320,361560
3/6/2025,Indrajith Abeykoon,Kalutara,Dodangoda,Western,4114,3918,8032,164560,156720,321280
3/7/2025,Indrajith Abeykoon,Kalutara,Dodangoda,Western,1059,1219,2278,42360,48760,91120
3/8/2025,Indrajith Abeykoon,Kalutara,Dodangoda,Western,6736,9647,16383,269440,385880,655320
3/9/2025,Indrajith Abeykoon,Kalutara,Dodangoda,Western,510,5381,5891,20400,215240,235640
3/10/2025,Indrajith Abeykoon,Kalutara,Dodangoda,Western,1671,634,2305,66840,25360,92200
3/11/2025,Indrajith Abeykoon,Kalutara,Dodangoda,Western,1488,4708,6196,59520,188320,247840
3/12/2025,Indrajith Abeykoon,Kalutara,Dodangoda,Western,9453,5323,14776,378120,212920,591040
3/13/2025,Indrajith Abeykoon,Kalutara,Dodangoda,Western,2670,6731,9401,106800,269240,376040
3/14/2025,Indrajith Abeykoon,Kalutara,Dodangoda,Western,1689,4222,5911,67560,168880,236440
3/15/2025,Indrajith Abeykoon,Kalutara,Dodangoda,Western,43,9627,9670,1720,385080,386800
3/16/2025,Indrajith Abeykoon,Kalutara,Dodangoda,Western,5436,8313,13749,217440,332520,549960
3/17/2025,Indrajith Abeykoon,Kalutara,Dodangoda,Western,6141,1235,7376,245640,49400,295040
3/18/2025,Indrajith Abeykoon,Kalutara,Dodangoda,Western,4462,1473,5935,178480,58920,237400
3/19/2025,Indrajith Abeykoon,Kalutara,Dodangoda,Western,8978,1976,10954,359120,79040,438160
3/20/2025,Indrajith Abeykoon,Kalutara,Dodangoda,Western,4404,4831,9235,176160,193240,369400
3/21/2025,Indrajith Abeykoon,Kalutara,Dodangoda,Western,6620,3830,10450,264800,153200,418000
3/22/2025,Indrajith Abeykoon,Kalutara,Dodangoda,Western,1176,1667,2843,47040,66680,113720
3/23/2025,Indrajith Abeykoon,Kalutara,Dodangoda,Western,659,7822,8481,26360,312880,339240
3/25/2024,Kasun Prasanna,Jaffna,Jaffna,Northern,805,7619,8424,32200,304760,336960
3/26/2024,Kasun Prasanna,Jaffna,Jaffna,Northern,298,3836,4134,11920,153440,165360
3/27/2024,Kasun Prasanna,Jaffna,Jaffna,Northern,922,3665,4587,36880,146600,183480
3/28/2024,Kasun Prasanna,Jaffna,Jaffna,Northern,5005,8751,13756,200200,350040,550240
3/29/2024,Kasun Prasanna,Jaffna,Jaffna,Northern,2722,1548,4270,108880,61920,170800
3/30/2024,Kasun Prasanna,Jaffna,Jaffna,Northern,4996,5961,10957,199840,238440,438280
3/31/2024,Kasun Prasanna,Jaffna,Jaffna,Northern,9061,1062,10123,362440,42480,404920
4/1/2024,Kasun Prasanna,Jaffna,Jaffna,Northern,8863,594,9457,354520,23760,378280
4/2/2024,Kasun Prasanna,Jaffna,Jaffna,Northern,4322,1538,5860,172880,61520,234400
4/3/2024,Kasun Prasanna,Jaffna,Jaffna,Northern,8944,2056,11000,357760,82240,440000
4/4/2024,Kasun Prasanna,Jaffna,Jaffna,Northern,5756,4377,10133,230240,175080,405320
4/5/2024,Kasun Prasanna,Jaffna,Jaffna,Northern,110,2597,2707,4400,103880,108280
4/6/2024,Kasun Prasanna,Jaffna,Jaffna,Northern,393,9024,9417,15720,360960,376680
4/7/2024,Kasun Prasanna,Jaffna,Jaffna,Northern,3756,7296,11052,150240,291840,442080
4/8/2024,Kasun Prasanna,Jaffna,Jaffna,Northern,2301,5197,7498,92040,207880,299920
4/9/2024,Kasun Prasanna,Jaffna,Jaffna,Northern,7770,3617,11387,310800,144680,455480
4/10/2024,Kasun Prasanna,Jaffna,Jaffna,Northern,8184,4153,12337,327360,166120,493480
4/11/2024,Kasun Prasanna,Jaffna,Jaffna,Northern,8867,3817,12684,354680,152680,507360
4/19/2024,Kasun Prasanna,Jaffna,Jaffna,Northern,6585,4240,10825,263400,169600,433000
4/20/2024,Kasun Prasanna,Jaffna,Jaffna,Northern,8498,4213,12711,339920,168520,508440
4/21/2024,Kasun Prasanna,Jaffna,Jaffna,Northern,8562,9424,17986,342480,376960,719440
4/22/2024,Kasun Prasanna,Jaffna,Jaffna,Northern,5507,9186,14693,220280,367440,587720
4/23/2024,Kasun Prasanna,Jaffna,Jaffna,Northern,735,6561,7296,29400,262440,291840
4/24/2024,Kasun Prasanna,Jaffna,Jaffna,Northern,9033,2501,11534,361320,100040,461360
4/25/2024,Kasun Prasanna,Jaffna,Jaffna,Northern,5597,5229,10826,223880,209160,433040
4/26/2024,Kasun Prasanna,Jaffna,Jaffna,Northern,1874,2112,3986,74960,84480,159440
4/27/2024,Kasun Prasanna,Jaffna,Jaffna,Northern,8432,9104,17536,337280,364160,701440
4/28/2024,Kasun Prasanna,Jaffna,Jaffna,Northern,4690,4757,9447,187600,190280,377880
4/29/2024,Kasun Prasanna,Jaffna,Jaffna,Northern,1398,8281,9679,55920,331240,387160
4/30/2024,Kasun Prasanna,Jaffna,Jaffna,Northern,6245,418,6663,249800,16720,266520
5/1/2024,Kasun Prasanna,Jaffna,Jaffna,Northern,5690,9757,15447,227600,390280,617880
5/2/2024,Kasun Prasanna,Jaffna,Jaffna,Northern,8643,1501,10144,345720,60040,405760
5/3/2024,Kasun Prasanna,Jaffna,Jaffna,Northern,5200,3035,8235,208000,121400,329400
5/4/2024,Kasun Prasanna,Jaffna,Jaffna,Northern,1683,3575,5258,67320,143000,210320
5/5/2024,Kasun Prasanna,Jaffna,Jaffna,Northern,3867,4971,8838,154680,198840,353520
5/6/2024,Kasun Prasanna,Jaffna,Jaffna,Northern,9913,9805,19718,396520,392200,788720
5/7/2024,Kasun Prasanna,Jaffna,Jaffna,Northern,5391,456,5847,215640,18240,233880
5/8/2024,Kasun Prasanna,Jaffna,Jaffna,Northern,6550,7933,14483,262000,317320,579320
5/9/2024,Kasun Prasanna,Jaffna,Jaffna,Northern,3883,732,4615,155320,29280,184600
5/10/2024,Kasun Prasanna,Jaffna,Jaffna,Northern,1920,5976,7896,76800,239040,315840
5/11/2024,Kasun Prasanna,Jaffna,Jaffna,Northern,1913,2811,4724,76520,112440,188960
5/12/2024,Kasun Prasanna,Jaffna,Jaffna,Northern,1500,1930,3430,60000,77200,137200
5/13/2024,Kasun Prasanna,Jaffna,Jaffna,Northern,5426,6392,11818,217040,255680,472720
5/14/2024,Kasun Prasanna,Jaffna,Jaffna,Northern,7045,974,8019,281800,38960,320760
5/15/2024,Kasun Prasanna,Jaffna,Jaffna,Northern,196,4692,4888,7840,187680,195520
5/16/2024,Kasun Prasanna,Jaffna,Jaffna,Northern,5078,9503,14581,203120,380120,583240
5/17/2024,Kasun Prasanna,Jaffna,Jaffna,Northern,9709,6785,16494,388360,271400,659760
5/18/2024,Kasun Prasanna,Jaffna,Jaffna,Northern,793,3704,4497,31720,148160,179880
5/19/2024,Kasun Prasanna,Jaffna,Jaffna,Northern,6182,113,6295,247280,4520,251800
5/20/2024,Kasun Prasanna,Jaffna,Jaffna,Northern,8339,7966,16305,333560,318640,652200
5/21/2024,Kasun Prasanna,Jaffna,Jaffna,Northern,7314,566,7880,292560,22640,315200
5/22/2024,Kasun Prasanna,Jaffna,Jaffna,Northern,3524,7805,11329,140960,312200,453160
5/24/2024,Kasun Prasanna,Jaffna,Jaffna,Northern,1416,4315,5731,56640,172600,229240
5/25/2024,Kasun Prasanna,Jaffna,Jaffna,Northern,5014,3184,8198,200560,127360,327920
5/26/2024,Kasun Prasanna,Jaffna,Jaffna,Northern,6928,4235,11163,277120,169400,446520
5/27/2024,Kasun Prasanna,Jaffna,Jaffna,Northern,4105,6279,10384,164200,251160,415360
5/28/2024,Kasun Prasanna,Jaffna,Jaffna,Northern,6356,5370,11726,254240,214800,469040
5/29/2024,Kasun Prasanna,Jaffna,Jaffna,Northern,4645,4392,9037,185800,175680,361480
5/30/2024,Kasun Prasanna,Jaffna,Jaffna,Northern,6380,92,6472,255200,3680,258880
5/31/2024,Kasun Prasanna,Jaffna,Jaffna,Northern,159,8535,8694,6360,341400,347760
6/1/2024,Kasun Prasanna,Jaffna,Jaffna,Northern,2569,7315,9884,102760,292600,395360
6/2/2024,Kasun Prasanna,Jaffna,Jaffna,Northern,8000,9427,17427,320000,377080,697080
6/3/2024,Kasun Prasanna,Jaffna,Jaffna,Northern,7551,1456,9007,302040,58240,360280
6/4/2024,Kasun Prasanna,Jaffna,Jaffna,Northern,661,9646,10307,26440,385840,412280
6/5/2024,Kasun Prasanna,Jaffna,Jaffna,Northern,3259,9198,12457,130360,367920,498280
6/6/2024,Kasun Prasanna,Jaffna,Jaffna,Northern,2882,8782,11664,115280,351280,466560
6/7/2024,Kasun Prasanna,Jaffna,Jaffna,Northern,5637,3186,8823,225480,127440,352920
6/8/2024,Kasun Prasanna,Jaffna,Jaffna,Northern,4291,8814,13105,171640,352560,524200
6/9/2024,Kasun Prasanna,Jaffna,Jaffna,Northern,6357,489,6846,254280,19560,273840
6/10/2024,Kasun Prasanna,Jaffna,Jaffna,Northern,6208,8062,14270,248320,322480,570800
6/11/2024,Kasun Prasanna,Jaffna,Jaffna,Northern,6817,8034,14851,272680,321360,594040
6/12/2024,Kasun Prasanna,Jaffna,Jaffna,Northern,9591,8682,18273,383640,347280,730920
6/13/2024,Kasun Prasanna,Jaffna,Jaffna,Northern,5,4698,4703,200,187920,188120
6/14/2024,Kasun Prasanna,Jaffna,Jaffna,Northern,7094,4258,11352,283760,170320,454080
6/15/2024,Kasun Prasanna,Jaffna,Jaffna,Northern,3559,7786,11345,142360,311440,453800
6/16/2024,Kasun Prasanna,Jaffna,Jaffna,Northern,2428,667,3095,97120,26680,123800
6/17/2024,Kasun Prasanna,Jaffna,Jaffna,Northern,8684,2860,11544,347360,114400,461760
6/18/2024,Kasun Prasanna,Jaffna,Jaffna,Northern,7042,2276,9318,281680,91040,372720
6/19/2024,Kasun Prasanna,Jaffna,Jaffna,Northern,5044,8030,13074,201760,321200,522960
6/20/2024,Kasun Prasanna,Jaffna,Jaffna,Northern,2384,8590,10974,95360,343600,438960
6/21/2024,Kasun Prasanna,Jaffna,Jaffna,Northern,7490,3113,10603,299600,124520,424120
6/22/2024,Kasun Prasanna,Jaffna,Jaffna,Northern,5094,9695,14789,203760,387800,591560
6/23/2024,Kasun Prasanna,Jaffna,Jaffna,Northern,1408,9054,10462,56320,362160,418480
6/24/2024,Kasun Prasanna,Jaffna,Jaffna,Northern,2590,8959,11549,103600,358360,461960
6/25/2024,Kasun Prasanna,Jaffna,Jaffna,Northern,8797,4164,12961,351880,166560,518440
6/26/2024,Kasun Prasanna,Jaffna,Jaffna,Northern,7417,3693,11110,296680,147720,444400
6/27/2024,Kasun Prasanna,Jaffna,Jaffna,Northern,2631,4251,6882,105240,170040,275280
6/28/2024,Kasun Prasanna,Jaffna,Jaffna,Northern,9583,2493,12076,383320,99720,483040
6/29/2024,Kasun Prasanna,Jaffna,Jaffna,Northern,2367,4923,7290,94680,196920,291600
6/30/2024,Kasun Prasanna,Jaffna,Jaffna,Northern,1460,882,2342,58400,35280,93680
7/1/2024,Kasun Prasanna,Jaffna,Jaffna,Northern,4761,8527,13288,190440,341080,531520
7/2/2024,Kasun Prasanna,Jaffna,Jaffna,Northern,5046,8116,13162,201840,324640,526480
7/3/2024,Kasun Prasanna,Jaffna,Jaffna,Northern,1514,1515,3029,60560,60600,121160
7/4/2024,Kasun Prasanna,Jaffna,Jaffna,Northern,4067,3865,7932,162680,154600,317280
7/5/2024,Kasun Prasanna,Jaffna,Jaffna,Northern,6885,1261,8146,275400,50440,325840
7/6/2024,Kasun Prasanna,Jaffna,Jaffna,Northern,7562,1192,8754,302480,47680,350160
7/7/2024,Kasun Prasanna,Jaffna,Jaffna,Northern,7866,6883,14749,314640,275320,589960
7/8/2024,Kasun Prasanna,Jaffna,Jaffna,Northern,8162,472,8634,326480,18880,345360
7/9/2024,Kasun Prasanna,Jaffna,Jaffna,Northern,3466,9214,12680,138640,368560,507200
7/10/2024,Kasun Prasanna,Jaffna,Jaffna,Northern,9753,8799,18552,390120,351960,742080
7/11/2024,Kasun Prasanna,Jaffna,Jaffna,Northern,7090,2351,9441,283600,94040,377640
7/12/2024,Kasun Prasanna,Jaffna,Jaffna,Northern,9130,4047,13177,365200,161880,527080
7/13/2024,Kasun Prasanna,Jaffna,Jaffna,Northern,7719,9131,16850,308760,365240,674000
7/14/2024,Kasun Prasanna,Jaffna,Jaffna,Northern,5409,8997,14406,216360,359880,576240
7/15/2024,Kasun Prasanna,Jaffna,Jaffna,Northern,1858,3473,5331,74320,138920,213240
7/16/2024,Kasun Prasanna,Jaffna,Jaffna,Northern,4745,7521,12266,189800,300840,490640
7/17/2024,Kasun Prasanna,Jaffna,Jaffna,Northern,4129,1731,5860,165160,69240,234400
7/18/2024,Kasun Prasanna,Jaffna,Jaffna,Northern,3636,3552,7188,145440,142080,287520
7/19/2024,Kasun Prasanna,Jaffna,Jaffna,Northern,7224,8101,15325,288960,324040,613000
7/20/2024,Kasun Prasanna,Jaffna,Jaffna,Northern,3823,9356,13179,152920,374240,527160
7/21/2024,Kasun Prasanna,Jaffna,Jaffna,Northern,6693,8542,15235,267720,341680,609400
7/22/2024,Kasun Prasanna,Jaffna,Jaffna,Northern,308,7946,8254,12320,317840,330160
7/23/2024,Kasun Prasanna,Jaffna,Jaffna,Northern,361,7696,8057,14440,307840,322280
7/24/2024,Kasun Prasanna,Jaffna,Jaffna,Northern,5749,9968,15717,229960,398720,628680
7/25/2024,Kasun Prasanna,Jaffna,Jaffna,Northern,498,5754,6252,19920,230160,250080
7/26/2024,Kasun Prasanna,Jaffna,Jaffna,Northern,1764,2481,4245,70560,99240,169800
7/27/2024,Kasun Prasanna,Jaffna,Jaffna,Northern,3206,3025,6231,128240,121000,249240
7/28/2024,Kasun Prasanna,Jaffna,Jaffna,Northern,6082,1787,7869,243280,71480,314760
7/29/2024,Kasun Prasanna,Jaffna,Jaffna,Northern,5212,7671,12883,208480,306840,515320
7/30/2024,Kasun Prasanna,Jaffna,Jaffna,Northern,6104,8109,14213,244160,324360,568520
7/31/2024,Kasun Prasanna,Jaffna,Jaffna,Northern,3452,8639,12091,138080,345560,483640
8/1/2024,Kasun Prasanna,Jaffna,Jaffna,Northern,7879,2816,10695,315160,112640,427800
8/2/2024,Kasun Prasanna,Jaffna,Jaffna,Northern,5294,5983,11277,211760,239320,451080
8/3/2024,Kasun Prasanna,Jaffna,Jaffna,Northern,345,6855,7200,13800,274200,288000
8/4/2024,Kasun Prasanna,Jaffna,Jaffna,Northern,9955,5053,15008,398200,202120,600320
8/5/2024,Kasun Prasanna,Jaffna,Jaffna,Northern,4658,1555,6213,186320,62200,248520
8/6/2024,Kasun Prasanna,Jaffna,Jaffna,Northern,7139,527,7666,285560,21080,306640
8/7/2024,Kasun Prasanna,Jaffna,Jaffna,Northern,8086,3557,11643,323440,142280,465720
8/8/2024,Kasun Prasanna,Jaffna,Jaffna,Northern,9030,8775,17805,361200,351000,712200
8/9/2024,Kasun Prasanna,Jaffna,Jaffna,Northern,890,1473,2363,35600,58920,94520
8/10/2024,Kasun Prasanna,Jaffna,Jaffna,Northern,6718,8293,15011,268720,331720,600440
8/11/2024,Kasun Prasanna,Jaffna,Jaffna,Northern,9532,6223,15755,381280,248920,630200
8/12/2024,Kasun Prasanna,Jaffna,Jaffna,Northern,7959,4597,12556,318360,183880,502240
8/13/2024,Kasun Prasanna,Jaffna,Jaffna,Northern,1132,1898,3030,45280,75920,121200
8/14/2024,Kasun Prasanna,Jaffna,Jaffna,Northern,8427,6481,14908,337080,259240,596320
8/15/2024,Kasun Prasanna,Jaffna,Jaffna,Northern,5596,6711,12307,223840,268440,492280
8/16/2024,Kasun Prasanna,Jaffna,Jaffna,Northern,7661,88,7749,306440,3520,309960
8/17/2024,Kasun Prasanna,Jaffna,Jaffna,Northern,5845,2425,8270,233800,97000,330800
8/18/2024,Kasun Prasanna,Jaffna,Jaffna,Northern,636,4281,4917,25440,171240,196680
8/19/2024,Kasun Prasanna,Jaffna,Jaffna,Northern,4946,4590,9536,197840,183600,381440
8/20/2024,Kasun Prasanna,Jaffna,Jaffna,Northern,5260,5320,10580,210400,212800,423200
8/21/2024,Kasun Prasanna,Jaffna,Jaffna,Northern,8877,1201,10078,355080,48040,403120
8/22/2024,Kasun Prasanna,Jaffna,Jaffna,Northern,2833,8668,11501,113320,346720,460040
8/23/2024,Kasun Prasanna,Jaffna,Jaffna,Northern,8147,7980,16127,325880,319200,645080
8/24/2024,Kasun Prasanna,Jaffna,Jaffna,Northern,4140,9399,13539,165600,375960,541560
8/25/2024,Kasun Prasanna,Jaffna,Jaffna,Northern,9856,2793,12649,394240,111720,505960
8/26/2024,Kasun Prasanna,Jaffna,Jaffna,Northern,8212,2704,10916,328480,108160,436640
8/27/2024,Kasun Prasanna,Jaffna,Jaffna,Northern,2117,6397,8514,84680,255880,340560
8/28/2024,Kasun Prasanna,Jaffna,Jaffna,Northern,6384,6580,12964,255360,263200,518560
8/29/2024,Kasun Prasanna,Jaffna,Jaffna,Northern,1998,4244,6242,79920,169760,249680
8/30/2024,Kasun Prasanna,Jaffna,Jaffna,Northern,7878,5033,12911,315120,201320,516440
8/31/2024,Kasun Prasanna,Jaffna,Jaffna,Northern,332,19,351,13280,760,14040
9/1/2024,Kasun Prasanna,Jaffna,Jaffna,Northern,6322,8472,14794,252880,338880,591760
9/2/2024,Kasun Prasanna,Jaffna,Jaffna,Northern,7525,6143,13668,301000,245720,546720
9/3/2024,Kasun Prasanna,Jaffna,Jaffna,Northern,4813,1232,6045,192520,49280,241800
9/4/2024,Kasun Prasanna,Jaffna,Jaffna,Northern,3912,5160,9072,156480,206400,362880
9/5/2024,Kasun Prasanna,Jaffna,Jaffna,Northern,7859,5421,13280,314360,216840,531200
9/6/2024,Kasun Prasanna,Jaffna,Jaffna,Northern,2294,7474,9768,91760,298960,390720
9/7/2024,Kasun Prasanna,Jaffna,Jaffna,Northern,7481,4771,12252,299240,190840,490080
9/8/2024,Kasun Prasanna,Jaffna,Jaffna,Northern,6610,1103,7713,264400,44120,308520
9/9/2024,Kasun Prasanna,Jaffna,Jaffna,Northern,1977,7407,9384,79080,296280,375360
9/10/2024,Kasun Prasanna,Jaffna,Jaffna,Northern,2333,5201,7534,93320,208040,301360
9/11/2024,Kasun Prasanna,Jaffna,Jaffna,Northern,3757,1302,5059,150280,52080,202360
9/12/2024,Kasun Prasanna,Jaffna,Jaffna,Northern,8856,4764,13620,354240,190560,544800
9/13/2024,Kasun Prasanna,Jaffna,Jaffna,Northern,1473,2784,4257,58920,111360,170280
9/14/2024,Kasun Prasanna,Jaffna,Jaffna,Northern,1095,6498,7593,43800,259920,303720
9/15/2024,Kasun Prasanna,Jaffna,Jaffna,Northern,177,3357,3534,7080,134280,141360
9/16/2024,Kasun Prasanna,Jaffna,Jaffna,Northern,719,5944,6663,28760,237760,266520
9/17/2024,Kasun Prasanna,Jaffna,Jaffna,Northern,3185,1882,5067,127400,75280,202680
9/18/2024,Kasun Prasanna,Jaffna,Jaffna,Northern,7379,4451,11830,295160,178040,473200
9/19/2024,Kasun Prasanna,Jaffna,Jaffna,Northern,8855,303,9158,354200,12120,366320
9/20/2024,Kasun Prasanna,Jaffna,Jaffna,Northern,1848,4513,6361,73920,180520,254440
9/21/2024,Kasun Prasanna,Jaffna,Jaffna,Northern,687,1790,2477,27480,71600,99080
9/22/2024,Kasun Prasanna,Jaffna,Jaffna,Northern,8208,1578,9786,328320,63120,391440
9/23/2024,Kasun Prasanna,Jaffna,Jaffna,Northern,7514,5440,12954,300560,217600,518160
9/24/2024,Kasun Prasanna,Jaffna,Jaffna,Northern,9312,7342,16654,372480,293680,666160
9/25/2024,Kasun Prasanna,Jaffna,Jaffna,Northern,6981,2235,9216,279240,89400,368640
9/26/2024,Kasun Prasanna,Jaffna,Jaffna,Northern,5739,5631,11370,229560,225240,454800
9/27/2024,Kasun Prasanna,Jaffna,Jaffna,Northern,7954,1273,9227,318160,50920,369080
9/28/2024,Kasun Prasanna,Jaffna,Jaffna,Northern,2077,869,2946,83080,34760,117840
9/29/2024,Kasun Prasanna,Jaffna,Jaffna,Northern,852,9522,10374,34080,380880,414960
9/30/2024,Kasun Prasanna,Jaffna,Jaffna,Northern,9361,8568,17929,374440,342720,717160
10/1/2024,Kasun Prasanna,Jaffna,Jaffna,Northern,133,7420,7553,5320,296800,302120
10/2/2024,Kasun Prasanna,Jaffna,Jaffna,Northern,1542,7954,9496,61680,318160,379840
10/3/2024,Kasun Prasanna,Jaffna,Jaffna,Northern,4735,5508,10243,189400,220320,409720
10/4/2024,Kasun Prasanna,Jaffna,Jaffna,Northern,9376,244,9620,375040,9760,384800
10/5/2024,Kasun Prasanna,Jaffna,Jaffna,Northern,6644,1461,8105,265760,58440,324200
10/6/2024,Kasun Prasanna,Jaffna,Jaffna,Northern,3370,2104,5474,134800,84160,218960
10/7/2024,Kasun Prasanna,Jaffna,Jaffna,Northern,6707,4367,11074,268280,174680,442960
10/8/2024,Kasun Prasanna,Jaffna,Jaffna,Northern,3520,8935,12455,140800,357400,498200
10/9/2024,Kasun Prasanna,Jaffna,Jaffna,Northern,5511,2149,7660,220440,85960,306400
10/10/2024,Kasun Prasanna,Jaffna,Jaffna,Northern,5792,3082,8874,231680,123280,354960
10/11/2024,Kasun Prasanna,Jaffna,Jaffna,Northern,1509,9310,10819,60360,372400,432760
10/12/2024,Kasun Prasanna,Jaffna,Jaffna,Northern,9680,2038,11718,387200,81520,468720
10/13/2024,Kasun Prasanna,Jaffna,Jaffna,Northern,8142,4157,12299,325680,166280,491960
10/14/2024,Kasun Prasanna,Jaffna,Jaffna,Northern,9900,2684,12584,396000,107360,503360
10/15/2024,Kasun Prasanna,Jaffna,Jaffna,Northern,3993,802,4795,159720,32080,191800
10/16/2024,Kasun Prasanna,Jaffna,Jaffna,Northern,5086,2541,7627,203440,101640,305080
10/17/2024,Kasun Prasanna,Jaffna,Jaffna,Northern,5920,9143,15063,236800,365720,602520
10/18/2024,Kasun Prasanna,Jaffna,Jaffna,Northern,9256,2760,12016,370240,110400,480640
10/19/2024,Kasun Prasanna,Jaffna,Jaffna,Northern,5106,5564,10670,204240,222560,426800
10/20/2024,Kasun Prasanna,Jaffna,Jaffna,Northern,6120,8390,14510,244800,335600,580400
10/21/2024,Kasun Prasanna,Jaffna,Jaffna,Northern,7902,7871,15773,316080,314840,630920
10/22/2024,Kasun Prasanna,Jaffna,Jaffna,Northern,3218,1148,4366,128720,45920,174640
10/23/2024,Kasun Prasanna,Jaffna,Jaffna,Northern,2441,3586,6027,97640,143440,241080
10/24/2024,Kasun Prasanna,Jaffna,Jaffna,Northern,6474,20,6494,258960,800,259760
10/25/2024,Kasun Prasanna,Jaffna,Jaffna,Northern,7490,9811,17301,299600,392440,692040
10/26/2024,Kasun Prasanna,Jaffna,Jaffna,Northern,8069,5118,13187,322760,204720,527480
10/27/2024,Kasun Prasanna,Jaffna,Jaffna,Northern,2450,7384,9834,98000,295360,393360
10/28/2024,Kasun Prasanna,Jaffna,Jaffna,Northern,6060,8690,14750,242400,347600,590000
10/29/2024,Kasun Prasanna,Jaffna,Jaffna,Northern,4549,2744,7293,181960,109760,291720
10/30/2024,Kasun Prasanna,Jaffna,Jaffna,Northern,8014,9436,17450,320560,377440,698000
10/31/2024,Kasun Prasanna,Jaffna,Jaffna,Northern,3196,7429,10625,127840,297160,425000
11/1/2024,Kasun Prasanna,Jaffna,Jaffna,Northern,5107,1761,6868,204280,70440,274720
11/2/2024,Kasun Prasanna,Jaffna,Jaffna,Northern,657,7552,8209,26280,302080,328360
11/3/2024,Kasun Prasanna,Jaffna,Jaffna,Northern,1999,5747,7746,79960,229880,309840
11/4/2024,Kasun Prasanna,Jaffna,Jaffna,Northern,6009,6655,12664,240360,266200,506560
11/5/2024,Kasun Prasanna,Jaffna,Jaffna,Northern,9959,9226,19185,398360,369040,767400
11/6/2024,Kasun Prasanna,Jaffna,Jaffna,Northern,8157,6739,14896,326280,269560,595840
11/7/2024,Kasun Prasanna,Jaffna,Jaffna,Northern,8767,8859,17626,350680,354360,705040
11/8/2024,Kasun Prasanna,Jaffna,Jaffna,Northern,2362,8203,10565,94480,328120,422600
11/9/2024,Kasun Prasanna,Jaffna,Jaffna,Northern,3332,6401,9733,133280,256040,389320
11/10/2024,Kasun Prasanna,Jaffna,Jaffna,Northern,8956,9171,18127,358240,366840,725080
11/11/2024,Kasun Prasanna,Jaffna,Jaffna,Northern,6897,9028,15925,275880,361120,637000
11/12/2024,Kasun Prasanna,Jaffna,Jaffna,Northern,3820,6474,10294,152800,258960,411760
11/13/2024,Kasun Prasanna,Jaffna,Jaffna,Northern,5458,8163,13621,218320,326520,544840
11/14/2024,Kasun Prasanna,Jaffna,Jaffna,Northern,3586,2935,6521,143440,117400,260840
11/15/2024,Kasun Prasanna,Jaffna,Jaffna,Northern,788,7553,8341,31520,302120,333640
11/16/2024,Kasun Prasanna,Jaffna,Jaffna,Northern,4713,6452,11165,188520,258080,446600
11/17/2024,Kasun Prasanna,Jaffna,Jaffna,Northern,5542,7594,13136,221680,303760,525440
11/18/2024,Kasun Prasanna,Jaffna,Jaffna,Northern,4776,8479,13255,191040,339160,530200
11/19/2024,Kasun Prasanna,Jaffna,Jaffna,Northern,9235,6280,15515,369400,251200,620600
11/20/2024,Kasun Prasanna,Jaffna,Jaffna,Northern,4072,9640,13712,162880,385600,548480
11/21/2024,Kasun Prasanna,Jaffna,Jaffna,Northern,2195,7119,9314,87800,284760,372560
11/22/2024,Kasun Prasanna,Jaffna,Jaffna,Northern,1719,9136,10855,68760,365440,434200
11/23/2024,Kasun Prasanna,Jaffna,Jaffna,Northern,8479,8869,17348,339160,354760,693920
11/24/2024,Kasun Prasanna,Jaffna,Jaffna,Northern,9157,2736,11893,366280,109440,475720
11/25/2024,Kasun Prasanna,Jaffna,Jaffna,Northern,6884,6746,13630,275360,269840,545200
11/26/2024,Kasun Prasanna,Jaffna,Jaffna,Northern,3692,696,4388,147680,27840,175520
11/27/2024,Kasun Prasanna,Jaffna,Jaffna,Northern,6566,74,6640,262640,2960,265600
11/28/2024,Kasun Prasanna,Jaffna,Jaffna,Northern,3579,3610,7189,143160,144400,287560
11/29/2024,Kasun Prasanna,Jaffna,Jaffna,Northern,1228,8360,9588,49120,334400,383520
11/30/2024,Kasun Prasanna,Jaffna,Jaffna,Northern,8389,1942,10331,335560,77680,413240
12/1/2024,Kasun Prasanna,Jaffna,Jaffna,Northern,1077,7958,9035,43080,318320,361400
12/2/2024,Kasun Prasanna,Jaffna,Jaffna,Northern,9019,7240,16259,360760,289600,650360
12/3/2024,Kasun Prasanna,Jaffna,Jaffna,Northern,4056,3459,7515,162240,138360,300600
12/4/2024,Kasun Prasanna,Jaffna,Jaffna,Northern,259,2955,3214,10360,118200,128560
12/5/2024,Kasun Prasanna,Jaffna,Jaffna,Northern,3463,3372,6835,138520,134880,273400
12/6/2024,Kasun Prasanna,Jaffna,Jaffna,Northern,4588,7424,12012,183520,296960,480480
12/7/2024,Kasun Prasanna,Jaffna,Jaffna,Northern,3092,9951,13043,123680,398040,521720
12/8/2024,Kasun Prasanna,Jaffna,Jaffna,Northern,5399,940,6339,215960,37600,253560
12/9/2024,Kasun Prasanna,Jaffna,Jaffna,Northern,728,6634,7362,29120,265360,294480
12/10/2024,Kasun Prasanna,Jaffna,Jaffna,Northern,459,8293,8752,18360,331720,350080
12/11/2024,Kasun Prasanna,Jaffna,Jaffna,Northern,8178,2711,10889,327120,108440,435560
12/12/2024,Kasun Prasanna,Jaffna,Jaffna,Northern,9781,7849,17630,391240,313960,705200
12/13/2024,Kasun Prasanna,Jaffna,Jaffna,Northern,2130,6573,8703,85200,262920,348120
12/14/2024,Kasun Prasanna,Jaffna,Jaffna,Northern,4327,4792,9119,173080,191680,364760
12/15/2024,Kasun Prasanna,Jaffna,Jaffna,Northern,3952,1186,5138,158080,47440,205520
12/16/2024,Kasun Prasanna,Jaffna,Jaffna,Northern,4349,7611,11960,173960,304440,478400
12/17/2024,Kasun Prasanna,Jaffna,Jaffna,Northern,9062,8904,17966,362480,356160,718640
12/18/2024,Kasun Prasanna,Jaffna,Jaffna,Northern,8291,2523,10814,331640,100920,432560
12/19/2024,Kasun Prasanna,Jaffna,Jaffna,Northern,811,138,949,32440,5520,37960
12/20/2024,Kasun Prasanna,Jaffna,Jaffna,Northern,5850,2618,8468,234000,104720,338720
12/21/2024,Kasun Prasanna,Jaffna,Jaffna,Northern,853,1408,2261,34120,56320,90440
12/22/2024,Kasun Prasanna,Jaffna,Jaffna,Northern,6986,4747,11733,279440,189880,469320
12/23/2024,Kasun Prasanna,Jaffna,Jaffna,Northern,7470,9737,17207,298800,389480,688280
12/24/2024,Kasun Prasanna,Jaffna,Jaffna,Northern,2772,2447,5219,110880,97880,208760
12/25/2024,Kasun Prasanna,Jaffna,Jaffna,Northern,329,8112,8441,13160,324480,337640
12/26/2024,Kasun Prasanna,Jaffna,Jaffna,Northern,4087,3943,8030,163480,157720,321200
12/27/2024,Kasun Prasanna,Jaffna,Jaffna,Northern,7373,3246,10619,294920,129840,424760
12/28/2024,Kasun Prasanna,Jaffna,Jaffna,Northern,6972,6206,13178,278880,248240,527120
12/29/2024,Kasun Prasanna,Jaffna,Jaffna,Northern,6589,2074,8663,263560,82960,346520
12/30/2024,Kasun Prasanna,Jaffna,Jaffna,Northern,915,984,1899,36600,39360,75960
12/31/2024,Kasun Prasanna,Jaffna,Jaffna,Northern,3931,5965,9896,157240,238600,395840
1/1/2025,Kasun Prasanna,Jaffna,Jaffna,Northern,7608,9495,17103,304320,379800,684120
1/2/2025,Kasun Prasanna,Jaffna,Jaffna,Northern,6042,3181,9223,241680,127240,368920
1/3/2025,Kasun Prasanna,Jaffna,Jaffna,Northern,6529,863,7392,261160,34520,295680
1/4/2025,Kasun Prasanna,Jaffna,Jaffna,Northern,5708,3204,8912,228320,128160,356480
1/5/2025,Kasun Prasanna,Jaffna,Jaffna,Northern,679,1002,1681,27160,40080,67240
1/6/2025,Kasun Prasanna,Jaffna,Jaffna,Northern,6695,6886,13581,267800,275440,543240
1/7/2025,Kasun Prasanna,Jaffna,Jaffna,Northern,363,564,927,14520,22560,37080
1/8/2025,Kasun Prasanna,Jaffna,Jaffna,Northern,6609,5751,12360,264360,230040,494400
1/9/2025,Kasun Prasanna,Jaffna,Jaffna,Northern,3392,5394,8786,135680,215760,351440
1/10/2025,Kasun Prasanna,Jaffna,Jaffna,Northern,6363,68,6431,254520,2720,257240
1/11/2025,Kasun Prasanna,Jaffna,Jaffna,Northern,1462,9883,11345,58480,395320,453800
1/12/2025,Kasun Prasanna,Jaffna,Jaffna,Northern,8855,3971,12826,354200,158840,513040
1/13/2025,Kasun Prasanna,Jaffna,Jaffna,Northern,221,897,1118,8840,35880,44720
1/14/2025,Kasun Prasanna,Jaffna,Jaffna,Northern,5590,8623,14213,223600,344920,568520
1/15/2025,Kasun Prasanna,Jaffna,Jaffna,Northern,8197,994,9191,327880,39760,367640
1/16/2025,Kasun Prasanna,Jaffna,Jaffna,Northern,5376,765,6141,215040,30600,245640
1/17/2025,Kasun Prasanna,Jaffna,Jaffna,Northern,8587,6410,14997,343480,256400,599880
1/18/2025,Kasun Prasanna,Jaffna,Jaffna,Northern,2387,2822,5209,95480,112880,208360
1/19/2025,Kasun Prasanna,Jaffna,Jaffna,Northern,6673,2573,9246,266920,102920,369840
1/20/2025,Kasun Prasanna,Jaffna,Jaffna,Northern,4800,4343,9143,192000,173720,365720
1/21/2025,Kasun Prasanna,Jaffna,Jaffna,Northern,4635,9655,14290,185400,386200,571600
1/22/2025,Kasun Prasanna,Jaffna,Jaffna,Northern,7558,8817,16375,302320,352680,655000
1/23/2025,Kasun Prasanna,Jaffna,Jaffna,Northern,4872,2758,7630,194880,110320,305200
1/24/2025,Kasun Prasanna,Jaffna,Jaffna,Northern,5917,2794,8711,236680,111760,348440
1/25/2025,Kasun Prasanna,Jaffna,Jaffna,Northern,7025,3507,10532,281000,140280,421280
1/26/2025,Kasun Prasanna,Jaffna,Jaffna,Northern,6775,8548,15323,271000,341920,612920
1/27/2025,Kasun Prasanna,Jaffna,Jaffna,Northern,1615,9054,10669,64600,362160,426760
1/28/2025,Kasun Prasanna,Jaffna,Jaffna,Northern,5903,1553,7456,236120,62120,298240
1/29/2025,Kasun Prasanna,Jaffna,Jaffna,Northern,1529,3037,4566,61160,121480,182640
1/30/2025,Kasun Prasanna,Jaffna,Jaffna,Northern,7350,6908,14258,294000,276320,570320
1/31/2025,Kasun Prasanna,Jaffna,Jaffna,Northern,1213,1864,3077,48520,74560,123080
2/1/2025,Kasun Prasanna,Jaffna,Jaffna,Northern,8745,9835,18580,349800,393400,743200
2/2/2025,Kasun Prasanna,Jaffna,Jaffna,Northern,1532,9238,10770,61280,369520,430800
2/3/2025,Kasun Prasanna,Jaffna,Jaffna,Northern,8876,7153,16029,355040,286120,641160
2/4/2025,Kasun Prasanna,Jaffna,Jaffna,Northern,317,4461,4778,12680,178440,191120
2/5/2025,Kasun Prasanna,Jaffna,Jaffna,Northern,2474,1973,4447,98960,78920,177880
2/6/2025,Kasun Prasanna,Jaffna,Jaffna,Northern,1791,3630,5421,71640,145200,216840
2/7/2025,Kasun Prasanna,Jaffna,Jaffna,Northern,6608,8193,14801,264320,327720,592040
2/8/2025,Kasun Prasanna,Jaffna,Jaffna,Northern,2741,2044,4785,109640,81760,191400
2/9/2025,Kasun Prasanna,Jaffna,Jaffna,Northern,818,2564,3382,32720,102560,135280
2/10/2025,Kasun Prasanna,Jaffna,Jaffna,Northern,334,9950,10284,13360,398000,411360
2/11/2025,Kasun Prasanna,Jaffna,Jaffna,Northern,5921,2282,8203,236840,91280,328120
2/12/2025,Kasun Prasanna,Jaffna,Jaffna,Northern,2955,9689,12644,118200,387560,505760
2/13/2025,Kasun Prasanna,Jaffna,Jaffna,Northern,1762,8490,10252,70480,339600,410080
2/14/2025,Kasun Prasanna,Jaffna,Jaffna,Northern,4879,6627,11506,195160,265080,460240
2/15/2025,Kasun Prasanna,Jaffna,Jaffna,Northern,2274,7973,10247,90960,318920,409880
2/16/2025,Kasun Prasanna,Jaffna,Jaffna,Northern,8219,9570,17789,328760,382800,711560
2/17/2025,Kasun Prasanna,Jaffna,Jaffna,Northern,5609,9834,15443,224360,393360,617720
2/18/2025,Kasun Prasanna,Jaffna,Jaffna,Northern,88,1501,1589,3520,60040,63560
2/19/2025,Kasun Prasanna,Jaffna,Jaffna,Northern,1727,3326,5053,69080,133040,202120
2/20/2025,Kasun Prasanna,Jaffna,Jaffna,Northern,5204,3210,8414,208160,128400,336560
2/21/2025,Kasun Prasanna,Jaffna,Jaffna,Northern,8991,2473,11464,359640,98920,458560
2/22/2025,Kasun Prasanna,Jaffna,Jaffna,Northern,8599,1584,10183,343960,63360,407320
2/23/2025,Kasun Prasanna,Jaffna,Jaffna,Northern,4417,9709,14126,176680,388360,565040
2/24/2025,Kasun Prasanna,Jaffna,Jaffna,Northern,9634,6834,16468,385360,273360,658720
2/25/2025,Kasun Prasanna,Jaffna,Jaffna,Northern,2760,803,3563,110400,32120,142520
2/26/2025,Kasun Prasanna,Jaffna,Jaffna,Northern,4923,1356,6279,196920,54240,251160
2/27/2025,Kasun Prasanna,Jaffna,Jaffna,Northern,6833,8804,15637,273320,352160,625480
2/28/2025,Kasun Prasanna,Jaffna,Jaffna,Northern,7425,7775,15200,297000,311000,608000
3/1/2025,Kasun Prasanna,Jaffna,Jaffna,Northern,4607,1281,5888,184280,51240,235520
3/2/2025,Kasun Prasanna,Jaffna,Jaffna,Northern,3954,8070,12024,158160,322800,480960
3/3/2025,Kasun Prasanna,Jaffna,Jaffna,Northern,326,8885,9211,13040,355400,368440
3/4/2025,Kasun Prasanna,Jaffna,Jaffna,Northern,4795,6350,11145,191800,254000,445800
3/5/2025,Kasun Prasanna,Jaffna,Jaffna,Northern,9637,2239,11876,385480,89560,475040
3/6/2025,Kasun Prasanna,Jaffna,Jaffna,Northern,7346,8562,15908,293840,342480,636320
3/7/2025,Kasun Prasanna,Jaffna,Jaffna,Northern,4540,731,5271,181600,29240,210840
3/8/2025,Kasun Prasanna,Jaffna,Jaffna,Northern,9624,8977,18601,384960,359080,744040
3/9/2025,Kasun Prasanna,Jaffna,Jaffna,Northern,3525,2462,5987,141000,98480,239480
3/10/2025,Kasun Prasanna,Jaffna,Jaffna,Northern,8121,2405,10526,324840,96200,421040
3/11/2025,Kasun Prasanna,Jaffna,Jaffna,Northern,2099,1001,3100,83960,40040,124000
3/12/2025,Kasun Prasanna,Jaffna,Jaffna,Northern,430,4597,5027,17200,183880,201080
3/13/2025,Kasun Prasanna,Jaffna,Jaffna,Northern,6604,7804,14408,264160,312160,576320
3/14/2025,Kasun Prasanna,Jaffna,Jaffna,Northern,5597,1085,6682,223880,43400,267280
3/15/2025,Kasun Prasanna,Jaffna,Jaffna,Northern,2470,8927,11397,98800,357080,455880
3/16/2025,Kasun Prasanna,Jaffna,Jaffna,Northern,3215,9635,12850,128600,385400,514000
3/17/2025,Kasun Prasanna,Jaffna,Jaffna,Northern,9399,1627,11026,375960,65080,441040
3/18/2025,Kasun Prasanna,Jaffna,Jaffna,Northern,1644,2760,4404,65760,110400,176160
3/19/2025,Kasun Prasanna,Jaffna,Jaffna,Northern,2641,7481,10122,105640,299240,404880
3/20/2025,Kasun Prasanna,Jaffna,Jaffna,Northern,8566,5054,13620,342640,202160,544800
3/21/2025,Kasun Prasanna,Jaffna,Jaffna,Northern,7480,3543,11023,299200,141720,440920
3/22/2025,Kasun Prasanna,Jaffna,Jaffna,Northern,9169,9399,18568,366760,375960,742720
3/23/2025,Kasun Prasanna,Jaffna,Jaffna,Northern,4648,2448,7096,185920,97920,283840
3/25/2024,Ruwani Perera,Batticaloa,Pothuvil,Eastern,5556,3144,8700,222240,125760,348000
3/26/2024,Ruwani Perera,Batticaloa,Pothuvil,Eastern,8684,1508,10192,347360,60320,407680
3/27/2024,Ruwani Perera,Batticaloa,Pothuvil,Eastern,662,4093,4755,26480,163720,190200
3/28/2024,Ruwani Perera,Batticaloa,Pothuvil,Eastern,9931,3086,13017,397240,123440,520680
3/29/2024,Ruwani Perera,Batticaloa,Pothuvil,Eastern,9939,5309,15248,397560,212360,609920
3/30/2024,Ruwani Perera,Batticaloa,Pothuvil,Eastern,459,8610,9069,18360,344400,362760
3/31/2024,Ruwani Perera,Batticaloa,Pothuvil,Eastern,4795,1358,6153,191800,54320,246120
4/1/2024,Ruwani Perera,Batticaloa,Pothuvil,Eastern,3169,7380,10549,126760,295200,421960
4/2/2024,Ruwani Perera,Batticaloa,Pothuvil,Eastern,6763,7808,14571,270520,312320,582840
4/3/2024,Ruwani Perera,Batticaloa,Pothuvil,Eastern,6765,6230,12995,270600,249200,519800
4/4/2024,Ruwani Perera,Batticaloa,Pothuvil,Eastern,2581,6576,9157,103240,263040,366280
4/5/2024,Ruwani Perera,Batticaloa,Pothuvil,Eastern,220,7877,8097,8800,315080,323880
4/6/2024,Ruwani Perera,Batticaloa,Pothuvil,Eastern,4414,667,5081,176560,26680,203240
4/7/2024,Ruwani Perera,Batticaloa,Pothuvil,Eastern,9733,6586,16319,389320,263440,652760
4/8/2024,Ruwani Perera,Batticaloa,Pothuvil,Eastern,6244,5902,12146,249760,236080,485840
4/9/2024,Ruwani Perera,Batticaloa,Pothuvil,Eastern,8935,4400,13335,357400,176000,533400
4/10/2024,Ruwani Perera,Batticaloa,Pothuvil,Eastern,4494,8062,12556,179760,322480,502240
4/11/2024,Ruwani Perera,Batticaloa,Pothuvil,Eastern,9750,4451,14201,390000,178040,568040
4/19/2024,Ruwani Perera,Batticaloa,Pothuvil,Eastern,2869,2253,5122,114760,90120,204880
4/20/2024,Ruwani Perera,Batticaloa,Pothuvil,Eastern,6753,9628,16381,270120,385120,655240
4/21/2024,Ruwani Perera,Batticaloa,Pothuvil,Eastern,8212,5404,13616,328480,216160,544640
4/22/2024,Ruwani Perera,Batticaloa,Pothuvil,Eastern,4024,3163,7187,160960,126520,287480
4/23/2024,Ruwani Perera,Batticaloa,Pothuvil,Eastern,6889,5721,12610,275560,228840,504400
4/24/2024,Ruwani Perera,Batticaloa,Pothuvil,Eastern,8465,4627,13092,338600,185080,523680
4/25/2024,Ruwani Perera,Batticaloa,Pothuvil,Eastern,5617,6242,11859,224680,249680,474360
4/26/2024,Ruwani Perera,Batticaloa,Pothuvil,Eastern,9516,8410,17926,380640,336400,717040
4/27/2024,Ruwani Perera,Batticaloa,Pothuvil,Eastern,5328,4293,9621,213120,171720,384840
4/28/2024,Ruwani Perera,Batticaloa,Pothuvil,Eastern,2715,9405,12120,108600,376200,484800
4/29/2024,Ruwani Perera,Batticaloa,Pothuvil,Eastern,6947,6474,13421,277880,258960,536840
4/30/2024,Ruwani Perera,Batticaloa,Pothuvil,Eastern,7247,3279,10526,289880,131160,421040
5/1/2024,Ruwani Perera,Batticaloa,Pothuvil,Eastern,785,5771,6556,31400,230840,262240
5/2/2024,Ruwani Perera,Batticaloa,Pothuvil,Eastern,9673,3150,12823,386920,126000,512920
5/3/2024,Ruwani Perera,Batticaloa,Pothuvil,Eastern,4371,8023,12394,174840,320920,495760
5/4/2024,Ruwani Perera,Batticaloa,Pothuvil,Eastern,6554,5440,11994,262160,217600,479760
5/5/2024,Ruwani Perera,Batticaloa,Pothuvil,Eastern,2353,9308,11661,94120,372320,466440
5/6/2024,Ruwani Perera,Batticaloa,Pothuvil,Eastern,9674,9511,19185,386960,380440,767400
5/7/2024,Ruwani Perera,Batticaloa,Pothuvil,Eastern,9075,7692,16767,363000,307680,670680
5/8/2024,Ruwani Perera,Batticaloa,Pothuvil,Eastern,9407,3851,13258,376280,154040,530320
5/9/2024,Ruwani Perera,Batticaloa,Pothuvil,Eastern,5494,6760,12254,219760,270400,490160
5/10/2024,Ruwani Perera,Batticaloa,Pothuvil,Eastern,3122,3221,6343,124880,128840,253720
5/11/2024,Ruwani Perera,Batticaloa,Pothuvil,Eastern,7529,3436,10965,301160,137440,438600
5/12/2024,Ruwani Perera,Batticaloa,Pothuvil,Eastern,6295,248,6543,251800,9920,261720
5/13/2024,Ruwani Perera,Batticaloa,Pothuvil,Eastern,5536,5063,10599,221440,202520,423960
5/14/2024,Ruwani Perera,Batticaloa,Pothuvil,Eastern,9137,9240,18377,365480,369600,735080
5/15/2024,Ruwani Perera,Batticaloa,Pothuvil,Eastern,6412,8548,14960,256480,341920,598400
5/16/2024,Ruwani Perera,Batticaloa,Pothuvil,Eastern,8185,5833,14018,327400,233320,560720
5/17/2024,Ruwani Perera,Batticaloa,Pothuvil,Eastern,8953,1354,10307,358120,54160,412280
5/18/2024,Ruwani Perera,Batticaloa,Pothuvil,Eastern,9975,6265,16240,399000,250600,649600
5/19/2024,Ruwani Perera,Batticaloa,Pothuvil,Eastern,6206,5902,12108,248240,236080,484320
5/20/2024,Ruwani Perera,Batticaloa,Pothuvil,Eastern,5070,8127,13197,202800,325080,527880
5/21/2024,Ruwani Perera,Batticaloa,Pothuvil,Eastern,465,7084,7549,18600,283360,301960
5/22/2024,Ruwani Perera,Batticaloa,Pothuvil,Eastern,450,9989,10439,18000,399560,417560
5/24/2024,Ruwani Perera,Batticaloa,Pothuvil,Eastern,5434,5297,10731,217360,211880,429240
5/25/2024,Ruwani Perera,Batticaloa,Pothuvil,Eastern,3659,314,3973,146360,12560,158920
5/26/2024,Ruwani Perera,Batticaloa,Pothuvil,Eastern,4054,5563,9617,162160,222520,384680
5/27/2024,Ruwani Perera,Batticaloa,Pothuvil,Eastern,9296,2615,11911,371840,104600,476440
5/28/2024,Ruwani Perera,Batticaloa,Pothuvil,Eastern,3742,4091,7833,149680,163640,313320
5/29/2024,Ruwani Perera,Batticaloa,Pothuvil,Eastern,9210,9066,18276,368400,362640,731040
5/30/2024,Ruwani Perera,Batticaloa,Pothuvil,Eastern,2860,9214,12074,114400,368560,482960
5/31/2024,Ruwani Perera,Batticaloa,Pothuvil,Eastern,4436,3503,7939,177440,140120,317560
6/1/2024,Ruwani Perera,Batticaloa,Pothuvil,Eastern,2710,6845,9555,108400,273800,382200
6/2/2024,Ruwani Perera,Batticaloa,Pothuvil,Eastern,4122,7290,11412,164880,291600,456480
6/3/2024,Ruwani Perera,Batticaloa,Pothuvil,Eastern,5339,7021,12360,213560,280840,494400
6/4/2024,Ruwani Perera,Batticaloa,Pothuvil,Eastern,7190,9470,16660,287600,378800,666400
6/5/2024,Ruwani Perera,Batticaloa,Pothuvil,Eastern,6078,92,6170,243120,3680,246800
6/6/2024,Ruwani Perera,Batticaloa,Pothuvil,Eastern,138,8772,8910,5520,350880,356400
6/7/2024,Ruwani Perera,Batticaloa,Pothuvil,Eastern,2884,3703,6587,115360,148120,263480
6/8/2024,Ruwani Perera,Batticaloa,Pothuvil,Eastern,6455,6419,12874,258200,256760,514960
6/9/2024,Ruwani Perera,Batticaloa,Pothuvil,Eastern,9351,6114,15465,374040,244560,618600
6/10/2024,Ruwani Perera,Batticaloa,Pothuvil,Eastern,9884,2042,11926,395360,81680,477040
6/11/2024,Ruwani Perera,Batticaloa,Pothuvil,Eastern,9160,1850,11010,366400,74000,440400
6/12/2024,Ruwani Perera,Batticaloa,Pothuvil,Eastern,385,5398,5783,15400,215920,231320
6/13/2024,Ruwani Perera,Batticaloa,Pothuvil,Eastern,6616,8632,15248,264640,345280,609920
6/14/2024,Ruwani Perera,Batticaloa,Pothuvil,Eastern,6715,8001,14716,268600,320040,588640
6/15/2024,Ruwani Perera,Batticaloa,Pothuvil,Eastern,353,7066,7419,14120,282640,296760
6/16/2024,Ruwani Perera,Batticaloa,Pothuvil,Eastern,7405,9182,16587,296200,367280,663480
6/17/2024,Ruwani Perera,Batticaloa,Pothuvil,Eastern,4664,7205,11869,186560,288200,474760
6/18/2024,Ruwani Perera,Batticaloa,Pothuvil,Eastern,62,4967,5029,2480,198680,201160
6/19/2024,Ruwani Perera,Batticaloa,Pothuvil,Eastern,7052,7644,14696,282080,305760,587840
6/20/2024,Ruwani Perera,Batticaloa,Pothuvil,Eastern,3898,9486,13384,155920,379440,535360
6/21/2024,Ruwani Perera,Batticaloa,Pothuvil,Eastern,5480,4824,10304,219200,192960,412160
6/22/2024,Ruwani Perera,Batticaloa,Pothuvil,Eastern,9267,4892,14159,370680,195680,566360
6/23/2024,Ruwani Perera,Batticaloa,Pothuvil,Eastern,9158,37,9195,366320,1480,367800
6/24/2024,Ruwani Perera,Batticaloa,Pothuvil,Eastern,2757,6894,9651,110280,275760,386040
6/25/2024,Ruwani Perera,Batticaloa,Pothuvil,Eastern,9769,7873,17642,390760,314920,705680
6/26/2024,Ruwani Perera,Batticaloa,Pothuvil,Eastern,2851,4615,7466,114040,184600,298640
6/27/2024,Ruwani Perera,Batticaloa,Pothuvil,Eastern,8169,2212,10381,326760,88480,415240
6/28/2024,Ruwani Perera,Batticaloa,Pothuvil,Eastern,6216,5575,11791,248640,223000,471640
6/29/2024,Ruwani Perera,Batticaloa,Pothuvil,Eastern,3217,8727,11944,128680,349080,477760
6/30/2024,Ruwani Perera,Batticaloa,Pothuvil,Eastern,1769,2847,4616,70760,113880,184640
7/1/2024,Ruwani Perera,Batticaloa,Pothuvil,Eastern,3301,2013,5314,132040,80520,212560
7/2/2024,Ruwani Perera,Batticaloa,Pothuvil,Eastern,5393,5753,11146,215720,230120,445840
7/3/2024,Ruwani Perera,Batticaloa,Pothuvil,Eastern,9045,305,9350,361800,12200,374000
7/4/2024,Ruwani Perera,Batticaloa,Pothuvil,Eastern,6395,3876,10271,255800,155040,410840
7/5/2024,Ruwani Perera,Batticaloa,Pothuvil,Eastern,7715,8022,15737,308600,320880,629480
7/6/2024,Ruwani Perera,Batticaloa,Pothuvil,Eastern,2551,1688,4239,102040,67520,169560
7/7/2024,Ruwani Perera,Batticaloa,Pothuvil,Eastern,6157,5454,11611,246280,218160,464440
7/8/2024,Ruwani Perera,Batticaloa,Pothuvil,Eastern,2257,7192,9449,90280,287680,377960
7/9/2024,Ruwani Perera,Batticaloa,Pothuvil,Eastern,762,7749,8511,30480,309960,340440
7/10/2024,Ruwani Perera,Batticaloa,Pothuvil,Eastern,9516,6093,15609,380640,243720,624360
7/11/2024,Ruwani Perera,Batticaloa,Pothuvil,Eastern,2758,7003,9761,110320,280120,390440
7/12/2024,Ruwani Perera,Batticaloa,Pothuvil,Eastern,3371,4491,7862,134840,179640,314480
7/13/2024,Ruwani Perera,Batticaloa,Pothuvil,Eastern,2871,1407,4278,114840,56280,171120
7/14/2024,Ruwani Perera,Batticaloa,Pothuvil,Eastern,1265,2859,4124,50600,114360,164960
7/15/2024,Ruwani Perera,Batticaloa,Pothuvil,Eastern,9091,5566,14657,363640,222640,586280
7/16/2024,Ruwani Perera,Batticaloa,Pothuvil,Eastern,4751,7366,12117,190040,294640,484680
7/17/2024,Ruwani Perera,Batticaloa,Pothuvil,Eastern,5447,8160,13607,217880,326400,544280
7/18/2024,Ruwani Perera,Batticaloa,Pothuvil,Eastern,2909,9816,12725,116360,392640,509000
7/19/2024,Ruwani Perera,Batticaloa,Pothuvil,Eastern,7578,1772,9350,303120,70880,374000
7/20/2024,Ruwani Perera,Batticaloa,Pothuvil,Eastern,8865,899,9764,354600,35960,390560
7/21/2024,Ruwani Perera,Batticaloa,Pothuvil,Eastern,8,506,514,320,20240,20560
7/22/2024,Ruwani Perera,Batticaloa,Pothuvil,Eastern,6206,6225,12431,248240,249000,497240
7/23/2024,Ruwani Perera,Batticaloa,Pothuvil,Eastern,8826,79,8905,353040,3160,356200
7/24/2024,Ruwani Perera,Batticaloa,Pothuvil,Eastern,4592,891,5483,183680,35640,219320
7/25/2024,Ruwani Perera,Batticaloa,Pothuvil,Eastern,5790,8131,13921,231600,325240,556840
7/26/2024,Ruwani Perera,Batticaloa,Pothuvil,Eastern,7799,5869,13668,311960,234760,546720
7/27/2024,Ruwani Perera,Batticaloa,Pothuvil,Eastern,5763,5387,11150,230520,215480,446000
7/28/2024,Ruwani Perera,Batticaloa,Pothuvil,Eastern,6283,3885,10168,251320,155400,406720
7/29/2024,Ruwani Perera,Batticaloa,Pothuvil,Eastern,7012,6588,13600,280480,263520,544000
7/30/2024,Ruwani Perera,Batticaloa,Pothuvil,Eastern,534,3907,4441,21360,156280,177640
7/31/2024,Ruwani Perera,Batticaloa,Pothuvil,Eastern,9997,3737,13734,399880,149480,549360
8/1/2024,Ruwani Perera,Batticaloa,Pothuvil,Eastern,7015,3925,10940,280600,157000,437600
8/2/2024,Ruwani Perera,Batticaloa,Pothuvil,Eastern,5505,3366,8871,220200,134640,354840
8/3/2024,Ruwani Perera,Batticaloa,Pothuvil,Eastern,1804,1976,3780,72160,79040,151200
8/4/2024,Ruwani Perera,Batticaloa,Pothuvil,Eastern,527,183,710,21080,7320,28400
8/5/2024,Ruwani Perera,Batticaloa,Pothuvil,Eastern,9739,7573,17312,389560,302920,692480
8/6/2024,Ruwani Perera,Batticaloa,Pothuvil,Eastern,47,6222,6269,1880,248880,250760
8/7/2024,Ruwani Perera,Batticaloa,Pothuvil,Eastern,8708,2446,11154,348320,97840,446160
8/8/2024,Ruwani Perera,Batticaloa,Pothuvil,Eastern,2689,5898,8587,107560,235920,343480
8/9/2024,Ruwani Perera,Batticaloa,Pothuvil,Eastern,323,2874,3197,12920,114960,127880
8/10/2024,Ruwani Perera,Batticaloa,Pothuvil,Eastern,8626,5898,14524,345040,235920,580960
8/11/2024,Ruwani Perera,Batticaloa,Pothuvil,Eastern,5775,9672,15447,231000,386880,617880
8/12/2024,Ruwani Perera,Batticaloa,Pothuvil,Eastern,9835,9331,19166,393400,373240,766640
8/13/2024,Ruwani Perera,Batticaloa,Pothuvil,Eastern,8343,635,8978,333720,25400,359120
8/14/2024,Ruwani Perera,Batticaloa,Pothuvil,Eastern,864,9504,10368,34560,380160,414720
8/15/2024,Ruwani Perera,Batticaloa,Pothuvil,Eastern,556,5948,6504,22240,237920,260160
8/16/2024,Ruwani Perera,Batticaloa,Pothuvil,Eastern,732,8125,8857,29280,325000,354280
8/17/2024,Ruwani Perera,Batticaloa,Pothuvil,Eastern,1099,8896,9995,43960,355840,399800
8/18/2024,Ruwani Perera,Batticaloa,Pothuvil,Eastern,8792,2336,11128,351680,93440,445120
8/19/2024,Ruwani Perera,Batticaloa,Pothuvil,Eastern,3022,7624,10646,120880,304960,425840
8/20/2024,Ruwani Perera,Batticaloa,Pothuvil,Eastern,605,5169,5774,24200,206760,230960
8/21/2024,Ruwani Perera,Batticaloa,Pothuvil,Eastern,5067,7735,12802,202680,309400,512080
8/22/2024,Ruwani Perera,Batticaloa,Pothuvil,Eastern,1324,7872,9196,52960,314880,367840
8/23/2024,Ruwani Perera,Batticaloa,Pothuvil,Eastern,1632,9743,11375,65280,389720,455000
8/24/2024,Ruwani Perera,Batticaloa,Pothuvil,Eastern,7852,3734,11586,314080,149360,463440
8/25/2024,Ruwani Perera,Batticaloa,Pothuvil,Eastern,2575,6478,9053,103000,259120,362120
8/26/2024,Ruwani Perera,Batticaloa,Pothuvil,Eastern,1999,6363,8362,79960,254520,334480
8/27/2024,Ruwani Perera,Batticaloa,Pothuvil,Eastern,6374,8301,14675,254960,332040,587000
8/28/2024,Ruwani Perera,Batticaloa,Pothuvil,Eastern,9198,8571,17769,367920,342840,710760
8/29/2024,Ruwani Perera,Batticaloa,Pothuvil,Eastern,5433,4153,9586,217320,166120,383440
8/30/2024,Ruwani Perera,Batticaloa,Pothuvil,Eastern,3821,6040,9861,152840,241600,394440
8/31/2024,Ruwani Perera,Batticaloa,Pothuvil,Eastern,5544,2393,7937,221760,95720,317480
9/1/2024,Ruwani Perera,Batticaloa,Pothuvil,Eastern,2244,840,3084,89760,33600,123360
9/2/2024,Ruwani Perera,Batticaloa,Pothuvil,Eastern,9924,9796,19720,396960,391840,788800
9/3/2024,Ruwani Perera,Batticaloa,Pothuvil,Eastern,5723,5764,11487,228920,230560,459480
9/4/2024,Ruwani Perera,Batticaloa,Pothuvil,Eastern,4523,1031,5554,180920,41240,222160
9/5/2024,Ruwani Perera,Batticaloa,Pothuvil,Eastern,4402,6650,11052,176080,266000,442080
9/6/2024,Ruwani Perera,Batticaloa,Pothuvil,Eastern,5386,376,5762,215440,15040,230480
9/7/2024,Ruwani Perera,Batticaloa,Pothuvil,Eastern,8802,4203,13005,352080,168120,520200
9/8/2024,Ruwani Perera,Batticaloa,Pothuvil,Eastern,4283,2289,6572,171320,91560,262880
9/9/2024,Ruwani Perera,Batticaloa,Pothuvil,Eastern,981,6836,7817,39240,273440,312680
9/10/2024,Ruwani Perera,Batticaloa,Pothuvil,Eastern,9711,9914,19625,388440,396560,785000
9/11/2024,Ruwani Perera,Batticaloa,Pothuvil,Eastern,6839,5593,12432,273560,223720,497280
9/12/2024,Ruwani Perera,Batticaloa,Pothuvil,Eastern,2564,5810,8374,102560,232400,334960
9/13/2024,Ruwani Perera,Batticaloa,Pothuvil,Eastern,7817,1160,8977,312680,46400,359080
9/14/2024,Ruwani Perera,Batticaloa,Pothuvil,Eastern,5339,5597,10936,213560,223880,437440
9/15/2024,Ruwani Perera,Batticaloa,Pothuvil,Eastern,8507,8150,16657,340280,326000,666280
9/16/2024,Ruwani Perera,Batticaloa,Pothuvil,Eastern,4442,7612,12054,177680,304480,482160
9/17/2024,Ruwani Perera,Batticaloa,Pothuvil,Eastern,6495,4814,11309,259800,192560,452360
9/18/2024,Ruwani Perera,Batticaloa,Pothuvil,Eastern,1558,9079,10637,62320,363160,425480
9/19/2024,Ruwani Perera,Batticaloa,Pothuvil,Eastern,4049,5134,9183,161960,205360,367320
9/20/2024,Ruwani Perera,Batticaloa,Pothuvil,Eastern,7871,4419,12290,314840,176760,491600
9/21/2024,Ruwani Perera,Batticaloa,Pothuvil,Eastern,1262,8846,10108,50480,353840,404320
9/22/2024,Ruwani Perera,Batticaloa,Pothuvil,Eastern,3364,7390,10754,134560,295600,430160
9/23/2024,Ruwani Perera,Batticaloa,Pothuvil,Eastern,3824,9911,13735,152960,396440,549400
9/24/2024,Ruwani Perera,Batticaloa,Pothuvil,Eastern,8284,1869,10153,331360,74760,406120
9/25/2024,Ruwani Perera,Batticaloa,Pothuvil,Eastern,8896,5846,14742,355840,233840,589680
9/26/2024,Ruwani Perera,Batticaloa,Pothuvil,Eastern,7622,9699,17321,304880,387960,692840
9/27/2024,Ruwani Perera,Batticaloa,Pothuvil,Eastern,3712,5998,9710,148480,239920,388400
9/28/2024,Ruwani Perera,Batticaloa,Pothuvil,Eastern,4181,7858,12039,167240,314320,481560
9/29/2024,Ruwani Perera,Batticaloa,Pothuvil,Eastern,2396,2337,4733,95840,93480,189320
9/30/2024,Ruwani Perera,Batticaloa,Pothuvil,Eastern,3233,8018,11251,129320,320720,450040
10/1/2024,Ruwani Perera,Batticaloa,Pothuvil,Eastern,6635,6939,13574,265400,277560,542960
10/2/2024,Ruwani Perera,Batticaloa,Pothuvil,Eastern,9362,5465,14827,374480,218600,593080
10/3/2024,Ruwani Perera,Batticaloa,Pothuvil,Eastern,3889,5227,9116,155560,209080,364640
10/4/2024,Ruwani Perera,Batticaloa,Pothuvil,Eastern,9089,3998,13087,363560,159920,523480
10/5/2024,Ruwani Perera,Batticaloa,Pothuvil,Eastern,4096,7460,11556,163840,298400,462240
10/6/2024,Ruwani Perera,Batticaloa,Pothuvil,Eastern,9333,9767,19100,373320,390680,764000
10/7/2024,Ruwani Perera,Batticaloa,Pothuvil,Eastern,4139,8963,13102,165560,358520,524080
10/8/2024,Ruwani Perera,Batticaloa,Pothuvil,Eastern,5475,9106,14581,219000,364240,583240
10/9/2024,Ruwani Perera,Batticaloa,Pothuvil,Eastern,8603,8507,17110,344120,340280,684400
10/10/2024,Ruwani Perera,Batticaloa,Pothuvil,Eastern,309,4784,5093,12360,191360,203720
10/11/2024,Ruwani Perera,Batticaloa,Pothuvil,Eastern,4973,1762,6735,198920,70480,269400
10/12/2024,Ruwani Perera,Batticaloa,Pothuvil,Eastern,5276,2116,7392,211040,84640,295680
10/13/2024,Ruwani Perera,Batticaloa,Pothuvil,Eastern,2759,5332,8091,110360,213280,323640
10/14/2024,Ruwani Perera,Batticaloa,Pothuvil,Eastern,7396,3703,11099,295840,148120,443960
10/15/2024,Ruwani Perera,Batticaloa,Pothuvil,Eastern,3760,610,4370,150400,24400,174800
10/16/2024,Ruwani Perera,Batticaloa,Pothuvil,Eastern,6995,6270,13265,279800,250800,530600
10/17/2024,Ruwani Perera,Batticaloa,Pothuvil,Eastern,1484,6087,7571,59360,243480,302840
10/18/2024,Ruwani Perera,Batticaloa,Pothuvil,Eastern,5662,9093,14755,226480,363720,590200
10/19/2024,Ruwani Perera,Batticaloa,Pothuvil,Eastern,8322,5942,14264,332880,237680,570560
10/20/2024,Ruwani Perera,Batticaloa,Pothuvil,Eastern,6570,6300,12870,262800,252000,514800
10/21/2024,Ruwani Perera,Batticaloa,Pothuvil,Eastern,7413,3636,11049,296520,145440,441960
10/22/2024,Ruwani Perera,Batticaloa,Pothuvil,Eastern,165,915,1080,6600,36600,43200
10/23/2024,Ruwani Perera,Batticaloa,Pothuvil,Eastern,4383,4421,8804,175320,176840,352160
10/24/2024,Ruwani Perera,Batticaloa,Pothuvil,Eastern,8986,3857,12843,359440,154280,513720
10/25/2024,Ruwani Perera,Batticaloa,Pothuvil,Eastern,7981,2047,10028,319240,81880,401120
10/26/2024,Ruwani Perera,Batticaloa,Pothuvil,Eastern,7993,7955,15948,319720,318200,637920
10/27/2024,Ruwani Perera,Batticaloa,Pothuvil,Eastern,2457,6023,8480,98280,240920,339200
10/28/2024,Ruwani Perera,Batticaloa,Pothuvil,Eastern,3309,447,3756,132360,17880,150240
10/29/2024,Ruwani Perera,Batticaloa,Pothuvil,Eastern,4703,4303,9006,188120,172120,360240
10/30/2024,Ruwani Perera,Batticaloa,Pothuvil,Eastern,6619,3643,10262,264760,145720,410480
10/31/2024,Ruwani Perera,Batticaloa,Pothuvil,Eastern,8971,5628,14599,358840,225120,583960
11/1/2024,Ruwani Perera,Batticaloa,Pothuvil,Eastern,7710,9417,17127,308400,376680,685080
11/2/2024,Ruwani Perera,Batticaloa,Pothuvil,Eastern,8319,2539,10858,332760,101560,434320
11/3/2024,Ruwani Perera,Batticaloa,Pothuvil,Eastern,646,2327,2973,25840,93080,118920
11/4/2024,Ruwani Perera,Batticaloa,Pothuvil,Eastern,6035,6419,12454,241400,256760,498160
11/5/2024,Ruwani Perera,Batticaloa,Pothuvil,Eastern,6906,4991,11897,276240,199640,475880
11/6/2024,Ruwani Perera,Batticaloa,Pothuvil,Eastern,7432,2867,10299,297280,114680,411960
11/7/2024,Ruwani Perera,Batticaloa,Pothuvil,Eastern,4762,8641,13403,190480,345640,536120
11/8/2024,Ruwani Perera,Batticaloa,Pothuvil,Eastern,7506,5500,13006,300240,220000,520240
11/9/2024,Ruwani Perera,Batticaloa,Pothuvil,Eastern,5042,5679,10721,201680,227160,428840
11/10/2024,Ruwani Perera,Batticaloa,Pothuvil,Eastern,9259,1142,10401,370360,45680,416040
11/11/2024,Ruwani Perera,Batticaloa,Pothuvil,Eastern,7724,2767,10491,308960,110680,419640
11/12/2024,Ruwani Perera,Batticaloa,Pothuvil,Eastern,4736,3893,8629,189440,155720,345160
11/13/2024,Ruwani Perera,Batticaloa,Pothuvil,Eastern,7860,236,8096,314400,9440,323840
11/14/2024,Ruwani Perera,Batticaloa,Pothuvil,Eastern,5451,8341,13792,218040,333640,551680
11/15/2024,Ruwani Perera,Batticaloa,Pothuvil,Eastern,3915,3235,7150,156600,129400,286000
11/16/2024,Ruwani Perera,Batticaloa,Pothuvil,Eastern,1897,194,2091,75880,7760,83640
11/17/2024,Ruwani Perera,Batticaloa,Pothuvil,Eastern,2899,7886,10785,115960,315440,431400
11/18/2024,Ruwani Perera,Batticaloa,Pothuvil,Eastern,2313,4034,6347,92520,161360,253880
11/19/2024,Ruwani Perera,Batticaloa,Pothuvil,Eastern,6943,6495,13438,277720,259800,537520
11/20/2024,Ruwani Perera,Batticaloa,Pothuvil,Eastern,5790,7739,13529,231600,309560,541160
11/21/2024,Ruwani Perera,Batticaloa,Pothuvil,Eastern,5200,896,6096,208000,35840,243840
11/22/2024,Ruwani Perera,Batticaloa,Pothuvil,Eastern,385,8404,8789,15400,336160,351560
11/23/2024,Ruwani Perera,Batticaloa,Pothuvil,Eastern,5177,7859,13036,207080,314360,521440
11/24/2024,Ruwani Perera,Batticaloa,Pothuvil,Eastern,5561,5139,10700,222440,205560,428000
11/25/2024,Ruwani Perera,Batticaloa,Pothuvil,Eastern,8479,5604,14083,339160,224160,563320
11/26/2024,Ruwani Perera,Batticaloa,Pothuvil,Eastern,3671,5496,9167,146840,219840,366680
11/27/2024,Ruwani Perera,Batticaloa,Pothuvil,Eastern,1511,6702,8213,60440,268080,328520
11/28/2024,Ruwani Perera,Batticaloa,Pothuvil,Eastern,5544,873,6417,221760,34920,256680
11/29/2024,Ruwani Perera,Batticaloa,Pothuvil,Eastern,4486,413,4899,179440,16520,195960
11/30/2024,Ruwani Perera,Batticaloa,Pothuvil,Eastern,5175,7193,12368,207000,287720,494720
12/1/2024,Ruwani Perera,Batticaloa,Pothuvil,Eastern,4162,8274,12436,166480,330960,497440
12/2/2024,Ruwani Perera,Batticaloa,Pothuvil,Eastern,523,7751,8274,20920,310040,330960
12/3/2024,Ruwani Perera,Batticaloa,Pothuvil,Eastern,3631,5690,9321,145240,227600,372840
12/4/2024,Ruwani Perera,Batticaloa,Pothuvil,Eastern,7684,5123,12807,307360,204920,512280
12/5/2024,Ruwani Perera,Batticaloa,Pothuvil,Eastern,6912,6896,13808,276480,275840,552320
12/6/2024,Ruwani Perera,Batticaloa,Pothuvil,Eastern,3149,7811,10960,125960,312440,438400
12/7/2024,Ruwani Perera,Batticaloa,Pothuvil,Eastern,175,2608,2783,7000,104320,111320
12/8/2024,Ruwani Perera,Batticaloa,Pothuvil,Eastern,7558,3884,11442,302320,155360,457680
12/9/2024,Ruwani Perera,Batticaloa,Pothuvil,Eastern,6051,6126,12177,242040,245040,487080
12/10/2024,Ruwani Perera,Batticaloa,Pothuvil,Eastern,3839,7665,11504,153560,306600,460160
12/11/2024,Ruwani Perera,Batticaloa,Pothuvil,Eastern,6214,1030,7244,248560,41200,289760
12/12/2024,Ruwani Perera,Batticaloa,Pothuvil,Eastern,92,4636,4728,3680,185440,189120
12/13/2024,Ruwani Perera,Batticaloa,Pothuvil,Eastern,6766,239,7005,270640,9560,280200
12/14/2024,Ruwani Perera,Batticaloa,Pothuvil,Eastern,6058,5533,11591,242320,221320,463640
12/15/2024,Ruwani Perera,Batticaloa,Pothuvil,Eastern,1111,8321,9432,44440,332840,377280
12/16/2024,Ruwani Perera,Batticaloa,Pothuvil,Eastern,5443,6092,11535,217720,243680,461400
12/17/2024,Ruwani Perera,Batticaloa,Pothuvil,Eastern,9920,8278,18198,396800,331120,727920
12/18/2024,Ruwani Perera,Batticaloa,Pothuvil,Eastern,7719,8693,16412,308760,347720,656480
12/19/2024,Ruwani Perera,Batticaloa,Pothuvil,Eastern,2202,1437,3639,88080,57480,145560
12/20/2024,Ruwani Perera,Batticaloa,Pothuvil,Eastern,6370,5183,11553,254800,207320,462120
12/21/2024,Ruwani Perera,Batticaloa,Pothuvil,Eastern,5803,921,6724,232120,36840,268960
12/22/2024,Ruwani Perera,Batticaloa,Pothuvil,Eastern,1830,4717,6547,73200,188680,261880
12/23/2024,Ruwani Perera,Batticaloa,Pothuvil,Eastern,2390,8121,10511,95600,324840,420440
12/24/2024,Ruwani Perera,Batticaloa,Pothuvil,Eastern,9529,7580,17109,381160,303200,684360
12/25/2024,Ruwani Perera,Batticaloa,Pothuvil,Eastern,7404,5972,13376,296160,238880,535040
12/26/2024,Ruwani Perera,Batticaloa,Pothuvil,Eastern,8918,5913,14831,356720,236520,593240
12/27/2024,Ruwani Perera,Batticaloa,Pothuvil,Eastern,3437,3857,7294,137480,154280,291760
12/28/2024,Ruwani Perera,Batticaloa,Pothuvil,Eastern,3663,2361,6024,146520,94440,240960
12/29/2024,Ruwani Perera,Batticaloa,Pothuvil,Eastern,5851,6860,12711,234040,274400,508440
12/30/2024,Ruwani Perera,Batticaloa,Pothuvil,Eastern,7926,4309,12235,317040,172360,489400
12/31/2024,Ruwani Perera,Batticaloa,Pothuvil,Eastern,9350,4022,13372,374000,160880,534880
1/1/2025,Ruwani Perera,Batticaloa,Pothuvil,Eastern,5931,1017,6948,237240,40680,277920
1/2/2025,Ruwani Perera,Batticaloa,Pothuvil,Eastern,7145,9740,16885,285800,389600,675400
1/3/2025,Ruwani Perera,Batticaloa,Pothuvil,Eastern,3297,3693,6990,131880,147720,279600
1/4/2025,Ruwani Perera,Batticaloa,Pothuvil,Eastern,9256,6499,15755,370240,259960,630200
1/5/2025,Ruwani Perera,Batticaloa,Pothuvil,Eastern,608,6086,6694,24320,243440,267760
1/6/2025,Ruwani Perera,Batticaloa,Pothuvil,Eastern,7374,4256,11630,294960,170240,465200
1/7/2025,Ruwani Perera,Batticaloa,Pothuvil,Eastern,7525,7440,14965,301000,297600,598600
1/8/2025,Ruwani Perera,Batticaloa,Pothuvil,Eastern,2474,5667,8141,98960,226680,325640
1/9/2025,Ruwani Perera,Batticaloa,Pothuvil,Eastern,172,4119,4291,6880,164760,171640
1/10/2025,Ruwani Perera,Batticaloa,Pothuvil,Eastern,703,7376,8079,28120,295040,323160
1/11/2025,Ruwani Perera,Batticaloa,Pothuvil,Eastern,707,7035,7742,28280,281400,309680
1/12/2025,Ruwani Perera,Batticaloa,Pothuvil,Eastern,5552,6511,12063,222080,260440,482520
1/13/2025,Ruwani Perera,Batticaloa,Pothuvil,Eastern,3366,4318,7684,134640,172720,307360
1/14/2025,Ruwani Perera,Batticaloa,Pothuvil,Eastern,8872,5120,13992,354880,204800,559680
1/15/2025,Ruwani Perera,Batticaloa,Pothuvil,Eastern,7710,1174,8884,308400,46960,355360
1/16/2025,Ruwani Perera,Batticaloa,Pothuvil,Eastern,4042,7190,11232,161680,287600,449280
1/17/2025,Ruwani Perera,Batticaloa,Pothuvil,Eastern,7737,1048,8785,309480,41920,351400
1/18/2025,Ruwani Perera,Batticaloa,Pothuvil,Eastern,7607,2069,9676,304280,82760,387040
1/19/2025,Ruwani Perera,Batticaloa,Pothuvil,Eastern,2640,8296,10936,105600,331840,437440
1/20/2025,Ruwani Perera,Batticaloa,Pothuvil,Eastern,2576,9968,12544,103040,398720,501760
1/21/2025,Ruwani Perera,Batticaloa,Pothuvil,Eastern,2455,8001,10456,98200,320040,418240
1/22/2025,Ruwani Perera,Batticaloa,Pothuvil,Eastern,2636,873,3509,105440,34920,140360
1/23/2025,Ruwani Perera,Batticaloa,Pothuvil,Eastern,7229,1496,8725,289160,59840,349000
1/24/2025,Ruwani Perera,Batticaloa,Pothuvil,Eastern,3336,530,3866,133440,21200,154640
1/25/2025,Ruwani Perera,Batticaloa,Pothuvil,Eastern,5560,451,6011,222400,18040,240440
1/26/2025,Ruwani Perera,Batticaloa,Pothuvil,Eastern,3028,6928,9956,121120,277120,398240
1/27/2025,Ruwani Perera,Batticaloa,Pothuvil,Eastern,2205,3818,6023,88200,152720,240920
1/28/2025,Ruwani Perera,Batticaloa,Pothuvil,Eastern,9666,981,10647,386640,39240,425880
1/29/2025,Ruwani Perera,Batticaloa,Pothuvil,Eastern,5632,5109,10741,225280,204360,429640
1/30/2025,Ruwani Perera,Batticaloa,Pothuvil,Eastern,5696,7115,12811,227840,284600,512440
1/31/2025,Ruwani Perera,Batticaloa,Pothuvil,Eastern,101,8084,8185,4040,323360,327400
2/1/2025,Ruwani Perera,Batticaloa,Pothuvil,Eastern,7469,3740,11209,298760,149600,448360
2/2/2025,Ruwani Perera,Batticaloa,Pothuvil,Eastern,3047,8760,11807,121880,350400,472280
2/3/2025,Ruwani Perera,Batticaloa,Pothuvil,Eastern,4880,368,5248,195200,14720,209920
2/4/2025,Ruwani Perera,Batticaloa,Pothuvil,Eastern,1072,4428,5500,42880,177120,220000
2/5/2025,Ruwani Perera,Batticaloa,Pothuvil,Eastern,6412,6775,13187,256480,271000,527480
2/6/2025,Ruwani Perera,Batticaloa,Pothuvil,Eastern,1054,8905,9959,42160,356200,398360
2/7/2025,Ruwani Perera,Batticaloa,Pothuvil,Eastern,4863,945,5808,194520,37800,232320
2/8/2025,Ruwani Perera,Batticaloa,Pothuvil,Eastern,6119,2852,8971,244760,114080,358840
2/9/2025,Ruwani Perera,Batticaloa,Pothuvil,Eastern,7582,8212,15794,303280,328480,631760
2/10/2025,Ruwani Perera,Batticaloa,Pothuvil,Eastern,8763,9853,18616,350520,394120,744640
2/11/2025,Ruwani Perera,Batticaloa,Pothuvil,Eastern,8026,1796,9822,321040,71840,392880
2/12/2025,Ruwani Perera,Batticaloa,Pothuvil,Eastern,906,314,1220,36240,12560,48800
2/13/2025,Ruwani Perera,Batticaloa,Pothuvil,Eastern,1069,3845,4914,42760,153800,196560
2/14/2025,Ruwani Perera,Batticaloa,Pothuvil,Eastern,3779,4912,8691,151160,196480,347640
2/15/2025,Ruwani Perera,Batticaloa,Pothuvil,Eastern,1499,9485,10984,59960,379400,439360
2/16/2025,Ruwani Perera,Batticaloa,Pothuvil,Eastern,1258,834,2092,50320,33360,83680
2/17/2025,Ruwani Perera,Batticaloa,Pothuvil,Eastern,5866,4656,10522,234640,186240,420880
2/18/2025,Ruwani Perera,Batticaloa,Pothuvil,Eastern,313,230,543,12520,9200,21720
2/19/2025,Ruwani Perera,Batticaloa,Pothuvil,Eastern,6747,7070,13817,269880,282800,552680
2/20/2025,Ruwani Perera,Batticaloa,Pothuvil,Eastern,1934,1688,3622,77360,67520,144880
2/21/2025,Ruwani Perera,Batticaloa,Pothuvil,Eastern,8554,6903,15457,342160,276120,618280
2/22/2025,Ruwani Perera,Batticaloa,Pothuvil,Eastern,8128,1591,9719,325120,63640,388760
2/23/2025,Ruwani Perera,Batticaloa,Pothuvil,Eastern,1139,9255,10394,45560,370200,415760
2/24/2025,Ruwani Perera,Batticaloa,Pothuvil,Eastern,260,679,939,10400,27160,37560
2/25/2025,Ruwani Perera,Batticaloa,Pothuvil,Eastern,8383,8387,16770,335320,335480,670800
2/26/2025,Ruwani Perera,Batticaloa,Pothuvil,Eastern,7854,9802,17656,314160,392080,706240
2/27/2025,Ruwani Perera,Batticaloa,Pothuvil,Eastern,487,1337,1824,19480,53480,72960
2/28/2025,Ruwani Perera,Batticaloa,Pothuvil,Eastern,4995,7739,12734,199800,309560,509360
3/1/2025,Ruwani Perera,Batticaloa,Pothuvil,Eastern,9730,1976,11706,389200,79040,468240
3/2/2025,Ruwani Perera,Batticaloa,Pothuvil,Eastern,8781,423,9204,351240,16920,368160
3/3/2025,Ruwani Perera,Batticaloa,Pothuvil,Eastern,8871,7808,16679,354840,312320,667160
3/4/2025,Ruwani Perera,Batticaloa,Pothuvil,Eastern,9307,8994,18301,372280,359760,732040
3/5/2025,Ruwani Perera,Batticaloa,Pothuvil,Eastern,3531,5500,9031,141240,220000,361240
3/6/2025,Ruwani Perera,Batticaloa,Pothuvil,Eastern,7122,916,8038,284880,36640,321520
3/7/2025,Ruwani Perera,Batticaloa,Pothuvil,Eastern,6386,3783,10169,255440,151320,406760
3/8/2025,Ruwani Perera,Batticaloa,Pothuvil,Eastern,6380,327,6707,255200,13080,268280
3/9/2025,Ruwani Perera,Batticaloa,Pothuvil,Eastern,3243,3299,6542,129720,131960,261680
3/10/2025,Ruwani Perera,Batticaloa,Pothuvil,Eastern,6003,7511,13514,240120,300440,540560
3/11/2025,Ruwani Perera,Batticaloa,Pothuvil,Eastern,8406,6860,15266,336240,274400,610640
3/12/2025,Ruwani Perera,Batticaloa,Pothuvil,Eastern,9817,122,9939,392680,4880,397560
3/13/2025,Ruwani Perera,Batticaloa,Pothuvil,Eastern,7295,316,7611,291800,12640,304440
3/14/2025,Ruwani Perera,Batticaloa,Pothuvil,Eastern,2560,978,3538,102400,39120,141520
3/15/2025,Ruwani Perera,Batticaloa,Pothuvil,Eastern,146,7314,7460,5840,292560,298400
3/16/2025,Ruwani Perera,Batticaloa,Pothuvil,Eastern,771,3765,4536,30840,150600,181440
3/17/2025,Ruwani Perera,Batticaloa,Pothuvil,Eastern,7826,384,8210,313040,15360,328400
3/18/2025,Ruwani Perera,Batticaloa,Pothuvil,Eastern,6665,2717,9382,266600,108680,375280
3/19/2025,Ruwani Perera,Batticaloa,Pothuvil,Eastern,155,2002,2157,6200,80080,86280
3/20/2025,Ruwani Perera,Batticaloa,Pothuvil,Eastern,9503,4703,14206,380120,188120,568240
3/21/2025,Ruwani Perera,Batticaloa,Pothuvil,Eastern,2544,883,3427,101760,35320,137080
3/22/2025,Ruwani Perera,Batticaloa,Pothuvil,Eastern,9367,6352,15719,374680,254080,628760
3/23/2025,Ruwani Perera,Batticaloa,Pothuvil,Eastern,2673,7167,9840,106920,286680,393600
3/25/2024,Samith Wijewickrama,Batticaloa,Pothuvil,Eastern,5573,9024,14597,222920,360960,583880
3/26/2024,Samith Wijewickrama,Batticaloa,Pothuvil,Eastern,3951,545,4496,158040,21800,179840
3/27/2024,Samith Wijewickrama,Batticaloa,Pothuvil,Eastern,9793,3580,13373,391720,143200,534920
3/28/2024,Samith Wijewickrama,Batticaloa,Pothuvil,Eastern,1723,5373,7096,68920,214920,283840
3/29/2024,Samith Wijewickrama,Batticaloa,Pothuvil,Eastern,5704,5767,11471,228160,230680,458840
3/30/2024,Samith Wijewickrama,Batticaloa,Pothuvil,Eastern,175,9024,9199,7000,360960,367960
3/31/2024,Samith Wijewickrama,Batticaloa,Pothuvil,Eastern,865,8874,9739,34600,354960,389560
4/1/2024,Samith Wijewickrama,Batticaloa,Pothuvil,Eastern,2433,7527,9960,97320,301080,398400
4/2/2024,Samith Wijewickrama,Batticaloa,Pothuvil,Eastern,4434,8026,12460,177360,321040,498400
4/3/2024,Samith Wijewickrama,Batticaloa,Pothuvil,Eastern,3694,9105,12799,147760,364200,511960
4/4/2024,Samith Wijewickrama,Batticaloa,Pothuvil,Eastern,1617,5934,7551,64680,237360,302040
4/5/2024,Samith Wijewickrama,Batticaloa,Pothuvil,Eastern,1416,7461,8877,56640,298440,355080
4/6/2024,Samith Wijewickrama,Batticaloa,Pothuvil,Eastern,2471,719,3190,98840,28760,127600
4/7/2024,Samith Wijewickrama,Batticaloa,Pothuvil,Eastern,8885,7215,16100,355400,288600,644000
4/8/2024,Samith Wijewickrama,Batticaloa,Pothuvil,Eastern,3613,8166,11779,144520,326640,471160
4/9/2024,Samith Wijewickrama,Batticaloa,Pothuvil,Eastern,2631,3641,6272,105240,145640,250880
4/10/2024,Samith Wijewickrama,Batticaloa,Pothuvil,Eastern,5076,7546,12622,203040,301840,504880
4/11/2024,Samith Wijewickrama,Batticaloa,Pothuvil,Eastern,8754,384,9138,350160,15360,365520
4/19/2024,Samith Wijewickrama,Batticaloa,Pothuvil,Eastern,2895,5863,8758,115800,234520,350320
4/20/2024,Samith Wijewickrama,Batticaloa,Pothuvil,Eastern,3274,3501,6775,130960,140040,271000
4/21/2024,Samith Wijewickrama,Batticaloa,Pothuvil,Eastern,7290,8320,15610,291600,332800,624400
4/22/2024,Samith Wijewickrama,Batticaloa,Pothuvil,Eastern,7619,6855,14474,304760,274200,578960
4/23/2024,Samith Wijewickrama,Batticaloa,Pothuvil,Eastern,909,6579,7488,36360,263160,299520
4/24/2024,Samith Wijewickrama,Batticaloa,Pothuvil,Eastern,2308,805,3113,92320,32200,124520
4/25/2024,Samith Wijewickrama,Batticaloa,Pothuvil,Eastern,4321,4552,8873,172840,182080,354920
4/26/2024,Samith Wijewickrama,Batticaloa,Pothuvil,Eastern,4314,9542,13856,172560,381680,554240
4/27/2024,Samith Wijewickrama,Batticaloa,Pothuvil,Eastern,8423,9764,18187,336920,390560,727480
4/28/2024,Samith Wijewickrama,Batticaloa,Pothuvil,Eastern,9965,2986,12951,398600,119440,518040
4/29/2024,Samith Wijewickrama,Batticaloa,Pothuvil,Eastern,5749,3401,9150,229960,136040,366000
4/30/2024,Samith Wijewickrama,Batticaloa,Pothuvil,Eastern,965,9747,10712,38600,389880,428480
5/1/2024,Samith Wijewickrama,Batticaloa,Pothuvil,Eastern,4845,925,5770,193800,37000,230800
5/2/2024,Samith Wijewickrama,Batticaloa,Pothuvil,Eastern,3063,366,3429,122520,14640,137160
5/3/2024,Samith Wijewickrama,Batticaloa,Pothuvil,Eastern,9807,6880,16687,392280,275200,667480
5/4/2024,Samith Wijewickrama,Batticaloa,Pothuvil,Eastern,9868,9423,19291,394720,376920,771640
5/5/2024,Samith Wijewickrama,Batticaloa,Pothuvil,Eastern,5745,9789,15534,229800,391560,621360
5/6/2024,Samith Wijewickrama,Batticaloa,Pothuvil,Eastern,6668,1362,8030,266720,54480,321200
5/7/2024,Samith Wijewickrama,Batticaloa,Pothuvil,Eastern,7799,7764,15563,311960,310560,622520
5/8/2024,Samith Wijewickrama,Batticaloa,Pothuvil,Eastern,8565,6872,15437,342600,274880,617480
5/9/2024,Samith Wijewickrama,Batticaloa,Pothuvil,Eastern,5429,7048,12477,217160,281920,499080
5/10/2024,Samith Wijewickrama,Batticaloa,Pothuvil,Eastern,4839,7448,12287,193560,297920,491480
5/11/2024,Samith Wijewickrama,Batticaloa,Pothuvil,Eastern,523,8375,8898,20920,335000,355920
5/12/2024,Samith Wijewickrama,Batticaloa,Pothuvil,Eastern,7777,6339,14116,311080,253560,564640
5/13/2024,Samith Wijewickrama,Batticaloa,Pothuvil,Eastern,7248,71,7319,289920,2840,292760
5/14/2024,Samith Wijewickrama,Batticaloa,Pothuvil,Eastern,7955,5555,13510,318200,222200,540400
5/15/2024,Samith Wijewickrama,Batticaloa,Pothuvil,Eastern,8740,8442,17182,349600,337680,687280
5/16/2024,Samith Wijewickrama,Batticaloa,Pothuvil,Eastern,4368,8787,13155,174720,351480,526200
5/17/2024,Samith Wijewickrama,Batticaloa,Pothuvil,Eastern,3475,6105,9580,139000,244200,383200
5/18/2024,Samith Wijewickrama,Batticaloa,Pothuvil,Eastern,7052,7467,14519,282080,298680,580760
5/19/2024,Samith Wijewickrama,Batticaloa,Pothuvil,Eastern,3040,5106,8146,121600,204240,325840
5/20/2024,Samith Wijewickrama,Batticaloa,Pothuvil,Eastern,2701,5095,7796,108040,203800,311840
5/21/2024,Samith Wijewickrama,Batticaloa,Pothuvil,Eastern,1569,1686,3255,62760,67440,130200
5/22/2024,Samith Wijewickrama,Batticaloa,Pothuvil,Eastern,4736,8435,13171,189440,337400,526840
5/24/2024,Samith Wijewickrama,Batticaloa,Pothuvil,Eastern,9629,5094,14723,385160,203760,588920
5/25/2024,Samith Wijewickrama,Batticaloa,Pothuvil,Eastern,4204,1187,5391,168160,47480,215640
5/26/2024,Samith Wijewickrama,Batticaloa,Pothuvil,Eastern,7276,8789,16065,291040,351560,642600
5/27/2024,Samith Wijewickrama,Batticaloa,Pothuvil,Eastern,7043,6504,13547,281720,260160,541880
5/28/2024,Samith Wijewickrama,Batticaloa,Pothuvil,Eastern,247,8848,9095,9880,353920,363800
5/29/2024,Samith Wijewickrama,Batticaloa,Pothuvil,Eastern,6137,165,6302,245480,6600,252080
5/30/2024,Samith Wijewickrama,Batticaloa,Pothuvil,Eastern,6411,4769,11180,256440,190760,447200
5/31/2024,Samith Wijewickrama,Batticaloa,Pothuvil,Eastern,8946,1508,10454,357840,60320,418160
6/1/2024,Samith Wijewickrama,Batticaloa,Pothuvil,Eastern,4794,4339,9133,191760,173560,365320
6/2/2024,Samith Wijewickrama,Batticaloa,Pothuvil,Eastern,9532,4248,13780,381280,169920,551200
6/3/2024,Samith Wijewickrama,Batticaloa,Pothuvil,Eastern,951,3754,4705,38040,150160,188200
6/4/2024,Samith Wijewickrama,Batticaloa,Pothuvil,Eastern,4264,311,4575,170560,12440,183000
6/5/2024,Samith Wijewickrama,Batticaloa,Pothuvil,Eastern,2152,6221,8373,86080,248840,334920
6/6/2024,Samith Wijewickrama,Batticaloa,Pothuvil,Eastern,6813,462,7275,272520,18480,291000
6/7/2024,Samith Wijewickrama,Batticaloa,Pothuvil,Eastern,8925,636,9561,357000,25440,382440
6/8/2024,Samith Wijewickrama,Batticaloa,Pothuvil,Eastern,1823,511,2334,72920,20440,93360
6/9/2024,Samith Wijewickrama,Batticaloa,Pothuvil,Eastern,7210,3608,10818,288400,144320,432720
6/10/2024,Samith Wijewickrama,Batticaloa,Pothuvil,Eastern,3549,8932,12481,141960,357280,499240
6/11/2024,Samith Wijewickrama,Batticaloa,Pothuvil,Eastern,8922,8654,17576,356880,346160,703040
6/12/2024,Samith Wijewickrama,Batticaloa,Pothuvil,Eastern,1856,2609,4465,74240,104360,178600
6/13/2024,Samith Wijewickrama,Batticaloa,Pothuvil,Eastern,8955,5871,14826,358200,234840,593040
6/14/2024,Samith Wijewickrama,Batticaloa,Pothuvil,Eastern,1053,5676,6729,42120,227040,269160
6/15/2024,Samith Wijewickrama,Batticaloa,Pothuvil,Eastern,1003,8694,9697,40120,347760,387880
6/16/2024,Samith Wijewickrama,Batticaloa,Pothuvil,Eastern,1636,3848,5484,65440,153920,219360
6/17/2024,Samith Wijewickrama,Batticaloa,Pothuvil,Eastern,3235,6829,10064,129400,273160,402560
6/18/2024,Samith Wijewickrama,Batticaloa,Pothuvil,Eastern,5682,7940,13622,227280,317600,544880
6/19/2024,Samith Wijewickrama,Batticaloa,Pothuvil,Eastern,1143,7079,8222,45720,283160,328880
6/20/2024,Samith Wijewickrama,Batticaloa,Pothuvil,Eastern,6634,9249,15883,265360,369960,635320
6/21/2024,Samith Wijewickrama,Batticaloa,Pothuvil,Eastern,5552,2892,8444,222080,115680,337760
6/22/2024,Samith Wijewickrama,Batticaloa,Pothuvil,Eastern,3955,1597,5552,158200,63880,222080
6/23/2024,Samith Wijewickrama,Batticaloa,Pothuvil,Eastern,6187,7275,13462,247480,291000,538480
6/24/2024,Samith Wijewickrama,Batticaloa,Pothuvil,Eastern,7560,3431,10991,302400,137240,439640
6/25/2024,Samith Wijewickrama,Batticaloa,Pothuvil,Eastern,5341,3813,9154,213640,152520,366160
6/26/2024,Samith Wijewickrama,Batticaloa,Pothuvil,Eastern,5935,9599,15534,237400,383960,621360
6/27/2024,Samith Wijewickrama,Batticaloa,Pothuvil,Eastern,2660,5766,8426,106400,230640,337040
6/28/2024,Samith Wijewickrama,Batticaloa,Pothuvil,Eastern,8359,7863,16222,334360,314520,648880
6/29/2024,Samith Wijewickrama,Batticaloa,Pothuvil,Eastern,9708,8377,18085,388320,335080,723400
6/30/2024,Samith Wijewickrama,Batticaloa,Pothuvil,Eastern,472,683,1155,18880,27320,46200
7/1/2024,Samith Wijewickrama,Batticaloa,Pothuvil,Eastern,6256,1919,8175,250240,76760,327000
7/2/2024,Samith Wijewickrama,Batticaloa,Pothuvil,Eastern,126,8112,8238,5040,324480,329520
7/3/2024,Samith Wijewickrama,Batticaloa,Pothuvil,Eastern,3095,8186,11281,123800,327440,451240
7/4/2024,Samith Wijewickrama,Batticaloa,Pothuvil,Eastern,7744,9013,16757,309760,360520,670280
7/5/2024,Samith Wijewickrama,Batticaloa,Pothuvil,Eastern,1302,5792,7094,52080,231680,283760
7/6/2024,Samith Wijewickrama,Batticaloa,Pothuvil,Eastern,4358,6588,10946,174320,263520,437840
7/7/2024,Samith Wijewickrama,Batticaloa,Pothuvil,Eastern,952,4956,5908,38080,198240,236320
7/8/2024,Samith Wijewickrama,Batticaloa,Pothuvil,Eastern,8354,842,9196,334160,33680,367840
7/9/2024,Samith Wijewickrama,Batticaloa,Pothuvil,Eastern,9950,4915,14865,398000,196600,594600
7/10/2024,Samith Wijewickrama,Batticaloa,Pothuvil,Eastern,515,255,770,20600,10200,30800
7/11/2024,Samith Wijewickrama,Batticaloa,Pothuvil,Eastern,6899,821,7720,275960,32840,308800
7/12/2024,Samith Wijewickrama,Batticaloa,Pothuvil,Eastern,1008,3442,4450,40320,137680,178000
7/13/2024,Samith Wijewickrama,Batticaloa,Pothuvil,Eastern,264,3015,3279,10560,120600,131160
7/14/2024,Samith Wijewickrama,Batticaloa,Pothuvil,Eastern,8720,2138,10858,348800,85520,434320
7/15/2024,Samith Wijewickrama,Batticaloa,Pothuvil,Eastern,833,4783,5616,33320,191320,224640
7/16/2024,Samith Wijewickrama,Batticaloa,Pothuvil,Eastern,6090,3743,9833,243600,149720,393320
7/17/2024,Samith Wijewickrama,Batticaloa,Pothuvil,Eastern,9329,1531,10860,373160,61240,434400
7/18/2024,Samith Wijewickrama,Batticaloa,Pothuvil,Eastern,9060,586,9646,362400,23440,385840
7/19/2024,Samith Wijewickrama,Batticaloa,Pothuvil,Eastern,6944,2277,9221,277760,91080,368840
7/20/2024,Samith Wijewickrama,Batticaloa,Pothuvil,Eastern,1493,3889,5382,59720,155560,215280
7/21/2024,Samith Wijewickrama,Batticaloa,Pothuvil,Eastern,7934,1282,9216,317360,51280,368640
7/22/2024,Samith Wijewickrama,Batticaloa,Pothuvil,Eastern,9438,4443,13881,377520,177720,555240
7/23/2024,Samith Wijewickrama,Batticaloa,Pothuvil,Eastern,4580,8791,13371,183200,351640,534840
7/24/2024,Samith Wijewickrama,Batticaloa,Pothuvil,Eastern,559,2869,3428,22360,114760,137120
7/25/2024,Samith Wijewickrama,Batticaloa,Pothuvil,Eastern,6369,1751,8120,254760,70040,324800
7/26/2024,Samith Wijewickrama,Batticaloa,Pothuvil,Eastern,1128,9123,10251,45120,364920,410040
7/27/2024,Samith Wijewickrama,Batticaloa,Pothuvil,Eastern,1413,6649,8062,56520,265960,322480
7/28/2024,Samith Wijewickrama,Batticaloa,Pothuvil,Eastern,4357,596,4953,174280,23840,198120
7/29/2024,Samith Wijewickrama,Batticaloa,Pothuvil,Eastern,1478,9418,10896,59120,376720,435840
7/30/2024,Samith Wijewickrama,Batticaloa,Pothuvil,Eastern,1441,8891,10332,57640,355640,413280
7/31/2024,Samith Wijewickrama,Batticaloa,Pothuvil,Eastern,8172,2491,10663,326880,99640,426520
8/1/2024,Samith Wijewickrama,Batticaloa,Pothuvil,Eastern,7831,4734,12565,313240,189360,502600
8/2/2024,Samith Wijewickrama,Batticaloa,Pothuvil,Eastern,8851,2080,10931,354040,83200,437240
8/3/2024,Samith Wijewickrama,Batticaloa,Pothuvil,Eastern,3075,5148,8223,123000,205920,328920
8/4/2024,Samith Wijewickrama,Batticaloa,Pothuvil,Eastern,1191,7221,8412,47640,288840,336480
8/5/2024,Samith Wijewickrama,Batticaloa,Pothuvil,Eastern,946,3789,4735,37840,151560,189400
8/6/2024,Samith Wijewickrama,Batticaloa,Pothuvil,Eastern,6414,3262,9676,256560,130480,387040
8/7/2024,Samith Wijewickrama,Batticaloa,Pothuvil,Eastern,3607,7190,10797,144280,287600,431880
8/8/2024,Samith Wijewickrama,Batticaloa,Pothuvil,Eastern,3324,7230,10554,132960,289200,422160
8/9/2024,Samith Wijewickrama,Batticaloa,Pothuvil,Eastern,2736,5331,8067,109440,213240,322680
8/10/2024,Samith Wijewickrama,Batticaloa,Pothuvil,Eastern,770,6200,6970,30800,248000,278800
8/11/2024,Samith Wijewickrama,Batticaloa,Pothuvil,Eastern,7137,2524,9661,285480,100960,386440
8/12/2024,Samith Wijewickrama,Batticaloa,Pothuvil,Eastern,6210,7509,13719,248400,300360,548760
8/13/2024,Samith Wijewickrama,Batticaloa,Pothuvil,Eastern,8937,6779,15716,357480,271160,628640
8/14/2024,Samith Wijewickrama,Batticaloa,Pothuvil,Eastern,759,9030,9789,30360,361200,391560
8/15/2024,Samith Wijewickrama,Batticaloa,Pothuvil,Eastern,875,251,1126,35000,10040,45040
8/16/2024,Samith Wijewickrama,Batticaloa,Pothuvil,Eastern,3926,2610,6536,157040,104400,261440
8/17/2024,Samith Wijewickrama,Batticaloa,Pothuvil,Eastern,1398,1759,3157,55920,70360,126280
8/18/2024,Samith Wijewickrama,Batticaloa,Pothuvil,Eastern,3846,9792,13638,153840,391680,545520
8/19/2024,Samith Wijewickrama,Batticaloa,Pothuvil,Eastern,5143,4294,9437,205720,171760,377480
8/20/2024,Samith Wijewickrama,Batticaloa,Pothuvil,Eastern,4490,9346,13836,179600,373840,553440
8/21/2024,Samith Wijewickrama,Batticaloa,Pothuvil,Eastern,5552,1164,6716,222080,46560,268640
8/22/2024,Samith Wijewickrama,Batticaloa,Pothuvil,Eastern,8262,1562,9824,330480,62480,392960
8/23/2024,Samith Wijewickrama,Batticaloa,Pothuvil,Eastern,8780,6336,15116,351200,253440,604640
8/24/2024,Samith Wijewickrama,Batticaloa,Pothuvil,Eastern,7162,8369,15531,286480,334760,621240
8/25/2024,Samith Wijewickrama,Batticaloa,Pothuvil,Eastern,2899,666,3565,115960,26640,142600
8/26/2024,Samith Wijewickrama,Batticaloa,Pothuvil,Eastern,7214,64,7278,288560,2560,291120
8/27/2024,Samith Wijewickrama,Batticaloa,Pothuvil,Eastern,103,6294,6397,4120,251760,255880
8/28/2024,Samith Wijewickrama,Batticaloa,Pothuvil,Eastern,1488,3487,4975,59520,139480,199000
8/29/2024,Samith Wijewickrama,Batticaloa,Pothuvil,Eastern,8042,136,8178,321680,5440,327120
8/30/2024,Samith Wijewickrama,Batticaloa,Pothuvil,Eastern,8761,8459,17220,350440,338360,688800
8/31/2024,Samith Wijewickrama,Batticaloa,Pothuvil,Eastern,6335,3552,9887,253400,142080,395480
9/1/2024,Samith Wijewickrama,Batticaloa,Pothuvil,Eastern,9206,5522,14728,368240,220880,589120
9/2/2024,Samith Wijewickrama,Batticaloa,Pothuvil,Eastern,2749,5415,8164,109960,216600,326560
9/3/2024,Samith Wijewickrama,Batticaloa,Pothuvil,Eastern,1149,2316,3465,45960,92640,138600
9/4/2024,Samith Wijewickrama,Batticaloa,Pothuvil,Eastern,6170,3364,9534,246800,134560,381360
9/5/2024,Samith Wijewickrama,Batticaloa,Pothuvil,Eastern,4740,9447,14187,189600,377880,567480
9/6/2024,Samith Wijewickrama,Batticaloa,Pothuvil,Eastern,6848,6932,13780,273920,277280,551200
9/7/2024,Samith Wijewickrama,Batticaloa,Pothuvil,Eastern,7020,3377,10397,280800,135080,415880
9/8/2024,Samith Wijewickrama,Batticaloa,Pothuvil,Eastern,5788,9690,15478,231520,387600,619120
9/9/2024,Samith Wijewickrama,Batticaloa,Pothuvil,Eastern,5082,1135,6217,203280,45400,248680
9/10/2024,Samith Wijewickrama,Batticaloa,Pothuvil,Eastern,1204,6046,7250,48160,241840,290000
9/11/2024,Samith Wijewickrama,Batticaloa,Pothuvil,Eastern,5240,2270,7510,209600,90800,300400
9/12/2024,Samith Wijewickrama,Batticaloa,Pothuvil,Eastern,5409,7694,13103,216360,307760,524120
9/13/2024,Samith Wijewickrama,Batticaloa,Pothuvil,Eastern,178,2855,3033,7120,114200,121320
9/14/2024,Samith Wijewickrama,Batticaloa,Pothuvil,Eastern,7018,330,7348,280720,13200,293920
9/15/2024,Samith Wijewickrama,Batticaloa,Pothuvil,Eastern,5618,7518,13136,224720,300720,525440
9/16/2024,Samith Wijewickrama,Batticaloa,Pothuvil,Eastern,6569,45,6614,262760,1800,264560
9/17/2024,Samith Wijewickrama,Batticaloa,Pothuvil,Eastern,5308,1085,6393,212320,43400,255720
9/18/2024,Samith Wijewickrama,Batticaloa,Pothuvil,Eastern,1463,2843,4306,58520,113720,172240
9/19/2024,Samith Wijewickrama,Batticaloa,Pothuvil,Eastern,8113,8940,17053,324520,357600,682120
9/20/2024,Samith Wijewickrama,Batticaloa,Pothuvil,Eastern,2839,3477,6316,113560,139080,252640
9/21/2024,Samith Wijewickrama,Batticaloa,Pothuvil,Eastern,8348,2188,10536,333920,87520,421440
9/22/2024,Samith Wijewickrama,Batticaloa,Pothuvil,Eastern,3138,1543,4681,125520,61720,187240
9/23/2024,Samith Wijewickrama,Batticaloa,Pothuvil,Eastern,9574,5487,15061,382960,219480,602440
9/24/2024,Samith Wijewickrama,Batticaloa,Pothuvil,Eastern,8447,4608,13055,337880,184320,522200
9/25/2024,Samith Wijewickrama,Batticaloa,Pothuvil,Eastern,5754,5020,10774,230160,200800,430960
9/26/2024,Samith Wijewickrama,Batticaloa,Pothuvil,Eastern,1609,5003,6612,64360,200120,264480
9/27/2024,Samith Wijewickrama,Batticaloa,Pothuvil,Eastern,5749,7401,13150,229960,296040,526000
9/28/2024,Samith Wijewickrama,Batticaloa,Pothuvil,Eastern,6911,3150,10061,276440,126000,402440
9/29/2024,Samith Wijewickrama,Batticaloa,Pothuvil,Eastern,5281,9215,14496,211240,368600,579840
9/30/2024,Samith Wijewickrama,Batticaloa,Pothuvil,Eastern,7597,1845,9442,303880,73800,377680
10/1/2024,Samith Wijewickrama,Batticaloa,Pothuvil,Eastern,5493,5881,11374,219720,235240,454960
10/2/2024,Samith Wijewickrama,Batticaloa,Pothuvil,Eastern,9660,320,9980,386400,12800,399200
10/3/2024,Samith Wijewickrama,Batticaloa,Pothuvil,Eastern,1710,1555,3265,68400,62200,130600
10/4/2024,Samith Wijewickrama,Batticaloa,Pothuvil,Eastern,922,6092,7014,36880,243680,280560
10/5/2024,Samith Wijewickrama,Batticaloa,Pothuvil,Eastern,9773,7353,17126,390920,294120,685040
10/6/2024,Samith Wijewickrama,Batticaloa,Pothuvil,Eastern,1250,2717,3967,50000,108680,158680
10/7/2024,Samith Wijewickrama,Batticaloa,Pothuvil,Eastern,1591,7491,9082,63640,299640,363280
10/8/2024,Samith Wijewickrama,Batticaloa,Pothuvil,Eastern,9540,5139,14679,381600,205560,587160
10/9/2024,Samith Wijewickrama,Batticaloa,Pothuvil,Eastern,8809,3304,12113,352360,132160,484520
10/10/2024,Samith Wijewickrama,Batticaloa,Pothuvil,Eastern,5358,1005,6363,214320,40200,254520
10/11/2024,Samith Wijewickrama,Batticaloa,Pothuvil,Eastern,6584,2057,8641,263360,82280,345640
10/12/2024,Samith Wijewickrama,Batticaloa,Pothuvil,Eastern,9327,6177,15504,373080,247080,620160
10/13/2024,Samith Wijewickrama,Batticaloa,Pothuvil,Eastern,8027,1746,9773,321080,69840,390920
10/14/2024,Samith Wijewickrama,Batticaloa,Pothuvil,Eastern,8776,9368,18144,351040,374720,725760
10/15/2024,Samith Wijewickrama,Batticaloa,Pothuvil,Eastern,9022,7189,16211,360880,287560,648440
10/16/2024,Samith Wijewickrama,Batticaloa,Pothuvil,Eastern,7888,1639,9527,315520,65560,381080
10/17/2024,Samith Wijewickrama,Batticaloa,Pothuvil,Eastern,6308,6798,13106,252320,271920,524240
10/18/2024,Samith Wijewickrama,Batticaloa,Pothuvil,Eastern,5861,1118,6979,234440,44720,279160
10/19/2024,Samith Wijewickrama,Batticaloa,Pothuvil,Eastern,957,630,1587,38280,25200,63480
10/20/2024,Samith Wijewickrama,Batticaloa,Pothuvil,Eastern,4871,4102,8973,194840,164080,358920
10/21/2024,Samith Wijewickrama,Batticaloa,Pothuvil,Eastern,2552,7627,10179,102080,305080,407160
10/22/2024,Samith Wijewickrama,Batticaloa,Pothuvil,Eastern,8410,1594,10004,336400,63760,400160
10/23/2024,Samith Wijewickrama,Batticaloa,Pothuvil,Eastern,4097,4894,8991,163880,195760,359640
10/24/2024,Samith Wijewickrama,Batticaloa,Pothuvil,Eastern,5915,4301,10216,236600,172040,408640
10/25/2024,Samith Wijewickrama,Batticaloa,Pothuvil,Eastern,260,7829,8089,10400,313160,323560
10/26/2024,Samith Wijewickrama,Batticaloa,Pothuvil,Eastern,167,1326,1493,6680,53040,59720
10/27/2024,Samith Wijewickrama,Batticaloa,Pothuvil,Eastern,3563,2182,5745,142520,87280,229800
10/28/2024,Samith Wijewickrama,Batticaloa,Pothuvil,Eastern,9813,4102,13915,392520,164080,556600
10/29/2024,Samith Wijewickrama,Batticaloa,Pothuvil,Eastern,3641,293,3934,145640,11720,157360
10/30/2024,Samith Wijewickrama,Batticaloa,Pothuvil,Eastern,1633,3866,5499,65320,154640,219960
10/31/2024,Samith Wijewickrama,Batticaloa,Pothuvil,Eastern,1728,7830,9558,69120,313200,382320
11/1/2024,Samith Wijewickrama,Batticaloa,Pothuvil,Eastern,6165,9668,15833,246600,386720,633320
11/2/2024,Samith Wijewickrama,Batticaloa,Pothuvil,Eastern,3464,2197,5661,138560,87880,226440
11/3/2024,Samith Wijewickrama,Batticaloa,Pothuvil,Eastern,4974,3398,8372,198960,135920,334880
11/4/2024,Samith Wijewickrama,Batticaloa,Pothuvil,Eastern,5834,8407,14241,233360,336280,569640
11/5/2024,Samith Wijewickrama,Batticaloa,Pothuvil,Eastern,6043,5569,11612,241720,222760,464480
11/6/2024,Samith Wijewickrama,Batticaloa,Pothuvil,Eastern,7404,903,8307,296160,36120,332280
11/7/2024,Samith Wijewickrama,Batticaloa,Pothuvil,Eastern,5324,3918,9242,212960,156720,369680
11/8/2024,Samith Wijewickrama,Batticaloa,Pothuvil,Eastern,9956,4387,14343,398240,175480,573720
11/9/2024,Samith Wijewickrama,Batticaloa,Pothuvil,Eastern,4558,1261,5819,182320,50440,232760
11/10/2024,Samith Wijewickrama,Batticaloa,Pothuvil,Eastern,3997,162,4159,159880,6480,166360
11/11/2024,Samith Wijewickrama,Batticaloa,Pothuvil,Eastern,7090,6286,13376,283600,251440,535040
11/12/2024,Samith Wijewickrama,Batticaloa,Pothuvil,Eastern,3587,2057,5644,143480,82280,225760
11/13/2024,Samith Wijewickrama,Batticaloa,Pothuvil,Eastern,4054,1430,5484,162160,57200,219360
11/14/2024,Samith Wijewickrama,Batticaloa,Pothuvil,Eastern,3927,5220,9147,157080,208800,365880
11/15/2024,Samith Wijewickrama,Batticaloa,Pothuvil,Eastern,6314,6021,12335,252560,240840,493400
11/16/2024,Samith Wijewickrama,Batticaloa,Pothuvil,Eastern,3590,6998,10588,143600,279920,423520
11/17/2024,Samith Wijewickrama,Batticaloa,Pothuvil,Eastern,4154,5081,9235,166160,203240,369400
11/18/2024,Samith Wijewickrama,Batticaloa,Pothuvil,Eastern,650,7890,8540,26000,315600,341600
11/19/2024,Samith Wijewickrama,Batticaloa,Pothuvil,Eastern,2115,2859,4974,84600,114360,198960
11/20/2024,Samith Wijewickrama,Batticaloa,Pothuvil,Eastern,7866,4441,12307,314640,177640,492280
11/21/2024,Samith Wijewickrama,Batticaloa,Pothuvil,Eastern,6602,4722,11324,264080,188880,452960
11/22/2024,Samith Wijewickrama,Batticaloa,Pothuvil,Eastern,1075,1503,2578,43000,60120,103120
11/23/2024,Samith Wijewickrama,Batticaloa,Pothuvil,Eastern,5228,7589,12817,209120,303560,512680
11/24/2024,Samith Wijewickrama,Batticaloa,Pothuvil,Eastern,8256,4829,13085,330240,193160,523400
11/25/2024,Samith Wijewickrama,Batticaloa,Pothuvil,Eastern,8764,706,9470,350560,28240,378800
11/26/2024,Samith Wijewickrama,Batticaloa,Pothuvil,Eastern,7164,8440,15604,286560,337600,624160
11/27/2024,Samith Wijewickrama,Batticaloa,Pothuvil,Eastern,3787,9607,13394,151480,384280,535760
11/28/2024,Samith Wijewickrama,Batticaloa,Pothuvil,Eastern,2935,3485,6420,117400,139400,256800
11/29/2024,Samith Wijewickrama,Batticaloa,Pothuvil,Eastern,7501,692,8193,300040,27680,327720
11/30/2024,Samith Wijewickrama,Batticaloa,Pothuvil,Eastern,5980,5360,11340,239200,214400,453600
12/1/2024,Samith Wijewickrama,Batticaloa,Pothuvil,Eastern,1170,612,1782,46800,24480,71280
12/2/2024,Samith Wijewickrama,Batticaloa,Pothuvil,Eastern,8729,4115,12844,349160,164600,513760
12/3/2024,Samith Wijewickrama,Batticaloa,Pothuvil,Eastern,9379,9502,18881,375160,380080,755240
12/4/2024,Samith Wijewickrama,Batticaloa,Pothuvil,Eastern,7178,2855,10033,287120,114200,401320
12/5/2024,Samith Wijewickrama,Batticaloa,Pothuvil,Eastern,5543,5511,11054,221720,220440,442160
12/6/2024,Samith Wijewickrama,Batticaloa,Pothuvil,Eastern,3833,9356,13189,153320,374240,527560
12/7/2024,Samith Wijewickrama,Batticaloa,Pothuvil,Eastern,9808,987,10795,392320,39480,431800
12/8/2024,Samith Wijewickrama,Batticaloa,Pothuvil,Eastern,2010,733,2743,80400,29320,109720
12/9/2024,Samith Wijewickrama,Batticaloa,Pothuvil,Eastern,2759,5511,8270,110360,220440,330800
12/10/2024,Samith Wijewickrama,Batticaloa,Pothuvil,Eastern,1271,7177,8448,50840,287080,337920
12/11/2024,Samith Wijewickrama,Batticaloa,Pothuvil,Eastern,1591,1123,2714,63640,44920,108560
12/12/2024,Samith Wijewickrama,Batticaloa,Pothuvil,Eastern,7344,1203,8547,293760,48120,341880
12/13/2024,Samith Wijewickrama,Batticaloa,Pothuvil,Eastern,1731,9826,11557,69240,393040,462280
12/14/2024,Samith Wijewickrama,Batticaloa,Pothuvil,Eastern,402,4086,4488,16080,163440,179520
12/15/2024,Samith Wijewickrama,Batticaloa,Pothuvil,Eastern,2556,5328,7884,102240,213120,315360
12/16/2024,Samith Wijewickrama,Batticaloa,Pothuvil,Eastern,1040,9393,10433,41600,375720,417320
12/17/2024,Samith Wijewickrama,Batticaloa,Pothuvil,Eastern,6712,4647,11359,268480,185880,454360
12/18/2024,Samith Wijewickrama,Batticaloa,Pothuvil,Eastern,6787,5025,11812,271480,201000,472480
12/19/2024,Samith Wijewickrama,Batticaloa,Pothuvil,Eastern,8079,9788,17867,323160,391520,714680
12/20/2024,Samith Wijewickrama,Batticaloa,Pothuvil,Eastern,8658,5727,14385,346320,229080,575400
12/21/2024,Samith Wijewickrama,Batticaloa,Pothuvil,Eastern,6828,1843,8671,273120,73720,346840
12/22/2024,Samith Wijewickrama,Batticaloa,Pothuvil,Eastern,5933,536,6469,237320,21440,258760
12/23/2024,Samith Wijewickrama,Batticaloa,Pothuvil,Eastern,6684,9631,16315,267360,385240,652600
12/24/2024,Samith Wijewickrama,Batticaloa,Pothuvil,Eastern,2174,9835,12009,86960,393400,480360
12/25/2024,Samith Wijewickrama,Batticaloa,Pothuvil,Eastern,4235,7100,11335,169400,284000,453400
12/26/2024,Samith Wijewickrama,Batticaloa,Pothuvil,Eastern,2930,1964,4894,117200,78560,195760
12/27/2024,Samith Wijewickrama,Batticaloa,Pothuvil,Eastern,8979,6238,15217,359160,249520,608680
12/28/2024,Samith Wijewickrama,Batticaloa,Pothuvil,Eastern,1449,2987,4436,57960,119480,177440
12/29/2024,Samith Wijewickrama,Batticaloa,Pothuvil,Eastern,5386,3602,8988,215440,144080,359520
12/30/2024,Samith Wijewickrama,Batticaloa,Pothuvil,Eastern,7255,2899,10154,290200,115960,406160
12/31/2024,Samith Wijewickrama,Batticaloa,Pothuvil,Eastern,8911,1972,10883,356440,78880,435320
1/1/2025,Samith Wijewickrama,Batticaloa,Pothuvil,Eastern,3600,9080,12680,144000,363200,507200
1/2/2025,Samith Wijewickrama,Batticaloa,Pothuvil,Eastern,1927,2381,4308,77080,95240,172320
1/3/2025,Samith Wijewickrama,Batticaloa,Pothuvil,Eastern,6490,5264,11754,259600,210560,470160
1/4/2025,Samith Wijewickrama,Batticaloa,Pothuvil,Eastern,9476,6665,16141,379040,266600,645640
1/5/2025,Samith Wijewickrama,Batticaloa,Pothuvil,Eastern,4894,9723,14617,195760,388920,584680
1/6/2025,Samith Wijewickrama,Batticaloa,Pothuvil,Eastern,2943,9219,12162,117720,368760,486480
1/7/2025,Samith Wijewickrama,Batticaloa,Pothuvil,Eastern,5693,7143,12836,227720,285720,513440
1/8/2025,Samith Wijewickrama,Batticaloa,Pothuvil,Eastern,8853,8490,17343,354120,339600,693720
1/9/2025,Samith Wijewickrama,Batticaloa,Pothuvil,Eastern,8732,5491,14223,349280,219640,568920
1/10/2025,Samith Wijewickrama,Batticaloa,Pothuvil,Eastern,9908,5430,15338,396320,217200,613520
1/11/2025,Samith Wijewickrama,Batticaloa,Pothuvil,Eastern,7923,9176,17099,316920,367040,683960
1/12/2025,Samith Wijewickrama,Batticaloa,Pothuvil,Eastern,397,743,1140,15880,29720,45600
1/13/2025,Samith Wijewickrama,Batticaloa,Pothuvil,Eastern,5382,184,5566,215280,7360,222640
1/14/2025,Samith Wijewickrama,Batticaloa,Pothuvil,Eastern,8250,5339,13589,330000,213560,543560
1/15/2025,Samith Wijewickrama,Batticaloa,Pothuvil,Eastern,1748,3248,4996,69920,129920,199840
1/16/2025,Samith Wijewickrama,Batticaloa,Pothuvil,Eastern,8460,7432,15892,338400,297280,635680
1/17/2025,Samith Wijewickrama,Batticaloa,Pothuvil,Eastern,2279,948,3227,91160,37920,129080
1/18/2025,Samith Wijewickrama,Batticaloa,Pothuvil,Eastern,4247,7955,12202,169880,318200,488080
1/19/2025,Samith Wijewickrama,Batticaloa,Pothuvil,Eastern,2158,7768,9926,86320,310720,397040
1/20/2025,Samith Wijewickrama,Batticaloa,Pothuvil,Eastern,8094,7653,15747,323760,306120,629880
1/21/2025,Samith Wijewickrama,Batticaloa,Pothuvil,Eastern,6529,610,7139,261160,24400,285560
1/22/2025,Samith Wijewickrama,Batticaloa,Pothuvil,Eastern,6852,4926,11778,274080,197040,471120
1/23/2025,Samith Wijewickrama,Batticaloa,Pothuvil,Eastern,5309,9114,14423,212360,364560,576920
1/24/2025,Samith Wijewickrama,Batticaloa,Pothuvil,Eastern,1469,2035,3504,58760,81400,140160
1/25/2025,Samith Wijewickrama,Batticaloa,Pothuvil,Eastern,2714,9020,11734,108560,360800,469360
1/26/2025,Samith Wijewickrama,Batticaloa,Pothuvil,Eastern,660,849,1509,26400,33960,60360
1/27/2025,Samith Wijewickrama,Batticaloa,Pothuvil,Eastern,6553,3451,10004,262120,138040,400160
1/28/2025,Samith Wijewickrama,Batticaloa,Pothuvil,Eastern,3312,6632,9944,132480,265280,397760
1/29/2025,Samith Wijewickrama,Batticaloa,Pothuvil,Eastern,3469,487,3956,138760,19480,158240
1/30/2025,Samith Wijewickrama,Batticaloa,Pothuvil,Eastern,2376,7910,10286,95040,316400,411440
1/31/2025,Samith Wijewickrama,Batticaloa,Pothuvil,Eastern,3716,7268,10984,148640,290720,439360
2/1/2025,Samith Wijewickrama,Batticaloa,Pothuvil,Eastern,5572,1991,7563,222880,79640,302520
2/2/2025,Samith Wijewickrama,Batticaloa,Pothuvil,Eastern,5799,3400,9199,231960,136000,367960
2/3/2025,Samith Wijewickrama,Batticaloa,Pothuvil,Eastern,936,2795,3731,37440,111800,149240
2/4/2025,Samith Wijewickrama,Batticaloa,Pothuvil,Eastern,9737,428,10165,389480,17120,406600
2/5/2025,Samith Wijewickrama,Batticaloa,Pothuvil,Eastern,8546,975,9521,341840,39000,380840
2/6/2025,Samith Wijewickrama,Batticaloa,Pothuvil,Eastern,2186,4967,7153,87440,198680,286120
2/7/2025,Samith Wijewickrama,Batticaloa,Pothuvil,Eastern,5630,1297,6927,225200,51880,277080
2/8/2025,Samith Wijewickrama,Batticaloa,Pothuvil,Eastern,3939,3103,7042,157560,124120,281680
2/9/2025,Samith Wijewickrama,Batticaloa,Pothuvil,Eastern,6944,835,7779,277760,33400,311160
2/10/2025,Samith Wijewickrama,Batticaloa,Pothuvil,Eastern,4981,9075,14056,199240,363000,562240
2/11/2025,Samith Wijewickrama,Batticaloa,Pothuvil,Eastern,2136,5473,7609,85440,218920,304360
2/12/2025,Samith Wijewickrama,Batticaloa,Pothuvil,Eastern,2003,8087,10090,80120,323480,403600
2/13/2025,Samith Wijewickrama,Batticaloa,Pothuvil,Eastern,8667,486,9153,346680,19440,366120
2/14/2025,Samith Wijewickrama,Batticaloa,Pothuvil,Eastern,2871,9344,12215,114840,373760,488600
2/15/2025,Samith Wijewickrama,Batticaloa,Pothuvil,Eastern,3134,4690,7824,125360,187600,312960
2/16/2025,Samith Wijewickrama,Batticaloa,Pothuvil,Eastern,1442,7170,8612,57680,286800,344480
2/17/2025,Samith Wijewickrama,Batticaloa,Pothuvil,Eastern,2794,9047,11841,111760,361880,473640
2/18/2025,Samith Wijewickrama,Batticaloa,Pothuvil,Eastern,3013,6121,9134,120520,244840,365360
2/19/2025,Samith Wijewickrama,Batticaloa,Pothuvil,Eastern,3694,1290,4984,147760,51600,199360
2/20/2025,Samith Wijewickrama,Batticaloa,Pothuvil,Eastern,9042,9016,18058,361680,360640,722320
2/21/2025,Samith Wijewickrama,Batticaloa,Pothuvil,Eastern,5894,6308,12202,235760,252320,488080
2/22/2025,Samith Wijewickrama,Batticaloa,Pothuvil,Eastern,8167,7966,16133,326680,318640,645320
2/23/2025,Samith Wijewickrama,Batticaloa,Pothuvil,Eastern,8110,8408,16518,324400,336320,660720
2/24/2025,Samith Wijewickrama,Batticaloa,Pothuvil,Eastern,6519,8171,14690,260760,326840,587600
2/25/2025,Samith Wijewickrama,Batticaloa,Pothuvil,Eastern,3280,9943,13223,131200,397720,528920
2/26/2025,Samith Wijewickrama,Batticaloa,Pothuvil,Eastern,4820,5573,10393,192800,222920,415720
2/27/2025,Samith Wijewickrama,Batticaloa,Pothuvil,Eastern,5174,3004,8178,206960,120160,327120
2/28/2025,Samith Wijewickrama,Batticaloa,Pothuvil,Eastern,5445,8729,14174,217800,349160,566960
3/1/2025,Samith Wijewickrama,Batticaloa,Pothuvil,Eastern,4538,741,5279,181520,29640,211160
3/2/2025,Samith Wijewickrama,Batticaloa,Pothuvil,Eastern,7555,8976,16531,302200,359040,661240
3/3/2025,Samith Wijewickrama,Batticaloa,Pothuvil,Eastern,5299,4554,9853,211960,182160,394120
3/4/2025,Samith Wijewickrama,Batticaloa,Pothuvil,Eastern,1596,8890,10486,63840,355600,419440
3/5/2025,Samith Wijewickrama,Batticaloa,Pothuvil,Eastern,3765,323,4088,150600,12920,163520
3/6/2025,Samith Wijewickrama,Batticaloa,Pothuvil,Eastern,8206,1270,9476,328240,50800,379040
3/7/2025,Samith Wijewickrama,Batticaloa,Pothuvil,Eastern,10,2129,2139,400,85160,85560
3/8/2025,Samith Wijewickrama,Batticaloa,Pothuvil,Eastern,84,4284,4368,3360,171360,174720
3/9/2025,Samith Wijewickrama,Batticaloa,Pothuvil,Eastern,8408,9242,17650,336320,369680,706000
3/10/2025,Samith Wijewickrama,Batticaloa,Pothuvil,Eastern,5627,8234,13861,225080,329360,554440
3/11/2025,Samith Wijewickrama,Batticaloa,Pothuvil,Eastern,8953,3814,12767,358120,152560,510680
3/12/2025,Samith Wijewickrama,Batticaloa,Pothuvil,Eastern,8136,7009,15145,325440,280360,605800
3/13/2025,Samith Wijewickrama,Batticaloa,Pothuvil,Eastern,9614,9253,18867,384560,370120,754680
3/14/2025,Samith Wijewickrama,Batticaloa,Pothuvil,Eastern,1371,6424,7795,54840,256960,311800
3/15/2025,Samith Wijewickrama,Batticaloa,Pothuvil,Eastern,7078,610,7688,283120,24400,307520
3/16/2025,Samith Wijewickrama,Batticaloa,Pothuvil,Eastern,2372,1184,3556,94880,47360,142240
3/17/2025,Samith Wijewickrama,Batticaloa,Pothuvil,Eastern,602,5221,5823,24080,208840,232920
3/18/2025,Samith Wijewickrama,Batticaloa,Pothuvil,Eastern,855,5483,6338,34200,219320,253520
3/19/2025,Samith Wijewickrama,Batticaloa,Pothuvil,Eastern,2270,5294,7564,90800,211760,302560
3/20/2025,Samith Wijewickrama,Batticaloa,Pothuvil,Eastern,9306,3969,13275,372240,158760,531000
3/21/2025,Samith Wijewickrama,Batticaloa,Pothuvil,Eastern,813,7099,7912,32520,283960,316480
3/22/2025,Samith Wijewickrama,Batticaloa,Pothuvil,Eastern,8918,9168,18086,356720,366720,723440
3/23/2025,Samith Wijewickrama,Batticaloa,Pothuvil,Eastern,9175,2976,12151,367000,119040,486040
3/25/2024,Vijitha Gunathilaka,Hambantota,Ruhunupura,Southern,2832,1338,4170,113280,53520,166800
3/26/2024,Vijitha Gunathilaka,Hambantota,Ruhunupura,Southern,858,138,996,34320,5520,39840
3/27/2024,Vijitha Gunathilaka,Hambantota,Ruhunupura,Southern,1717,4376,6093,68680,175040,243720
3/28/2024,Vijitha Gunathilaka,Hambantota,Ruhunupura,Southern,9840,8458,18298,393600,338320,731920
3/29/2024,Vijitha Gunathilaka,Hambantota,Ruhunupura,Southern,947,8569,9516,37880,342760,380640
3/30/2024,Vijitha Gunathilaka,Hambantota,Ruhunupura,Southern,5447,7516,12963,217880,300640,518520
3/31/2024,Vijitha Gunathilaka,Hambantota,Ruhunupura,Southern,4207,7217,11424,168280,288680,456960
4/1/2024,Vijitha Gunathilaka,Hambantota,Ruhunupura,Southern,9415,2042,11457,376600,81680,458280
4/2/2024,Vijitha Gunathilaka,Hambantota,Ruhunupura,Southern,2165,5607,7772,86600,224280,310880
4/3/2024,Vijitha Gunathilaka,Hambantota,Ruhunupura,Southern,5621,9937,15558,224840,397480,622320
4/4/2024,Vijitha Gunathilaka,Hambantota,Ruhunupura,Southern,9580,8179,17759,383200,327160,710360
4/5/2024,Vijitha Gunathilaka,Hambantota,Ruhunupura,Southern,7491,6013,13504,299640,240520,540160
4/6/2024,Vijitha Gunathilaka,Hambantota,Ruhunupura,Southern,3591,1743,5334,143640,69720,213360
4/7/2024,Vijitha Gunathilaka,Hambantota,Ruhunupura,Southern,6921,5827,12748,276840,233080,509920
4/8/2024,Vijitha Gunathilaka,Hambantota,Ruhunupura,Southern,8949,1899,10848,357960,75960,433920
4/9/2024,Vijitha Gunathilaka,Hambantota,Ruhunupura,Southern,9902,9922,19824,396080,396880,792960
4/10/2024,Vijitha Gunathilaka,Hambantota,Ruhunupura,Southern,440,6314,6754,17600,252560,270160
4/11/2024,Vijitha Gunathilaka,Hambantota,Ruhunupura,Southern,5755,6217,11972,230200,248680,478880
4/19/2024,Vijitha Gunathilaka,Hambantota,Ruhunupura,Southern,9512,4846,14358,380480,193840,574320
4/20/2024,Vijitha Gunathilaka,Hambantota,Ruhunupura,Southern,2164,4137,6301,86560,165480,252040
4/21/2024,Vijitha Gunathilaka,Hambantota,Ruhunupura,Southern,7837,5153,12990,313480,206120,519600
4/22/2024,Vijitha Gunathilaka,Hambantota,Ruhunupura,Southern,8008,6637,14645,320320,265480,585800
4/23/2024,Vijitha Gunathilaka,Hambantota,Ruhunupura,Southern,8119,5039,13158,324760,201560,526320
4/24/2024,Vijitha Gunathilaka,Hambantota,Ruhunupura,Southern,2133,5760,7893,85320,230400,315720
4/25/2024,Vijitha Gunathilaka,Hambantota,Ruhunupura,Southern,5821,4285,10106,232840,171400,404240
4/26/2024,Vijitha Gunathilaka,Hambantota,Ruhunupura,Southern,5162,2306,7468,206480,92240,298720
4/27/2024,Vijitha Gunathilaka,Hambantota,Ruhunupura,Southern,3490,3992,7482,139600,159680,299280
4/28/2024,Vijitha Gunathilaka,Hambantota,Ruhunupura,Southern,466,5677,6143,18640,227080,245720
4/29/2024,Vijitha Gunathilaka,Hambantota,Ruhunupura,Southern,8577,6172,14749,343080,246880,589960
4/30/2024,Vijitha Gunathilaka,Hambantota,Ruhunupura,Southern,9678,1904,11582,387120,76160,463280
5/1/2024,Vijitha Gunathilaka,Hambantota,Ruhunupura,Southern,1108,7281,8389,44320,291240,335560
5/2/2024,Vijitha Gunathilaka,Hambantota,Ruhunupura,Southern,1717,5099,6816,68680,203960,272640
5/3/2024,Vijitha Gunathilaka,Hambantota,Ruhunupura,Southern,1350,5669,7019,54000,226760,280760
5/4/2024,Vijitha Gunathilaka,Hambantota,Ruhunupura,Southern,2777,1156,3933,111080,46240,157320
5/5/2024,Vijitha Gunathilaka,Hambantota,Ruhunupura,Southern,3277,8297,11574,131080,331880,462960
5/6/2024,Vijitha Gunathilaka,Hambantota,Ruhunupura,Southern,5900,8399,14299,236000,335960,571960
5/7/2024,Vijitha Gunathilaka,Hambantota,Ruhunupura,Southern,1015,9751,10766,40600,390040,430640
5/8/2024,Vijitha Gunathilaka,Hambantota,Ruhunupura,Southern,6865,3844,10709,274600,153760,428360
5/9/2024,Vijitha Gunathilaka,Hambantota,Ruhunupura,Southern,8718,7411,16129,348720,296440,645160
5/10/2024,Vijitha Gunathilaka,Hambantota,Ruhunupura,Southern,2831,9872,12703,113240,394880,508120
5/11/2024,Vijitha Gunathilaka,Hambantota,Ruhunupura,Southern,1729,6171,7900,69160,246840,316000
5/12/2024,Vijitha Gunathilaka,Hambantota,Ruhunupura,Southern,7121,3873,10994,284840,154920,439760
5/13/2024,Vijitha Gunathilaka,Hambantota,Ruhunupura,Southern,6492,8878,15370,259680,355120,614800
5/14/2024,Vijitha Gunathilaka,Hambantota,Ruhunupura,Southern,1620,8879,10499,64800,355160,419960
5/15/2024,Vijitha Gunathilaka,Hambantota,Ruhunupura,Southern,3860,8775,12635,154400,351000,505400
5/16/2024,Vijitha Gunathilaka,Hambantota,Ruhunupura,Southern,9324,9148,18472,372960,365920,738880
5/17/2024,Vijitha Gunathilaka,Hambantota,Ruhunupura,Southern,2558,2523,5081,102320,100920,203240
5/18/2024,Vijitha Gunathilaka,Hambantota,Ruhunupura,Southern,2590,5735,8325,103600,229400,333000
5/19/2024,Vijitha Gunathilaka,Hambantota,Ruhunupura,Southern,4304,5440,9744,172160,217600,389760
5/20/2024,Vijitha Gunathilaka,Hambantota,Ruhunupura,Southern,4919,3598,8517,196760,143920,340680
5/21/2024,Vijitha Gunathilaka,Hambantota,Ruhunupura,Southern,7238,5461,12699,289520,218440,507960
5/22/2024,Vijitha Gunathilaka,Hambantota,Ruhunupura,Southern,9359,9727,19086,374360,389080,763440
5/24/2024,Vijitha Gunathilaka,Hambantota,Ruhunupura,Southern,1620,7477,9097,64800,299080,363880
5/25/2024,Vijitha Gunathilaka,Hambantota,Ruhunupura,Southern,5397,3492,8889,215880,139680,355560
5/26/2024,Vijitha Gunathilaka,Hambantota,Ruhunupura,Southern,8808,2008,10816,352320,80320,432640
5/27/2024,Vijitha Gunathilaka,Hambantota,Ruhunupura,Southern,1821,9084,10905,72840,363360,436200
5/28/2024,Vijitha Gunathilaka,Hambantota,Ruhunupura,Southern,715,9861,10576,28600,394440,423040
5/29/2024,Vijitha Gunathilaka,Hambantota,Ruhunupura,Southern,1348,8230,9578,53920,329200,383120
5/30/2024,Vijitha Gunathilaka,Hambantota,Ruhunupura,Southern,7385,9517,16902,295400,380680,676080
5/31/2024,Vijitha Gunathilaka,Hambantota,Ruhunupura,Southern,8341,5513,13854,333640,220520,554160
6/1/2024,Vijitha Gunathilaka,Hambantota,Ruhunupura,Southern,9057,6339,15396,362280,253560,615840
6/2/2024,Vijitha Gunathilaka,Hambantota,Ruhunupura,Southern,6757,3867,10624,270280,154680,424960
6/3/2024,Vijitha Gunathilaka,Hambantota,Ruhunupura,Southern,131,4757,4888,5240,190280,195520
6/4/2024,Vijitha Gunathilaka,Hambantota,Ruhunupura,Southern,4145,511,4656,165800,20440,186240
6/5/2024,Vijitha Gunathilaka,Hambantota,Ruhunupura,Southern,6133,6076,12209,245320,243040,488360
6/6/2024,Vijitha Gunathilaka,Hambantota,Ruhunupura,Southern,8029,2564,10593,321160,102560,423720
6/7/2024,Vijitha Gunathilaka,Hambantota,Ruhunupura,Southern,1013,9011,10024,40520,360440,400960
6/8/2024,Vijitha Gunathilaka,Hambantota,Ruhunupura,Southern,3357,5498,8855,134280,219920,354200
6/9/2024,Vijitha Gunathilaka,Hambantota,Ruhunupura,Southern,1324,7203,8527,52960,288120,341080
6/10/2024,Vijitha Gunathilaka,Hambantota,Ruhunupura,Southern,820,2065,2885,32800,82600,115400
6/11/2024,Vijitha Gunathilaka,Hambantota,Ruhunupura,Southern,7812,959,8771,312480,38360,350840
6/12/2024,Vijitha Gunathilaka,Hambantota,Ruhunupura,Southern,666,6044,6710,26640,241760,268400
6/13/2024,Vijitha Gunathilaka,Hambantota,Ruhunupura,Southern,8588,3129,11717,343520,125160,468680
6/14/2024,Vijitha Gunathilaka,Hambantota,Ruhunupura,Southern,7613,8423,16036,304520,336920,641440
6/15/2024,Vijitha Gunathilaka,Hambantota,Ruhunupura,Southern,3876,5647,9523,155040,225880,380920
6/16/2024,Vijitha Gunathilaka,Hambantota,Ruhunupura,Southern,4826,2518,7344,193040,100720,293760
6/17/2024,Vijitha Gunathilaka,Hambantota,Ruhunupura,Southern,3790,4345,8135,151600,173800,325400
6/18/2024,Vijitha Gunathilaka,Hambantota,Ruhunupura,Southern,9477,576,10053,379080,23040,402120
6/19/2024,Vijitha Gunathilaka,Hambantota,Ruhunupura,Southern,115,3063,3178,4600,122520,127120
6/20/2024,Vijitha Gunathilaka,Hambantota,Ruhunupura,Southern,2911,5250,8161,116440,210000,326440
6/21/2024,Vijitha Gunathilaka,Hambantota,Ruhunupura,Southern,9959,4750,14709,398360,190000,588360
6/22/2024,Vijitha Gunathilaka,Hambantota,Ruhunupura,Southern,6527,126,6653,261080,5040,266120
6/23/2024,Vijitha Gunathilaka,Hambantota,Ruhunupura,Southern,9393,6161,15554,375720,246440,622160
6/24/2024,Vijitha Gunathilaka,Hambantota,Ruhunupura,Southern,9203,3957,13160,368120,158280,526400
6/25/2024,Vijitha Gunathilaka,Hambantota,Ruhunupura,Southern,9399,7114,16513,375960,284560,660520
6/26/2024,Vijitha Gunathilaka,Hambantota,Ruhunupura,Southern,3549,5212,8761,141960,208480,350440
6/27/2024,Vijitha Gunathilaka,Hambantota,Ruhunupura,Southern,4522,2765,7287,180880,110600,291480
6/28/2024,Vijitha Gunathilaka,Hambantota,Ruhunupura,Southern,5172,8006,13178,206880,320240,527120
6/29/2024,Vijitha Gunathilaka,Hambantota,Ruhunupura,Southern,6172,6191,12363,246880,247640,494520
6/30/2024,Vijitha Gunathilaka,Hambantota,Ruhunupura,Southern,2619,2761,5380,104760,110440,215200
7/1/2024,Vijitha Gunathilaka,Hambantota,Ruhunupura,Southern,237,1087,1324,9480,43480,52960
7/2/2024,Vijitha Gunathilaka,Hambantota,Ruhunupura,Southern,3403,8656,12059,136120,346240,482360
7/3/2024,Vijitha Gunathilaka,Hambantota,Ruhunupura,Southern,5621,3915,9536,224840,156600,381440
7/4/2024,Vijitha Gunathilaka,Hambantota,Ruhunupura,Southern,7908,2664,10572,316320,106560,422880
7/5/2024,Vijitha Gunathilaka,Hambantota,Ruhunupura,Southern,1523,7199,8722,60920,287960,348880
7/6/2024,Vijitha Gunathilaka,Hambantota,Ruhunupura,Southern,3335,5522,8857,133400,220880,354280
7/7/2024,Vijitha Gunathilaka,Hambantota,Ruhunupura,Southern,8019,4619,12638,320760,184760,505520
7/8/2024,Vijitha Gunathilaka,Hambantota,Ruhunupura,Southern,8697,601,9298,347880,24040,371920
7/9/2024,Vijitha Gunathilaka,Hambantota,Ruhunupura,Southern,2295,3817,6112,91800,152680,244480
7/10/2024,Vijitha Gunathilaka,Hambantota,Ruhunupura,Southern,4581,3741,8322,183240,149640,332880
7/11/2024,Vijitha Gunathilaka,Hambantota,Ruhunupura,Southern,3973,9573,13546,158920,382920,541840
7/12/2024,Vijitha Gunathilaka,Hambantota,Ruhunupura,Southern,612,7451,8063,24480,298040,322520
7/13/2024,Vijitha Gunathilaka,Hambantota,Ruhunupura,Southern,3041,2445,5486,121640,97800,219440
7/14/2024,Vijitha Gunathilaka,Hambantota,Ruhunupura,Southern,2010,7073,9083,80400,282920,363320
7/15/2024,Vijitha Gunathilaka,Hambantota,Ruhunupura,Southern,1034,2875,3909,41360,115000,156360
7/16/2024,Vijitha Gunathilaka,Hambantota,Ruhunupura,Southern,3221,59,3280,128840,2360,131200
7/17/2024,Vijitha Gunathilaka,Hambantota,Ruhunupura,Southern,4853,5050,9903,194120,202000,396120
7/18/2024,Vijitha Gunathilaka,Hambantota,Ruhunupura,Southern,364,2565,2929,14560,102600,117160
7/19/2024,Vijitha Gunathilaka,Hambantota,Ruhunupura,Southern,4947,4461,9408,197880,178440,376320
7/20/2024,Vijitha Gunathilaka,Hambantota,Ruhunupura,Southern,8301,9844,18145,332040,393760,725800
7/21/2024,Vijitha Gunathilaka,Hambantota,Ruhunupura,Southern,471,388,859,18840,15520,34360
7/22/2024,Vijitha Gunathilaka,Hambantota,Ruhunupura,Southern,2734,1506,4240,109360,60240,169600
7/23/2024,Vijitha Gunathilaka,Hambantota,Ruhunupura,Southern,5434,8360,13794,217360,334400,551760
7/24/2024,Vijitha Gunathilaka,Hambantota,Ruhunupura,Southern,3472,3995,7467,138880,159800,298680
7/25/2024,Vijitha Gunathilaka,Hambantota,Ruhunupura,Southern,4494,9182,13676,179760,367280,547040
7/26/2024,Vijitha Gunathilaka,Hambantota,Ruhunupura,Southern,8957,8797,17754,358280,351880,710160
7/27/2024,Vijitha Gunathilaka,Hambantota,Ruhunupura,Southern,2297,1607,3904,91880,64280,156160
7/28/2024,Vijitha Gunathilaka,Hambantota,Ruhunupura,Southern,1526,8520,10046,61040,340800,401840
7/29/2024,Vijitha Gunathilaka,Hambantota,Ruhunupura,Southern,8531,5042,13573,341240,201680,542920
7/30/2024,Vijitha Gunathilaka,Hambantota,Ruhunupura,Southern,5820,25,5845,232800,1000,233800
7/31/2024,Vijitha Gunathilaka,Hambantota,Ruhunupura,Southern,5546,6447,11993,221840,257880,479720
8/1/2024,Vijitha Gunathilaka,Hambantota,Ruhunupura,Southern,109,9281,9390,4360,371240,375600
8/2/2024,Vijitha Gunathilaka,Hambantota,Ruhunupura,Southern,3170,4469,7639,126800,178760,305560
8/3/2024,Vijitha Gunathilaka,Hambantota,Ruhunupura,Southern,5212,4860,10072,208480,194400,402880
8/4/2024,Vijitha Gunathilaka,Hambantota,Ruhunupura,Southern,9443,9368,18811,377720,374720,752440
8/5/2024,Vijitha Gunathilaka,Hambantota,Ruhunupura,Southern,5599,1046,6645,223960,41840,265800
8/6/2024,Vijitha Gunathilaka,Hambantota,Ruhunupura,Southern,1172,420,1592,46880,16800,63680
8/7/2024,Vijitha Gunathilaka,Hambantota,Ruhunupura,Southern,3556,3838,7394,142240,153520,295760
8/8/2024,Vijitha Gunathilaka,Hambantota,Ruhunupura,Southern,9660,371,10031,386400,14840,401240
8/9/2024,Vijitha Gunathilaka,Hambantota,Ruhunupura,Southern,990,498,1488,39600,19920,59520
8/10/2024,Vijitha Gunathilaka,Hambantota,Ruhunupura,Southern,4345,1900,6245,173800,76000,249800
8/11/2024,Vijitha Gunathilaka,Hambantota,Ruhunupura,Southern,5093,1682,6775,203720,67280,271000
8/12/2024,Vijitha Gunathilaka,Hambantota,Ruhunupura,Southern,3398,5133,8531,135920,205320,341240
8/13/2024,Vijitha Gunathilaka,Hambantota,Ruhunupura,Southern,7603,2486,10089,304120,99440,403560
8/14/2024,Vijitha Gunathilaka,Hambantota,Ruhunupura,Southern,8231,7862,16093,329240,314480,643720
8/15/2024,Vijitha Gunathilaka,Hambantota,Ruhunupura,Southern,858,5578,6436,34320,223120,257440
8/16/2024,Vijitha Gunathilaka,Hambantota,Ruhunupura,Southern,1723,7369,9092,68920,294760,363680
8/17/2024,Vijitha Gunathilaka,Hambantota,Ruhunupura,Southern,9741,6000,15741,389640,240000,629640
8/18/2024,Vijitha Gunathilaka,Hambantota,Ruhunupura,Southern,3484,362,3846,139360,14480,153840
8/19/2024,Vijitha Gunathilaka,Hambantota,Ruhunupura,Southern,1950,6296,8246,78000,251840,329840
8/20/2024,Vijitha Gunathilaka,Hambantota,Ruhunupura,Southern,6836,8824,15660,273440,352960,626400
8/21/2024,Vijitha Gunathilaka,Hambantota,Ruhunupura,Southern,8453,3867,12320,338120,154680,492800
8/22/2024,Vijitha Gunathilaka,Hambantota,Ruhunupura,Southern,2005,6182,8187,80200,247280,327480
8/23/2024,Vijitha Gunathilaka,Hambantota,Ruhunupura,Southern,4287,863,5150,171480,34520,206000
8/24/2024,Vijitha Gunathilaka,Hambantota,Ruhunupura,Southern,9538,7688,17226,381520,307520,689040
8/25/2024,Vijitha Gunathilaka,Hambantota,Ruhunupura,Southern,5944,8924,14868,237760,356960,594720
8/26/2024,Vijitha Gunathilaka,Hambantota,Ruhunupura,Southern,5076,2579,7655,203040,103160,306200
8/27/2024,Vijitha Gunathilaka,Hambantota,Ruhunupura,Southern,5694,8861,14555,227760,354440,582200
8/28/2024,Vijitha Gunathilaka,Hambantota,Ruhunupura,Southern,9075,7047,16122,363000,281880,644880
8/29/2024,Vijitha Gunathilaka,Hambantota,Ruhunupura,Southern,2700,2556,5256,108000,102240,210240
8/30/2024,Vijitha Gunathilaka,Hambantota,Ruhunupura,Southern,4667,8477,13144,186680,339080,525760
8/31/2024,Vijitha Gunathilaka,Hambantota,Ruhunupura,Southern,4669,2698,7367,186760,107920,294680
9/1/2024,Vijitha Gunathilaka,Hambantota,Ruhunupura,Southern,1244,8738,9982,49760,349520,399280
9/2/2024,Vijitha Gunathilaka,Hambantota,Ruhunupura,Southern,1035,392,1427,41400,15680,57080
9/3/2024,Vijitha Gunathilaka,Hambantota,Ruhunupura,Southern,5355,6270,11625,214200,250800,465000
9/4/2024,Vijitha Gunathilaka,Hambantota,Ruhunupura,Southern,4908,695,5603,196320,27800,224120
9/5/2024,Vijitha Gunathilaka,Hambantota,Ruhunupura,Southern,7646,5611,13257,305840,224440,530280
9/6/2024,Vijitha Gunathilaka,Hambantota,Ruhunupura,Southern,1310,8765,10075,52400,350600,403000
9/7/2024,Vijitha Gunathilaka,Hambantota,Ruhunupura,Southern,9377,5362,14739,375080,214480,589560
9/8/2024,Vijitha Gunathilaka,Hambantota,Ruhunupura,Southern,1455,9673,11128,58200,386920,445120
9/9/2024,Vijitha Gunathilaka,Hambantota,Ruhunupura,Southern,5072,1683,6755,202880,67320,270200
9/10/2024,Vijitha Gunathilaka,Hambantota,Ruhunupura,Southern,2600,3602,6202,104000,144080,248080
9/11/2024,Vijitha Gunathilaka,Hambantota,Ruhunupura,Southern,2006,9836,11842,80240,393440,473680
9/12/2024,Vijitha Gunathilaka,Hambantota,Ruhunupura,Southern,7476,9796,17272,299040,391840,690880
9/13/2024,Vijitha Gunathilaka,Hambantota,Ruhunupura,Southern,3886,9184,13070,155440,367360,522800
9/14/2024,Vijitha Gunathilaka,Hambantota,Ruhunupura,Southern,9511,861,10372,380440,34440,414880
9/15/2024,Vijitha Gunathilaka,Hambantota,Ruhunupura,Southern,826,3713,4539,33040,148520,181560
9/16/2024,Vijitha Gunathilaka,Hambantota,Ruhunupura,Southern,2613,8220,10833,104520,328800,433320
9/17/2024,Vijitha Gunathilaka,Hambantota,Ruhunupura,Southern,1640,7609,9249,65600,304360,369960
9/18/2024,Vijitha Gunathilaka,Hambantota,Ruhunupura,Southern,6287,453,6740,251480,18120,269600
9/19/2024,Vijitha Gunathilaka,Hambantota,Ruhunupura,Southern,4778,6987,11765,191120,279480,470600
9/20/2024,Vijitha Gunathilaka,Hambantota,Ruhunupura,Southern,2753,8002,10755,110120,320080,430200
9/21/2024,Vijitha Gunathilaka,Hambantota,Ruhunupura,Southern,9078,4092,13170,363120,163680,526800
9/22/2024,Vijitha Gunathilaka,Hambantota,Ruhunupura,Southern,9969,9463,19432,398760,378520,777280
9/23/2024,Vijitha Gunathilaka,Hambantota,Ruhunupura,Southern,5357,754,6111,214280,30160,244440
9/24/2024,Vijitha Gunathilaka,Hambantota,Ruhunupura,Southern,215,7277,7492,8600,291080,299680
9/25/2024,Vijitha Gunathilaka,Hambantota,Ruhunupura,Southern,6220,9722,15942,248800,388880,637680
9/26/2024,Vijitha Gunathilaka,Hambantota,Ruhunupura,Southern,3803,5058,8861,152120,202320,354440
9/27/2024,Vijitha Gunathilaka,Hambantota,Ruhunupura,Southern,4209,5002,9211,168360,200080,368440
9/28/2024,Vijitha Gunathilaka,Hambantota,Ruhunupura,Southern,4821,9430,14251,192840,377200,570040
9/29/2024,Vijitha Gunathilaka,Hambantota,Ruhunupura,Southern,7811,798,8609,312440,31920,344360
9/30/2024,Vijitha Gunathilaka,Hambantota,Ruhunupura,Southern,6548,9419,15967,261920,376760,638680
10/1/2024,Vijitha Gunathilaka,Hambantota,Ruhunupura,Southern,8896,1081,9977,355840,43240,399080
10/2/2024,Vijitha Gunathilaka,Hambantota,Ruhunupura,Southern,205,490,695,8200,19600,27800
10/3/2024,Vijitha Gunathilaka,Hambantota,Ruhunupura,Southern,786,8294,9080,31440,331760,363200
10/4/2024,Vijitha Gunathilaka,Hambantota,Ruhunupura,Southern,6718,4338,11056,268720,173520,442240
10/5/2024,Vijitha Gunathilaka,Hambantota,Ruhunupura,Southern,9605,3703,13308,384200,148120,532320
10/6/2024,Vijitha Gunathilaka,Hambantota,Ruhunupura,Southern,3336,5946,9282,133440,237840,371280
10/7/2024,Vijitha Gunathilaka,Hambantota,Ruhunupura,Southern,4415,6217,10632,176600,248680,425280
10/8/2024,Vijitha Gunathilaka,Hambantota,Ruhunupura,Southern,8609,4965,13574,344360,198600,542960
10/9/2024,Vijitha Gunathilaka,Hambantota,Ruhunupura,Southern,1105,4032,5137,44200,161280,205480
10/10/2024,Vijitha Gunathilaka,Hambantota,Ruhunupura,Southern,6014,4972,10986,240560,198880,439440
10/11/2024,Vijitha Gunathilaka,Hambantota,Ruhunupura,Southern,7725,7562,15287,309000,302480,611480
10/12/2024,Vijitha Gunathilaka,Hambantota,Ruhunupura,Southern,1672,7242,8914,66880,289680,356560
10/13/2024,Vijitha Gunathilaka,Hambantota,Ruhunupura,Southern,1239,9702,10941,49560,388080,437640
10/14/2024,Vijitha Gunathilaka,Hambantota,Ruhunupura,Southern,4973,8581,13554,198920,343240,542160
10/15/2024,Vijitha Gunathilaka,Hambantota,Ruhunupura,Southern,431,8654,9085,17240,346160,363400
10/16/2024,Vijitha Gunathilaka,Hambantota,Ruhunupura,Southern,2085,5050,7135,83400,202000,285400
10/17/2024,Vijitha Gunathilaka,Hambantota,Ruhunupura,Southern,6573,9579,16152,262920,383160,646080
10/18/2024,Vijitha Gunathilaka,Hambantota,Ruhunupura,Southern,4499,986,5485,179960,39440,219400
10/19/2024,Vijitha Gunathilaka,Hambantota,Ruhunupura,Southern,2527,2750,5277,101080,110000,211080
10/20/2024,Vijitha Gunathilaka,Hambantota,Ruhunupura,Southern,329,2384,2713,13160,95360,108520
10/21/2024,Vijitha Gunathilaka,Hambantota,Ruhunupura,Southern,9691,6964,16655,387640,278560,666200
10/22/2024,Vijitha Gunathilaka,Hambantota,Ruhunupura,Southern,3417,4673,8090,136680,186920,323600
10/23/2024,Vijitha Gunathilaka,Hambantota,Ruhunupura,Southern,4989,7988,12977,199560,319520,519080
10/24/2024,Vijitha Gunathilaka,Hambantota,Ruhunupura,Southern,6267,5311,11578,250680,212440,463120
10/25/2024,Vijitha Gunathilaka,Hambantota,Ruhunupura,Southern,7140,9501,16641,285600,380040,665640
10/26/2024,Vijitha Gunathilaka,Hambantota,Ruhunupura,Southern,2615,9810,12425,104600,392400,497000
10/27/2024,Vijitha Gunathilaka,Hambantota,Ruhunupura,Southern,8488,7291,15779,339520,291640,631160
10/28/2024,Vijitha Gunathilaka,Hambantota,Ruhunupura,Southern,2355,8188,10543,94200,327520,421720
10/29/2024,Vijitha Gunathilaka,Hambantota,Ruhunupura,Southern,5792,1163,6955,231680,46520,278200
10/30/2024,Vijitha Gunathilaka,Hambantota,Ruhunupura,Southern,1155,5431,6586,46200,217240,263440
10/31/2024,Vijitha Gunathilaka,Hambantota,Ruhunupura,Southern,4324,4039,8363,172960,161560,334520
11/1/2024,Vijitha Gunathilaka,Hambantota,Ruhunupura,Southern,3596,5444,9040,143840,217760,361600
11/2/2024,Vijitha Gunathilaka,Hambantota,Ruhunupura,Southern,2338,5720,8058,93520,228800,322320
11/3/2024,Vijitha Gunathilaka,Hambantota,Ruhunupura,Southern,5155,8174,13329,206200,326960,533160
11/4/2024,Vijitha Gunathilaka,Hambantota,Ruhunupura,Southern,5145,4786,9931,205800,191440,397240
11/5/2024,Vijitha Gunathilaka,Hambantota,Ruhunupura,Southern,7178,920,8098,287120,36800,323920
11/6/2024,Vijitha Gunathilaka,Hambantota,Ruhunupura,Southern,227,812,1039,9080,32480,41560
11/7/2024,Vijitha Gunathilaka,Hambantota,Ruhunupura,Southern,6017,7222,13239,240680,288880,529560
11/8/2024,Vijitha Gunathilaka,Hambantota,Ruhunupura,Southern,3229,3276,6505,129160,131040,260200
11/9/2024,Vijitha Gunathilaka,Hambantota,Ruhunupura,Southern,6320,9288,15608,252800,371520,624320
11/10/2024,Vijitha Gunathilaka,Hambantota,Ruhunupura,Southern,4706,8204,12910,188240,328160,516400
11/11/2024,Vijitha Gunathilaka,Hambantota,Ruhunupura,Southern,3998,9428,13426,159920,377120,537040
11/12/2024,Vijitha Gunathilaka,Hambantota,Ruhunupura,Southern,5161,6443,11604,206440,257720,464160
11/13/2024,Vijitha Gunathilaka,Hambantota,Ruhunupura,Southern,6165,5285,11450,246600,211400,458000
11/14/2024,Vijitha Gunathilaka,Hambantota,Ruhunupura,Southern,3760,906,4666,150400,36240,186640
11/15/2024,Vijitha Gunathilaka,Hambantota,Ruhunupura,Southern,1843,9178,11021,73720,367120,440840
11/16/2024,Vijitha Gunathilaka,Hambantota,Ruhunupura,Southern,9671,8900,18571,386840,356000,742840
11/17/2024,Vijitha Gunathilaka,Hambantota,Ruhunupura,Southern,4321,4017,8338,172840,160680,333520
11/18/2024,Vijitha Gunathilaka,Hambantota,Ruhunupura,Southern,6531,4252,10783,261240,170080,431320
11/19/2024,Vijitha Gunathilaka,Hambantota,Ruhunupura,Southern,3320,7785,11105,132800,311400,444200
11/20/2024,Vijitha Gunathilaka,Hambantota,Ruhunupura,Southern,5391,6362,11753,215640,254480,470120
11/21/2024,Vijitha Gunathilaka,Hambantota,Ruhunupura,Southern,7516,2998,10514,300640,119920,420560
11/22/2024,Vijitha Gunathilaka,Hambantota,Ruhunupura,Southern,800,2215,3015,32000,88600,120600
11/23/2024,Vijitha Gunathilaka,Hambantota,Ruhunupura,Southern,91,315,406,3640,12600,16240
11/24/2024,Vijitha Gunathilaka,Hambantota,Ruhunupura,Southern,8055,2533,10588,322200,101320,423520
11/25/2024,Vijitha Gunathilaka,Hambantota,Ruhunupura,Southern,6154,9764,15918,246160,390560,636720
11/26/2024,Vijitha Gunathilaka,Hambantota,Ruhunupura,Southern,7377,9795,17172,295080,391800,686880
11/27/2024,Vijitha Gunathilaka,Hambantota,Ruhunupura,Southern,1049,7400,8449,41960,296000,337960
11/28/2024,Vijitha Gunathilaka,Hambantota,Ruhunupura,Southern,6399,5434,11833,255960,217360,473320
11/29/2024,Vijitha Gunathilaka,Hambantota,Ruhunupura,Southern,3997,6405,10402,159880,256200,416080
11/30/2024,Vijitha Gunathilaka,Hambantota,Ruhunupura,Southern,8887,4272,13159,355480,170880,526360
12/1/2024,Vijitha Gunathilaka,Hambantota,Ruhunupura,Southern,6975,7376,14351,279000,295040,574040
12/2/2024,Vijitha Gunathilaka,Hambantota,Ruhunupura,Southern,3878,142,4020,155120,5680,160800
12/3/2024,Vijitha Gunathilaka,Hambantota,Ruhunupura,Southern,5047,3396,8443,201880,135840,337720
12/4/2024,Vijitha Gunathilaka,Hambantota,Ruhunupura,Southern,4841,6739,11580,193640,269560,463200
12/5/2024,Vijitha Gunathilaka,Hambantota,Ruhunupura,Southern,3804,3051,6855,152160,122040,274200
12/6/2024,Vijitha Gunathilaka,Hambantota,Ruhunupura,Southern,6108,3053,9161,244320,122120,366440
12/7/2024,Vijitha Gunathilaka,Hambantota,Ruhunupura,Southern,9126,6205,15331,365040,248200,613240
12/8/2024,Vijitha Gunathilaka,Hambantota,Ruhunupura,Southern,2468,338,2806,98720,13520,112240
12/9/2024,Vijitha Gunathilaka,Hambantota,Ruhunupura,Southern,1846,8030,9876,73840,321200,395040
12/10/2024,Vijitha Gunathilaka,Hambantota,Ruhunupura,Southern,2182,1374,3556,87280,54960,142240
12/11/2024,Vijitha Gunathilaka,Hambantota,Ruhunupura,Southern,9399,5883,15282,375960,235320,611280
12/12/2024,Vijitha Gunathilaka,Hambantota,Ruhunupura,Southern,6654,6051,12705,266160,242040,508200
12/13/2024,Vijitha Gunathilaka,Hambantota,Ruhunupura,Southern,4618,7828,12446,184720,313120,497840
12/14/2024,Vijitha Gunathilaka,Hambantota,Ruhunupura,Southern,296,5259,5555,11840,210360,222200
12/15/2024,Vijitha Gunathilaka,Hambantota,Ruhunupura,Southern,9690,3934,13624,387600,157360,544960
12/16/2024,Vijitha Gunathilaka,Hambantota,Ruhunupura,Southern,7413,6825,14238,296520,273000,569520
12/17/2024,Vijitha Gunathilaka,Hambantota,Ruhunupura,Southern,6557,4775,11332,262280,191000,453280
12/18/2024,Vijitha Gunathilaka,Hambantota,Ruhunupura,Southern,6263,607,6870,250520,24280,274800
12/19/2024,Vijitha Gunathilaka,Hambantota,Ruhunupura,Southern,9855,5439,15294,394200,217560,611760
12/20/2024,Vijitha Gunathilaka,Hambantota,Ruhunupura,Southern,9746,7291,17037,389840,291640,681480
12/21/2024,Vijitha Gunathilaka,Hambantota,Ruhunupura,Southern,1013,6463,7476,40520,258520,299040
12/22/2024,Vijitha Gunathilaka,Hambantota,Ruhunupura,Southern,5127,9792,14919,205080,391680,596760
12/23/2024,Vijitha Gunathilaka,Hambantota,Ruhunupura,Southern,2774,5366,8140,110960,214640,325600
12/24/2024,Vijitha Gunathilaka,Hambantota,Ruhunupura,Southern,18,8141,8159,720,325640,326360
12/25/2024,Vijitha Gunathilaka,Hambantota,Ruhunupura,Southern,7844,6205,14049,313760,248200,561960
12/26/2024,Vijitha Gunathilaka,Hambantota,Ruhunupura,Southern,1852,4132,5984,74080,165280,239360
12/27/2024,Vijitha Gunathilaka,Hambantota,Ruhunupura,Southern,8382,2782,11164,335280,111280,446560
12/28/2024,Vijitha Gunathilaka,Hambantota,Ruhunupura,Southern,6039,200,6239,241560,8000,249560
12/29/2024,Vijitha Gunathilaka,Hambantota,Ruhunupura,Southern,1257,2000,3257,50280,80000,130280
12/30/2024,Vijitha Gunathilaka,Hambantota,Ruhunupura,Southern,385,5086,5471,15400,203440,218840
12/31/2024,Vijitha Gunathilaka,Hambantota,Ruhunupura,Southern,9376,2867,12243,375040,114680,489720
1/1/2025,Vijitha Gunathilaka,Hambantota,Ruhunupura,Southern,9637,5073,14710,385480,202920,588400
1/2/2025,Vijitha Gunathilaka,Hambantota,Ruhunupura,Southern,3022,7436,10458,120880,297440,418320
1/3/2025,Vijitha Gunathilaka,Hambantota,Ruhunupura,Southern,7442,1917,9359,297680,76680,374360
1/4/2025,Vijitha Gunathilaka,Hambantota,Ruhunupura,Southern,4777,7579,12356,191080,303160,494240
1/5/2025,Vijitha Gunathilaka,Hambantota,Ruhunupura,Southern,4137,4714,8851,165480,188560,354040
1/6/2025,Vijitha Gunathilaka,Hambantota,Ruhunupura,Southern,3087,8468,11555,123480,338720,462200
1/7/2025,Vijitha Gunathilaka,Hambantota,Ruhunupura,Southern,7550,2475,10025,302000,99000,401000
1/8/2025,Vijitha Gunathilaka,Hambantota,Ruhunupura,Southern,2359,9653,12012,94360,386120,480480
1/9/2025,Vijitha Gunathilaka,Hambantota,Ruhunupura,Southern,6075,5958,12033,243000,238320,481320
1/10/2025,Vijitha Gunathilaka,Hambantota,Ruhunupura,Southern,6545,1360,7905,261800,54400,316200
1/11/2025,Vijitha Gunathilaka,Hambantota,Ruhunupura,Southern,8950,9082,18032,358000,363280,721280
1/12/2025,Vijitha Gunathilaka,Hambantota,Ruhunupura,Southern,1218,2083,3301,48720,83320,132040
1/13/2025,Vijitha Gunathilaka,Hambantota,Ruhunupura,Southern,6116,3559,9675,244640,142360,387000
1/14/2025,Vijitha Gunathilaka,Hambantota,Ruhunupura,Southern,2175,3484,5659,87000,139360,226360
1/15/2025,Vijitha Gunathilaka,Hambantota,Ruhunupura,Southern,5960,4756,10716,238400,190240,428640
1/16/2025,Vijitha Gunathilaka,Hambantota,Ruhunupura,Southern,2653,5734,8387,106120,229360,335480
1/17/2025,Vijitha Gunathilaka,Hambantota,Ruhunupura,Southern,2737,7341,10078,109480,293640,403120
1/18/2025,Vijitha Gunathilaka,Hambantota,Ruhunupura,Southern,3310,9169,12479,132400,366760,499160
1/19/2025,Vijitha Gunathilaka,Hambantota,Ruhunupura,Southern,3345,7251,10596,133800,290040,423840
1/20/2025,Vijitha Gunathilaka,Hambantota,Ruhunupura,Southern,5400,289,5689,216000,11560,227560
1/21/2025,Vijitha Gunathilaka,Hambantota,Ruhunupura,Southern,4821,6428,11249,192840,257120,449960
1/22/2025,Vijitha Gunathilaka,Hambantota,Ruhunupura,Southern,6748,4609,11357,269920,184360,454280
1/23/2025,Vijitha Gunathilaka,Hambantota,Ruhunupura,Southern,8721,3451,12172,348840,138040,486880
1/24/2025,Vijitha Gunathilaka,Hambantota,Ruhunupura,Southern,5069,3763,8832,202760,150520,353280
1/25/2025,Vijitha Gunathilaka,Hambantota,Ruhunupura,Southern,136,9547,9683,5440,381880,387320
1/26/2025,Vijitha Gunathilaka,Hambantota,Ruhunupura,Southern,8560,5230,13790,342400,209200,551600
1/27/2025,Vijitha Gunathilaka,Hambantota,Ruhunupura,Southern,4900,4135,9035,196000,165400,361400
1/28/2025,Vijitha Gunathilaka,Hambantota,Ruhunupura,Southern,898,1659,2557,35920,66360,102280
1/29/2025,Vijitha Gunathilaka,Hambantota,Ruhunupura,Southern,3538,4597,8135,141520,183880,325400
1/30/2025,Vijitha Gunathilaka,Hambantota,Ruhunupura,Southern,14,5398,5412,560,215920,216480
1/31/2025,Vijitha Gunathilaka,Hambantota,Ruhunupura,Southern,7352,3141,10493,294080,125640,419720
2/1/2025,Vijitha Gunathilaka,Hambantota,Ruhunupura,Southern,1572,9272,10844,62880,370880,433760
2/2/2025,Vijitha Gunathilaka,Hambantota,Ruhunupura,Southern,2898,8634,11532,115920,345360,461280
2/3/2025,Vijitha Gunathilaka,Hambantota,Ruhunupura,Southern,121,8659,8780,4840,346360,351200
2/4/2025,Vijitha Gunathilaka,Hambantota,Ruhunupura,Southern,912,7099,8011,36480,283960,320440
2/5/2025,Vijitha Gunathilaka,Hambantota,Ruhunupura,Southern,1059,7148,8207,42360,285920,328280
2/6/2025,Vijitha Gunathilaka,Hambantota,Ruhunupura,Southern,5456,812,6268,218240,32480,250720
2/7/2025,Vijitha Gunathilaka,Hambantota,Ruhunupura,Southern,7515,5641,13156,300600,225640,526240
2/8/2025,Vijitha Gunathilaka,Hambantota,Ruhunupura,Southern,8041,1786,9827,321640,71440,393080
2/9/2025,Vijitha Gunathilaka,Hambantota,Ruhunupura,Southern,9839,6879,16718,393560,275160,668720
2/10/2025,Vijitha Gunathilaka,Hambantota,Ruhunupura,Southern,4704,7794,12498,188160,311760,499920
2/11/2025,Vijitha Gunathilaka,Hambantota,Ruhunupura,Southern,1060,1075,2135,42400,43000,85400
2/12/2025,Vijitha Gunathilaka,Hambantota,Ruhunupura,Southern,8236,5478,13714,329440,219120,548560
2/13/2025,Vijitha Gunathilaka,Hambantota,Ruhunupura,Southern,732,8313,9045,29280,332520,361800
2/14/2025,Vijitha Gunathilaka,Hambantota,Ruhunupura,Southern,6643,7154,13797,265720,286160,551880
2/15/2025,Vijitha Gunathilaka,Hambantota,Ruhunupura,Southern,7345,9373,16718,293800,374920,668720
2/16/2025,Vijitha Gunathilaka,Hambantota,Ruhunupura,Southern,3584,7878,11462,143360,315120,458480
2/17/2025,Vijitha Gunathilaka,Hambantota,Ruhunupura,Southern,8001,8269,16270,320040,330760,650800
2/18/2025,Vijitha Gunathilaka,Hambantota,Ruhunupura,Southern,2879,9789,12668,115160,391560,506720
2/19/2025,Vijitha Gunathilaka,Hambantota,Ruhunupura,Southern,3979,704,4683,159160,28160,187320
2/20/2025,Vijitha Gunathilaka,Hambantota,Ruhunupura,Southern,3399,8872,12271,135960,354880,490840
2/21/2025,Vijitha Gunathilaka,Hambantota,Ruhunupura,Southern,3498,782,4280,139920,31280,171200
2/22/2025,Vijitha Gunathilaka,Hambantota,Ruhunupura,Southern,6357,3172,9529,254280,126880,381160
2/23/2025,Vijitha Gunathilaka,Hambantota,Ruhunupura,Southern,1683,109,1792,67320,4360,71680
2/24/2025,Vijitha Gunathilaka,Hambantota,Ruhunupura,Southern,8339,4977,13316,333560,199080,532640
2/25/2025,Vijitha Gunathilaka,Hambantota,Ruhunupura,Southern,9712,7737,17449,388480,309480,697960
2/26/2025,Vijitha Gunathilaka,Hambantota,Ruhunupura,Southern,9459,5184,14643,378360,207360,585720
2/27/2025,Vijitha Gunathilaka,Hambantota,Ruhunupura,Southern,5148,4834,9982,205920,193360,399280
2/28/2025,Vijitha Gunathilaka,Hambantota,Ruhunupura,Southern,6454,5156,11610,258160,206240,464400
3/1/2025,Vijitha Gunathilaka,Hambantota,Ruhunupura,Southern,4724,4741,9465,188960,189640,378600
3/2/2025,Vijitha Gunathilaka,Hambantota,Ruhunupura,Southern,7063,4198,11261,282520,167920,450440
3/3/2025,Vijitha Gunathilaka,Hambantota,Ruhunupura,Southern,2320,8441,10761,92800,337640,430440
3/4/2025,Vijitha Gunathilaka,Hambantota,Ruhunupura,Southern,7105,1420,8525,284200,56800,341000
3/5/2025,Vijitha Gunathilaka,Hambantota,Ruhunupura,Southern,1501,4271,5772,60040,170840,230880
3/6/2025,Vijitha Gunathilaka,Hambantota,Ruhunupura,Southern,4780,7764,12544,191200,310560,501760
3/7/2025,Vijitha Gunathilaka,Hambantota,Ruhunupura,Southern,5005,2914,7919,200200,116560,316760
3/8/2025,Vijitha Gunathilaka,Hambantota,Ruhunupura,Southern,5014,8344,13358,200560,333760,534320
3/9/2025,Vijitha Gunathilaka,Hambantota,Ruhunupura,Southern,2319,6213,8532,92760,248520,341280
3/10/2025,Vijitha Gunathilaka,Hambantota,Ruhunupura,Southern,5793,7725,13518,231720,309000,540720
3/11/2025,Vijitha Gunathilaka,Hambantota,Ruhunupura,Southern,3689,2021,5710,147560,80840,228400
3/12/2025,Vijitha Gunathilaka,Hambantota,Ruhunupura,Southern,9765,1053,10818,390600,42120,432720
3/13/2025,Vijitha Gunathilaka,Hambantota,Ruhunupura,Southern,8485,1144,9629,339400,45760,385160
3/14/2025,Vijitha Gunathilaka,Hambantota,Ruhunupura,Southern,1808,3185,4993,72320,127400,199720
3/15/2025,Vijitha Gunathilaka,Hambantota,Ruhunupura,Southern,1286,1748,3034,51440,69920,121360
3/16/2025,Vijitha Gunathilaka,Hambantota,Ruhunupura,Southern,7291,7301,14592,291640,292040,583680
3/17/2025,Vijitha Gunathilaka,Hambantota,Ruhunupura,Southern,8041,7347,15388,321640,293880,615520
3/18/2025,Vijitha Gunathilaka,Hambantota,Ruhunupura,Southern,1090,3344,4434,43600,133760,177360
3/19/2025,Vijitha Gunathilaka,Hambantota,Ruhunupura,Southern,8835,750,9585,353400,30000,383400
3/20/2025,Vijitha Gunathilaka,Hambantota,Ruhunupura,Southern,950,6794,7744,38000,271760,309760
3/21/2025,Vijitha Gunathilaka,Hambantota,Ruhunupura,Southern,6140,5030,11170,245600,201200,446800
3/22/2025,Vijitha Gunathilaka,Hambantota,Ruhunupura,Southern,9045,8054,17099,361800,322160,683960
3/23/2025,Vijitha Gunathilaka,Hambantota,Ruhunupura,Southern,6966,1507,8473,278640,60280,338920
3/25/2024,Tharushi Jayasuriya,Batticaloa,Pothuvil,Eastern,7680,9554,17234,307200,382160,689360
3/26/2024,Tharushi Jayasuriya,Batticaloa,Pothuvil,Eastern,882,6059,6941,35280,242360,277640
3/27/2024,Tharushi Jayasuriya,Batticaloa,Pothuvil,Eastern,1331,3965,5296,53240,158600,211840
3/28/2024,Tharushi Jayasuriya,Batticaloa,Pothuvil,Eastern,9942,5820,15762,397680,232800,630480
3/29/2024,Tharushi Jayasuriya,Batticaloa,Pothuvil,Eastern,3585,120,3705,143400,4800,148200
3/30/2024,Tharushi Jayasuriya,Batticaloa,Pothuvil,Eastern,9496,423,9919,379840,16920,396760
3/31/2024,Tharushi Jayasuriya,Batticaloa,Pothuvil,Eastern,4501,6501,11002,180040,260040,440080
4/1/2024,Tharushi Jayasuriya,Batticaloa,Pothuvil,Eastern,2998,198,3196,119920,7920,127840
4/2/2024,Tharushi Jayasuriya,Batticaloa,Pothuvil,Eastern,8033,3420,11453,321320,136800,458120
4/3/2024,Tharushi Jayasuriya,Batticaloa,Pothuvil,Eastern,7707,5015,12722,308280,200600,508880
4/4/2024,Tharushi Jayasuriya,Batticaloa,Pothuvil,Eastern,8670,1017,9687,346800,40680,387480
4/5/2024,Tharushi Jayasuriya,Batticaloa,Pothuvil,Eastern,8621,9677,18298,344840,387080,731920
4/6/2024,Tharushi Jayasuriya,Batticaloa,Pothuvil,Eastern,1995,5590,7585,79800,223600,303400
4/7/2024,Tharushi Jayasuriya,Batticaloa,Pothuvil,Eastern,8251,7484,15735,330040,299360,629400
4/8/2024,Tharushi Jayasuriya,Batticaloa,Pothuvil,Eastern,1382,4948,6330,55280,197920,253200
4/9/2024,Tharushi Jayasuriya,Batticaloa,Pothuvil,Eastern,820,4257,5077,32800,170280,203080
4/10/2024,Tharushi Jayasuriya,Batticaloa,Pothuvil,Eastern,701,8246,8947,28040,329840,357880
4/11/2024,Tharushi Jayasuriya,Batticaloa,Pothuvil,Eastern,8479,8046,16525,339160,321840,661000
4/19/2024,Tharushi Jayasuriya,Batticaloa,Pothuvil,Eastern,3359,7947,11306,134360,317880,452240
4/20/2024,Tharushi Jayasuriya,Batticaloa,Pothuvil,Eastern,2952,1296,4248,118080,51840,169920
4/21/2024,Tharushi Jayasuriya,Batticaloa,Pothuvil,Eastern,1327,6789,8116,53080,271560,324640
4/22/2024,Tharushi Jayasuriya,Batticaloa,Pothuvil,Eastern,6849,482,7331,273960,19280,293240
4/23/2024,Tharushi Jayasuriya,Batticaloa,Pothuvil,Eastern,639,5566,6205,25560,222640,248200
4/24/2024,Tharushi Jayasuriya,Batticaloa,Pothuvil,Eastern,9725,1155,10880,389000,46200,435200
4/25/2024,Tharushi Jayasuriya,Batticaloa,Pothuvil,Eastern,1474,102,1576,58960,4080,63040
4/26/2024,Tharushi Jayasuriya,Batticaloa,Pothuvil,Eastern,2016,435,2451,80640,17400,98040
4/27/2024,Tharushi Jayasuriya,Batticaloa,Pothuvil,Eastern,9088,591,9679,363520,23640,387160
4/28/2024,Tharushi Jayasuriya,Batticaloa,Pothuvil,Eastern,6728,5486,12214,269120,219440,488560
4/29/2024,Tharushi Jayasuriya,Batticaloa,Pothuvil,Eastern,5445,2488,7933,217800,99520,317320
4/30/2024,Tharushi Jayasuriya,Batticaloa,Pothuvil,Eastern,9539,708,10247,381560,28320,409880
5/1/2024,Tharushi Jayasuriya,Batticaloa,Pothuvil,Eastern,261,4103,4364,10440,164120,174560
5/2/2024,Tharushi Jayasuriya,Batticaloa,Pothuvil,Eastern,756,7612,8368,30240,304480,334720
5/3/2024,Tharushi Jayasuriya,Batticaloa,Pothuvil,Eastern,1717,2870,4587,68680,114800,183480
5/4/2024,Tharushi Jayasuriya,Batticaloa,Pothuvil,Eastern,2160,1815,3975,86400,72600,159000
5/5/2024,Tharushi Jayasuriya,Batticaloa,Pothuvil,Eastern,3996,7961,11957,159840,318440,478280
5/6/2024,Tharushi Jayasuriya,Batticaloa,Pothuvil,Eastern,458,6881,7339,18320,275240,293560
5/7/2024,Tharushi Jayasuriya,Batticaloa,Pothuvil,Eastern,566,6702,7268,22640,268080,290720
5/8/2024,Tharushi Jayasuriya,Batticaloa,Pothuvil,Eastern,7538,4264,11802,301520,170560,472080
5/9/2024,Tharushi Jayasuriya,Batticaloa,Pothuvil,Eastern,3523,957,4480,140920,38280,179200
5/10/2024,Tharushi Jayasuriya,Batticaloa,Pothuvil,Eastern,8497,91,8588,339880,3640,343520
5/11/2024,Tharushi Jayasuriya,Batticaloa,Pothuvil,Eastern,2703,9142,11845,108120,365680,473800
5/12/2024,Tharushi Jayasuriya,Batticaloa,Pothuvil,Eastern,3929,1853,5782,157160,74120,231280
5/13/2024,Tharushi Jayasuriya,Batticaloa,Pothuvil,Eastern,7891,1068,8959,315640,42720,358360
5/14/2024,Tharushi Jayasuriya,Batticaloa,Pothuvil,Eastern,4976,7359,12335,199040,294360,493400
5/15/2024,Tharushi Jayasuriya,Batticaloa,Pothuvil,Eastern,9070,5238,14308,362800,209520,572320
5/16/2024,Tharushi Jayasuriya,Batticaloa,Pothuvil,Eastern,2899,7518,10417,115960,300720,416680
5/17/2024,Tharushi Jayasuriya,Batticaloa,Pothuvil,Eastern,181,4830,5011,7240,193200,200440
5/18/2024,Tharushi Jayasuriya,Batticaloa,Pothuvil,Eastern,8394,6429,14823,335760,257160,592920
5/19/2024,Tharushi Jayasuriya,Batticaloa,Pothuvil,Eastern,9426,1417,10843,377040,56680,433720
5/20/2024,Tharushi Jayasuriya,Batticaloa,Pothuvil,Eastern,1330,5290,6620,53200,211600,264800
5/21/2024,Tharushi Jayasuriya,Batticaloa,Pothuvil,Eastern,7998,4737,12735,319920,189480,509400
5/22/2024,Tharushi Jayasuriya,Batticaloa,Pothuvil,Eastern,3906,9825,13731,156240,393000,549240
5/24/2024,Tharushi Jayasuriya,Batticaloa,Pothuvil,Eastern,2434,6276,8710,97360,251040,348400
5/25/2024,Tharushi Jayasuriya,Batticaloa,Pothuvil,Eastern,5625,486,6111,225000,19440,244440
5/26/2024,Tharushi Jayasuriya,Batticaloa,Pothuvil,Eastern,9226,8397,17623,369040,335880,704920
5/27/2024,Tharushi Jayasuriya,Batticaloa,Pothuvil,Eastern,9807,7770,17577,392280,310800,703080
5/28/2024,Tharushi Jayasuriya,Batticaloa,Pothuvil,Eastern,8605,7507,16112,344200,300280,644480
5/29/2024,Tharushi Jayasuriya,Batticaloa,Pothuvil,Eastern,2225,3075,5300,89000,123000,212000
5/30/2024,Tharushi Jayasuriya,Batticaloa,Pothuvil,Eastern,3764,631,4395,150560,25240,175800
5/31/2024,Tharushi Jayasuriya,Batticaloa,Pothuvil,Eastern,4167,5347,9514,166680,213880,380560
6/1/2024,Tharushi Jayasuriya,Batticaloa,Pothuvil,Eastern,9155,4008,13163,366200,160320,526520
6/2/2024,Tharushi Jayasuriya,Batticaloa,Pothuvil,Eastern,2751,4541,7292,110040,181640,291680
6/3/2024,Tharushi Jayasuriya,Batticaloa,Pothuvil,Eastern,6262,6989,13251,250480,279560,530040
6/4/2024,Tharushi Jayasuriya,Batticaloa,Pothuvil,Eastern,1952,7109,9061,78080,284360,362440
6/5/2024,Tharushi Jayasuriya,Batticaloa,Pothuvil,Eastern,2750,7389,10139,110000,295560,405560
6/6/2024,Tharushi Jayasuriya,Batticaloa,Pothuvil,Eastern,7920,8835,16755,316800,353400,670200
6/7/2024,Tharushi Jayasuriya,Batticaloa,Pothuvil,Eastern,6150,8939,15089,246000,357560,603560
6/8/2024,Tharushi Jayasuriya,Batticaloa,Pothuvil,Eastern,220,8221,8441,8800,328840,337640
6/9/2024,Tharushi Jayasuriya,Batticaloa,Pothuvil,Eastern,6413,7785,14198,256520,311400,567920
6/10/2024,Tharushi Jayasuriya,Batticaloa,Pothuvil,Eastern,3999,3584,7583,159960,143360,303320
6/11/2024,Tharushi Jayasuriya,Batticaloa,Pothuvil,Eastern,6395,2319,8714,255800,92760,348560
6/12/2024,Tharushi Jayasuriya,Batticaloa,Pothuvil,Eastern,6999,8857,15856,279960,354280,634240
6/13/2024,Tharushi Jayasuriya,Batticaloa,Pothuvil,Eastern,6978,5699,12677,279120,227960,507080
6/14/2024,Tharushi Jayasuriya,Batticaloa,Pothuvil,Eastern,4769,5365,10134,190760,214600,405360
6/15/2024,Tharushi Jayasuriya,Batticaloa,Pothuvil,Eastern,2542,2817,5359,101680,112680,214360
6/16/2024,Tharushi Jayasuriya,Batticaloa,Pothuvil,Eastern,649,1334,1983,25960,53360,79320
6/17/2024,Tharushi Jayasuriya,Batticaloa,Pothuvil,Eastern,4659,1388,6047,186360,55520,241880
6/18/2024,Tharushi Jayasuriya,Batticaloa,Pothuvil,Eastern,8244,9673,17917,329760,386920,716680
6/19/2024,Tharushi Jayasuriya,Batticaloa,Pothuvil,Eastern,9552,7927,17479,382080,317080,699160
6/20/2024,Tharushi Jayasuriya,Batticaloa,Pothuvil,Eastern,1199,8948,10147,47960,357920,405880
6/21/2024,Tharushi Jayasuriya,Batticaloa,Pothuvil,Eastern,4696,8306,13002,187840,332240,520080
6/22/2024,Tharushi Jayasuriya,Batticaloa,Pothuvil,Eastern,1101,9012,10113,44040,360480,404520
6/23/2024,Tharushi Jayasuriya,Batticaloa,Pothuvil,Eastern,1017,1735,2752,40680,69400,110080
6/24/2024,Tharushi Jayasuriya,Batticaloa,Pothuvil,Eastern,7645,3515,11160,305800,140600,446400
6/25/2024,Tharushi Jayasuriya,Batticaloa,Pothuvil,Eastern,241,4623,4864,9640,184920,194560
6/26/2024,Tharushi Jayasuriya,Batticaloa,Pothuvil,Eastern,3103,4575,7678,124120,183000,307120
6/27/2024,Tharushi Jayasuriya,Batticaloa,Pothuvil,Eastern,9371,7120,16491,374840,284800,659640
6/28/2024,Tharushi Jayasuriya,Batticaloa,Pothuvil,Eastern,8484,5384,13868,339360,215360,554720
6/29/2024,Tharushi Jayasuriya,Batticaloa,Pothuvil,Eastern,6813,4122,10935,272520,164880,437400
6/30/2024,Tharushi Jayasuriya,Batticaloa,Pothuvil,Eastern,307,9656,9963,12280,386240,398520
7/1/2024,Tharushi Jayasuriya,Batticaloa,Pothuvil,Eastern,2122,8157,10279,84880,326280,411160
7/2/2024,Tharushi Jayasuriya,Batticaloa,Pothuvil,Eastern,5803,1497,7300,232120,59880,292000
7/3/2024,Tharushi Jayasuriya,Batticaloa,Pothuvil,Eastern,2606,9641,12247,104240,385640,489880
7/4/2024,Tharushi Jayasuriya,Batticaloa,Pothuvil,Eastern,8574,4256,12830,342960,170240,513200
7/5/2024,Tharushi Jayasuriya,Batticaloa,Pothuvil,Eastern,9374,449,9823,374960,17960,392920
7/6/2024,Tharushi Jayasuriya,Batticaloa,Pothuvil,Eastern,4625,1561,6186,185000,62440,247440
7/7/2024,Tharushi Jayasuriya,Batticaloa,Pothuvil,Eastern,3629,4060,7689,145160,162400,307560
7/8/2024,Tharushi Jayasuriya,Batticaloa,Pothuvil,Eastern,6225,2646,8871,249000,105840,354840
7/9/2024,Tharushi Jayasuriya,Batticaloa,Pothuvil,Eastern,9169,3843,13012,366760,153720,520480
7/10/2024,Tharushi Jayasuriya,Batticaloa,Pothuvil,Eastern,7188,522,7710,287520,20880,308400
7/11/2024,Tharushi Jayasuriya,Batticaloa,Pothuvil,Eastern,314,9903,10217,12560,396120,408680
7/12/2024,Tharushi Jayasuriya,Batticaloa,Pothuvil,Eastern,843,8372,9215,33720,334880,368600
7/13/2024,Tharushi Jayasuriya,Batticaloa,Pothuvil,Eastern,6808,7493,14301,272320,299720,572040
7/14/2024,Tharushi Jayasuriya,Batticaloa,Pothuvil,Eastern,1552,5981,7533,62080,239240,301320
7/15/2024,Tharushi Jayasuriya,Batticaloa,Pothuvil,Eastern,5138,6308,11446,205520,252320,457840
7/16/2024,Tharushi Jayasuriya,Batticaloa,Pothuvil,Eastern,2810,6317,9127,112400,252680,365080
7/17/2024,Tharushi Jayasuriya,Batticaloa,Pothuvil,Eastern,5219,5292,10511,208760,211680,420440
7/18/2024,Tharushi Jayasuriya,Batticaloa,Pothuvil,Eastern,6551,8984,15535,262040,359360,621400
7/19/2024,Tharushi Jayasuriya,Batticaloa,Pothuvil,Eastern,3383,7295,10678,135320,291800,427120
7/20/2024,Tharushi Jayasuriya,Batticaloa,Pothuvil,Eastern,8918,4550,13468,356720,182000,538720
7/21/2024,Tharushi Jayasuriya,Batticaloa,Pothuvil,Eastern,9299,6572,15871,371960,262880,634840
7/22/2024,Tharushi Jayasuriya,Batticaloa,Pothuvil,Eastern,6248,106,6354,249920,4240,254160
7/23/2024,Tharushi Jayasuriya,Batticaloa,Pothuvil,Eastern,5514,4786,10300,220560,191440,412000
7/24/2024,Tharushi Jayasuriya,Batticaloa,Pothuvil,Eastern,6568,6432,13000,262720,257280,520000
7/25/2024,Tharushi Jayasuriya,Batticaloa,Pothuvil,Eastern,912,9850,10762,36480,394000,430480
7/26/2024,Tharushi Jayasuriya,Batticaloa,Pothuvil,Eastern,8324,9352,17676,332960,374080,707040
7/27/2024,Tharushi Jayasuriya,Batticaloa,Pothuvil,Eastern,8359,8388,16747,334360,335520,669880
7/28/2024,Tharushi Jayasuriya,Batticaloa,Pothuvil,Eastern,8774,1759,10533,350960,70360,421320
7/29/2024,Tharushi Jayasuriya,Batticaloa,Pothuvil,Eastern,9330,6944,16274,373200,277760,650960
7/30/2024,Tharushi Jayasuriya,Batticaloa,Pothuvil,Eastern,8295,4902,13197,331800,196080,527880
7/31/2024,Tharushi Jayasuriya,Batticaloa,Pothuvil,Eastern,5749,5941,11690,229960,237640,467600
8/1/2024,Tharushi Jayasuriya,Batticaloa,Pothuvil,Eastern,1272,3478,4750,50880,139120,190000
8/2/2024,Tharushi Jayasuriya,Batticaloa,Pothuvil,Eastern,8151,7503,15654,326040,300120,626160
8/3/2024,Tharushi Jayasuriya,Batticaloa,Pothuvil,Eastern,4111,8940,13051,164440,357600,522040
8/4/2024,Tharushi Jayasuriya,Batticaloa,Pothuvil,Eastern,1347,1790,3137,53880,71600,125480
8/5/2024,Tharushi Jayasuriya,Batticaloa,Pothuvil,Eastern,9850,9659,19509,394000,386360,780360
8/6/2024,Tharushi Jayasuriya,Batticaloa,Pothuvil,Eastern,9434,7460,16894,377360,298400,675760
8/7/2024,Tharushi Jayasuriya,Batticaloa,Pothuvil,Eastern,3361,4038,7399,134440,161520,295960
8/8/2024,Tharushi Jayasuriya,Batticaloa,Pothuvil,Eastern,1014,6141,7155,40560,245640,286200
8/9/2024,Tharushi Jayasuriya,Batticaloa,Pothuvil,Eastern,6629,6990,13619,265160,279600,544760
8/10/2024,Tharushi Jayasuriya,Batticaloa,Pothuvil,Eastern,2239,1404,3643,89560,56160,145720
8/11/2024,Tharushi Jayasuriya,Batticaloa,Pothuvil,Eastern,8910,9421,18331,356400,376840,733240
8/12/2024,Tharushi Jayasuriya,Batticaloa,Pothuvil,Eastern,3428,4166,7594,137120,166640,303760
8/13/2024,Tharushi Jayasuriya,Batticaloa,Pothuvil,Eastern,9232,7993,17225,369280,319720,689000
8/14/2024,Tharushi Jayasuriya,Batticaloa,Pothuvil,Eastern,9527,2344,11871,381080,93760,474840
8/15/2024,Tharushi Jayasuriya,Batticaloa,Pothuvil,Eastern,8513,9461,17974,340520,378440,718960
8/16/2024,Tharushi Jayasuriya,Batticaloa,Pothuvil,Eastern,6453,4991,11444,258120,199640,457760
8/17/2024,Tharushi Jayasuriya,Batticaloa,Pothuvil,Eastern,8474,6118,14592,338960,244720,583680
8/18/2024,Tharushi Jayasuriya,Batticaloa,Pothuvil,Eastern,6406,560,6966,256240,22400,278640
8/19/2024,Tharushi Jayasuriya,Batticaloa,Pothuvil,Eastern,3582,9462,13044,143280,378480,521760
8/20/2024,Tharushi Jayasuriya,Batticaloa,Pothuvil,Eastern,3544,9732,13276,141760,389280,531040
8/21/2024,Tharushi Jayasuriya,Batticaloa,Pothuvil,Eastern,1611,1474,3085,64440,58960,123400
8/22/2024,Tharushi Jayasuriya,Batticaloa,Pothuvil,Eastern,3450,5246,8696,138000,209840,347840
8/23/2024,Tharushi Jayasuriya,Batticaloa,Pothuvil,Eastern,2864,456,3320,114560,18240,132800
8/24/2024,Tharushi Jayasuriya,Batticaloa,Pothuvil,Eastern,6516,1199,7715,260640,47960,308600
8/25/2024,Tharushi Jayasuriya,Batticaloa,Pothuvil,Eastern,4949,975,5924,197960,39000,236960
8/26/2024,Tharushi Jayasuriya,Batticaloa,Pothuvil,Eastern,7188,5074,12262,287520,202960,490480
8/27/2024,Tharushi Jayasuriya,Batticaloa,Pothuvil,Eastern,6652,8049,14701,266080,321960,588040
8/28/2024,Tharushi Jayasuriya,Batticaloa,Pothuvil,Eastern,1885,8447,10332,75400,337880,413280
8/29/2024,Tharushi Jayasuriya,Batticaloa,Pothuvil,Eastern,5703,1898,7601,228120,75920,304040
8/30/2024,Tharushi Jayasuriya,Batticaloa,Pothuvil,Eastern,7483,2234,9717,299320,89360,388680
8/31/2024,Tharushi Jayasuriya,Batticaloa,Pothuvil,Eastern,6122,6589,12711,244880,263560,508440
9/1/2024,Tharushi Jayasuriya,Batticaloa,Pothuvil,Eastern,7617,7238,14855,304680,289520,594200
9/2/2024,Tharushi Jayasuriya,Batticaloa,Pothuvil,Eastern,1715,4055,5770,68600,162200,230800
9/3/2024,Tharushi Jayasuriya,Batticaloa,Pothuvil,Eastern,7326,9772,17098,293040,390880,683920
9/4/2024,Tharushi Jayasuriya,Batticaloa,Pothuvil,Eastern,1,4100,4101,40,164000,164040
9/5/2024,Tharushi Jayasuriya,Batticaloa,Pothuvil,Eastern,6280,2941,9221,251200,117640,368840
9/6/2024,Tharushi Jayasuriya,Batticaloa,Pothuvil,Eastern,5129,5081,10210,205160,203240,408400
9/7/2024,Tharushi Jayasuriya,Batticaloa,Pothuvil,Eastern,742,4443,5185,29680,177720,207400
9/8/2024,Tharushi Jayasuriya,Batticaloa,Pothuvil,Eastern,1098,515,1613,43920,20600,64520
9/9/2024,Tharushi Jayasuriya,Batticaloa,Pothuvil,Eastern,9688,9752,19440,387520,390080,777600
9/10/2024,Tharushi Jayasuriya,Batticaloa,Pothuvil,Eastern,6391,7257,13648,255640,290280,545920
9/11/2024,Tharushi Jayasuriya,Batticaloa,Pothuvil,Eastern,9456,4906,14362,378240,196240,574480
9/12/2024,Tharushi Jayasuriya,Batticaloa,Pothuvil,Eastern,4426,4769,9195,177040,190760,367800
9/13/2024,Tharushi Jayasuriya,Batticaloa,Pothuvil,Eastern,1769,3913,5682,70760,156520,227280
9/14/2024,Tharushi Jayasuriya,Batticaloa,Pothuvil,Eastern,9848,8773,18621,393920,350920,744840
9/15/2024,Tharushi Jayasuriya,Batticaloa,Pothuvil,Eastern,9819,1890,11709,392760,75600,468360
9/16/2024,Tharushi Jayasuriya,Batticaloa,Pothuvil,Eastern,9346,2508,11854,373840,100320,474160
9/17/2024,Tharushi Jayasuriya,Batticaloa,Pothuvil,Eastern,1025,3053,4078,41000,122120,163120
9/18/2024,Tharushi Jayasuriya,Batticaloa,Pothuvil,Eastern,6332,8995,15327,253280,359800,613080
9/19/2024,Tharushi Jayasuriya,Batticaloa,Pothuvil,Eastern,5548,8161,13709,221920,326440,548360
9/20/2024,Tharushi Jayasuriya,Batticaloa,Pothuvil,Eastern,627,1491,2118,25080,59640,84720
9/21/2024,Tharushi Jayasuriya,Batticaloa,Pothuvil,Eastern,1665,3127,4792,66600,125080,191680
9/22/2024,Tharushi Jayasuriya,Batticaloa,Pothuvil,Eastern,5347,6775,12122,213880,271000,484880
9/23/2024,Tharushi Jayasuriya,Batticaloa,Pothuvil,Eastern,3420,6981,10401,136800,279240,416040
9/24/2024,Tharushi Jayasuriya,Batticaloa,Pothuvil,Eastern,9795,4901,14696,391800,196040,587840
9/25/2024,Tharushi Jayasuriya,Batticaloa,Pothuvil,Eastern,5042,2272,7314,201680,90880,292560
9/26/2024,Tharushi Jayasuriya,Batticaloa,Pothuvil,Eastern,4277,3464,7741,171080,138560,309640
9/27/2024,Tharushi Jayasuriya,Batticaloa,Pothuvil,Eastern,7388,4570,11958,295520,182800,478320
9/28/2024,Tharushi Jayasuriya,Batticaloa,Pothuvil,Eastern,8375,227,8602,335000,9080,344080
9/29/2024,Tharushi Jayasuriya,Batticaloa,Pothuvil,Eastern,1247,4084,5331,49880,163360,213240
9/30/2024,Tharushi Jayasuriya,Batticaloa,Pothuvil,Eastern,2345,4780,7125,93800,191200,285000
10/1/2024,Tharushi Jayasuriya,Batticaloa,Pothuvil,Eastern,551,6553,7104,22040,262120,284160
10/2/2024,Tharushi Jayasuriya,Batticaloa,Pothuvil,Eastern,4815,2569,7384,192600,102760,295360
10/3/2024,Tharushi Jayasuriya,Batticaloa,Pothuvil,Eastern,191,6317,6508,7640,252680,260320
10/4/2024,Tharushi Jayasuriya,Batticaloa,Pothuvil,Eastern,8940,1917,10857,357600,76680,434280
10/5/2024,Tharushi Jayasuriya,Batticaloa,Pothuvil,Eastern,4932,5597,10529,197280,223880,421160
10/6/2024,Tharushi Jayasuriya,Batticaloa,Pothuvil,Eastern,1884,6554,8438,75360,262160,337520
10/7/2024,Tharushi Jayasuriya,Batticaloa,Pothuvil,Eastern,4834,7865,12699,193360,314600,507960
10/8/2024,Tharushi Jayasuriya,Batticaloa,Pothuvil,Eastern,2697,6034,8731,107880,241360,349240
10/9/2024,Tharushi Jayasuriya,Batticaloa,Pothuvil,Eastern,7293,9085,16378,291720,363400,655120
10/10/2024,Tharushi Jayasuriya,Batticaloa,Pothuvil,Eastern,2419,259,2678,96760,10360,107120
10/11/2024,Tharushi Jayasuriya,Batticaloa,Pothuvil,Eastern,4111,3513,7624,164440,140520,304960
10/12/2024,Tharushi Jayasuriya,Batticaloa,Pothuvil,Eastern,1997,2919,4916,79880,116760,196640
10/13/2024,Tharushi Jayasuriya,Batticaloa,Pothuvil,Eastern,8163,2519,10682,326520,100760,427280
10/14/2024,Tharushi Jayasuriya,Batticaloa,Pothuvil,Eastern,3191,4478,7669,127640,179120,306760
10/15/2024,Tharushi Jayasuriya,Batticaloa,Pothuvil,Eastern,2844,5285,8129,113760,211400,325160
10/16/2024,Tharushi Jayasuriya,Batticaloa,Pothuvil,Eastern,946,4347,5293,37840,173880,211720
10/17/2024,Tharushi Jayasuriya,Batticaloa,Pothuvil,Eastern,54,3764,3818,2160,150560,152720
10/18/2024,Tharushi Jayasuriya,Batticaloa,Pothuvil,Eastern,2594,3021,5615,103760,120840,224600
10/19/2024,Tharushi Jayasuriya,Batticaloa,Pothuvil,Eastern,7834,6189,14023,313360,247560,560920
10/20/2024,Tharushi Jayasuriya,Batticaloa,Pothuvil,Eastern,9048,257,9305,361920,10280,372200
10/21/2024,Tharushi Jayasuriya,Batticaloa,Pothuvil,Eastern,7840,4248,12088,313600,169920,483520
10/22/2024,Tharushi Jayasuriya,Batticaloa,Pothuvil,Eastern,4173,6896,11069,166920,275840,442760
10/23/2024,Tharushi Jayasuriya,Batticaloa,Pothuvil,Eastern,4723,5978,10701,188920,239120,428040
10/24/2024,Tharushi Jayasuriya,Batticaloa,Pothuvil,Eastern,6153,3610,9763,246120,144400,390520
10/25/2024,Tharushi Jayasuriya,Batticaloa,Pothuvil,Eastern,8707,1836,10543,348280,73440,421720
10/26/2024,Tharushi Jayasuriya,Batticaloa,Pothuvil,Eastern,2756,1103,3859,110240,44120,154360
10/27/2024,Tharushi Jayasuriya,Batticaloa,Pothuvil,Eastern,651,4952,5603,26040,198080,224120
10/28/2024,Tharushi Jayasuriya,Batticaloa,Pothuvil,Eastern,8154,3662,11816,326160,146480,472640
10/29/2024,Tharushi Jayasuriya,Batticaloa,Pothuvil,Eastern,4243,500,4743,169720,20000,189720
10/30/2024,Tharushi Jayasuriya,Batticaloa,Pothuvil,Eastern,1378,7585,8963,55120,303400,358520
10/31/2024,Tharushi Jayasuriya,Batticaloa,Pothuvil,Eastern,9396,7874,17270,375840,314960,690800
11/1/2024,Tharushi Jayasuriya,Batticaloa,Pothuvil,Eastern,9189,6320,15509,367560,252800,620360
11/2/2024,Tharushi Jayasuriya,Batticaloa,Pothuvil,Eastern,1017,9903,10920,40680,396120,436800
11/3/2024,Tharushi Jayasuriya,Batticaloa,Pothuvil,Eastern,8748,8399,17147,349920,335960,685880
11/4/2024,Tharushi Jayasuriya,Batticaloa,Pothuvil,Eastern,6277,3848,10125,251080,153920,405000
11/5/2024,Tharushi Jayasuriya,Batticaloa,Pothuvil,Eastern,8876,5324,14200,355040,212960,568000
11/6/2024,Tharushi Jayasuriya,Batticaloa,Pothuvil,Eastern,9284,792,10076,371360,31680,403040
11/7/2024,Tharushi Jayasuriya,Batticaloa,Pothuvil,Eastern,2093,9731,11824,83720,389240,472960
11/8/2024,Tharushi Jayasuriya,Batticaloa,Pothuvil,Eastern,4657,3579,8236,186280,143160,329440
11/9/2024,Tharushi Jayasuriya,Batticaloa,Pothuvil,Eastern,679,8042,8721,27160,321680,348840
11/10/2024,Tharushi Jayasuriya,Batticaloa,Pothuvil,Eastern,8278,7970,16248,331120,318800,649920
11/11/2024,Tharushi Jayasuriya,Batticaloa,Pothuvil,Eastern,9996,5031,15027,399840,201240,601080
11/12/2024,Tharushi Jayasuriya,Batticaloa,Pothuvil,Eastern,511,604,1115,20440,24160,44600
11/13/2024,Tharushi Jayasuriya,Batticaloa,Pothuvil,Eastern,6126,4764,10890,245040,190560,435600
11/14/2024,Tharushi Jayasuriya,Batticaloa,Pothuvil,Eastern,7929,8885,16814,317160,355400,672560
11/15/2024,Tharushi Jayasuriya,Batticaloa,Pothuvil,Eastern,1042,528,1570,41680,21120,62800
11/16/2024,Tharushi Jayasuriya,Batticaloa,Pothuvil,Eastern,9459,1890,11349,378360,75600,453960
11/17/2024,Tharushi Jayasuriya,Batticaloa,Pothuvil,Eastern,9556,9840,19396,382240,393600,775840
11/18/2024,Tharushi Jayasuriya,Batticaloa,Pothuvil,Eastern,9706,310,10016,388240,12400,400640
11/19/2024,Tharushi Jayasuriya,Batticaloa,Pothuvil,Eastern,4163,2012,6175,166520,80480,247000
11/20/2024,Tharushi Jayasuriya,Batticaloa,Pothuvil,Eastern,2,885,887,80,35400,35480
11/21/2024,Tharushi Jayasuriya,Batticaloa,Pothuvil,Eastern,6153,8952,15105,246120,358080,604200
11/22/2024,Tharushi Jayasuriya,Batticaloa,Pothuvil,Eastern,2765,671,3436,110600,26840,137440
11/23/2024,Tharushi Jayasuriya,Batticaloa,Pothuvil,Eastern,5822,3147,8969,232880,125880,358760
11/24/2024,Tharushi Jayasuriya,Batticaloa,Pothuvil,Eastern,4970,1314,6284,198800,52560,251360
11/25/2024,Tharushi Jayasuriya,Batticaloa,Pothuvil,Eastern,7007,3806,10813,280280,152240,432520
11/26/2024,Tharushi Jayasuriya,Batticaloa,Pothuvil,Eastern,8906,519,9425,356240,20760,377000
11/27/2024,Tharushi Jayasuriya,Batticaloa,Pothuvil,Eastern,9828,9118,18946,393120,364720,757840
11/28/2024,Tharushi Jayasuriya,Batticaloa,Pothuvil,Eastern,2680,1360,4040,107200,54400,161600
11/29/2024,Tharushi Jayasuriya,Batticaloa,Pothuvil,Eastern,9659,9313,18972,386360,372520,758880
11/30/2024,Tharushi Jayasuriya,Batticaloa,Pothuvil,Eastern,7824,1114,8938,312960,44560,357520
12/1/2024,Tharushi Jayasuriya,Batticaloa,Pothuvil,Eastern,4274,1740,6014,170960,69600,240560
12/2/2024,Tharushi Jayasuriya,Batticaloa,Pothuvil,Eastern,8032,8597,16629,321280,343880,665160
12/3/2024,Tharushi Jayasuriya,Batticaloa,Pothuvil,Eastern,3179,5216,8395,127160,208640,335800
12/4/2024,Tharushi Jayasuriya,Batticaloa,Pothuvil,Eastern,9714,5959,15673,388560,238360,626920
12/5/2024,Tharushi Jayasuriya,Batticaloa,Pothuvil,Eastern,6171,3770,9941,246840,150800,397640
12/6/2024,Tharushi Jayasuriya,Batticaloa,Pothuvil,Eastern,4953,6522,11475,198120,260880,459000
12/7/2024,Tharushi Jayasuriya,Batticaloa,Pothuvil,Eastern,4263,1941,6204,170520,77640,248160
12/8/2024,Tharushi Jayasuriya,Batticaloa,Pothuvil,Eastern,5433,8068,13501,217320,322720,540040
12/9/2024,Tharushi Jayasuriya,Batticaloa,Pothuvil,Eastern,644,9661,10305,25760,386440,412200
12/10/2024,Tharushi Jayasuriya,Batticaloa,Pothuvil,Eastern,8444,8975,17419,337760,359000,696760
12/11/2024,Tharushi Jayasuriya,Batticaloa,Pothuvil,Eastern,8552,8519,17071,342080,340760,682840
12/12/2024,Tharushi Jayasuriya,Batticaloa,Pothuvil,Eastern,8408,3281,11689,336320,131240,467560
12/13/2024,Tharushi Jayasuriya,Batticaloa,Pothuvil,Eastern,4200,2586,6786,168000,103440,271440
12/14/2024,Tharushi Jayasuriya,Batticaloa,Pothuvil,Eastern,9861,5616,15477,394440,224640,619080
12/15/2024,Tharushi Jayasuriya,Batticaloa,Pothuvil,Eastern,4538,7227,11765,181520,289080,470600
12/16/2024,Tharushi Jayasuriya,Batticaloa,Pothuvil,Eastern,9590,8944,18534,383600,357760,741360
12/17/2024,Tharushi Jayasuriya,Batticaloa,Pothuvil,Eastern,1211,666,1877,48440,26640,75080
12/18/2024,Tharushi Jayasuriya,Batticaloa,Pothuvil,Eastern,4248,4560,8808,169920,182400,352320
12/19/2024,Tharushi Jayasuriya,Batticaloa,Pothuvil,Eastern,524,2321,2845,20960,92840,113800
12/20/2024,Tharushi Jayasuriya,Batticaloa,Pothuvil,Eastern,9128,4529,13657,365120,181160,546280
12/21/2024,Tharushi Jayasuriya,Batticaloa,Pothuvil,Eastern,6256,6884,13140,250240,275360,525600
12/22/2024,Tharushi Jayasuriya,Batticaloa,Pothuvil,Eastern,6148,631,6779,245920,25240,271160
12/23/2024,Tharushi Jayasuriya,Batticaloa,Pothuvil,Eastern,3920,282,4202,156800,11280,168080
12/24/2024,Tharushi Jayasuriya,Batticaloa,Pothuvil,Eastern,9216,3305,12521,368640,132200,500840
12/25/2024,Tharushi Jayasuriya,Batticaloa,Pothuvil,Eastern,9461,9200,18661,378440,368000,746440
12/26/2024,Tharushi Jayasuriya,Batticaloa,Pothuvil,Eastern,1966,5687,7653,78640,227480,306120
12/27/2024,Tharushi Jayasuriya,Batticaloa,Pothuvil,Eastern,5614,4092,9706,224560,163680,388240
12/28/2024,Tharushi Jayasuriya,Batticaloa,Pothuvil,Eastern,9706,6683,16389,388240,267320,655560
12/29/2024,Tharushi Jayasuriya,Batticaloa,Pothuvil,Eastern,8830,200,9030,353200,8000,361200
12/30/2024,Tharushi Jayasuriya,Batticaloa,Pothuvil,Eastern,517,9338,9855,20680,373520,394200
12/31/2024,Tharushi Jayasuriya,Batticaloa,Pothuvil,Eastern,1683,702,2385,67320,28080,95400
1/1/2025,Tharushi Jayasuriya,Batticaloa,Pothuvil,Eastern,8858,5982,14840,354320,239280,593600
1/2/2025,Tharushi Jayasuriya,Batticaloa,Pothuvil,Eastern,4661,9009,13670,186440,360360,546800
1/3/2025,Tharushi Jayasuriya,Batticaloa,Pothuvil,Eastern,6460,2804,9264,258400,112160,370560
1/4/2025,Tharushi Jayasuriya,Batticaloa,Pothuvil,Eastern,3340,8193,11533,133600,327720,461320
1/5/2025,Tharushi Jayasuriya,Batticaloa,Pothuvil,Eastern,5509,7579,13088,220360,303160,523520
1/6/2025,Tharushi Jayasuriya,Batticaloa,Pothuvil,Eastern,1434,4898,6332,57360,195920,253280
1/7/2025,Tharushi Jayasuriya,Batticaloa,Pothuvil,Eastern,8470,9538,18008,338800,381520,720320
1/8/2025,Tharushi Jayasuriya,Batticaloa,Pothuvil,Eastern,3106,787,3893,124240,31480,155720
1/9/2025,Tharushi Jayasuriya,Batticaloa,Pothuvil,Eastern,5826,1354,7180,233040,54160,287200
1/10/2025,Tharushi Jayasuriya,Batticaloa,Pothuvil,Eastern,7237,3050,10287,289480,122000,411480
1/11/2025,Tharushi Jayasuriya,Batticaloa,Pothuvil,Eastern,2796,2918,5714,111840,116720,228560
1/12/2025,Tharushi Jayasuriya,Batticaloa,Pothuvil,Eastern,538,9051,9589,21520,362040,383560
1/13/2025,Tharushi Jayasuriya,Batticaloa,Pothuvil,Eastern,1312,9806,11118,52480,392240,444720
1/14/2025,Tharushi Jayasuriya,Batticaloa,Pothuvil,Eastern,6718,3498,10216,268720,139920,408640
1/15/2025,Tharushi Jayasuriya,Batticaloa,Pothuvil,Eastern,4239,6637,10876,169560,265480,435040
1/16/2025,Tharushi Jayasuriya,Batticaloa,Pothuvil,Eastern,7672,8161,15833,306880,326440,633320
1/17/2025,Tharushi Jayasuriya,Batticaloa,Pothuvil,Eastern,3193,1597,4790,127720,63880,191600
1/18/2025,Tharushi Jayasuriya,Batticaloa,Pothuvil,Eastern,7492,6050,13542,299680,242000,541680
1/19/2025,Tharushi Jayasuriya,Batticaloa,Pothuvil,Eastern,5999,8976,14975,239960,359040,599000
1/20/2025,Tharushi Jayasuriya,Batticaloa,Pothuvil,Eastern,5403,8197,13600,216120,327880,544000
1/21/2025,Tharushi Jayasuriya,Batticaloa,Pothuvil,Eastern,8328,1300,9628,333120,52000,385120
1/22/2025,Tharushi Jayasuriya,Batticaloa,Pothuvil,Eastern,8078,4875,12953,323120,195000,518120
1/23/2025,Tharushi Jayasuriya,Batticaloa,Pothuvil,Eastern,4326,9744,14070,173040,389760,562800
1/24/2025,Tharushi Jayasuriya,Batticaloa,Pothuvil,Eastern,8382,3472,11854,335280,138880,474160
1/25/2025,Tharushi Jayasuriya,Batticaloa,Pothuvil,Eastern,7935,4708,12643,317400,188320,505720
1/26/2025,Tharushi Jayasuriya,Batticaloa,Pothuvil,Eastern,8390,1903,10293,335600,76120,411720
1/27/2025,Tharushi Jayasuriya,Batticaloa,Pothuvil,Eastern,6105,6328,12433,244200,253120,497320
1/28/2025,Tharushi Jayasuriya,Batticaloa,Pothuvil,Eastern,8986,5777,14763,359440,231080,590520
1/29/2025,Tharushi Jayasuriya,Batticaloa,Pothuvil,Eastern,1019,9690,10709,40760,387600,428360
1/30/2025,Tharushi Jayasuriya,Batticaloa,Pothuvil,Eastern,5341,7698,13039,213640,307920,521560
1/31/2025,Tharushi Jayasuriya,Batticaloa,Pothuvil,Eastern,4692,6573,11265,187680,262920,450600
2/1/2025,Tharushi Jayasuriya,Batticaloa,Pothuvil,Eastern,2445,3290,5735,97800,131600,229400
2/2/2025,Tharushi Jayasuriya,Batticaloa,Pothuvil,Eastern,3350,4634,7984,134000,185360,319360
2/3/2025,Tharushi Jayasuriya,Batticaloa,Pothuvil,Eastern,6124,4054,10178,244960,162160,407120
2/4/2025,Tharushi Jayasuriya,Batticaloa,Pothuvil,Eastern,3787,5384,9171,151480,215360,366840
2/5/2025,Tharushi Jayasuriya,Batticaloa,Pothuvil,Eastern,2432,2999,5431,97280,119960,217240
2/6/2025,Tharushi Jayasuriya,Batticaloa,Pothuvil,Eastern,8322,5619,13941,332880,224760,557640
2/7/2025,Tharushi Jayasuriya,Batticaloa,Pothuvil,Eastern,6314,3171,9485,252560,126840,379400
2/8/2025,Tharushi Jayasuriya,Batticaloa,Pothuvil,Eastern,7834,872,8706,313360,34880,348240
2/9/2025,Tharushi Jayasuriya,Batticaloa,Pothuvil,Eastern,570,2026,2596,22800,81040,103840
2/10/2025,Tharushi Jayasuriya,Batticaloa,Pothuvil,Eastern,8623,430,9053,344920,17200,362120
2/11/2025,Tharushi Jayasuriya,Batticaloa,Pothuvil,Eastern,6000,4766,10766,240000,190640,430640
2/12/2025,Tharushi Jayasuriya,Batticaloa,Pothuvil,Eastern,1954,2726,4680,78160,109040,187200
2/13/2025,Tharushi Jayasuriya,Batticaloa,Pothuvil,Eastern,7023,8936,15959,280920,357440,638360
2/14/2025,Tharushi Jayasuriya,Batticaloa,Pothuvil,Eastern,8358,3980,12338,334320,159200,493520
2/15/2025,Tharushi Jayasuriya,Batticaloa,Pothuvil,Eastern,2993,8169,11162,119720,326760,446480
2/16/2025,Tharushi Jayasuriya,Batticaloa,Pothuvil,Eastern,5031,6564,11595,201240,262560,463800
2/17/2025,Tharushi Jayasuriya,Batticaloa,Pothuvil,Eastern,5118,8091,13209,204720,323640,528360
2/18/2025,Tharushi Jayasuriya,Batticaloa,Pothuvil,Eastern,6007,278,6285,240280,11120,251400
2/19/2025,Tharushi Jayasuriya,Batticaloa,Pothuvil,Eastern,6592,4275,10867,263680,171000,434680
2/20/2025,Tharushi Jayasuriya,Batticaloa,Pothuvil,Eastern,4664,7599,12263,186560,303960,490520
2/21/2025,Tharushi Jayasuriya,Batticaloa,Pothuvil,Eastern,7441,8792,16233,297640,351680,649320
2/22/2025,Tharushi Jayasuriya,Batticaloa,Pothuvil,Eastern,3354,7700,11054,134160,308000,442160
2/23/2025,Tharushi Jayasuriya,Batticaloa,Pothuvil,Eastern,8305,5699,14004,332200,227960,560160
2/24/2025,Tharushi Jayasuriya,Batticaloa,Pothuvil,Eastern,3439,6946,10385,137560,277840,415400
2/25/2025,Tharushi Jayasuriya,Batticaloa,Pothuvil,Eastern,6446,5020,11466,257840,200800,458640
2/26/2025,Tharushi Jayasuriya,Batticaloa,Pothuvil,Eastern,1195,4048,5243,47800,161920,209720
2/27/2025,Tharushi Jayasuriya,Batticaloa,Pothuvil,Eastern,5040,1844,6884,201600,73760,275360
2/28/2025,Tharushi Jayasuriya,Batticaloa,Pothuvil,Eastern,7405,4170,11575,296200,166800,463000
3/1/2025,Tharushi Jayasuriya,Batticaloa,Pothuvil,Eastern,9698,9541,19239,387920,381640,769560
3/2/2025,Tharushi Jayasuriya,Batticaloa,Pothuvil,Eastern,8422,1797,10219,336880,71880,408760
3/3/2025,Tharushi Jayasuriya,Batticaloa,Pothuvil,Eastern,9987,608,10595,399480,24320,423800
3/4/2025,Tharushi Jayasuriya,Batticaloa,Pothuvil,Eastern,5978,1968,7946,239120,78720,317840
3/5/2025,Tharushi Jayasuriya,Batticaloa,Pothuvil,Eastern,2730,718,3448,109200,28720,137920
3/6/2025,Tharushi Jayasuriya,Batticaloa,Pothuvil,Eastern,1512,8090,9602,60480,323600,384080
3/7/2025,Tharushi Jayasuriya,Batticaloa,Pothuvil,Eastern,227,1812,2039,9080,72480,81560
3/8/2025,Tharushi Jayasuriya,Batticaloa,Pothuvil,Eastern,221,9050,9271,8840,362000,370840
3/9/2025,Tharushi Jayasuriya,Batticaloa,Pothuvil,Eastern,2023,3843,5866,80920,153720,234640
3/10/2025,Tharushi Jayasuriya,Batticaloa,Pothuvil,Eastern,7949,1839,9788,317960,73560,391520
3/11/2025,Tharushi Jayasuriya,Batticaloa,Pothuvil,Eastern,5087,1727,6814,203480,69080,272560
3/12/2025,Tharushi Jayasuriya,Batticaloa,Pothuvil,Eastern,282,584,866,11280,23360,34640
3/13/2025,Tharushi Jayasuriya,Batticaloa,Pothuvil,Eastern,3808,8995,12803,152320,359800,512120
3/14/2025,Tharushi Jayasuriya,Batticaloa,Pothuvil,Eastern,320,1081,1401,12800,43240,56040
3/15/2025,Tharushi Jayasuriya,Batticaloa,Pothuvil,Eastern,3624,4435,8059,144960,177400,322360
3/16/2025,Tharushi Jayasuriya,Batticaloa,Pothuvil,Eastern,8130,6202,14332,325200,248080,573280
3/17/2025,Tharushi Jayasuriya,Batticaloa,Pothuvil,Eastern,9772,5089,14861,390880,203560,594440
3/18/2025,Tharushi Jayasuriya,Batticaloa,Pothuvil,Eastern,1966,8375,10341,78640,335000,413640
3/19/2025,Tharushi Jayasuriya,Batticaloa,Pothuvil,Eastern,2105,5007,7112,84200,200280,284480
3/20/2025,Tharushi Jayasuriya,Batticaloa,Pothuvil,Eastern,4946,385,5331,197840,15400,213240
3/21/2025,Tharushi Jayasuriya,Batticaloa,Pothuvil,Eastern,3454,4572,8026,138160,182880,321040
3/22/2025,Tharushi Jayasuriya,Batticaloa,Pothuvil,Eastern,1964,9672,11636,78560,386880,465440
3/23/2025,Tharushi Jayasuriya,Batticaloa,Pothuvil,Eastern,5737,549,6286,229480,21960,251440
3/25/2024,Sashini Karunarathna,Polonnaruwa,Minneriya,North Central,6889,633,7522,275560,25320,300880
3/26/2024,Sashini Karunarathna,Polonnaruwa,Minneriya,North Central,1825,7080,8905,73000,283200,356200
3/27/2024,Sashini Karunarathna,Polonnaruwa,Minneriya,North Central,5529,8364,13893,221160,334560,555720
3/28/2024,Sashini Karunarathna,Polonnaruwa,Minneriya,North Central,8714,9318,18032,348560,372720,721280
3/29/2024,Sashini Karunarathna,Polonnaruwa,Minneriya,North Central,7018,545,7563,280720,21800,302520
3/30/2024,Sashini Karunarathna,Polonnaruwa,Minneriya,North Central,6845,3751,10596,273800,150040,423840
3/31/2024,Sashini Karunarathna,Polonnaruwa,Minneriya,North Central,9579,121,9700,383160,4840,388000
4/1/2024,Sashini Karunarathna,Polonnaruwa,Minneriya,North Central,9798,38,9836,391920,1520,393440
4/2/2024,Sashini Karunarathna,Polonnaruwa,Minneriya,North Central,7782,1919,9701,311280,76760,388040
4/3/2024,Sashini Karunarathna,Polonnaruwa,Minneriya,North Central,7985,8618,16603,319400,344720,664120
4/4/2024,Sashini Karunarathna,Polonnaruwa,Minneriya,North Central,6161,7367,13528,246440,294680,541120
4/5/2024,Sashini Karunarathna,Polonnaruwa,Minneriya,North Central,4959,1826,6785,198360,73040,271400
4/6/2024,Sashini Karunarathna,Polonnaruwa,Minneriya,North Central,2713,4179,6892,108520,167160,275680
4/7/2024,Sashini Karunarathna,Polonnaruwa,Minneriya,North Central,6470,5737,12207,258800,229480,488280
4/8/2024,Sashini Karunarathna,Polonnaruwa,Minneriya,North Central,8627,576,9203,345080,23040,368120
4/9/2024,Sashini Karunarathna,Polonnaruwa,Minneriya,North Central,4505,8583,13088,180200,343320,523520
4/10/2024,Sashini Karunarathna,Polonnaruwa,Minneriya,North Central,5573,2433,8006,222920,97320,320240
4/11/2024,Sashini Karunarathna,Polonnaruwa,Minneriya,North Central,9603,8501,18104,384120,340040,724160
4/19/2024,Sashini Karunarathna,Polonnaruwa,Minneriya,North Central,4515,5555,10070,180600,222200,402800
4/20/2024,Sashini Karunarathna,Polonnaruwa,Minneriya,North Central,8285,6340,14625,331400,253600,585000
4/21/2024,Sashini Karunarathna,Polonnaruwa,Minneriya,North Central,5457,2741,8198,218280,109640,327920
4/22/2024,Sashini Karunarathna,Polonnaruwa,Minneriya,North Central,4025,480,4505,161000,19200,180200
4/23/2024,Sashini Karunarathna,Polonnaruwa,Minneriya,North Central,3041,2871,5912,121640,114840,236480
4/24/2024,Sashini Karunarathna,Polonnaruwa,Minneriya,North Central,3102,3621,6723,124080,144840,268920
4/25/2024,Sashini Karunarathna,Polonnaruwa,Minneriya,North Central,8631,450,9081,345240,18000,363240
4/26/2024,Sashini Karunarathna,Polonnaruwa,Minneriya,North Central,2960,4365,7325,118400,174600,293000
4/27/2024,Sashini Karunarathna,Polonnaruwa,Minneriya,North Central,8933,4511,13444,357320,180440,537760
4/28/2024,Sashini Karunarathna,Polonnaruwa,Minneriya,North Central,7224,6388,13612,288960,255520,544480
4/29/2024,Sashini Karunarathna,Polonnaruwa,Minneriya,North Central,353,3573,3926,14120,142920,157040
4/30/2024,Sashini Karunarathna,Polonnaruwa,Minneriya,North Central,8398,6039,14437,335920,241560,577480
5/1/2024,Sashini Karunarathna,Polonnaruwa,Minneriya,North Central,9336,8654,17990,373440,346160,719600
5/2/2024,Sashini Karunarathna,Polonnaruwa,Minneriya,North Central,8940,6297,15237,357600,251880,609480
5/3/2024,Sashini Karunarathna,Polonnaruwa,Minneriya,North Central,2070,9912,11982,82800,396480,479280
5/4/2024,Sashini Karunarathna,Polonnaruwa,Minneriya,North Central,8450,1836,10286,338000,73440,411440
5/5/2024,Sashini Karunarathna,Polonnaruwa,Minneriya,North Central,4687,4248,8935,187480,169920,357400
5/6/2024,Sashini Karunarathna,Polonnaruwa,Minneriya,North Central,8753,2503,11256,350120,100120,450240
5/7/2024,Sashini Karunarathna,Polonnaruwa,Minneriya,North Central,4945,4616,9561,197800,184640,382440
5/8/2024,Sashini Karunarathna,Polonnaruwa,Minneriya,North Central,4926,1390,6316,197040,55600,252640
5/9/2024,Sashini Karunarathna,Polonnaruwa,Minneriya,North Central,2169,2152,4321,86760,86080,172840
5/10/2024,Sashini Karunarathna,Polonnaruwa,Minneriya,North Central,8455,4905,13360,338200,196200,534400
5/11/2024,Sashini Karunarathna,Polonnaruwa,Minneriya,North Central,5052,9003,14055,202080,360120,562200
5/12/2024,Sashini Karunarathna,Polonnaruwa,Minneriya,North Central,6521,3846,10367,260840,153840,414680
5/13/2024,Sashini Karunarathna,Polonnaruwa,Minneriya,North Central,663,9821,10484,26520,392840,419360
5/14/2024,Sashini Karunarathna,Polonnaruwa,Minneriya,North Central,1796,4229,6025,71840,169160,241000
5/15/2024,Sashini Karunarathna,Polonnaruwa,Minneriya,North Central,1933,2872,4805,77320,114880,192200
5/16/2024,Sashini Karunarathna,Polonnaruwa,Minneriya,North Central,5433,1432,6865,217320,57280,274600
5/17/2024,Sashini Karunarathna,Polonnaruwa,Minneriya,North Central,4174,9591,13765,166960,383640,550600
5/18/2024,Sashini Karunarathna,Polonnaruwa,Minneriya,North Central,606,1773,2379,24240,70920,95160
5/19/2024,Sashini Karunarathna,Polonnaruwa,Minneriya,North Central,6371,2022,8393,254840,80880,335720
5/20/2024,Sashini Karunarathna,Polonnaruwa,Minneriya,North Central,1949,459,2408,77960,18360,96320
5/21/2024,Sashini Karunarathna,Polonnaruwa,Minneriya,North Central,8920,576,9496,356800,23040,379840
5/22/2024,Sashini Karunarathna,Polonnaruwa,Minneriya,North Central,9624,9021,18645,384960,360840,745800
5/24/2024,Sashini Karunarathna,Polonnaruwa,Minneriya,North Central,704,7088,7792,28160,283520,311680
5/25/2024,Sashini Karunarathna,Polonnaruwa,Minneriya,North Central,2861,776,3637,114440,31040,145480
5/26/2024,Sashini Karunarathna,Polonnaruwa,Minneriya,North Central,3018,4325,7343,120720,173000,293720
5/27/2024,Sashini Karunarathna,Polonnaruwa,Minneriya,North Central,9094,5088,14182,363760,203520,567280
5/28/2024,Sashini Karunarathna,Polonnaruwa,Minneriya,North Central,1810,8645,10455,72400,345800,418200
5/29/2024,Sashini Karunarathna,Polonnaruwa,Minneriya,North Central,288,8662,8950,11520,346480,358000
5/30/2024,Sashini Karunarathna,Polonnaruwa,Minneriya,North Central,9216,2341,11557,368640,93640,462280
5/31/2024,Sashini Karunarathna,Polonnaruwa,Minneriya,North Central,2216,1344,3560,88640,53760,142400
6/1/2024,Sashini Karunarathna,Polonnaruwa,Minneriya,North Central,3074,9278,12352,122960,371120,494080
6/2/2024,Sashini Karunarathna,Polonnaruwa,Minneriya,North Central,6641,7030,13671,265640,281200,546840
6/3/2024,Sashini Karunarathna,Polonnaruwa,Minneriya,North Central,2958,1205,4163,118320,48200,166520
6/4/2024,Sashini Karunarathna,Polonnaruwa,Minneriya,North Central,5047,5634,10681,201880,225360,427240
6/5/2024,Sashini Karunarathna,Polonnaruwa,Minneriya,North Central,6601,7527,14128,264040,301080,565120
6/6/2024,Sashini Karunarathna,Polonnaruwa,Minneriya,North Central,8452,4916,13368,338080,196640,534720
6/7/2024,Sashini Karunarathna,Polonnaruwa,Minneriya,North Central,1789,8936,10725,71560,357440,429000
6/8/2024,Sashini Karunarathna,Polonnaruwa,Minneriya,North Central,5914,8669,14583,236560,346760,583320
6/9/2024,Sashini Karunarathna,Polonnaruwa,Minneriya,North Central,6735,8769,15504,269400,350760,620160
6/10/2024,Sashini Karunarathna,Polonnaruwa,Minneriya,North Central,7624,43,7667,304960,1720,306680
6/11/2024,Sashini Karunarathna,Polonnaruwa,Minneriya,North Central,7642,9875,17517,305680,395000,700680
6/12/2024,Sashini Karunarathna,Polonnaruwa,Minneriya,North Central,2460,3546,6006,98400,141840,240240
6/13/2024,Sashini Karunarathna,Polonnaruwa,Minneriya,North Central,6483,6933,13416,259320,277320,536640
6/14/2024,Sashini Karunarathna,Polonnaruwa,Minneriya,North Central,5581,9586,15167,223240,383440,606680
6/15/2024,Sashini Karunarathna,Polonnaruwa,Minneriya,North Central,5,6496,6501,200,259840,260040
6/16/2024,Sashini Karunarathna,Polonnaruwa,Minneriya,North Central,6545,5581,12126,261800,223240,485040
6/17/2024,Sashini Karunarathna,Polonnaruwa,Minneriya,North Central,6262,5549,11811,250480,221960,472440
6/18/2024,Sashini Karunarathna,Polonnaruwa,Minneriya,North Central,2328,3004,5332,93120,120160,213280
6/19/2024,Sashini Karunarathna,Polonnaruwa,Minneriya,North Central,4951,9248,14199,198040,369920,567960
6/20/2024,Sashini Karunarathna,Polonnaruwa,Minneriya,North Central,4592,6050,10642,183680,242000,425680
6/21/2024,Sashini Karunarathna,Polonnaruwa,Minneriya,North Central,8231,770,9001,329240,30800,360040
6/22/2024,Sashini Karunarathna,Polonnaruwa,Minneriya,North Central,5428,8982,14410,217120,359280,576400
6/23/2024,Sashini Karunarathna,Polonnaruwa,Minneriya,North Central,6582,458,7040,263280,18320,281600
6/24/2024,Sashini Karunarathna,Polonnaruwa,Minneriya,North Central,4104,1754,5858,164160,70160,234320
6/25/2024,Sashini Karunarathna,Polonnaruwa,Minneriya,North Central,3291,5917,9208,131640,236680,368320
6/26/2024,Sashini Karunarathna,Polonnaruwa,Minneriya,North Central,5499,583,6082,219960,23320,243280
6/27/2024,Sashini Karunarathna,Polonnaruwa,Minneriya,North Central,5062,9343,14405,202480,373720,576200
6/28/2024,Sashini Karunarathna,Polonnaruwa,Minneriya,North Central,6382,5195,11577,255280,207800,463080
6/29/2024,Sashini Karunarathna,Polonnaruwa,Minneriya,North Central,7517,3000,10517,300680,120000,420680
6/30/2024,Sashini Karunarathna,Polonnaruwa,Minneriya,North Central,7867,4582,12449,314680,183280,497960
7/1/2024,Sashini Karunarathna,Polonnaruwa,Minneriya,North Central,7729,4516,12245,309160,180640,489800
7/2/2024,Sashini Karunarathna,Polonnaruwa,Minneriya,North Central,524,713,1237,20960,28520,49480
7/3/2024,Sashini Karunarathna,Polonnaruwa,Minneriya,North Central,93,9921,10014,3720,396840,400560
7/4/2024,Sashini Karunarathna,Polonnaruwa,Minneriya,North Central,3260,115,3375,130400,4600,135000
7/5/2024,Sashini Karunarathna,Polonnaruwa,Minneriya,North Central,6119,7822,13941,244760,312880,557640
7/6/2024,Sashini Karunarathna,Polonnaruwa,Minneriya,North Central,739,1819,2558,29560,72760,102320
7/7/2024,Sashini Karunarathna,Polonnaruwa,Minneriya,North Central,9162,4369,13531,366480,174760,541240
7/8/2024,Sashini Karunarathna,Polonnaruwa,Minneriya,North Central,2461,4035,6496,98440,161400,259840
7/9/2024,Sashini Karunarathna,Polonnaruwa,Minneriya,North Central,3307,4063,7370,132280,162520,294800
7/10/2024,Sashini Karunarathna,Polonnaruwa,Minneriya,North Central,7189,3136,10325,287560,125440,413000
7/11/2024,Sashini Karunarathna,Polonnaruwa,Minneriya,North Central,3893,4391,8284,155720,175640,331360
7/12/2024,Sashini Karunarathna,Polonnaruwa,Minneriya,North Central,8873,1682,10555,354920,67280,422200
7/13/2024,Sashini Karunarathna,Polonnaruwa,Minneriya,North Central,1472,6305,7777,58880,252200,311080
7/14/2024,Sashini Karunarathna,Polonnaruwa,Minneriya,North Central,1875,3433,5308,75000,137320,212320
7/15/2024,Sashini Karunarathna,Polonnaruwa,Minneriya,North Central,9787,6265,16052,391480,250600,642080
7/16/2024,Sashini Karunarathna,Polonnaruwa,Minneriya,North Central,5270,76,5346,210800,3040,213840
7/17/2024,Sashini Karunarathna,Polonnaruwa,Minneriya,North Central,9185,3541,12726,367400,141640,509040
7/18/2024,Sashini Karunarathna,Polonnaruwa,Minneriya,North Central,6194,6307,12501,247760,252280,500040
7/19/2024,Sashini Karunarathna,Polonnaruwa,Minneriya,North Central,8662,5100,13762,346480,204000,550480
7/20/2024,Sashini Karunarathna,Polonnaruwa,Minneriya,North Central,9018,8100,17118,360720,324000,684720
7/21/2024,Sashini Karunarathna,Polonnaruwa,Minneriya,North Central,4755,8249,13004,190200,329960,520160
7/22/2024,Sashini Karunarathna,Polonnaruwa,Minneriya,North Central,1894,7761,9655,75760,310440,386200
7/23/2024,Sashini Karunarathna,Polonnaruwa,Minneriya,North Central,9544,5918,15462,381760,236720,618480
7/24/2024,Sashini Karunarathna,Polonnaruwa,Minneriya,North Central,9607,3132,12739,384280,125280,509560
7/25/2024,Sashini Karunarathna,Polonnaruwa,Minneriya,North Central,9986,7395,17381,399440,295800,695240
7/26/2024,Sashini Karunarathna,Polonnaruwa,Minneriya,North Central,4709,1424,6133,188360,56960,245320
7/27/2024,Sashini Karunarathna,Polonnaruwa,Minneriya,North Central,4178,9239,13417,167120,369560,536680
7/28/2024,Sashini Karunarathna,Polonnaruwa,Minneriya,North Central,3151,6808,9959,126040,272320,398360
7/29/2024,Sashini Karunarathna,Polonnaruwa,Minneriya,North Central,9853,3141,12994,394120,125640,519760
7/30/2024,Sashini Karunarathna,Polonnaruwa,Minneriya,North Central,908,2436,3344,36320,97440,133760
7/31/2024,Sashini Karunarathna,Polonnaruwa,Minneriya,North Central,175,1134,1309,7000,45360,52360
8/1/2024,Sashini Karunarathna,Polonnaruwa,Minneriya,North Central,2729,9817,12546,109160,392680,501840
8/2/2024,Sashini Karunarathna,Polonnaruwa,Minneriya,North Central,8089,6227,14316,323560,249080,572640
8/3/2024,Sashini Karunarathna,Polonnaruwa,Minneriya,North Central,6974,5312,12286,278960,212480,491440
8/4/2024,Sashini Karunarathna,Polonnaruwa,Minneriya,North Central,9367,6896,16263,374680,275840,650520
8/5/2024,Sashini Karunarathna,Polonnaruwa,Minneriya,North Central,2495,6265,8760,99800,250600,350400
8/6/2024,Sashini Karunarathna,Polonnaruwa,Minneriya,North Central,803,5021,5824,32120,200840,232960
8/7/2024,Sashini Karunarathna,Polonnaruwa,Minneriya,North Central,8190,4796,12986,327600,191840,519440
8/8/2024,Sashini Karunarathna,Polonnaruwa,Minneriya,North Central,1164,7801,8965,46560,312040,358600
8/9/2024,Sashini Karunarathna,Polonnaruwa,Minneriya,North Central,6285,9534,15819,251400,381360,632760
8/10/2024,Sashini Karunarathna,Polonnaruwa,Minneriya,North Central,6571,1245,7816,262840,49800,312640
8/11/2024,Sashini Karunarathna,Polonnaruwa,Minneriya,North Central,4002,2370,6372,160080,94800,254880
8/12/2024,Sashini Karunarathna,Polonnaruwa,Minneriya,North Central,5397,4905,10302,215880,196200,412080
8/13/2024,Sashini Karunarathna,Polonnaruwa,Minneriya,North Central,2363,5901,8264,94520,236040,330560
8/14/2024,Sashini Karunarathna,Polonnaruwa,Minneriya,North Central,4868,8173,13041,194720,326920,521640
8/15/2024,Sashini Karunarathna,Polonnaruwa,Minneriya,North Central,8187,7214,15401,327480,288560,616040
8/16/2024,Sashini Karunarathna,Polonnaruwa,Minneriya,North Central,2835,1779,4614,113400,71160,184560
8/17/2024,Sashini Karunarathna,Polonnaruwa,Minneriya,North Central,1997,7795,9792,79880,311800,391680
8/18/2024,Sashini Karunarathna,Polonnaruwa,Minneriya,North Central,6220,4083,10303,248800,163320,412120
8/19/2024,Sashini Karunarathna,Polonnaruwa,Minneriya,North Central,9709,7433,17142,388360,297320,685680
8/20/2024,Sashini Karunarathna,Polonnaruwa,Minneriya,North Central,356,6735,7091,14240,269400,283640
8/21/2024,Sashini Karunarathna,Polonnaruwa,Minneriya,North Central,7264,9008,16272,290560,360320,650880
8/22/2024,Sashini Karunarathna,Polonnaruwa,Minneriya,North Central,5669,4408,10077,226760,176320,403080
8/23/2024,Sashini Karunarathna,Polonnaruwa,Minneriya,North Central,4340,799,5139,173600,31960,205560
8/24/2024,Sashini Karunarathna,Polonnaruwa,Minneriya,North Central,2909,481,3390,116360,19240,135600
8/25/2024,Sashini Karunarathna,Polonnaruwa,Minneriya,North Central,469,8238,8707,18760,329520,348280
8/26/2024,Sashini Karunarathna,Polonnaruwa,Minneriya,North Central,4052,6952,11004,162080,278080,440160
8/27/2024,Sashini Karunarathna,Polonnaruwa,Minneriya,North Central,602,1930,2532,24080,77200,101280
8/28/2024,Sashini Karunarathna,Polonnaruwa,Minneriya,North Central,6356,6167,12523,254240,246680,500920
8/29/2024,Sashini Karunarathna,Polonnaruwa,Minneriya,North Central,4007,2594,6601,160280,103760,264040
8/30/2024,Sashini Karunarathna,Polonnaruwa,Minneriya,North Central,878,5284,6162,35120,211360,246480
8/31/2024,Sashini Karunarathna,Polonnaruwa,Minneriya,North Central,2717,1353,4070,108680,54120,162800
9/1/2024,Sashini Karunarathna,Polonnaruwa,Minneriya,North Central,3852,2745,6597,154080,109800,263880
9/2/2024,Sashini Karunarathna,Polonnaruwa,Minneriya,North Central,8069,5973,14042,322760,238920,561680
9/3/2024,Sashini Karunarathna,Polonnaruwa,Minneriya,North Central,8781,7688,16469,351240,307520,658760
9/4/2024,Sashini Karunarathna,Polonnaruwa,Minneriya,North Central,3324,8071,11395,132960,322840,455800
9/5/2024,Sashini Karunarathna,Polonnaruwa,Minneriya,North Central,8311,8850,17161,332440,354000,686440
9/6/2024,Sashini Karunarathna,Polonnaruwa,Minneriya,North Central,8602,519,9121,344080,20760,364840
9/7/2024,Sashini Karunarathna,Polonnaruwa,Minneriya,North Central,9350,4473,13823,374000,178920,552920
9/8/2024,Sashini Karunarathna,Polonnaruwa,Minneriya,North Central,6825,3135,9960,273000,125400,398400
9/9/2024,Sashini Karunarathna,Polonnaruwa,Minneriya,North Central,9464,9766,19230,378560,390640,769200
9/10/2024,Sashini Karunarathna,Polonnaruwa,Minneriya,North Central,5594,2804,8398,223760,112160,335920
9/11/2024,Sashini Karunarathna,Polonnaruwa,Minneriya,North Central,762,6956,7718,30480,278240,308720
9/12/2024,Sashini Karunarathna,Polonnaruwa,Minneriya,North Central,7530,8984,16514,301200,359360,660560
9/13/2024,Sashini Karunarathna,Polonnaruwa,Minneriya,North Central,6614,7526,14140,264560,301040,565600
9/14/2024,Sashini Karunarathna,Polonnaruwa,Minneriya,North Central,9039,2458,11497,361560,98320,459880
9/15/2024,Sashini Karunarathna,Polonnaruwa,Minneriya,North Central,7445,5092,12537,297800,203680,501480
9/16/2024,Sashini Karunarathna,Polonnaruwa,Minneriya,North Central,8863,3058,11921,354520,122320,476840
9/17/2024,Sashini Karunarathna,Polonnaruwa,Minneriya,North Central,7254,3440,10694,290160,137600,427760
9/18/2024,Sashini Karunarathna,Polonnaruwa,Minneriya,North Central,1702,1138,2840,68080,45520,113600
9/19/2024,Sashini Karunarathna,Polonnaruwa,Minneriya,North Central,2856,3952,6808,114240,158080,272320
9/20/2024,Sashini Karunarathna,Polonnaruwa,Minneriya,North Central,8399,3379,11778,335960,135160,471120
9/21/2024,Sashini Karunarathna,Polonnaruwa,Minneriya,North Central,3318,2530,5848,132720,101200,233920
9/22/2024,Sashini Karunarathna,Polonnaruwa,Minneriya,North Central,7374,1759,9133,294960,70360,365320
9/23/2024,Sashini Karunarathna,Polonnaruwa,Minneriya,North Central,3822,3824,7646,152880,152960,305840
9/24/2024,Sashini Karunarathna,Polonnaruwa,Minneriya,North Central,8786,5998,14784,351440,239920,591360
9/25/2024,Sashini Karunarathna,Polonnaruwa,Minneriya,North Central,9838,6817,16655,393520,272680,666200
9/26/2024,Sashini Karunarathna,Polonnaruwa,Minneriya,North Central,2284,8109,10393,91360,324360,415720
9/27/2024,Sashini Karunarathna,Polonnaruwa,Minneriya,North Central,511,1627,2138,20440,65080,85520
9/28/2024,Sashini Karunarathna,Polonnaruwa,Minneriya,North Central,3328,1183,4511,133120,47320,180440
9/29/2024,Sashini Karunarathna,Polonnaruwa,Minneriya,North Central,5855,3551,9406,234200,142040,376240
9/30/2024,Sashini Karunarathna,Polonnaruwa,Minneriya,North Central,7444,6676,14120,297760,267040,564800
10/1/2024,Sashini Karunarathna,Polonnaruwa,Minneriya,North Central,1177,4918,6095,47080,196720,243800
10/2/2024,Sashini Karunarathna,Polonnaruwa,Minneriya,North Central,4797,1717,6514,191880,68680,260560
10/3/2024,Sashini Karunarathna,Polonnaruwa,Minneriya,North Central,1522,5607,7129,60880,224280,285160
10/4/2024,Sashini Karunarathna,Polonnaruwa,Minneriya,North Central,4711,3228,7939,188440,129120,317560
10/5/2024,Sashini Karunarathna,Polonnaruwa,Minneriya,North Central,3475,5053,8528,139000,202120,341120
10/6/2024,Sashini Karunarathna,Polonnaruwa,Minneriya,North Central,5108,5433,10541,204320,217320,421640
10/7/2024,Sashini Karunarathna,Polonnaruwa,Minneriya,North Central,2461,3806,6267,98440,152240,250680
10/8/2024,Sashini Karunarathna,Polonnaruwa,Minneriya,North Central,6910,202,7112,276400,8080,284480
10/9/2024,Sashini Karunarathna,Polonnaruwa,Minneriya,North Central,3137,4317,7454,125480,172680,298160
10/10/2024,Sashini Karunarathna,Polonnaruwa,Minneriya,North Central,2465,5703,8168,98600,228120,326720
10/11/2024,Sashini Karunarathna,Polonnaruwa,Minneriya,North Central,2284,5163,7447,91360,206520,297880
10/12/2024,Sashini Karunarathna,Polonnaruwa,Minneriya,North Central,4500,4930,9430,180000,197200,377200
10/13/2024,Sashini Karunarathna,Polonnaruwa,Minneriya,North Central,3912,378,4290,156480,15120,171600
10/14/2024,Sashini Karunarathna,Polonnaruwa,Minneriya,North Central,5203,8575,13778,208120,343000,551120
10/15/2024,Sashini Karunarathna,Polonnaruwa,Minneriya,North Central,9786,4706,14492,391440,188240,579680
10/16/2024,Sashini Karunarathna,Polonnaruwa,Minneriya,North Central,15,3734,3749,600,149360,149960
10/17/2024,Sashini Karunarathna,Polonnaruwa,Minneriya,North Central,1856,5192,7048,74240,207680,281920
10/18/2024,Sashini Karunarathna,Polonnaruwa,Minneriya,North Central,1560,5284,6844,62400,211360,273760
10/19/2024,Sashini Karunarathna,Polonnaruwa,Minneriya,North Central,7344,9112,16456,293760,364480,658240
10/20/2024,Sashini Karunarathna,Polonnaruwa,Minneriya,North Central,8334,7760,16094,333360,310400,643760
10/21/2024,Sashini Karunarathna,Polonnaruwa,Minneriya,North Central,688,7256,7944,27520,290240,317760
10/22/2024,Sashini Karunarathna,Polonnaruwa,Minneriya,North Central,9427,9406,18833,377080,376240,753320
10/23/2024,Sashini Karunarathna,Polonnaruwa,Minneriya,North Central,3230,133,3363,129200,5320,134520
10/24/2024,Sashini Karunarathna,Polonnaruwa,Minneriya,North Central,5077,3117,8194,203080,124680,327760
10/25/2024,Sashini Karunarathna,Polonnaruwa,Minneriya,North Central,8038,3934,11972,321520,157360,478880
10/26/2024,Sashini Karunarathna,Polonnaruwa,Minneriya,North Central,2163,9949,12112,86520,397960,484480
10/27/2024,Sashini Karunarathna,Polonnaruwa,Minneriya,North Central,9817,4632,14449,392680,185280,577960
10/28/2024,Sashini Karunarathna,Polonnaruwa,Minneriya,North Central,8821,9570,18391,352840,382800,735640
10/29/2024,Sashini Karunarathna,Polonnaruwa,Minneriya,North Central,811,6982,7793,32440,279280,311720
10/30/2024,Sashini Karunarathna,Polonnaruwa,Minneriya,North Central,4246,5982,10228,169840,239280,409120
10/31/2024,Sashini Karunarathna,Polonnaruwa,Minneriya,North Central,7548,7006,14554,301920,280240,582160
11/1/2024,Sashini Karunarathna,Polonnaruwa,Minneriya,North Central,3318,1111,4429,132720,44440,177160
11/2/2024,Sashini Karunarathna,Polonnaruwa,Minneriya,North Central,5302,3576,8878,212080,143040,355120
11/3/2024,Sashini Karunarathna,Polonnaruwa,Minneriya,North Central,140,6676,6816,5600,267040,272640
11/4/2024,Sashini Karunarathna,Polonnaruwa,Minneriya,North Central,809,7716,8525,32360,308640,341000
11/5/2024,Sashini Karunarathna,Polonnaruwa,Minneriya,North Central,6994,4891,11885,279760,195640,475400
11/6/2024,Sashini Karunarathna,Polonnaruwa,Minneriya,North Central,7009,2128,9137,280360,85120,365480
11/7/2024,Sashini Karunarathna,Polonnaruwa,Minneriya,North Central,3695,2207,5902,147800,88280,236080
11/8/2024,Sashini Karunarathna,Polonnaruwa,Minneriya,North Central,8821,9134,17955,352840,365360,718200
11/9/2024,Sashini Karunarathna,Polonnaruwa,Minneriya,North Central,6787,7941,14728,271480,317640,589120
11/10/2024,Sashini Karunarathna,Polonnaruwa,Minneriya,North Central,4900,7905,12805,196000,316200,512200
11/11/2024,Sashini Karunarathna,Polonnaruwa,Minneriya,North Central,9505,6580,16085,380200,263200,643400
11/12/2024,Sashini Karunarathna,Polonnaruwa,Minneriya,North Central,8136,3909,12045,325440,156360,481800
11/13/2024,Sashini Karunarathna,Polonnaruwa,Minneriya,North Central,1678,5431,7109,67120,217240,284360
11/14/2024,Sashini Karunarathna,Polonnaruwa,Minneriya,North Central,8945,5284,14229,357800,211360,569160
11/15/2024,Sashini Karunarathna,Polonnaruwa,Minneriya,North Central,7255,8880,16135,290200,355200,645400
11/16/2024,Sashini Karunarathna,Polonnaruwa,Minneriya,North Central,6003,3904,9907,240120,156160,396280
11/17/2024,Sashini Karunarathna,Polonnaruwa,Minneriya,North Central,2506,8842,11348,100240,353680,453920
11/18/2024,Sashini Karunarathna,Polonnaruwa,Minneriya,North Central,8127,8974,17101,325080,358960,684040
11/19/2024,Sashini Karunarathna,Polonnaruwa,Minneriya,North Central,539,605,1144,21560,24200,45760
11/20/2024,Sashini Karunarathna,Polonnaruwa,Minneriya,North Central,9555,7140,16695,382200,285600,667800
11/21/2024,Sashini Karunarathna,Polonnaruwa,Minneriya,North Central,5254,2462,7716,210160,98480,308640
11/22/2024,Sashini Karunarathna,Polonnaruwa,Minneriya,North Central,6581,7595,14176,263240,303800,567040
11/23/2024,Sashini Karunarathna,Polonnaruwa,Minneriya,North Central,1328,9934,11262,53120,397360,450480
11/24/2024,Sashini Karunarathna,Polonnaruwa,Minneriya,North Central,1749,6113,7862,69960,244520,314480
11/25/2024,Sashini Karunarathna,Polonnaruwa,Minneriya,North Central,5114,4849,9963,204560,193960,398520
11/26/2024,Sashini Karunarathna,Polonnaruwa,Minneriya,North Central,8146,8400,16546,325840,336000,661840
11/27/2024,Sashini Karunarathna,Polonnaruwa,Minneriya,North Central,4580,9130,13710,183200,365200,548400
11/28/2024,Sashini Karunarathna,Polonnaruwa,Minneriya,North Central,3462,286,3748,138480,11440,149920
11/29/2024,Sashini Karunarathna,Polonnaruwa,Minneriya,North Central,2001,5910,7911,80040,236400,316440
11/30/2024,Sashini Karunarathna,Polonnaruwa,Minneriya,North Central,7143,9817,16960,285720,392680,678400
12/1/2024,Sashini Karunarathna,Polonnaruwa,Minneriya,North Central,6276,2243,8519,251040,89720,340760
12/2/2024,Sashini Karunarathna,Polonnaruwa,Minneriya,North Central,4861,8339,13200,194440,333560,528000
12/3/2024,Sashini Karunarathna,Polonnaruwa,Minneriya,North Central,1813,8079,9892,72520,323160,395680
12/4/2024,Sashini Karunarathna,Polonnaruwa,Minneriya,North Central,859,3287,4146,34360,131480,165840
12/5/2024,Sashini Karunarathna,Polonnaruwa,Minneriya,North Central,6408,836,7244,256320,33440,289760
12/6/2024,Sashini Karunarathna,Polonnaruwa,Minneriya,North Central,5498,4068,9566,219920,162720,382640
12/7/2024,Sashini Karunarathna,Polonnaruwa,Minneriya,North Central,8350,2713,11063,334000,108520,442520
12/8/2024,Sashini Karunarathna,Polonnaruwa,Minneriya,North Central,4713,2449,7162,188520,97960,286480
12/9/2024,Sashini Karunarathna,Polonnaruwa,Minneriya,North Central,2981,4994,7975,119240,199760,319000
12/10/2024,Sashini Karunarathna,Polonnaruwa,Minneriya,North Central,9644,7658,17302,385760,306320,692080
12/11/2024,Sashini Karunarathna,Polonnaruwa,Minneriya,North Central,9250,2545,11795,370000,101800,471800
12/12/2024,Sashini Karunarathna,Polonnaruwa,Minneriya,North Central,4858,9870,14728,194320,394800,589120
12/13/2024,Sashini Karunarathna,Polonnaruwa,Minneriya,North Central,8565,4429,12994,342600,177160,519760
12/14/2024,Sashini Karunarathna,Polonnaruwa,Minneriya,North Central,2618,1120,3738,104720,44800,149520
12/15/2024,Sashini Karunarathna,Polonnaruwa,Minneriya,North Central,8968,1019,9987,358720,40760,399480
12/16/2024,Sashini Karunarathna,Polonnaruwa,Minneriya,North Central,4964,4957,9921,198560,198280,396840
12/17/2024,Sashini Karunarathna,Polonnaruwa,Minneriya,North Central,2883,4103,6986,115320,164120,279440
12/18/2024,Sashini Karunarathna,Polonnaruwa,Minneriya,North Central,4425,9440,13865,177000,377600,554600
12/19/2024,Sashini Karunarathna,Polonnaruwa,Minneriya,North Central,3568,6116,9684,142720,244640,387360
12/20/2024,Sashini Karunarathna,Polonnaruwa,Minneriya,North Central,328,1308,1636,13120,52320,65440
12/21/2024,Sashini Karunarathna,Polonnaruwa,Minneriya,North Central,948,3543,4491,37920,141720,179640
12/22/2024,Sashini Karunarathna,Polonnaruwa,Minneriya,North Central,1050,7686,8736,42000,307440,349440
12/23/2024,Sashini Karunarathna,Polonnaruwa,Minneriya,North Central,6361,1442,7803,254440,57680,312120
12/24/2024,Sashini Karunarathna,Polonnaruwa,Minneriya,North Central,6151,3768,9919,246040,150720,396760
12/25/2024,Sashini Karunarathna,Polonnaruwa,Minneriya,North Central,3958,3303,7261,158320,132120,290440
12/26/2024,Sashini Karunarathna,Polonnaruwa,Minneriya,North Central,8413,9320,17733,336520,372800,709320
12/27/2024,Sashini Karunarathna,Polonnaruwa,Minneriya,North Central,3697,6862,10559,147880,274480,422360
12/28/2024,Sashini Karunarathna,Polonnaruwa,Minneriya,North Central,9391,3616,13007,375640,144640,520280
12/29/2024,Sashini Karunarathna,Polonnaruwa,Minneriya,North Central,4571,3884,8455,182840,155360,338200
12/30/2024,Sashini Karunarathna,Polonnaruwa,Minneriya,North Central,7743,2474,10217,309720,98960,408680
12/31/2024,Sashini Karunarathna,Polonnaruwa,Minneriya,North Central,8180,338,8518,327200,13520,340720
1/1/2025,Sashini Karunarathna,Polonnaruwa,Minneriya,North Central,5606,5346,10952,224240,213840,438080
1/2/2025,Sashini Karunarathna,Polonnaruwa,Minneriya,North Central,6483,1300,7783,259320,52000,311320
1/3/2025,Sashini Karunarathna,Polonnaruwa,Minneriya,North Central,1337,8553,9890,53480,342120,395600
1/4/2025,Sashini Karunarathna,Polonnaruwa,Minneriya,North Central,1345,8820,10165,53800,352800,406600
1/5/2025,Sashini Karunarathna,Polonnaruwa,Minneriya,North Central,3209,3780,6989,128360,151200,279560
1/6/2025,Sashini Karunarathna,Polonnaruwa,Minneriya,North Central,718,2948,3666,28720,117920,146640
1/7/2025,Sashini Karunarathna,Polonnaruwa,Minneriya,North Central,1189,8551,9740,47560,342040,389600
1/8/2025,Sashini Karunarathna,Polonnaruwa,Minneriya,North Central,2515,4349,6864,100600,173960,274560
1/9/2025,Sashini Karunarathna,Polonnaruwa,Minneriya,North Central,7044,7452,14496,281760,298080,579840
1/10/2025,Sashini Karunarathna,Polonnaruwa,Minneriya,North Central,2297,8872,11169,91880,354880,446760
1/11/2025,Sashini Karunarathna,Polonnaruwa,Minneriya,North Central,1422,1682,3104,56880,67280,124160
1/12/2025,Sashini Karunarathna,Polonnaruwa,Minneriya,North Central,9208,532,9740,368320,21280,389600
1/13/2025,Sashini Karunarathna,Polonnaruwa,Minneriya,North Central,7039,6796,13835,281560,271840,553400
1/14/2025,Sashini Karunarathna,Polonnaruwa,Minneriya,North Central,9022,8657,17679,360880,346280,707160
1/15/2025,Sashini Karunarathna,Polonnaruwa,Minneriya,North Central,730,3355,4085,29200,134200,163400
1/16/2025,Sashini Karunarathna,Polonnaruwa,Minneriya,North Central,7670,5242,12912,306800,209680,516480
1/17/2025,Sashini Karunarathna,Polonnaruwa,Minneriya,North Central,3481,6897,10378,139240,275880,415120
1/18/2025,Sashini Karunarathna,Polonnaruwa,Minneriya,North Central,2434,4193,6627,97360,167720,265080
1/19/2025,Sashini Karunarathna,Polonnaruwa,Minneriya,North Central,4003,685,4688,160120,27400,187520
1/20/2025,Sashini Karunarathna,Polonnaruwa,Minneriya,North Central,6652,6398,13050,266080,255920,522000
1/21/2025,Sashini Karunarathna,Polonnaruwa,Minneriya,North Central,8433,2031,10464,337320,81240,418560
1/22/2025,Sashini Karunarathna,Polonnaruwa,Minneriya,North Central,2973,9773,12746,118920,390920,509840
1/23/2025,Sashini Karunarathna,Polonnaruwa,Minneriya,North Central,2037,4756,6793,81480,190240,271720
1/24/2025,Sashini Karunarathna,Polonnaruwa,Minneriya,North Central,5624,8182,13806,224960,327280,552240
1/25/2025,Sashini Karunarathna,Polonnaruwa,Minneriya,North Central,4251,4048,8299,170040,161920,331960
1/26/2025,Sashini Karunarathna,Polonnaruwa,Minneriya,North Central,1975,7615,9590,79000,304600,383600
1/27/2025,Sashini Karunarathna,Polonnaruwa,Minneriya,North Central,848,8047,8895,33920,321880,355800
1/28/2025,Sashini Karunarathna,Polonnaruwa,Minneriya,North Central,1904,9089,10993,76160,363560,439720
1/29/2025,Sashini Karunarathna,Polonnaruwa,Minneriya,North Central,4142,1228,5370,165680,49120,214800
1/30/2025,Sashini Karunarathna,Polonnaruwa,Minneriya,North Central,1446,2921,4367,57840,116840,174680
1/31/2025,Sashini Karunarathna,Polonnaruwa,Minneriya,North Central,6741,7506,14247,269640,300240,569880
2/1/2025,Sashini Karunarathna,Polonnaruwa,Minneriya,North Central,140,6523,6663,5600,260920,266520
2/2/2025,Sashini Karunarathna,Polonnaruwa,Minneriya,North Central,714,5120,5834,28560,204800,233360
2/3/2025,Sashini Karunarathna,Polonnaruwa,Minneriya,North Central,9696,8537,18233,387840,341480,729320
2/4/2025,Sashini Karunarathna,Polonnaruwa,Minneriya,North Central,5499,3601,9100,219960,144040,364000
2/5/2025,Sashini Karunarathna,Polonnaruwa,Minneriya,North Central,8160,7387,15547,326400,295480,621880
2/6/2025,Sashini Karunarathna,Polonnaruwa,Minneriya,North Central,1793,6783,8576,71720,271320,343040
2/7/2025,Sashini Karunarathna,Polonnaruwa,Minneriya,North Central,6548,3349,9897,261920,133960,395880
2/8/2025,Sashini Karunarathna,Polonnaruwa,Minneriya,North Central,7774,9705,17479,310960,388200,699160
2/9/2025,Sashini Karunarathna,Polonnaruwa,Minneriya,North Central,9437,9531,18968,377480,381240,758720
2/10/2025,Sashini Karunarathna,Polonnaruwa,Minneriya,North Central,3253,5470,8723,130120,218800,348920
2/11/2025,Sashini Karunarathna,Polonnaruwa,Minneriya,North Central,5275,2550,7825,211000,102000,313000
2/12/2025,Sashini Karunarathna,Polonnaruwa,Minneriya,North Central,3108,8201,11309,124320,328040,452360
2/13/2025,Sashini Karunarathna,Polonnaruwa,Minneriya,North Central,3819,7370,11189,152760,294800,447560
2/14/2025,Sashini Karunarathna,Polonnaruwa,Minneriya,North Central,701,749,1450,28040,29960,58000
2/15/2025,Sashini Karunarathna,Polonnaruwa,Minneriya,North Central,8699,87,8786,347960,3480,351440
2/16/2025,Sashini Karunarathna,Polonnaruwa,Minneriya,North Central,6306,9809,16115,252240,392360,644600
2/17/2025,Sashini Karunarathna,Polonnaruwa,Minneriya,North Central,8955,8718,17673,358200,348720,706920
2/18/2025,Sashini Karunarathna,Polonnaruwa,Minneriya,North Central,919,5524,6443,36760,220960,257720
2/19/2025,Sashini Karunarathna,Polonnaruwa,Minneriya,North Central,8489,1899,10388,339560,75960,415520
2/20/2025,Sashini Karunarathna,Polonnaruwa,Minneriya,North Central,6204,1510,7714,248160,60400,308560
2/21/2025,Sashini Karunarathna,Polonnaruwa,Minneriya,North Central,3156,6830,9986,126240,273200,399440
2/22/2025,Sashini Karunarathna,Polonnaruwa,Minneriya,North Central,8268,7997,16265,330720,319880,650600
2/23/2025,Sashini Karunarathna,Polonnaruwa,Minneriya,North Central,7375,4667,12042,295000,186680,481680
2/24/2025,Sashini Karunarathna,Polonnaruwa,Minneriya,North Central,8874,9788,18662,354960,391520,746480
2/25/2025,Sashini Karunarathna,Polonnaruwa,Minneriya,North Central,4205,8290,12495,168200,331600,499800
2/26/2025,Sashini Karunarathna,Polonnaruwa,Minneriya,North Central,2962,4963,7925,118480,198520,317000
2/27/2025,Sashini Karunarathna,Polonnaruwa,Minneriya,North Central,7063,768,7831,282520,30720,313240
2/28/2025,Sashini Karunarathna,Polonnaruwa,Minneriya,North Central,5897,2551,8448,235880,102040,337920
3/1/2025,Sashini Karunarathna,Polonnaruwa,Minneriya,North Central,742,694,1436,29680,27760,57440
3/2/2025,Sashini Karunarathna,Polonnaruwa,Minneriya,North Central,8598,2764,11362,343920,110560,454480
3/3/2025,Sashini Karunarathna,Polonnaruwa,Minneriya,North Central,8469,8899,17368,338760,355960,694720
3/4/2025,Sashini Karunarathna,Polonnaruwa,Minneriya,North Central,1881,7279,9160,75240,291160,366400
3/5/2025,Sashini Karunarathna,Polonnaruwa,Minneriya,North Central,3907,314,4221,156280,12560,168840
3/6/2025,Sashini Karunarathna,Polonnaruwa,Minneriya,North Central,7349,278,7627,293960,11120,305080
3/7/2025,Sashini Karunarathna,Polonnaruwa,Minneriya,North Central,6718,6582,13300,268720,263280,532000
3/8/2025,Sashini Karunarathna,Polonnaruwa,Minneriya,North Central,938,3942,4880,37520,157680,195200
3/9/2025,Sashini Karunarathna,Polonnaruwa,Minneriya,North Central,3102,7075,10177,124080,283000,407080
3/10/2025,Sashini Karunarathna,Polonnaruwa,Minneriya,North Central,5864,2032,7896,234560,81280,315840
3/11/2025,Sashini Karunarathna,Polonnaruwa,Minneriya,North Central,7615,2748,10363,304600,109920,414520
3/12/2025,Sashini Karunarathna,Polonnaruwa,Minneriya,North Central,1640,6027,7667,65600,241080,306680
3/13/2025,Sashini Karunarathna,Polonnaruwa,Minneriya,North Central,7841,5804,13645,313640,232160,545800
3/14/2025,Sashini Karunarathna,Polonnaruwa,Minneriya,North Central,8438,6081,14519,337520,243240,580760
3/15/2025,Sashini Karunarathna,Polonnaruwa,Minneriya,North Central,5385,4136,9521,215400,165440,380840
3/16/2025,Sashini Karunarathna,Polonnaruwa,Minneriya,North Central,6728,1454,8182,269120,58160,327280
3/17/2025,Sashini Karunarathna,Polonnaruwa,Minneriya,North Central,2853,9025,11878,114120,361000,475120
3/18/2025,Sashini Karunarathna,Polonnaruwa,Minneriya,North Central,2204,2564,4768,88160,102560,190720
3/19/2025,Sashini Karunarathna,Polonnaruwa,Minneriya,North Central,1777,7888,9665,71080,315520,386600
3/20/2025,Sashini Karunarathna,Polonnaruwa,Minneriya,North Central,7430,6523,13953,297200,260920,558120
3/21/2025,Sashini Karunarathna,Polonnaruwa,Minneriya,North Central,6603,9575,16178,264120,383000,647120
3/22/2025,Sashini Karunarathna,Polonnaruwa,Minneriya,North Central,6770,6633,13403,270800,265320,536120
3/23/2025,Sashini Karunarathna,Polonnaruwa,Minneriya,North Central,2604,8293,10897,104160,331720,435880
3/25/2024,Shashini Perera,Jaffna,Jaffna,Northern,1656,9243,10899,66240,369720,435960
3/26/2024,Shashini Perera,Jaffna,Jaffna,Northern,5003,7146,12149,200120,285840,485960
3/27/2024,Shashini Perera,Jaffna,Jaffna,Northern,8715,2243,10958,348600,89720,438320
3/28/2024,Shashini Perera,Jaffna,Jaffna,Northern,1927,5751,7678,77080,230040,307120
3/29/2024,Shashini Perera,Jaffna,Jaffna,Northern,2409,3498,5907,96360,139920,236280
3/30/2024,Shashini Perera,Jaffna,Jaffna,Northern,7797,5476,13273,311880,219040,530920
3/31/2024,Shashini Perera,Jaffna,Jaffna,Northern,4158,8937,13095,166320,357480,523800
4/1/2024,Shashini Perera,Jaffna,Jaffna,Northern,7846,8930,16776,313840,357200,671040
4/2/2024,Shashini Perera,Jaffna,Jaffna,Northern,6127,6820,12947,245080,272800,517880
4/3/2024,Shashini Perera,Jaffna,Jaffna,Northern,3011,814,3825,120440,32560,153000
4/4/2024,Shashini Perera,Jaffna,Jaffna,Northern,794,9856,10650,31760,394240,426000
4/5/2024,Shashini Perera,Jaffna,Jaffna,Northern,4006,5734,9740,160240,229360,389600
4/6/2024,Shashini Perera,Jaffna,Jaffna,Northern,8086,7056,15142,323440,282240,605680
4/7/2024,Shashini Perera,Jaffna,Jaffna,Northern,7255,856,8111,290200,34240,324440
4/8/2024,Shashini Perera,Jaffna,Jaffna,Northern,4838,9073,13911,193520,362920,556440
4/9/2024,Shashini Perera,Jaffna,Jaffna,Northern,3754,3365,7119,150160,134600,284760
4/10/2024,Shashini Perera,Jaffna,Jaffna,Northern,9126,6628,15754,365040,265120,630160
4/11/2024,Shashini Perera,Jaffna,Jaffna,Northern,3053,8804,11857,122120,352160,474280
4/19/2024,Shashini Perera,Jaffna,Jaffna,Northern,6441,329,6770,257640,13160,270800
4/20/2024,Shashini Perera,Jaffna,Jaffna,Northern,98,8637,8735,3920,345480,349400
4/21/2024,Shashini Perera,Jaffna,Jaffna,Northern,3472,4685,8157,138880,187400,326280
4/22/2024,Shashini Perera,Jaffna,Jaffna,Northern,9240,6146,15386,369600,245840,615440
4/23/2024,Shashini Perera,Jaffna,Jaffna,Northern,1898,8844,10742,75920,353760,429680
4/24/2024,Shashini Perera,Jaffna,Jaffna,Northern,7072,2836,9908,282880,113440,396320
4/25/2024,Shashini Perera,Jaffna,Jaffna,Northern,506,1401,1907,20240,56040,76280
4/26/2024,Shashini Perera,Jaffna,Jaffna,Northern,3054,3949,7003,122160,157960,280120
4/27/2024,Shashini Perera,Jaffna,Jaffna,Northern,6253,9052,15305,250120,362080,612200
4/28/2024,Shashini Perera,Jaffna,Jaffna,Northern,3423,8042,11465,136920,321680,458600
4/29/2024,Shashini Perera,Jaffna,Jaffna,Northern,1615,5466,7081,64600,218640,283240
4/30/2024,Shashini Perera,Jaffna,Jaffna,Northern,1944,159,2103,77760,6360,84120
5/1/2024,Shashini Perera,Jaffna,Jaffna,Northern,4264,9185,13449,170560,367400,537960
5/2/2024,Shashini Perera,Jaffna,Jaffna,Northern,9873,3805,13678,394920,152200,547120
5/3/2024,Shashini Perera,Jaffna,Jaffna,Northern,6809,5677,12486,272360,227080,499440
5/4/2024,Shashini Perera,Jaffna,Jaffna,Northern,4596,230,4826,183840,9200,193040
5/5/2024,Shashini Perera,Jaffna,Jaffna,Northern,3881,6980,10861,155240,279200,434440
5/6/2024,Shashini Perera,Jaffna,Jaffna,Northern,175,4591,4766,7000,183640,190640
5/7/2024,Shashini Perera,Jaffna,Jaffna,Northern,5226,3890,9116,209040,155600,364640
5/8/2024,Shashini Perera,Jaffna,Jaffna,Northern,3309,7219,10528,132360,288760,421120
5/9/2024,Shashini Perera,Jaffna,Jaffna,Northern,391,6613,7004,15640,264520,280160
5/10/2024,Shashini Perera,Jaffna,Jaffna,Northern,1197,9316,10513,47880,372640,420520
5/11/2024,Shashini Perera,Jaffna,Jaffna,Northern,7199,9149,16348,287960,365960,653920
5/12/2024,Shashini Perera,Jaffna,Jaffna,Northern,347,6499,6846,13880,259960,273840
5/13/2024,Shashini Perera,Jaffna,Jaffna,Northern,7320,7055,14375,292800,282200,575000
5/14/2024,Shashini Perera,Jaffna,Jaffna,Northern,8457,1843,10300,338280,73720,412000
5/15/2024,Shashini Perera,Jaffna,Jaffna,Northern,276,5023,5299,11040,200920,211960
5/16/2024,Shashini Perera,Jaffna,Jaffna,Northern,7252,6256,13508,290080,250240,540320
5/17/2024,Shashini Perera,Jaffna,Jaffna,Northern,6109,1804,7913,244360,72160,316520
5/18/2024,Shashini Perera,Jaffna,Jaffna,Northern,1797,5123,6920,71880,204920,276800
5/19/2024,Shashini Perera,Jaffna,Jaffna,Northern,6255,1395,7650,250200,55800,306000
5/20/2024,Shashini Perera,Jaffna,Jaffna,Northern,1511,7330,8841,60440,293200,353640
5/21/2024,Shashini Perera,Jaffna,Jaffna,Northern,4978,7525,12503,199120,301000,500120
5/22/2024,Shashini Perera,Jaffna,Jaffna,Northern,5486,4522,10008,219440,180880,400320
5/24/2024,Shashini Perera,Jaffna,Jaffna,Northern,6809,867,7676,272360,34680,307040
5/25/2024,Shashini Perera,Jaffna,Jaffna,Northern,3025,5818,8843,121000,232720,353720
5/26/2024,Shashini Perera,Jaffna,Jaffna,Northern,2859,2272,5131,114360,90880,205240
5/27/2024,Shashini Perera,Jaffna,Jaffna,Northern,9635,8067,17702,385400,322680,708080
5/28/2024,Shashini Perera,Jaffna,Jaffna,Northern,4088,1537,5625,163520,61480,225000
5/29/2024,Shashini Perera,Jaffna,Jaffna,Northern,4484,1268,5752,179360,50720,230080
5/30/2024,Shashini Perera,Jaffna,Jaffna,Northern,2379,4392,6771,95160,175680,270840
5/31/2024,Shashini Perera,Jaffna,Jaffna,Northern,7021,3112,10133,280840,124480,405320
6/1/2024,Shashini Perera,Jaffna,Jaffna,Northern,2498,2983,5481,99920,119320,219240
6/2/2024,Shashini Perera,Jaffna,Jaffna,Northern,9122,9611,18733,364880,384440,749320
6/3/2024,Shashini Perera,Jaffna,Jaffna,Northern,8624,4498,13122,344960,179920,524880
6/4/2024,Shashini Perera,Jaffna,Jaffna,Northern,5615,8542,14157,224600,341680,566280
6/5/2024,Shashini Perera,Jaffna,Jaffna,Northern,6255,3369,9624,250200,134760,384960
6/6/2024,Shashini Perera,Jaffna,Jaffna,Northern,3535,1655,5190,141400,66200,207600
6/7/2024,Shashini Perera,Jaffna,Jaffna,Northern,8772,7020,15792,350880,280800,631680
6/8/2024,Shashini Perera,Jaffna,Jaffna,Northern,1463,7575,9038,58520,303000,361520
6/9/2024,Shashini Perera,Jaffna,Jaffna,Northern,1012,1307,2319,40480,52280,92760
6/10/2024,Shashini Perera,Jaffna,Jaffna,Northern,4003,4848,8851,160120,193920,354040
6/11/2024,Shashini Perera,Jaffna,Jaffna,Northern,6418,823,7241,256720,32920,289640
6/12/2024,Shashini Perera,Jaffna,Jaffna,Northern,556,8234,8790,22240,329360,351600
6/13/2024,Shashini Perera,Jaffna,Jaffna,Northern,7424,9772,17196,296960,390880,687840
6/14/2024,Shashini Perera,Jaffna,Jaffna,Northern,8284,4096,12380,331360,163840,495200
6/15/2024,Shashini Perera,Jaffna,Jaffna,Northern,5809,8711,14520,232360,348440,580800
6/16/2024,Shashini Perera,Jaffna,Jaffna,Northern,7505,5476,12981,300200,219040,519240
6/17/2024,Shashini Perera,Jaffna,Jaffna,Northern,2557,9947,12504,102280,397880,500160
6/18/2024,Shashini Perera,Jaffna,Jaffna,Northern,1051,8160,9211,42040,326400,368440
6/19/2024,Shashini Perera,Jaffna,Jaffna,Northern,2504,4646,7150,100160,185840,286000
6/20/2024,Shashini Perera,Jaffna,Jaffna,Northern,7539,9839,17378,301560,393560,695120
6/21/2024,Shashini Perera,Jaffna,Jaffna,Northern,9642,616,10258,385680,24640,410320
6/22/2024,Shashini Perera,Jaffna,Jaffna,Northern,8845,5092,13937,353800,203680,557480
6/23/2024,Shashini Perera,Jaffna,Jaffna,Northern,5442,9775,15217,217680,391000,608680
6/24/2024,Shashini Perera,Jaffna,Jaffna,Northern,6160,6505,12665,246400,260200,506600
6/25/2024,Shashini Perera,Jaffna,Jaffna,Northern,795,6717,7512,31800,268680,300480
6/26/2024,Shashini Perera,Jaffna,Jaffna,Northern,7761,7195,14956,310440,287800,598240
6/27/2024,Shashini Perera,Jaffna,Jaffna,Northern,8624,6857,15481,344960,274280,619240
6/28/2024,Shashini Perera,Jaffna,Jaffna,Northern,4282,4196,8478,171280,167840,339120
6/29/2024,Shashini Perera,Jaffna,Jaffna,Northern,3243,8009,11252,129720,320360,450080
6/30/2024,Shashini Perera,Jaffna,Jaffna,Northern,7645,8637,16282,305800,345480,651280
7/1/2024,Shashini Perera,Jaffna,Jaffna,Northern,8820,7288,16108,352800,291520,644320
7/2/2024,Shashini Perera,Jaffna,Jaffna,Northern,7044,7906,14950,281760,316240,598000
7/3/2024,Shashini Perera,Jaffna,Jaffna,Northern,7804,519,8323,312160,20760,332920
7/4/2024,Shashini Perera,Jaffna,Jaffna,Northern,1239,2725,3964,49560,109000,158560
7/5/2024,Shashini Perera,Jaffna,Jaffna,Northern,5984,3897,9881,239360,155880,395240
7/6/2024,Shashini Perera,Jaffna,Jaffna,Northern,8744,1908,10652,349760,76320,426080
7/7/2024,Shashini Perera,Jaffna,Jaffna,Northern,9715,1150,10865,388600,46000,434600
7/8/2024,Shashini Perera,Jaffna,Jaffna,Northern,9198,9765,18963,367920,390600,758520
7/9/2024,Shashini Perera,Jaffna,Jaffna,Northern,3168,2671,5839,126720,106840,233560
7/10/2024,Shashini Perera,Jaffna,Jaffna,Northern,6778,7451,14229,271120,298040,569160
7/11/2024,Shashini Perera,Jaffna,Jaffna,Northern,903,9525,10428,36120,381000,417120
7/12/2024,Shashini Perera,Jaffna,Jaffna,Northern,7819,4274,12093,312760,170960,483720
7/13/2024,Shashini Perera,Jaffna,Jaffna,Northern,7331,6063,13394,293240,242520,535760
7/14/2024,Shashini Perera,Jaffna,Jaffna,Northern,3565,7699,11264,142600,307960,450560
7/15/2024,Shashini Perera,Jaffna,Jaffna,Northern,7212,1565,8777,288480,62600,351080
7/16/2024,Shashini Perera,Jaffna,Jaffna,Northern,5620,1900,7520,224800,76000,300800
7/17/2024,Shashini Perera,Jaffna,Jaffna,Northern,6707,7353,14060,268280,294120,562400
7/18/2024,Shashini Perera,Jaffna,Jaffna,Northern,8606,3255,11861,344240,130200,474440
7/19/2024,Shashini Perera,Jaffna,Jaffna,Northern,1897,6696,8593,75880,267840,343720
7/20/2024,Shashini Perera,Jaffna,Jaffna,Northern,5656,6552,12208,226240,262080,488320
7/21/2024,Shashini Perera,Jaffna,Jaffna,Northern,9797,4746,14543,391880,189840,581720
7/22/2024,Shashini Perera,Jaffna,Jaffna,Northern,2368,1616,3984,94720,64640,159360
7/23/2024,Shashini Perera,Jaffna,Jaffna,Northern,6974,5475,12449,278960,219000,497960
7/24/2024,Shashini Perera,Jaffna,Jaffna,Northern,90,9826,9916,3600,393040,396640
7/25/2024,Shashini Perera,Jaffna,Jaffna,Northern,2187,7004,9191,87480,280160,367640
7/26/2024,Shashini Perera,Jaffna,Jaffna,Northern,7186,1812,8998,287440,72480,359920
7/27/2024,Shashini Perera,Jaffna,Jaffna,Northern,5277,6606,11883,211080,264240,475320
7/28/2024,Shashini Perera,Jaffna,Jaffna,Northern,4988,5656,10644,199520,226240,425760
7/29/2024,Shashini Perera,Jaffna,Jaffna,Northern,1866,1875,3741,74640,75000,149640
7/30/2024,Shashini Perera,Jaffna,Jaffna,Northern,5066,9200,14266,202640,368000,570640
7/31/2024,Shashini Perera,Jaffna,Jaffna,Northern,1863,5583,7446,74520,223320,297840
8/1/2024,Shashini Perera,Jaffna,Jaffna,Northern,6366,4158,10524,254640,166320,420960
8/2/2024,Shashini Perera,Jaffna,Jaffna,Northern,5140,6084,11224,205600,243360,448960
8/3/2024,Shashini Perera,Jaffna,Jaffna,Northern,1270,230,1500,50800,9200,60000
8/4/2024,Shashini Perera,Jaffna,Jaffna,Northern,5750,4263,10013,230000,170520,400520
8/5/2024,Shashini Perera,Jaffna,Jaffna,Northern,9401,8690,18091,376040,347600,723640
8/6/2024,Shashini Perera,Jaffna,Jaffna,Northern,3706,1493,5199,148240,59720,207960
8/7/2024,Shashini Perera,Jaffna,Jaffna,Northern,4209,9865,14074,168360,394600,562960
8/8/2024,Shashini Perera,Jaffna,Jaffna,Northern,26,1777,1803,1040,71080,72120
8/9/2024,Shashini Perera,Jaffna,Jaffna,Northern,2935,4843,7778,117400,193720,311120
8/10/2024,Shashini Perera,Jaffna,Jaffna,Northern,7018,1307,8325,280720,52280,333000
8/11/2024,Shashini Perera,Jaffna,Jaffna,Northern,7940,5177,13117,317600,207080,524680
8/12/2024,Shashini Perera,Jaffna,Jaffna,Northern,2435,505,2940,97400,20200,117600
8/13/2024,Shashini Perera,Jaffna,Jaffna,Northern,6441,6460,12901,257640,258400,516040
8/14/2024,Shashini Perera,Jaffna,Jaffna,Northern,6249,958,7207,249960,38320,288280
8/15/2024,Shashini Perera,Jaffna,Jaffna,Northern,4250,9446,13696,170000,377840,547840
8/16/2024,Shashini Perera,Jaffna,Jaffna,Northern,600,7560,8160,24000,302400,326400
8/17/2024,Shashini Perera,Jaffna,Jaffna,Northern,292,8767,9059,11680,350680,362360
8/18/2024,Shashini Perera,Jaffna,Jaffna,Northern,450,2663,3113,18000,106520,124520
8/19/2024,Shashini Perera,Jaffna,Jaffna,Northern,466,3706,4172,18640,148240,166880
8/20/2024,Shashini Perera,Jaffna,Jaffna,Northern,201,7107,7308,8040,284280,292320
8/21/2024,Shashini Perera,Jaffna,Jaffna,Northern,3643,7542,11185,145720,301680,447400
8/22/2024,Shashini Perera,Jaffna,Jaffna,Northern,2911,1725,4636,116440,69000,185440
8/23/2024,Shashini Perera,Jaffna,Jaffna,Northern,5285,571,5856,211400,22840,234240
8/24/2024,Shashini Perera,Jaffna,Jaffna,Northern,166,8179,8345,6640,327160,333800
8/25/2024,Shashini Perera,Jaffna,Jaffna,Northern,6239,6433,12672,249560,257320,506880
8/26/2024,Shashini Perera,Jaffna,Jaffna,Northern,9607,6064,15671,384280,242560,626840
8/27/2024,Shashini Perera,Jaffna,Jaffna,Northern,300,2087,2387,12000,83480,95480
8/28/2024,Shashini Perera,Jaffna,Jaffna,Northern,9822,7481,17303,392880,299240,692120
8/29/2024,Shashini Perera,Jaffna,Jaffna,Northern,5528,6749,12277,221120,269960,491080
8/30/2024,Shashini Perera,Jaffna,Jaffna,Northern,4212,6842,11054,168480,273680,442160
8/31/2024,Shashini Perera,Jaffna,Jaffna,Northern,8542,288,8830,341680,11520,353200
9/1/2024,Shashini Perera,Jaffna,Jaffna,Northern,6462,4076,10538,258480,163040,421520
9/2/2024,Shashini Perera,Jaffna,Jaffna,Northern,2866,6633,9499,114640,265320,379960
9/3/2024,Shashini Perera,Jaffna,Jaffna,Northern,6740,449,7189,269600,17960,287560
9/4/2024,Shashini Perera,Jaffna,Jaffna,Northern,4410,659,5069,176400,26360,202760
9/5/2024,Shashini Perera,Jaffna,Jaffna,Northern,479,7387,7866,19160,295480,314640
9/6/2024,Shashini Perera,Jaffna,Jaffna,Northern,8903,6736,15639,356120,269440,625560
9/7/2024,Shashini Perera,Jaffna,Jaffna,Northern,2421,7502,9923,96840,300080,396920
9/8/2024,Shashini Perera,Jaffna,Jaffna,Northern,1899,4846,6745,75960,193840,269800
9/9/2024,Shashini Perera,Jaffna,Jaffna,Northern,198,1164,1362,7920,46560,54480
9/10/2024,Shashini Perera,Jaffna,Jaffna,Northern,2137,3153,5290,85480,126120,211600
9/11/2024,Shashini Perera,Jaffna,Jaffna,Northern,7237,7630,14867,289480,305200,594680
9/12/2024,Shashini Perera,Jaffna,Jaffna,Northern,1219,340,1559,48760,13600,62360
9/13/2024,Shashini Perera,Jaffna,Jaffna,Northern,5445,3713,9158,217800,148520,366320
9/14/2024,Shashini Perera,Jaffna,Jaffna,Northern,9801,3723,13524,392040,148920,540960
9/15/2024,Shashini Perera,Jaffna,Jaffna,Northern,8858,5137,13995,354320,205480,559800
9/16/2024,Shashini Perera,Jaffna,Jaffna,Northern,528,1695,2223,21120,67800,88920
9/17/2024,Shashini Perera,Jaffna,Jaffna,Northern,1969,3222,5191,78760,128880,207640
9/18/2024,Shashini Perera,Jaffna,Jaffna,Northern,2964,2548,5512,118560,101920,220480
9/19/2024,Shashini Perera,Jaffna,Jaffna,Northern,5525,5497,11022,221000,219880,440880
9/20/2024,Shashini Perera,Jaffna,Jaffna,Northern,2140,8337,10477,85600,333480,419080
9/21/2024,Shashini Perera,Jaffna,Jaffna,Northern,8810,5932,14742,352400,237280,589680
9/22/2024,Shashini Perera,Jaffna,Jaffna,Northern,1268,5041,6309,50720,201640,252360
9/23/2024,Shashini Perera,Jaffna,Jaffna,Northern,5493,3141,8634,219720,125640,345360
9/24/2024,Shashini Perera,Jaffna,Jaffna,Northern,3181,2309,5490,127240,92360,219600
9/25/2024,Shashini Perera,Jaffna,Jaffna,Northern,8869,5786,14655,354760,231440,586200
9/26/2024,Shashini Perera,Jaffna,Jaffna,Northern,1728,5339,7067,69120,213560,282680
9/27/2024,Shashini Perera,Jaffna,Jaffna,Northern,8588,9199,17787,343520,367960,711480
9/28/2024,Shashini Perera,Jaffna,Jaffna,Northern,2254,9954,12208,90160,398160,488320
9/29/2024,Shashini Perera,Jaffna,Jaffna,Northern,874,3043,3917,34960,121720,156680
9/30/2024,Shashini Perera,Jaffna,Jaffna,Northern,9502,9310,18812,380080,372400,752480
10/1/2024,Shashini Perera,Jaffna,Jaffna,Northern,2159,5926,8085,86360,237040,323400
10/2/2024,Shashini Perera,Jaffna,Jaffna,Northern,6802,7308,14110,272080,292320,564400
10/3/2024,Shashini Perera,Jaffna,Jaffna,Northern,9309,4309,13618,372360,172360,544720
10/4/2024,Shashini Perera,Jaffna,Jaffna,Northern,8580,6141,14721,343200,245640,588840
10/5/2024,Shashini Perera,Jaffna,Jaffna,Northern,3372,4029,7401,134880,161160,296040
10/6/2024,Shashini Perera,Jaffna,Jaffna,Northern,5490,9164,14654,219600,366560,586160
10/7/2024,Shashini Perera,Jaffna,Jaffna,Northern,5730,4434,10164,229200,177360,406560
10/8/2024,Shashini Perera,Jaffna,Jaffna,Northern,1439,4978,6417,57560,199120,256680
10/9/2024,Shashini Perera,Jaffna,Jaffna,Northern,8661,2970,11631,346440,118800,465240
10/10/2024,Shashini Perera,Jaffna,Jaffna,Northern,5759,3254,9013,230360,130160,360520
10/11/2024,Shashini Perera,Jaffna,Jaffna,Northern,1189,1700,2889,47560,68000,115560
10/12/2024,Shashini Perera,Jaffna,Jaffna,Northern,4181,3613,7794,167240,144520,311760
10/13/2024,Shashini Perera,Jaffna,Jaffna,Northern,550,2851,3401,22000,114040,136040
10/14/2024,Shashini Perera,Jaffna,Jaffna,Northern,4290,5582,9872,171600,223280,394880
10/15/2024,Shashini Perera,Jaffna,Jaffna,Northern,2310,3019,5329,92400,120760,213160
10/16/2024,Shashini Perera,Jaffna,Jaffna,Northern,1491,520,2011,59640,20800,80440
10/17/2024,Shashini Perera,Jaffna,Jaffna,Northern,2623,6157,8780,104920,246280,351200
10/18/2024,Shashini Perera,Jaffna,Jaffna,Northern,1655,7030,8685,66200,281200,347400
10/19/2024,Shashini Perera,Jaffna,Jaffna,Northern,461,8029,8490,18440,321160,339600
10/20/2024,Shashini Perera,Jaffna,Jaffna,Northern,8272,1541,9813,330880,61640,392520
10/21/2024,Shashini Perera,Jaffna,Jaffna,Northern,1934,8842,10776,77360,353680,431040
10/22/2024,Shashini Perera,Jaffna,Jaffna,Northern,1663,8481,10144,66520,339240,405760
10/23/2024,Shashini Perera,Jaffna,Jaffna,Northern,8123,7901,16024,324920,316040,640960
10/24/2024,Shashini Perera,Jaffna,Jaffna,Northern,9694,3428,13122,387760,137120,524880
10/25/2024,Shashini Perera,Jaffna,Jaffna,Northern,2218,5284,7502,88720,211360,300080
10/26/2024,Shashini Perera,Jaffna,Jaffna,Northern,5346,4453,9799,213840,178120,391960
10/27/2024,Shashini Perera,Jaffna,Jaffna,Northern,567,3376,3943,22680,135040,157720
10/28/2024,Shashini Perera,Jaffna,Jaffna,Northern,3081,3824,6905,123240,152960,276200
10/29/2024,Shashini Perera,Jaffna,Jaffna,Northern,5523,4965,10488,220920,198600,419520
10/30/2024,Shashini Perera,Jaffna,Jaffna,Northern,1710,9961,11671,68400,398440,466840
10/31/2024,Shashini Perera,Jaffna,Jaffna,Northern,4667,8728,13395,186680,349120,535800
11/1/2024,Shashini Perera,Jaffna,Jaffna,Northern,9392,1345,10737,375680,53800,429480
11/2/2024,Shashini Perera,Jaffna,Jaffna,Northern,8887,1106,9993,355480,44240,399720
11/3/2024,Shashini Perera,Jaffna,Jaffna,Northern,1166,8414,9580,46640,336560,383200
11/4/2024,Shashini Perera,Jaffna,Jaffna,Northern,3625,1896,5521,145000,75840,220840
11/5/2024,Shashini Perera,Jaffna,Jaffna,Northern,5326,4919,10245,213040,196760,409800
11/6/2024,Shashini Perera,Jaffna,Jaffna,Northern,2837,5412,8249,113480,216480,329960
11/7/2024,Shashini Perera,Jaffna,Jaffna,Northern,7536,8379,15915,301440,335160,636600
11/8/2024,Shashini Perera,Jaffna,Jaffna,Northern,8677,676,9353,347080,27040,374120
11/9/2024,Shashini Perera,Jaffna,Jaffna,Northern,6527,1908,8435,261080,76320,337400
11/10/2024,Shashini Perera,Jaffna,Jaffna,Northern,5557,5454,11011,222280,218160,440440
11/11/2024,Shashini Perera,Jaffna,Jaffna,Northern,8875,5674,14549,355000,226960,581960
11/12/2024,Shashini Perera,Jaffna,Jaffna,Northern,8535,2852,11387,341400,114080,455480
11/13/2024,Shashini Perera,Jaffna,Jaffna,Northern,9012,2084,11096,360480,83360,443840
11/14/2024,Shashini Perera,Jaffna,Jaffna,Northern,1266,6000,7266,50640,240000,290640
11/15/2024,Shashini Perera,Jaffna,Jaffna,Northern,5651,3091,8742,226040,123640,349680
11/16/2024,Shashini Perera,Jaffna,Jaffna,Northern,9276,5545,14821,371040,221800,592840
11/17/2024,Shashini Perera,Jaffna,Jaffna,Northern,2520,3192,5712,100800,127680,228480
11/18/2024,Shashini Perera,Jaffna,Jaffna,Northern,8277,6102,14379,331080,244080,575160
11/19/2024,Shashini Perera,Jaffna,Jaffna,Northern,7121,2092,9213,284840,83680,368520
11/20/2024,Shashini Perera,Jaffna,Jaffna,Northern,7275,4671,11946,291000,186840,477840
11/21/2024,Shashini Perera,Jaffna,Jaffna,Northern,1074,730,1804,42960,29200,72160
11/22/2024,Shashini Perera,Jaffna,Jaffna,Northern,9990,7623,17613,399600,304920,704520
11/23/2024,Shashini Perera,Jaffna,Jaffna,Northern,8927,8855,17782,357080,354200,711280
11/24/2024,Shashini Perera,Jaffna,Jaffna,Northern,1684,2010,3694,67360,80400,147760
11/25/2024,Shashini Perera,Jaffna,Jaffna,Northern,7160,4960,12120,286400,198400,484800
11/26/2024,Shashini Perera,Jaffna,Jaffna,Northern,2046,85,2131,81840,3400,85240
11/27/2024,Shashini Perera,Jaffna,Jaffna,Northern,9223,8246,17469,368920,329840,698760
11/28/2024,Shashini Perera,Jaffna,Jaffna,Northern,5551,4225,9776,222040,169000,391040
11/29/2024,Shashini Perera,Jaffna,Jaffna,Northern,7780,2644,10424,311200,105760,416960
11/30/2024,Shashini Perera,Jaffna,Jaffna,Northern,2848,1931,4779,113920,77240,191160
12/1/2024,Shashini Perera,Jaffna,Jaffna,Northern,2693,3893,6586,107720,155720,263440
12/2/2024,Shashini Perera,Jaffna,Jaffna,Northern,7554,2187,9741,302160,87480,389640
12/3/2024,Shashini Perera,Jaffna,Jaffna,Northern,8946,6226,15172,357840,249040,606880
12/4/2024,Shashini Perera,Jaffna,Jaffna,Northern,7318,4083,11401,292720,163320,456040
12/5/2024,Shashini Perera,Jaffna,Jaffna,Northern,8998,2942,11940,359920,117680,477600
12/6/2024,Shashini Perera,Jaffna,Jaffna,Northern,2384,7456,9840,95360,298240,393600
12/7/2024,Shashini Perera,Jaffna,Jaffna,Northern,1376,9202,10578,55040,368080,423120
12/8/2024,Shashini Perera,Jaffna,Jaffna,Northern,6151,366,6517,246040,14640,260680
12/9/2024,Shashini Perera,Jaffna,Jaffna,Northern,2132,7269,9401,85280,290760,376040
12/10/2024,Shashini Perera,Jaffna,Jaffna,Northern,4015,6173,10188,160600,246920,407520
12/11/2024,Shashini Perera,Jaffna,Jaffna,Northern,7956,8741,16697,318240,349640,667880
12/12/2024,Shashini Perera,Jaffna,Jaffna,Northern,3929,5524,9453,157160,220960,378120
12/13/2024,Shashini Perera,Jaffna,Jaffna,Northern,5245,7604,12849,209800,304160,513960
12/14/2024,Shashini Perera,Jaffna,Jaffna,Northern,3402,2476,5878,136080,99040,235120
12/15/2024,Shashini Perera,Jaffna,Jaffna,Northern,3343,3778,7121,133720,151120,284840
12/16/2024,Shashini Perera,Jaffna,Jaffna,Northern,6504,1666,8170,260160,66640,326800
12/17/2024,Shashini Perera,Jaffna,Jaffna,Northern,6588,689,7277,263520,27560,291080
12/18/2024,Shashini Perera,Jaffna,Jaffna,Northern,9952,4446,14398,398080,177840,575920
12/19/2024,Shashini Perera,Jaffna,Jaffna,Northern,9653,4249,13902,386120,169960,556080
12/20/2024,Shashini Perera,Jaffna,Jaffna,Northern,3998,7137,11135,159920,285480,445400
12/21/2024,Shashini Perera,Jaffna,Jaffna,Northern,6537,2662,9199,261480,106480,367960
12/22/2024,Shashini Perera,Jaffna,Jaffna,Northern,5422,9611,15033,216880,384440,601320
12/23/2024,Shashini Perera,Jaffna,Jaffna,Northern,6072,4510,10582,242880,180400,423280
12/24/2024,Shashini Perera,Jaffna,Jaffna,Northern,1957,5513,7470,78280,220520,298800
12/25/2024,Shashini Perera,Jaffna,Jaffna,Northern,7930,5678,13608,317200,227120,544320
12/26/2024,Shashini Perera,Jaffna,Jaffna,Northern,1476,2166,3642,59040,86640,145680
12/27/2024,Shashini Perera,Jaffna,Jaffna,Northern,5545,5624,11169,221800,224960,446760
12/28/2024,Shashini Perera,Jaffna,Jaffna,Northern,1727,3811,5538,69080,152440,221520
12/29/2024,Shashini Perera,Jaffna,Jaffna,Northern,8086,5083,13169,323440,203320,526760
12/30/2024,Shashini Perera,Jaffna,Jaffna,Northern,5176,6327,11503,207040,253080,460120
12/31/2024,Shashini Perera,Jaffna,Jaffna,Northern,203,9279,9482,8120,371160,379280
1/1/2025,Shashini Perera,Jaffna,Jaffna,Northern,3652,5823,9475,146080,232920,379000
1/2/2025,Shashini Perera,Jaffna,Jaffna,Northern,6353,9202,15555,254120,368080,622200
1/3/2025,Shashini Perera,Jaffna,Jaffna,Northern,4905,9478,14383,196200,379120,575320
1/4/2025,Shashini Perera,Jaffna,Jaffna,Northern,1322,312,1634,52880,12480,65360
1/5/2025,Shashini Perera,Jaffna,Jaffna,Northern,398,1998,2396,15920,79920,95840
1/6/2025,Shashini Perera,Jaffna,Jaffna,Northern,9519,8469,17988,380760,338760,719520
1/7/2025,Shashini Perera,Jaffna,Jaffna,Northern,5398,3686,9084,215920,147440,363360
1/8/2025,Shashini Perera,Jaffna,Jaffna,Northern,968,3856,4824,38720,154240,192960
1/9/2025,Shashini Perera,Jaffna,Jaffna,Northern,7987,7216,15203,319480,288640,608120
1/10/2025,Shashini Perera,Jaffna,Jaffna,Northern,1854,5306,7160,74160,212240,286400
1/11/2025,Shashini Perera,Jaffna,Jaffna,Northern,5534,1316,6850,221360,52640,274000
1/12/2025,Shashini Perera,Jaffna,Jaffna,Northern,2353,752,3105,94120,30080,124200
1/13/2025,Shashini Perera,Jaffna,Jaffna,Northern,6875,1579,8454,275000,63160,338160
1/14/2025,Shashini Perera,Jaffna,Jaffna,Northern,4377,3952,8329,175080,158080,333160
1/15/2025,Shashini Perera,Jaffna,Jaffna,Northern,4569,6943,11512,182760,277720,460480
1/16/2025,Shashini Perera,Jaffna,Jaffna,Northern,932,8695,9627,37280,347800,385080
1/17/2025,Shashini Perera,Jaffna,Jaffna,Northern,1681,5521,7202,67240,220840,288080
1/18/2025,Shashini Perera,Jaffna,Jaffna,Northern,4740,3088,7828,189600,123520,313120
1/19/2025,Shashini Perera,Jaffna,Jaffna,Northern,4530,9039,13569,181200,361560,542760
1/20/2025,Shashini Perera,Jaffna,Jaffna,Northern,7301,1019,8320,292040,40760,332800
1/21/2025,Shashini Perera,Jaffna,Jaffna,Northern,9552,7963,17515,382080,318520,700600
1/22/2025,Shashini Perera,Jaffna,Jaffna,Northern,1721,627,2348,68840,25080,93920
1/23/2025,Shashini Perera,Jaffna,Jaffna,Northern,1,7996,7997,40,319840,319880
1/24/2025,Shashini Perera,Jaffna,Jaffna,Northern,623,6415,7038,24920,256600,281520
1/25/2025,Shashini Perera,Jaffna,Jaffna,Northern,6949,693,7642,277960,27720,305680
1/26/2025,Shashini Perera,Jaffna,Jaffna,Northern,1407,8020,9427,56280,320800,377080
1/27/2025,Shashini Perera,Jaffna,Jaffna,Northern,6242,9960,16202,249680,398400,648080
1/28/2025,Shashini Perera,Jaffna,Jaffna,Northern,4585,5731,10316,183400,229240,412640
1/29/2025,Shashini Perera,Jaffna,Jaffna,Northern,8747,6372,15119,349880,254880,604760
1/30/2025,Shashini Perera,Jaffna,Jaffna,Northern,6821,8003,14824,272840,320120,592960
1/31/2025,Shashini Perera,Jaffna,Jaffna,Northern,194,5551,5745,7760,222040,229800
2/1/2025,Shashini Perera,Jaffna,Jaffna,Northern,3473,8263,11736,138920,330520,469440
2/2/2025,Shashini Perera,Jaffna,Jaffna,Northern,8106,7759,15865,324240,310360,634600
2/3/2025,Shashini Perera,Jaffna,Jaffna,Northern,2428,5345,7773,97120,213800,310920
2/4/2025,Shashini Perera,Jaffna,Jaffna,Northern,1003,6618,7621,40120,264720,304840
2/5/2025,Shashini Perera,Jaffna,Jaffna,Northern,5598,6566,12164,223920,262640,486560
2/6/2025,Shashini Perera,Jaffna,Jaffna,Northern,3991,9466,13457,159640,378640,538280
2/7/2025,Shashini Perera,Jaffna,Jaffna,Northern,273,1812,2085,10920,72480,83400
2/8/2025,Shashini Perera,Jaffna,Jaffna,Northern,1059,9702,10761,42360,388080,430440
2/9/2025,Shashini Perera,Jaffna,Jaffna,Northern,3006,5665,8671,120240,226600,346840
2/10/2025,Shashini Perera,Jaffna,Jaffna,Northern,917,3529,4446,36680,141160,177840
2/11/2025,Shashini Perera,Jaffna,Jaffna,Northern,4623,3914,8537,184920,156560,341480
2/12/2025,Shashini Perera,Jaffna,Jaffna,Northern,4256,5959,10215,170240,238360,408600
2/13/2025,Shashini Perera,Jaffna,Jaffna,Northern,8254,7146,15400,330160,285840,616000
2/14/2025,Shashini Perera,Jaffna,Jaffna,Northern,8878,9366,18244,355120,374640,729760
2/15/2025,Shashini Perera,Jaffna,Jaffna,Northern,256,7344,7600,10240,293760,304000
2/16/2025,Shashini Perera,Jaffna,Jaffna,Northern,4773,5073,9846,190920,202920,393840
2/17/2025,Shashini Perera,Jaffna,Jaffna,Northern,44,7709,7753,1760,308360,310120
2/18/2025,Shashini Perera,Jaffna,Jaffna,Northern,3667,7027,10694,146680,281080,427760
2/19/2025,Shashini Perera,Jaffna,Jaffna,Northern,3845,395,4240,153800,15800,169600
2/20/2025,Shashini Perera,Jaffna,Jaffna,Northern,9359,8822,18181,374360,352880,727240
2/21/2025,Shashini Perera,Jaffna,Jaffna,Northern,2995,9515,12510,119800,380600,500400
2/22/2025,Shashini Perera,Jaffna,Jaffna,Northern,7039,2856,9895,281560,114240,395800
2/23/2025,Shashini Perera,Jaffna,Jaffna,Northern,6148,9871,16019,245920,394840,640760
2/24/2025,Shashini Perera,Jaffna,Jaffna,Northern,6710,1395,8105,268400,55800,324200
2/25/2025,Shashini Perera,Jaffna,Jaffna,Northern,366,8187,8553,14640,327480,342120
2/26/2025,Shashini Perera,Jaffna,Jaffna,Northern,586,4642,5228,23440,185680,209120
2/27/2025,Shashini Perera,Jaffna,Jaffna,Northern,4293,3976,8269,171720,159040,330760
2/28/2025,Shashini Perera,Jaffna,Jaffna,Northern,1124,3054,4178,44960,122160,167120
3/1/2025,Shashini Perera,Jaffna,Jaffna,Northern,9926,2390,12316,397040,95600,492640
3/2/2025,Shashini Perera,Jaffna,Jaffna,Northern,1987,7853,9840,79480,314120,393600
3/3/2025,Shashini Perera,Jaffna,Jaffna,Northern,3083,3103,6186,123320,124120,247440
3/4/2025,Shashini Perera,Jaffna,Jaffna,Northern,205,1793,1998,8200,71720,79920
3/5/2025,Shashini Perera,Jaffna,Jaffna,Northern,635,1908,2543,25400,76320,101720
3/6/2025,Shashini Perera,Jaffna,Jaffna,Northern,8417,1922,10339,336680,76880,413560
3/7/2025,Shashini Perera,Jaffna,Jaffna,Northern,8767,4112,12879,350680,164480,515160
3/8/2025,Shashini Perera,Jaffna,Jaffna,Northern,421,1278,1699,16840,51120,67960
3/9/2025,Shashini Perera,Jaffna,Jaffna,Northern,8537,5210,13747,341480,208400,549880
3/10/2025,Shashini Perera,Jaffna,Jaffna,Northern,2915,1897,4812,116600,75880,192480
3/11/2025,Shashini Perera,Jaffna,Jaffna,Northern,6109,4803,10912,244360,192120,436480
3/12/2025,Shashini Perera,Jaffna,Jaffna,Northern,8192,8500,16692,327680,340000,667680
3/13/2025,Shashini Perera,Jaffna,Jaffna,Northern,2983,4873,7856,119320,194920,314240
3/14/2025,Shashini Perera,Jaffna,Jaffna,Northern,9620,631,10251,384800,25240,410040
3/15/2025,Shashini Perera,Jaffna,Jaffna,Northern,6794,4713,11507,271760,188520,460280
3/16/2025,Shashini Perera,Jaffna,Jaffna,Northern,4275,9499,13774,171000,379960,550960
3/17/2025,Shashini Perera,Jaffna,Jaffna,Northern,6214,5595,11809,248560,223800,472360
3/18/2025,Shashini Perera,Jaffna,Jaffna,Northern,8228,8218,16446,329120,328720,657840
3/19/2025,Shashini Perera,Jaffna,Jaffna,Northern,2779,3424,6203,111160,136960,248120
3/20/2025,Shashini Perera,Jaffna,Jaffna,Northern,3818,5088,8906,152720,203520,356240
3/21/2025,Shashini Perera,Jaffna,Jaffna,Northern,3885,7909,11794,155400,316360,471760
3/22/2025,Shashini Perera,Jaffna,Jaffna,Northern,3263,7631,10894,130520,305240,435760
3/23/2025,Shashini Perera,Jaffna,Jaffna,Northern,6799,8212,15011,271960,328480,600440
3/25/2024,Kavindi Liyanage,Puttalam,Marawila,North Western,1647,7386,9033,65880,295440,361320
3/26/2024,Kavindi Liyanage,Puttalam,Marawila,North Western,452,4427,4879,18080,177080,195160
3/27/2024,Kavindi Liyanage,Puttalam,Marawila,North Western,7550,2591,10141,302000,103640,405640
3/28/2024,Kavindi Liyanage,Puttalam,Marawila,North Western,9806,1538,11344,392240,61520,453760
3/29/2024,Kavindi Liyanage,Puttalam,Marawila,North Western,6461,9869,16330,258440,394760,653200
3/30/2024,Kavindi Liyanage,Puttalam,Marawila,North Western,7264,138,7402,290560,5520,296080
3/31/2024,Kavindi Liyanage,Puttalam,Marawila,North Western,4962,5587,10549,198480,223480,421960
4/1/2024,Kavindi Liyanage,Puttalam,Marawila,North Western,2603,1994,4597,104120,79760,183880
4/2/2024,Kavindi Liyanage,Puttalam,Marawila,North Western,3301,2222,5523,132040,88880,220920
4/3/2024,Kavindi Liyanage,Puttalam,Marawila,North Western,132,4814,4946,5280,192560,197840
4/4/2024,Kavindi Liyanage,Puttalam,Marawila,North Western,8235,8358,16593,329400,334320,663720
4/5/2024,Kavindi Liyanage,Puttalam,Marawila,North Western,7501,4226,11727,300040,169040,469080
4/6/2024,Kavindi Liyanage,Puttalam,Marawila,North Western,3402,4483,7885,136080,179320,315400
4/7/2024,Kavindi Liyanage,Puttalam,Marawila,North Western,4065,7773,11838,162600,310920,473520
4/8/2024,Kavindi Liyanage,Puttalam,Marawila,North Western,7432,2560,9992,297280,102400,399680
4/9/2024,Kavindi Liyanage,Puttalam,Marawila,North Western,6771,8886,15657,270840,355440,626280
4/10/2024,Kavindi Liyanage,Puttalam,Marawila,North Western,6020,4006,10026,240800,160240,401040
4/11/2024,Kavindi Liyanage,Puttalam,Marawila,North Western,5513,6804,12317,220520,272160,492680
4/19/2024,Kavindi Liyanage,Puttalam,Marawila,North Western,959,6506,7465,38360,260240,298600
4/20/2024,Kavindi Liyanage,Puttalam,Marawila,North Western,449,38,487,17960,1520,19480
4/21/2024,Kavindi Liyanage,Puttalam,Marawila,North Western,1966,9492,11458,78640,379680,458320
4/22/2024,Kavindi Liyanage,Puttalam,Marawila,North Western,8880,9303,18183,355200,372120,727320
4/23/2024,Kavindi Liyanage,Puttalam,Marawila,North Western,3607,4346,7953,144280,173840,318120
4/24/2024,Kavindi Liyanage,Puttalam,Marawila,North Western,9787,4162,13949,391480,166480,557960
4/25/2024,Kavindi Liyanage,Puttalam,Marawila,North Western,3932,4402,8334,157280,176080,333360
4/26/2024,Kavindi Liyanage,Puttalam,Marawila,North Western,6793,186,6979,271720,7440,279160
4/27/2024,Kavindi Liyanage,Puttalam,Marawila,North Western,9678,5088,14766,387120,203520,590640
4/28/2024,Kavindi Liyanage,Puttalam,Marawila,North Western,9781,506,10287,391240,20240,411480
4/29/2024,Kavindi Liyanage,Puttalam,Marawila,North Western,3666,7033,10699,146640,281320,427960
4/30/2024,Kavindi Liyanage,Puttalam,Marawila,North Western,7268,6774,14042,290720,270960,561680
5/1/2024,Kavindi Liyanage,Puttalam,Marawila,North Western,2046,9966,12012,81840,398640,480480
5/2/2024,Kavindi Liyanage,Puttalam,Marawila,North Western,3589,6352,9941,143560,254080,397640
5/3/2024,Kavindi Liyanage,Puttalam,Marawila,North Western,4145,8095,12240,165800,323800,489600
5/4/2024,Kavindi Liyanage,Puttalam,Marawila,North Western,9687,9217,18904,387480,368680,756160
5/5/2024,Kavindi Liyanage,Puttalam,Marawila,North Western,6149,8278,14427,245960,331120,577080
5/6/2024,Kavindi Liyanage,Puttalam,Marawila,North Western,1404,4064,5468,56160,162560,218720
5/7/2024,Kavindi Liyanage,Puttalam,Marawila,North Western,3238,7943,11181,129520,317720,447240
5/8/2024,Kavindi Liyanage,Puttalam,Marawila,North Western,6255,7091,13346,250200,283640,533840
5/9/2024,Kavindi Liyanage,Puttalam,Marawila,North Western,6296,4413,10709,251840,176520,428360
5/10/2024,Kavindi Liyanage,Puttalam,Marawila,North Western,6915,6835,13750,276600,273400,550000
5/11/2024,Kavindi Liyanage,Puttalam,Marawila,North Western,1943,937,2880,77720,37480,115200
5/12/2024,Kavindi Liyanage,Puttalam,Marawila,North Western,6838,453,7291,273520,18120,291640
5/13/2024,Kavindi Liyanage,Puttalam,Marawila,North Western,4505,7623,12128,180200,304920,485120
5/14/2024,Kavindi Liyanage,Puttalam,Marawila,North Western,5956,8866,14822,238240,354640,592880
5/15/2024,Kavindi Liyanage,Puttalam,Marawila,North Western,198,5831,6029,7920,233240,241160
5/16/2024,Kavindi Liyanage,Puttalam,Marawila,North Western,2923,41,2964,116920,1640,118560
5/17/2024,Kavindi Liyanage,Puttalam,Marawila,North Western,8287,5541,13828,331480,221640,553120
5/18/2024,Kavindi Liyanage,Puttalam,Marawila,North Western,3429,6388,9817,137160,255520,392680
5/19/2024,Kavindi Liyanage,Puttalam,Marawila,North Western,8578,9951,18529,343120,398040,741160
5/20/2024,Kavindi Liyanage,Puttalam,Marawila,North Western,8812,6023,14835,352480,240920,593400
5/21/2024,Kavindi Liyanage,Puttalam,Marawila,North Western,5007,2441,7448,200280,97640,297920
5/22/2024,Kavindi Liyanage,Puttalam,Marawila,North Western,1497,9421,10918,59880,376840,436720
5/24/2024,Kavindi Liyanage,Puttalam,Marawila,North Western,1813,9569,11382,72520,382760,455280
5/25/2024,Kavindi Liyanage,Puttalam,Marawila,North Western,7694,3624,11318,307760,144960,452720
5/26/2024,Kavindi Liyanage,Puttalam,Marawila,North Western,6768,1546,8314,270720,61840,332560
5/27/2024,Kavindi Liyanage,Puttalam,Marawila,North Western,7654,6937,14591,306160,277480,583640
5/28/2024,Kavindi Liyanage,Puttalam,Marawila,North Western,4256,6098,10354,170240,243920,414160
5/29/2024,Kavindi Liyanage,Puttalam,Marawila,North Western,388,6861,7249,15520,274440,289960
5/30/2024,Kavindi Liyanage,Puttalam,Marawila,North Western,4196,8573,12769,167840,342920,510760
5/31/2024,Kavindi Liyanage,Puttalam,Marawila,North Western,8519,2601,11120,340760,104040,444800
6/1/2024,Kavindi Liyanage,Puttalam,Marawila,North Western,5032,3602,8634,201280,144080,345360
6/2/2024,Kavindi Liyanage,Puttalam,Marawila,North Western,6115,6453,12568,244600,258120,502720
6/3/2024,Kavindi Liyanage,Puttalam,Marawila,North Western,7760,1789,9549,310400,71560,381960
6/4/2024,Kavindi Liyanage,Puttalam,Marawila,North Western,7292,7099,14391,291680,283960,575640
6/5/2024,Kavindi Liyanage,Puttalam,Marawila,North Western,3919,3095,7014,156760,123800,280560
6/6/2024,Kavindi Liyanage,Puttalam,Marawila,North Western,6233,9456,15689,249320,378240,627560
6/7/2024,Kavindi Liyanage,Puttalam,Marawila,North Western,2108,3816,5924,84320,152640,236960
6/8/2024,Kavindi Liyanage,Puttalam,Marawila,North Western,4339,9322,13661,173560,372880,546440
6/9/2024,Kavindi Liyanage,Puttalam,Marawila,North Western,446,3671,4117,17840,146840,164680
6/10/2024,Kavindi Liyanage,Puttalam,Marawila,North Western,2660,8094,10754,106400,323760,430160
6/11/2024,Kavindi Liyanage,Puttalam,Marawila,North Western,9953,5940,15893,398120,237600,635720
6/12/2024,Kavindi Liyanage,Puttalam,Marawila,North Western,2445,8863,11308,97800,354520,452320
6/13/2024,Kavindi Liyanage,Puttalam,Marawila,North Western,8797,6154,14951,351880,246160,598040
6/14/2024,Kavindi Liyanage,Puttalam,Marawila,North Western,7803,1563,9366,312120,62520,374640
6/15/2024,Kavindi Liyanage,Puttalam,Marawila,North Western,7219,5126,12345,288760,205040,493800
6/16/2024,Kavindi Liyanage,Puttalam,Marawila,North Western,5984,1684,7668,239360,67360,306720
6/17/2024,Kavindi Liyanage,Puttalam,Marawila,North Western,8067,162,8229,322680,6480,329160
6/18/2024,Kavindi Liyanage,Puttalam,Marawila,North Western,9144,133,9277,365760,5320,371080
6/19/2024,Kavindi Liyanage,Puttalam,Marawila,North Western,4471,5558,10029,178840,222320,401160
6/20/2024,Kavindi Liyanage,Puttalam,Marawila,North Western,548,4541,5089,21920,181640,203560
6/21/2024,Kavindi Liyanage,Puttalam,Marawila,North Western,773,6368,7141,30920,254720,285640
6/22/2024,Kavindi Liyanage,Puttalam,Marawila,North Western,7627,4271,11898,305080,170840,475920
6/23/2024,Kavindi Liyanage,Puttalam,Marawila,North Western,232,176,408,9280,7040,16320
6/24/2024,Kavindi Liyanage,Puttalam,Marawila,North Western,2477,227,2704,99080,9080,108160
6/25/2024,Kavindi Liyanage,Puttalam,Marawila,North Western,1729,4274,6003,69160,170960,240120
6/26/2024,Kavindi Liyanage,Puttalam,Marawila,North Western,6156,2781,8937,246240,111240,357480
6/27/2024,Kavindi Liyanage,Puttalam,Marawila,North Western,7998,70,8068,319920,2800,322720
6/28/2024,Kavindi Liyanage,Puttalam,Marawila,North Western,3127,2368,5495,125080,94720,219800
6/29/2024,Kavindi Liyanage,Puttalam,Marawila,North Western,9027,8536,17563,361080,341440,702520
6/30/2024,Kavindi Liyanage,Puttalam,Marawila,North Western,8542,1475,10017,341680,59000,400680
7/1/2024,Kavindi Liyanage,Puttalam,Marawila,North Western,3413,1591,5004,136520,63640,200160
7/2/2024,Kavindi Liyanage,Puttalam,Marawila,North Western,7591,9758,17349,303640,390320,693960
7/3/2024,Kavindi Liyanage,Puttalam,Marawila,North Western,1172,253,1425,46880,10120,57000
7/4/2024,Kavindi Liyanage,Puttalam,Marawila,North Western,5472,1641,7113,218880,65640,284520
7/5/2024,Kavindi Liyanage,Puttalam,Marawila,North Western,932,5822,6754,37280,232880,270160
7/6/2024,Kavindi Liyanage,Puttalam,Marawila,North Western,4103,2761,6864,164120,110440,274560
7/7/2024,Kavindi Liyanage,Puttalam,Marawila,North Western,5879,5485,11364,235160,219400,454560
7/8/2024,Kavindi Liyanage,Puttalam,Marawila,North Western,6585,200,6785,263400,8000,271400
7/9/2024,Kavindi Liyanage,Puttalam,Marawila,North Western,9360,1485,10845,374400,59400,433800
7/10/2024,Kavindi Liyanage,Puttalam,Marawila,North Western,3737,5651,9388,149480,226040,375520
7/11/2024,Kavindi Liyanage,Puttalam,Marawila,North Western,5158,6430,11588,206320,257200,463520
7/12/2024,Kavindi Liyanage,Puttalam,Marawila,North Western,3875,9856,13731,155000,394240,549240
7/13/2024,Kavindi Liyanage,Puttalam,Marawila,North Western,1864,2591,4455,74560,103640,178200
7/14/2024,Kavindi Liyanage,Puttalam,Marawila,North Western,2107,867,2974,84280,34680,118960
7/15/2024,Kavindi Liyanage,Puttalam,Marawila,North Western,2647,4771,7418,105880,190840,296720
7/16/2024,Kavindi Liyanage,Puttalam,Marawila,North Western,3496,5197,8693,139840,207880,347720
7/17/2024,Kavindi Liyanage,Puttalam,Marawila,North Western,1481,1849,3330,59240,73960,133200
7/18/2024,Kavindi Liyanage,Puttalam,Marawila,North Western,9893,3500,13393,395720,140000,535720
7/19/2024,Kavindi Liyanage,Puttalam,Marawila,North Western,1288,498,1786,51520,19920,71440
7/20/2024,Kavindi Liyanage,Puttalam,Marawila,North Western,9356,6732,16088,374240,269280,643520
7/21/2024,Kavindi Liyanage,Puttalam,Marawila,North Western,2548,876,3424,101920,35040,136960
7/22/2024,Kavindi Liyanage,Puttalam,Marawila,North Western,9174,8835,18009,366960,353400,720360
7/23/2024,Kavindi Liyanage,Puttalam,Marawila,North Western,8465,4105,12570,338600,164200,502800
7/24/2024,Kavindi Liyanage,Puttalam,Marawila,North Western,3254,9602,12856,130160,384080,514240
7/25/2024,Kavindi Liyanage,Puttalam,Marawila,North Western,3360,1378,4738,134400,55120,189520
7/26/2024,Kavindi Liyanage,Puttalam,Marawila,North Western,3671,3016,6687,146840,120640,267480
7/27/2024,Kavindi Liyanage,Puttalam,Marawila,North Western,810,7603,8413,32400,304120,336520
7/28/2024,Kavindi Liyanage,Puttalam,Marawila,North Western,5905,8894,14799,236200,355760,591960
7/29/2024,Kavindi Liyanage,Puttalam,Marawila,North Western,4067,6242,10309,162680,249680,412360
7/30/2024,Kavindi Liyanage,Puttalam,Marawila,North Western,3632,850,4482,145280,34000,179280
7/31/2024,Kavindi Liyanage,Puttalam,Marawila,North Western,8749,9969,18718,349960,398760,748720
8/1/2024,Kavindi Liyanage,Puttalam,Marawila,North Western,8224,5845,14069,328960,233800,562760
8/2/2024,Kavindi Liyanage,Puttalam,Marawila,North Western,803,1932,2735,32120,77280,109400
8/3/2024,Kavindi Liyanage,Puttalam,Marawila,North Western,4409,9323,13732,176360,372920,549280
8/4/2024,Kavindi Liyanage,Puttalam,Marawila,North Western,7046,8753,15799,281840,350120,631960
8/5/2024,Kavindi Liyanage,Puttalam,Marawila,North Western,6416,9837,16253,256640,393480,650120
8/6/2024,Kavindi Liyanage,Puttalam,Marawila,North Western,1494,6513,8007,59760,260520,320280
8/7/2024,Kavindi Liyanage,Puttalam,Marawila,North Western,3314,7487,10801,132560,299480,432040
8/8/2024,Kavindi Liyanage,Puttalam,Marawila,North Western,5189,7832,13021,207560,313280,520840
8/9/2024,Kavindi Liyanage,Puttalam,Marawila,North Western,9507,6238,15745,380280,249520,629800
8/10/2024,Kavindi Liyanage,Puttalam,Marawila,North Western,3272,1759,5031,130880,70360,201240
8/11/2024,Kavindi Liyanage,Puttalam,Marawila,North Western,268,2768,3036,10720,110720,121440
8/12/2024,Kavindi Liyanage,Puttalam,Marawila,North Western,508,3436,3944,20320,137440,157760
8/13/2024,Kavindi Liyanage,Puttalam,Marawila,North Western,773,4359,5132,30920,174360,205280
8/14/2024,Kavindi Liyanage,Puttalam,Marawila,North Western,9269,3835,13104,370760,153400,524160
8/15/2024,Kavindi Liyanage,Puttalam,Marawila,North Western,3348,6964,10312,133920,278560,412480
8/16/2024,Kavindi Liyanage,Puttalam,Marawila,North Western,183,6254,6437,7320,250160,257480
8/17/2024,Kavindi Liyanage,Puttalam,Marawila,North Western,4560,1969,6529,182400,78760,261160
8/18/2024,Kavindi Liyanage,Puttalam,Marawila,North Western,2840,3241,6081,113600,129640,243240
8/19/2024,Kavindi Liyanage,Puttalam,Marawila,North Western,4739,5746,10485,189560,229840,419400
8/20/2024,Kavindi Liyanage,Puttalam,Marawila,North Western,9513,7645,17158,380520,305800,686320
8/21/2024,Kavindi Liyanage,Puttalam,Marawila,North Western,7133,4361,11494,285320,174440,459760
8/22/2024,Kavindi Liyanage,Puttalam,Marawila,North Western,5906,5825,11731,236240,233000,469240
8/23/2024,Kavindi Liyanage,Puttalam,Marawila,North Western,2736,1302,4038,109440,52080,161520
8/24/2024,Kavindi Liyanage,Puttalam,Marawila,North Western,9413,9869,19282,376520,394760,771280
8/25/2024,Kavindi Liyanage,Puttalam,Marawila,North Western,7528,9599,17127,301120,383960,685080
8/26/2024,Kavindi Liyanage,Puttalam,Marawila,North Western,2685,8203,10888,107400,328120,435520
8/27/2024,Kavindi Liyanage,Puttalam,Marawila,North Western,1998,6091,8089,79920,243640,323560
8/28/2024,Kavindi Liyanage,Puttalam,Marawila,North Western,4782,9069,13851,191280,362760,554040
8/29/2024,Kavindi Liyanage,Puttalam,Marawila,North Western,3595,9687,13282,143800,387480,531280
8/30/2024,Kavindi Liyanage,Puttalam,Marawila,North Western,6984,3861,10845,279360,154440,433800
8/31/2024,Kavindi Liyanage,Puttalam,Marawila,North Western,2331,1838,4169,93240,73520,166760
9/1/2024,Kavindi Liyanage,Puttalam,Marawila,North Western,7630,2081,9711,305200,83240,388440
9/2/2024,Kavindi Liyanage,Puttalam,Marawila,North Western,1655,4912,6567,66200,196480,262680
9/3/2024,Kavindi Liyanage,Puttalam,Marawila,North Western,1653,1657,3310,66120,66280,132400
9/4/2024,Kavindi Liyanage,Puttalam,Marawila,North Western,105,5806,5911,4200,232240,236440
9/5/2024,Kavindi Liyanage,Puttalam,Marawila,North Western,1647,6333,7980,65880,253320,319200
9/6/2024,Kavindi Liyanage,Puttalam,Marawila,North Western,8683,2355,11038,347320,94200,441520
9/7/2024,Kavindi Liyanage,Puttalam,Marawila,North Western,7810,2803,10613,312400,112120,424520
9/8/2024,Kavindi Liyanage,Puttalam,Marawila,North Western,2720,8869,11589,108800,354760,463560
9/9/2024,Kavindi Liyanage,Puttalam,Marawila,North Western,4327,7744,12071,173080,309760,482840
9/10/2024,Kavindi Liyanage,Puttalam,Marawila,North Western,6328,2611,8939,253120,104440,357560
9/11/2024,Kavindi Liyanage,Puttalam,Marawila,North Western,5580,6795,12375,223200,271800,495000
9/12/2024,Kavindi Liyanage,Puttalam,Marawila,North Western,9614,6937,16551,384560,277480,662040
9/13/2024,Kavindi Liyanage,Puttalam,Marawila,North Western,3771,9395,13166,150840,375800,526640
9/14/2024,Kavindi Liyanage,Puttalam,Marawila,North Western,6014,7871,13885,240560,314840,555400
9/15/2024,Kavindi Liyanage,Puttalam,Marawila,North Western,217,4982,5199,8680,199280,207960
9/16/2024,Kavindi Liyanage,Puttalam,Marawila,North Western,9915,812,10727,396600,32480,429080
9/17/2024,Kavindi Liyanage,Puttalam,Marawila,North Western,9871,8141,18012,394840,325640,720480
9/18/2024,Kavindi Liyanage,Puttalam,Marawila,North Western,5138,2403,7541,205520,96120,301640
9/19/2024,Kavindi Liyanage,Puttalam,Marawila,North Western,9670,3247,12917,386800,129880,516680
9/20/2024,Kavindi Liyanage,Puttalam,Marawila,North Western,163,8250,8413,6520,330000,336520
9/21/2024,Kavindi Liyanage,Puttalam,Marawila,North Western,7092,8888,15980,283680,355520,639200
9/22/2024,Kavindi Liyanage,Puttalam,Marawila,North Western,3621,4382,8003,144840,175280,320120
9/23/2024,Kavindi Liyanage,Puttalam,Marawila,North Western,1081,1124,2205,43240,44960,88200
9/24/2024,Kavindi Liyanage,Puttalam,Marawila,North Western,6265,2888,9153,250600,115520,366120
9/25/2024,Kavindi Liyanage,Puttalam,Marawila,North Western,5720,1902,7622,228800,76080,304880
9/26/2024,Kavindi Liyanage,Puttalam,Marawila,North Western,9194,4880,14074,367760,195200,562960
9/27/2024,Kavindi Liyanage,Puttalam,Marawila,North Western,2756,5178,7934,110240,207120,317360
9/28/2024,Kavindi Liyanage,Puttalam,Marawila,North Western,1180,1557,2737,47200,62280,109480
9/29/2024,Kavindi Liyanage,Puttalam,Marawila,North Western,1656,3533,5189,66240,141320,207560
9/30/2024,Kavindi Liyanage,Puttalam,Marawila,North Western,1463,9873,11336,58520,394920,453440
10/1/2024,Kavindi Liyanage,Puttalam,Marawila,North Western,2230,5981,8211,89200,239240,328440
10/2/2024,Kavindi Liyanage,Puttalam,Marawila,North Western,3088,6044,9132,123520,241760,365280
10/3/2024,Kavindi Liyanage,Puttalam,Marawila,North Western,3601,1041,4642,144040,41640,185680
10/4/2024,Kavindi Liyanage,Puttalam,Marawila,North Western,4633,838,5471,185320,33520,218840
10/5/2024,Kavindi Liyanage,Puttalam,Marawila,North Western,734,2319,3053,29360,92760,122120
10/6/2024,Kavindi Liyanage,Puttalam,Marawila,North Western,5411,7209,12620,216440,288360,504800
10/7/2024,Kavindi Liyanage,Puttalam,Marawila,North Western,3191,7310,10501,127640,292400,420040
10/8/2024,Kavindi Liyanage,Puttalam,Marawila,North Western,5027,2179,7206,201080,87160,288240
10/9/2024,Kavindi Liyanage,Puttalam,Marawila,North Western,2570,6021,8591,102800,240840,343640
10/10/2024,Kavindi Liyanage,Puttalam,Marawila,North Western,3776,1290,5066,151040,51600,202640
10/11/2024,Kavindi Liyanage,Puttalam,Marawila,North Western,2648,2461,5109,105920,98440,204360
10/12/2024,Kavindi Liyanage,Puttalam,Marawila,North Western,8317,6703,15020,332680,268120,600800
10/13/2024,Kavindi Liyanage,Puttalam,Marawila,North Western,7710,8685,16395,308400,347400,655800
10/14/2024,Kavindi Liyanage,Puttalam,Marawila,North Western,3756,3352,7108,150240,134080,284320
10/15/2024,Kavindi Liyanage,Puttalam,Marawila,North Western,8834,577,9411,353360,23080,376440
10/16/2024,Kavindi Liyanage,Puttalam,Marawila,North Western,953,8237,9190,38120,329480,367600
10/17/2024,Kavindi Liyanage,Puttalam,Marawila,North Western,4894,3176,8070,195760,127040,322800
10/18/2024,Kavindi Liyanage,Puttalam,Marawila,North Western,5293,1145,6438,211720,45800,257520
10/19/2024,Kavindi Liyanage,Puttalam,Marawila,North Western,9840,1486,11326,393600,59440,453040
10/20/2024,Kavindi Liyanage,Puttalam,Marawila,North Western,6711,6344,13055,268440,253760,522200
10/21/2024,Kavindi Liyanage,Puttalam,Marawila,North Western,4686,5131,9817,187440,205240,392680
10/22/2024,Kavindi Liyanage,Puttalam,Marawila,North Western,4871,1683,6554,194840,67320,262160
10/23/2024,Kavindi Liyanage,Puttalam,Marawila,North Western,9278,1676,10954,371120,67040,438160
10/24/2024,Kavindi Liyanage,Puttalam,Marawila,North Western,8440,7459,15899,337600,298360,635960
10/25/2024,Kavindi Liyanage,Puttalam,Marawila,North Western,463,4376,4839,18520,175040,193560
10/26/2024,Kavindi Liyanage,Puttalam,Marawila,North Western,4935,5150,10085,197400,206000,403400
10/27/2024,Kavindi Liyanage,Puttalam,Marawila,North Western,2503,7686,10189,100120,307440,407560
10/28/2024,Kavindi Liyanage,Puttalam,Marawila,North Western,7384,564,7948,295360,22560,317920
10/29/2024,Kavindi Liyanage,Puttalam,Marawila,North Western,6,7459,7465,240,298360,298600
10/30/2024,Kavindi Liyanage,Puttalam,Marawila,North Western,7150,9740,16890,286000,389600,675600
10/31/2024,Kavindi Liyanage,Puttalam,Marawila,North Western,2714,2557,5271,108560,102280,210840
11/1/2024,Kavindi Liyanage,Puttalam,Marawila,North Western,7952,8853,16805,318080,354120,672200
11/2/2024,Kavindi Liyanage,Puttalam,Marawila,North Western,7973,2759,10732,318920,110360,429280
11/3/2024,Kavindi Liyanage,Puttalam,Marawila,North Western,7388,7437,14825,295520,297480,593000
11/4/2024,Kavindi Liyanage,Puttalam,Marawila,North Western,3711,3613,7324,148440,144520,292960
11/5/2024,Kavindi Liyanage,Puttalam,Marawila,North Western,7268,6410,13678,290720,256400,547120
11/6/2024,Kavindi Liyanage,Puttalam,Marawila,North Western,2272,5050,7322,90880,202000,292880
11/7/2024,Kavindi Liyanage,Puttalam,Marawila,North Western,7948,4798,12746,317920,191920,509840
11/8/2024,Kavindi Liyanage,Puttalam,Marawila,North Western,890,9328,10218,35600,373120,408720
11/9/2024,Kavindi Liyanage,Puttalam,Marawila,North Western,7203,2548,9751,288120,101920,390040
11/10/2024,Kavindi Liyanage,Puttalam,Marawila,North Western,4625,8197,12822,185000,327880,512880
11/11/2024,Kavindi Liyanage,Puttalam,Marawila,North Western,6195,6729,12924,247800,269160,516960
11/12/2024,Kavindi Liyanage,Puttalam,Marawila,North Western,9284,1752,11036,371360,70080,441440
11/13/2024,Kavindi Liyanage,Puttalam,Marawila,North Western,1956,1556,3512,78240,62240,140480
11/14/2024,Kavindi Liyanage,Puttalam,Marawila,North Western,6678,1392,8070,267120,55680,322800
11/15/2024,Kavindi Liyanage,Puttalam,Marawila,North Western,407,2108,2515,16280,84320,100600
11/16/2024,Kavindi Liyanage,Puttalam,Marawila,North Western,3295,313,3608,131800,12520,144320
11/17/2024,Kavindi Liyanage,Puttalam,Marawila,North Western,7487,2501,9988,299480,100040,399520
11/18/2024,Kavindi Liyanage,Puttalam,Marawila,North Western,3517,6804,10321,140680,272160,412840
11/19/2024,Kavindi Liyanage,Puttalam,Marawila,North Western,7437,7760,15197,297480,310400,607880
11/20/2024,Kavindi Liyanage,Puttalam,Marawila,North Western,9070,7340,16410,362800,293600,656400
11/21/2024,Kavindi Liyanage,Puttalam,Marawila,North Western,3975,6074,10049,159000,242960,401960
11/22/2024,Kavindi Liyanage,Puttalam,Marawila,North Western,8170,5462,13632,326800,218480,545280
11/23/2024,Kavindi Liyanage,Puttalam,Marawila,North Western,2389,5665,8054,95560,226600,322160
11/24/2024,Kavindi Liyanage,Puttalam,Marawila,North Western,5616,1518,7134,224640,60720,285360
11/25/2024,Kavindi Liyanage,Puttalam,Marawila,North Western,3982,2770,6752,159280,110800,270080
11/26/2024,Kavindi Liyanage,Puttalam,Marawila,North Western,837,151,988,33480,6040,39520
11/27/2024,Kavindi Liyanage,Puttalam,Marawila,North Western,9407,1023,10430,376280,40920,417200
11/28/2024,Kavindi Liyanage,Puttalam,Marawila,North Western,6693,2152,8845,267720,86080,353800
11/29/2024,Kavindi Liyanage,Puttalam,Marawila,North Western,6082,6849,12931,243280,273960,517240
11/30/2024,Kavindi Liyanage,Puttalam,Marawila,North Western,4689,7674,12363,187560,306960,494520
12/1/2024,Kavindi Liyanage,Puttalam,Marawila,North Western,9836,3233,13069,393440,129320,522760
12/2/2024,Kavindi Liyanage,Puttalam,Marawila,North Western,8300,6293,14593,332000,251720,583720
12/3/2024,Kavindi Liyanage,Puttalam,Marawila,North Western,3164,3317,6481,126560,132680,259240
12/4/2024,Kavindi Liyanage,Puttalam,Marawila,North Western,8024,552,8576,320960,22080,343040
12/5/2024,Kavindi Liyanage,Puttalam,Marawila,North Western,7286,549,7835,291440,21960,313400
12/6/2024,Kavindi Liyanage,Puttalam,Marawila,North Western,5996,6788,12784,239840,271520,511360
12/7/2024,Kavindi Liyanage,Puttalam,Marawila,North Western,3709,4150,7859,148360,166000,314360
12/8/2024,Kavindi Liyanage,Puttalam,Marawila,North Western,4077,3148,7225,163080,125920,289000
12/9/2024,Kavindi Liyanage,Puttalam,Marawila,North Western,9660,9297,18957,386400,371880,758280
12/10/2024,Kavindi Liyanage,Puttalam,Marawila,North Western,2072,5692,7764,82880,227680,310560
12/11/2024,Kavindi Liyanage,Puttalam,Marawila,North Western,9371,620,9991,374840,24800,399640
12/12/2024,Kavindi Liyanage,Puttalam,Marawila,North Western,2329,1548,3877,93160,61920,155080
12/13/2024,Kavindi Liyanage,Puttalam,Marawila,North Western,9503,4604,14107,380120,184160,564280
12/14/2024,Kavindi Liyanage,Puttalam,Marawila,North Western,3238,6923,10161,129520,276920,406440
12/15/2024,Kavindi Liyanage,Puttalam,Marawila,North Western,9985,4271,14256,399400,170840,570240
12/16/2024,Kavindi Liyanage,Puttalam,Marawila,North Western,2883,2310,5193,115320,92400,207720
12/17/2024,Kavindi Liyanage,Puttalam,Marawila,North Western,205,9338,9543,8200,373520,381720
12/18/2024,Kavindi Liyanage,Puttalam,Marawila,North Western,2683,3779,6462,107320,151160,258480
12/19/2024,Kavindi Liyanage,Puttalam,Marawila,North Western,1469,617,2086,58760,24680,83440
12/20/2024,Kavindi Liyanage,Puttalam,Marawila,North Western,6199,4288,10487,247960,171520,419480
12/21/2024,Kavindi Liyanage,Puttalam,Marawila,North Western,4899,9749,14648,195960,389960,585920
12/22/2024,Kavindi Liyanage,Puttalam,Marawila,North Western,5172,4595,9767,206880,183800,390680
12/23/2024,Kavindi Liyanage,Puttalam,Marawila,North Western,4565,6976,11541,182600,279040,461640
12/24/2024,Kavindi Liyanage,Puttalam,Marawila,North Western,9675,3510,13185,387000,140400,527400
12/25/2024,Kavindi Liyanage,Puttalam,Marawila,North Western,6541,2252,8793,261640,90080,351720
12/26/2024,Kavindi Liyanage,Puttalam,Marawila,North Western,1172,8266,9438,46880,330640,377520
12/27/2024,Kavindi Liyanage,Puttalam,Marawila,North Western,9914,589,10503,396560,23560,420120
12/28/2024,Kavindi Liyanage,Puttalam,Marawila,North Western,1896,4304,6200,75840,172160,248000
12/29/2024,Kavindi Liyanage,Puttalam,Marawila,North Western,8477,6080,14557,339080,243200,582280
12/30/2024,Kavindi Liyanage,Puttalam,Marawila,North Western,5740,733,6473,229600,29320,258920
12/31/2024,Kavindi Liyanage,Puttalam,Marawila,North Western,8752,2824,11576,350080,112960,463040
1/1/2025,Kavindi Liyanage,Puttalam,Marawila,North Western,3396,454,3850,135840,18160,154000
1/2/2025,Kavindi Liyanage,Puttalam,Marawila,North Western,292,6821,7113,11680,272840,284520
1/3/2025,Kavindi Liyanage,Puttalam,Marawila,North Western,853,8658,9511,34120,346320,380440
1/4/2025,Kavindi Liyanage,Puttalam,Marawila,North Western,7187,3269,10456,287480,130760,418240
1/5/2025,Kavindi Liyanage,Puttalam,Marawila,North Western,1200,6399,7599,48000,255960,303960
1/6/2025,Kavindi Liyanage,Puttalam,Marawila,North Western,7674,1485,9159,306960,59400,366360
1/7/2025,Kavindi Liyanage,Puttalam,Marawila,North Western,6168,8049,14217,246720,321960,568680
1/8/2025,Kavindi Liyanage,Puttalam,Marawila,North Western,7704,8593,16297,308160,343720,651880
1/9/2025,Kavindi Liyanage,Puttalam,Marawila,North Western,9532,247,9779,381280,9880,391160
1/10/2025,Kavindi Liyanage,Puttalam,Marawila,North Western,3850,8926,12776,154000,357040,511040
1/11/2025,Kavindi Liyanage,Puttalam,Marawila,North Western,4410,9298,13708,176400,371920,548320
1/12/2025,Kavindi Liyanage,Puttalam,Marawila,North Western,8130,2724,10854,325200,108960,434160
1/13/2025,Kavindi Liyanage,Puttalam,Marawila,North Western,3070,2011,5081,122800,80440,203240
1/14/2025,Kavindi Liyanage,Puttalam,Marawila,North Western,1549,2411,3960,61960,96440,158400
1/15/2025,Kavindi Liyanage,Puttalam,Marawila,North Western,3994,9531,13525,159760,381240,541000
1/16/2025,Kavindi Liyanage,Puttalam,Marawila,North Western,7269,2537,9806,290760,101480,392240
1/17/2025,Kavindi Liyanage,Puttalam,Marawila,North Western,7002,9739,16741,280080,389560,669640
1/18/2025,Kavindi Liyanage,Puttalam,Marawila,North Western,3184,5371,8555,127360,214840,342200
1/19/2025,Kavindi Liyanage,Puttalam,Marawila,North Western,2307,5800,8107,92280,232000,324280
1/20/2025,Kavindi Liyanage,Puttalam,Marawila,North Western,6569,1814,8383,262760,72560,335320
1/21/2025,Kavindi Liyanage,Puttalam,Marawila,North Western,6820,1109,7929,272800,44360,317160
1/22/2025,Kavindi Liyanage,Puttalam,Marawila,North Western,1587,2390,3977,63480,95600,159080
1/23/2025,Kavindi Liyanage,Puttalam,Marawila,North Western,3075,5678,8753,123000,227120,350120
1/24/2025,Kavindi Liyanage,Puttalam,Marawila,North Western,6559,763,7322,262360,30520,292880
1/25/2025,Kavindi Liyanage,Puttalam,Marawila,North Western,5188,8758,13946,207520,350320,557840
1/26/2025,Kavindi Liyanage,Puttalam,Marawila,North Western,773,3907,4680,30920,156280,187200
1/27/2025,Kavindi Liyanage,Puttalam,Marawila,North Western,1872,3866,5738,74880,154640,229520
1/28/2025,Kavindi Liyanage,Puttalam,Marawila,North Western,4961,7410,12371,198440,296400,494840
1/29/2025,Kavindi Liyanage,Puttalam,Marawila,North Western,4653,7215,11868,186120,288600,474720
1/30/2025,Kavindi Liyanage,Puttalam,Marawila,North Western,9040,7720,16760,361600,308800,670400
1/31/2025,Kavindi Liyanage,Puttalam,Marawila,North Western,8350,8053,16403,334000,322120,656120
2/1/2025,Kavindi Liyanage,Puttalam,Marawila,North Western,3247,8515,11762,129880,340600,470480
2/2/2025,Kavindi Liyanage,Puttalam,Marawila,North Western,3573,6619,10192,142920,264760,407680
2/3/2025,Kavindi Liyanage,Puttalam,Marawila,North Western,7415,6812,14227,296600,272480,569080
2/4/2025,Kavindi Liyanage,Puttalam,Marawila,North Western,3065,5534,8599,122600,221360,343960
2/5/2025,Kavindi Liyanage,Puttalam,Marawila,North Western,700,8939,9639,28000,357560,385560
2/6/2025,Kavindi Liyanage,Puttalam,Marawila,North Western,2015,4126,6141,80600,165040,245640
2/7/2025,Kavindi Liyanage,Puttalam,Marawila,North Western,1269,6229,7498,50760,249160,299920
2/8/2025,Kavindi Liyanage,Puttalam,Marawila,North Western,5342,9573,14915,213680,382920,596600
2/9/2025,Kavindi Liyanage,Puttalam,Marawila,North Western,9420,6530,15950,376800,261200,638000
2/10/2025,Kavindi Liyanage,Puttalam,Marawila,North Western,1842,5972,7814,73680,238880,312560
2/11/2025,Kavindi Liyanage,Puttalam,Marawila,North Western,6678,1659,8337,267120,66360,333480
2/12/2025,Kavindi Liyanage,Puttalam,Marawila,North Western,8781,8547,17328,351240,341880,693120
2/13/2025,Kavindi Liyanage,Puttalam,Marawila,North Western,5351,5795,11146,214040,231800,445840
2/14/2025,Kavindi Liyanage,Puttalam,Marawila,North Western,1320,5627,6947,52800,225080,277880
2/15/2025,Kavindi Liyanage,Puttalam,Marawila,North Western,4576,3762,8338,183040,150480,333520
2/16/2025,Kavindi Liyanage,Puttalam,Marawila,North Western,1736,5981,7717,69440,239240,308680
2/17/2025,Kavindi Liyanage,Puttalam,Marawila,North Western,4118,539,4657,164720,21560,186280
2/18/2025,Kavindi Liyanage,Puttalam,Marawila,North Western,2461,5491,7952,98440,219640,318080
2/19/2025,Kavindi Liyanage,Puttalam,Marawila,North Western,6905,8713,15618,276200,348520,624720
2/20/2025,Kavindi Liyanage,Puttalam,Marawila,North Western,7831,9902,17733,313240,396080,709320
2/21/2025,Kavindi Liyanage,Puttalam,Marawila,North Western,3829,4346,8175,153160,173840,327000
2/22/2025,Kavindi Liyanage,Puttalam,Marawila,North Western,365,6927,7292,14600,277080,291680
2/23/2025,Kavindi Liyanage,Puttalam,Marawila,North Western,6723,4503,11226,268920,180120,449040
2/24/2025,Kavindi Liyanage,Puttalam,Marawila,North Western,1340,845,2185,53600,33800,87400
2/25/2025,Kavindi Liyanage,Puttalam,Marawila,North Western,9780,2507,12287,391200,100280,491480
2/26/2025,Kavindi Liyanage,Puttalam,Marawila,North Western,6134,6034,12168,245360,241360,486720
2/27/2025,Kavindi Liyanage,Puttalam,Marawila,North Western,7540,2280,9820,301600,91200,392800
2/28/2025,Kavindi Liyanage,Puttalam,Marawila,North Western,2471,35,2506,98840,1400,100240
3/1/2025,Kavindi Liyanage,Puttalam,Marawila,North Western,4097,37,4134,163880,1480,165360
3/2/2025,Kavindi Liyanage,Puttalam,Marawila,North Western,2369,2756,5125,94760,110240,205000
3/3/2025,Kavindi Liyanage,Puttalam,Marawila,North Western,6408,3714,10122,256320,148560,404880
3/4/2025,Kavindi Liyanage,Puttalam,Marawila,North Western,3660,6965,10625,146400,278600,425000
3/5/2025,Kavindi Liyanage,Puttalam,Marawila,North Western,4615,2021,6636,184600,80840,265440
3/6/2025,Kavindi Liyanage,Puttalam,Marawila,North Western,2111,376,2487,84440,15040,99480
3/7/2025,Kavindi Liyanage,Puttalam,Marawila,North Western,6596,5178,11774,263840,207120,470960
3/8/2025,Kavindi Liyanage,Puttalam,Marawila,North Western,8450,4265,12715,338000,170600,508600
3/9/2025,Kavindi Liyanage,Puttalam,Marawila,North Western,4765,1117,5882,190600,44680,235280
3/10/2025,Kavindi Liyanage,Puttalam,Marawila,North Western,8714,4760,13474,348560,190400,538960
3/11/2025,Kavindi Liyanage,Puttalam,Marawila,North Western,9597,8637,18234,383880,345480,729360
3/12/2025,Kavindi Liyanage,Puttalam,Marawila,North Western,3972,7170,11142,158880,286800,445680
3/13/2025,Kavindi Liyanage,Puttalam,Marawila,North Western,9957,3189,13146,398280,127560,525840
3/14/2025,Kavindi Liyanage,Puttalam,Marawila,North Western,7880,2863,10743,315200,114520,429720
3/15/2025,Kavindi Liyanage,Puttalam,Marawila,North Western,8289,6919,15208,331560,276760,608320
3/16/2025,Kavindi Liyanage,Puttalam,Marawila,North Western,8514,8220,16734,340560,328800,669360
3/17/2025,Kavindi Liyanage,Puttalam,Marawila,North Western,8177,4924,13101,327080,196960,524040
3/18/2025,Kavindi Liyanage,Puttalam,Marawila,North Western,1570,4299,5869,62800,171960,234760
3/19/2025,Kavindi Liyanage,Puttalam,Marawila,North Western,3295,2481,5776,131800,99240,231040
3/20/2025,Kavindi Liyanage,Puttalam,Marawila,North Western,7874,7410,15284,314960,296400,611360
3/21/2025,Kavindi Liyanage,Puttalam,Marawila,North Western,788,4091,4879,31520,163640,195160
3/22/2025,Kavindi Liyanage,Puttalam,Marawila,North Western,9755,6702,16457,390200,268080,658280
3/23/2025,Kavindi Liyanage,Puttalam,Marawila,North Western,9644,2697,12341,385760,107880,493640
3/25/2024,Indika Gunathilaka,Jaffna,Manipay,Northern,9289,263,9552,371560,10520,382080
3/26/2024,Indika Gunathilaka,Jaffna,Manipay,Northern,2715,7354,10069,108600,294160,402760
3/27/2024,Indika Gunathilaka,Jaffna,Manipay,Northern,8784,8719,17503,351360,348760,700120
3/28/2024,Indika Gunathilaka,Jaffna,Manipay,Northern,3258,2573,5831,130320,102920,233240
3/29/2024,Indika Gunathilaka,Jaffna,Manipay,Northern,7499,5944,13443,299960,237760,537720
3/30/2024,Indika Gunathilaka,Jaffna,Manipay,Northern,3578,1460,5038,143120,58400,201520
3/31/2024,Indika Gunathilaka,Jaffna,Manipay,Northern,4433,1966,6399,177320,78640,255960
4/1/2024,Indika Gunathilaka,Jaffna,Manipay,Northern,9126,6928,16054,365040,277120,642160
4/2/2024,Indika Gunathilaka,Jaffna,Manipay,Northern,5569,3177,8746,222760,127080,349840
4/3/2024,Indika Gunathilaka,Jaffna,Manipay,Northern,3361,6207,9568,134440,248280,382720
4/4/2024,Indika Gunathilaka,Jaffna,Manipay,Northern,194,4558,4752,7760,182320,190080
4/5/2024,Indika Gunathilaka,Jaffna,Manipay,Northern,16,1422,1438,640,56880,57520
4/6/2024,Indika Gunathilaka,Jaffna,Manipay,Northern,9697,8944,18641,387880,357760,745640
4/7/2024,Indika Gunathilaka,Jaffna,Manipay,Northern,4615,3962,8577,184600,158480,343080
4/8/2024,Indika Gunathilaka,Jaffna,Manipay,Northern,5783,9099,14882,231320,363960,595280
4/9/2024,Indika Gunathilaka,Jaffna,Manipay,Northern,9667,3284,12951,386680,131360,518040
4/10/2024,Indika Gunathilaka,Jaffna,Manipay,Northern,1468,7366,8834,58720,294640,353360
4/11/2024,Indika Gunathilaka,Jaffna,Manipay,Northern,2909,9535,12444,116360,381400,497760
4/19/2024,Indika Gunathilaka,Jaffna,Manipay,Northern,62,6598,6660,2480,263920,266400
4/20/2024,Indika Gunathilaka,Jaffna,Manipay,Northern,9936,8355,18291,397440,334200,731640
4/21/2024,Indika Gunathilaka,Jaffna,Manipay,Northern,5737,5368,11105,229480,214720,444200
4/22/2024,Indika Gunathilaka,Jaffna,Manipay,Northern,4190,8506,12696,167600,340240,507840
4/23/2024,Indika Gunathilaka,Jaffna,Manipay,Northern,2241,1234,3475,89640,49360,139000
4/24/2024,Indika Gunathilaka,Jaffna,Manipay,Northern,8023,4147,12170,320920,165880,486800
4/25/2024,Indika Gunathilaka,Jaffna,Manipay,Northern,4688,921,5609,187520,36840,224360
4/26/2024,Indika Gunathilaka,Jaffna,Manipay,Northern,9529,6722,16251,381160,268880,650040
4/27/2024,Indika Gunathilaka,Jaffna,Manipay,Northern,1791,3734,5525,71640,149360,221000
4/28/2024,Indika Gunathilaka,Jaffna,Manipay,Northern,324,7671,7995,12960,306840,319800
4/29/2024,Indika Gunathilaka,Jaffna,Manipay,Northern,9506,4397,13903,380240,175880,556120
4/30/2024,Indika Gunathilaka,Jaffna,Manipay,Northern,8983,4867,13850,359320,194680,554000
5/1/2024,Indika Gunathilaka,Jaffna,Manipay,Northern,4783,3842,8625,191320,153680,345000
5/2/2024,Indika Gunathilaka,Jaffna,Manipay,Northern,1081,5285,6366,43240,211400,254640
5/3/2024,Indika Gunathilaka,Jaffna,Manipay,Northern,2174,9602,11776,86960,384080,471040
5/4/2024,Indika Gunathilaka,Jaffna,Manipay,Northern,2601,4814,7415,104040,192560,296600
5/5/2024,Indika Gunathilaka,Jaffna,Manipay,Northern,4963,9337,14300,198520,373480,572000
5/6/2024,Indika Gunathilaka,Jaffna,Manipay,Northern,8318,9905,18223,332720,396200,728920
5/7/2024,Indika Gunathilaka,Jaffna,Manipay,Northern,2876,6588,9464,115040,263520,378560
5/8/2024,Indika Gunathilaka,Jaffna,Manipay,Northern,5649,254,5903,225960,10160,236120
5/9/2024,Indika Gunathilaka,Jaffna,Manipay,Northern,2702,986,3688,108080,39440,147520
5/10/2024,Indika Gunathilaka,Jaffna,Manipay,Northern,1038,1993,3031,41520,79720,121240
5/11/2024,Indika Gunathilaka,Jaffna,Manipay,Northern,5894,4443,10337,235760,177720,413480
5/12/2024,Indika Gunathilaka,Jaffna,Manipay,Northern,1217,2959,4176,48680,118360,167040
5/13/2024,Indika Gunathilaka,Jaffna,Manipay,Northern,873,5449,6322,34920,217960,252880
5/14/2024,Indika Gunathilaka,Jaffna,Manipay,Northern,6515,3994,10509,260600,159760,420360
5/15/2024,Indika Gunathilaka,Jaffna,Manipay,Northern,4460,3692,8152,178400,147680,326080
5/16/2024,Indika Gunathilaka,Jaffna,Manipay,Northern,6309,1889,8198,252360,75560,327920
5/17/2024,Indika Gunathilaka,Jaffna,Manipay,Northern,2901,1860,4761,116040,74400,190440
5/18/2024,Indika Gunathilaka,Jaffna,Manipay,Northern,171,7096,7267,6840,283840,290680
5/19/2024,Indika Gunathilaka,Jaffna,Manipay,Northern,3914,5066,8980,156560,202640,359200
5/20/2024,Indika Gunathilaka,Jaffna,Manipay,Northern,7469,2741,10210,298760,109640,408400
5/21/2024,Indika Gunathilaka,Jaffna,Manipay,Northern,7711,305,8016,308440,12200,320640
5/22/2024,Indika Gunathilaka,Jaffna,Manipay,Northern,8237,9824,18061,329480,392960,722440
5/24/2024,Indika Gunathilaka,Jaffna,Manipay,Northern,5796,310,6106,231840,12400,244240
5/25/2024,Indika Gunathilaka,Jaffna,Manipay,Northern,9121,735,9856,364840,29400,394240
5/26/2024,Indika Gunathilaka,Jaffna,Manipay,Northern,7062,1896,8958,282480,75840,358320
5/27/2024,Indika Gunathilaka,Jaffna,Manipay,Northern,9702,4713,14415,388080,188520,576600
5/28/2024,Indika Gunathilaka,Jaffna,Manipay,Northern,7119,9043,16162,284760,361720,646480
5/29/2024,Indika Gunathilaka,Jaffna,Manipay,Northern,4884,9134,14018,195360,365360,560720
5/30/2024,Indika Gunathilaka,Jaffna,Manipay,Northern,4149,1365,5514,165960,54600,220560
5/31/2024,Indika Gunathilaka,Jaffna,Manipay,Northern,8168,6856,15024,326720,274240,600960
6/1/2024,Indika Gunathilaka,Jaffna,Manipay,Northern,3422,253,3675,136880,10120,147000
6/2/2024,Indika Gunathilaka,Jaffna,Manipay,Northern,8389,3247,11636,335560,129880,465440
6/3/2024,Indika Gunathilaka,Jaffna,Manipay,Northern,5403,7595,12998,216120,303800,519920
6/4/2024,Indika Gunathilaka,Jaffna,Manipay,Northern,2680,5215,7895,107200,208600,315800
6/5/2024,Indika Gunathilaka,Jaffna,Manipay,Northern,9548,5121,14669,381920,204840,586760
6/6/2024,Indika Gunathilaka,Jaffna,Manipay,Northern,1363,2546,3909,54520,101840,156360
6/7/2024,Indika Gunathilaka,Jaffna,Manipay,Northern,9900,4699,14599,396000,187960,583960
6/8/2024,Indika Gunathilaka,Jaffna,Manipay,Northern,6294,4784,11078,251760,191360,443120
6/9/2024,Indika Gunathilaka,Jaffna,Manipay,Northern,2968,979,3947,118720,39160,157880
6/10/2024,Indika Gunathilaka,Jaffna,Manipay,Northern,4506,6492,10998,180240,259680,439920
6/11/2024,Indika Gunathilaka,Jaffna,Manipay,Northern,7568,4969,12537,302720,198760,501480
6/12/2024,Indika Gunathilaka,Jaffna,Manipay,Northern,100,4660,4760,4000,186400,190400
6/13/2024,Indika Gunathilaka,Jaffna,Manipay,Northern,1613,7049,8662,64520,281960,346480
6/14/2024,Indika Gunathilaka,Jaffna,Manipay,Northern,4286,376,4662,171440,15040,186480
6/15/2024,Indika Gunathilaka,Jaffna,Manipay,Northern,2676,5646,8322,107040,225840,332880
6/16/2024,Indika Gunathilaka,Jaffna,Manipay,Northern,7572,6088,13660,302880,243520,546400
6/17/2024,Indika Gunathilaka,Jaffna,Manipay,Northern,8009,7165,15174,320360,286600,606960
6/18/2024,Indika Gunathilaka,Jaffna,Manipay,Northern,9135,9971,19106,365400,398840,764240
6/19/2024,Indika Gunathilaka,Jaffna,Manipay,Northern,6706,3026,9732,268240,121040,389280
6/20/2024,Indika Gunathilaka,Jaffna,Manipay,Northern,7578,4772,12350,303120,190880,494000
6/21/2024,Indika Gunathilaka,Jaffna,Manipay,Northern,5082,8584,13666,203280,343360,546640
6/22/2024,Indika Gunathilaka,Jaffna,Manipay,Northern,848,538,1386,33920,21520,55440
6/23/2024,Indika Gunathilaka,Jaffna,Manipay,Northern,9884,7400,17284,395360,296000,691360
6/24/2024,Indika Gunathilaka,Jaffna,Manipay,Northern,6950,8492,15442,278000,339680,617680
6/25/2024,Indika Gunathilaka,Jaffna,Manipay,Northern,1770,8161,9931,70800,326440,397240
6/26/2024,Indika Gunathilaka,Jaffna,Manipay,Northern,343,2855,3198,13720,114200,127920
6/27/2024,Indika Gunathilaka,Jaffna,Manipay,Northern,5987,1997,7984,239480,79880,319360
6/28/2024,Indika Gunathilaka,Jaffna,Manipay,Northern,6708,4085,10793,268320,163400,431720
6/29/2024,Indika Gunathilaka,Jaffna,Manipay,Northern,551,2927,3478,22040,117080,139120
6/30/2024,Indika Gunathilaka,Jaffna,Manipay,Northern,6735,7634,14369,269400,305360,574760
7/1/2024,Indika Gunathilaka,Jaffna,Manipay,Northern,9900,3917,13817,396000,156680,552680
7/2/2024,Indika Gunathilaka,Jaffna,Manipay,Northern,3148,3864,7012,125920,154560,280480
7/3/2024,Indika Gunathilaka,Jaffna,Manipay,Northern,6211,1090,7301,248440,43600,292040
7/4/2024,Indika Gunathilaka,Jaffna,Manipay,Northern,4491,8221,12712,179640,328840,508480
7/5/2024,Indika Gunathilaka,Jaffna,Manipay,Northern,4846,6872,11718,193840,274880,468720
7/6/2024,Indika Gunathilaka,Jaffna,Manipay,Northern,1344,339,1683,53760,13560,67320
7/7/2024,Indika Gunathilaka,Jaffna,Manipay,Northern,7407,5276,12683,296280,211040,507320
7/8/2024,Indika Gunathilaka,Jaffna,Manipay,Northern,8228,8998,17226,329120,359920,689040
7/9/2024,Indika Gunathilaka,Jaffna,Manipay,Northern,7387,7932,15319,295480,317280,612760
7/10/2024,Indika Gunathilaka,Jaffna,Manipay,Northern,3465,5404,8869,138600,216160,354760
7/11/2024,Indika Gunathilaka,Jaffna,Manipay,Northern,8246,507,8753,329840,20280,350120
7/12/2024,Indika Gunathilaka,Jaffna,Manipay,Northern,4212,5484,9696,168480,219360,387840
7/13/2024,Indika Gunathilaka,Jaffna,Manipay,Northern,4509,1326,5835,180360,53040,233400
7/14/2024,Indika Gunathilaka,Jaffna,Manipay,Northern,7940,4079,12019,317600,163160,480760
7/15/2024,Indika Gunathilaka,Jaffna,Manipay,Northern,6153,9172,15325,246120,366880,613000
7/16/2024,Indika Gunathilaka,Jaffna,Manipay,Northern,5643,6834,12477,225720,273360,499080
7/17/2024,Indika Gunathilaka,Jaffna,Manipay,Northern,5581,8607,14188,223240,344280,567520
7/18/2024,Indika Gunathilaka,Jaffna,Manipay,Northern,799,7723,8522,31960,308920,340880
7/19/2024,Indika Gunathilaka,Jaffna,Manipay,Northern,3423,1385,4808,136920,55400,192320
7/20/2024,Indika Gunathilaka,Jaffna,Manipay,Northern,9569,9349,18918,382760,373960,756720
7/21/2024,Indika Gunathilaka,Jaffna,Manipay,Northern,852,3917,4769,34080,156680,190760
7/22/2024,Indika Gunathilaka,Jaffna,Manipay,Northern,2510,4879,7389,100400,195160,295560
7/23/2024,Indika Gunathilaka,Jaffna,Manipay,Northern,8134,5087,13221,325360,203480,528840
7/24/2024,Indika Gunathilaka,Jaffna,Manipay,Northern,8618,4205,12823,344720,168200,512920
7/25/2024,Indika Gunathilaka,Jaffna,Manipay,Northern,7900,9900,17800,316000,396000,712000
7/26/2024,Indika Gunathilaka,Jaffna,Manipay,Northern,9460,6866,16326,378400,274640,653040
7/27/2024,Indika Gunathilaka,Jaffna,Manipay,Northern,2162,8377,10539,86480,335080,421560
7/28/2024,Indika Gunathilaka,Jaffna,Manipay,Northern,859,2895,3754,34360,115800,150160
7/29/2024,Indika Gunathilaka,Jaffna,Manipay,Northern,1367,1451,2818,54680,58040,112720
7/30/2024,Indika Gunathilaka,Jaffna,Manipay,Northern,4440,413,4853,177600,16520,194120
7/31/2024,Indika Gunathilaka,Jaffna,Manipay,Northern,10,3187,3197,400,127480,127880
8/1/2024,Indika Gunathilaka,Jaffna,Manipay,Northern,2412,4819,7231,96480,192760,289240
8/2/2024,Indika Gunathilaka,Jaffna,Manipay,Northern,3446,2257,5703,137840,90280,228120
8/3/2024,Indika Gunathilaka,Jaffna,Manipay,Northern,6402,7349,13751,256080,293960,550040
8/4/2024,Indika Gunathilaka,Jaffna,Manipay,Northern,2360,5511,7871,94400,220440,314840
8/5/2024,Indika Gunathilaka,Jaffna,Manipay,Northern,9427,3209,12636,377080,128360,505440
8/6/2024,Indika Gunathilaka,Jaffna,Manipay,Northern,5621,2097,7718,224840,83880,308720
8/7/2024,Indika Gunathilaka,Jaffna,Manipay,Northern,6414,5253,11667,256560,210120,466680
8/8/2024,Indika Gunathilaka,Jaffna,Manipay,Northern,9519,1449,10968,380760,57960,438720
8/9/2024,Indika Gunathilaka,Jaffna,Manipay,Northern,8906,1024,9930,356240,40960,397200
8/10/2024,Indika Gunathilaka,Jaffna,Manipay,Northern,1081,7916,8997,43240,316640,359880
8/11/2024,Indika Gunathilaka,Jaffna,Manipay,Northern,6621,2003,8624,264840,80120,344960
8/12/2024,Indika Gunathilaka,Jaffna,Manipay,Northern,7262,2661,9923,290480,106440,396920
8/13/2024,Indika Gunathilaka,Jaffna,Manipay,Northern,5144,6095,11239,205760,243800,449560
8/14/2024,Indika Gunathilaka,Jaffna,Manipay,Northern,2453,4755,7208,98120,190200,288320
8/15/2024,Indika Gunathilaka,Jaffna,Manipay,Northern,4999,6482,11481,199960,259280,459240
8/16/2024,Indika Gunathilaka,Jaffna,Manipay,Northern,8376,4248,12624,335040,169920,504960
8/17/2024,Indika Gunathilaka,Jaffna,Manipay,Northern,364,5159,5523,14560,206360,220920
8/18/2024,Indika Gunathilaka,Jaffna,Manipay,Northern,6922,5046,11968,276880,201840,478720
8/19/2024,Indika Gunathilaka,Jaffna,Manipay,Northern,8381,5835,14216,335240,233400,568640
8/20/2024,Indika Gunathilaka,Jaffna,Manipay,Northern,9062,7103,16165,362480,284120,646600
8/21/2024,Indika Gunathilaka,Jaffna,Manipay,Northern,7962,9860,17822,318480,394400,712880
8/22/2024,Indika Gunathilaka,Jaffna,Manipay,Northern,4051,8266,12317,162040,330640,492680
8/23/2024,Indika Gunathilaka,Jaffna,Manipay,Northern,3217,3236,6453,128680,129440,258120
8/24/2024,Indika Gunathilaka,Jaffna,Manipay,Northern,1555,1840,3395,62200,73600,135800
8/25/2024,Indika Gunathilaka,Jaffna,Manipay,Northern,4611,9355,13966,184440,374200,558640
8/26/2024,Indika Gunathilaka,Jaffna,Manipay,Northern,1882,5949,7831,75280,237960,313240
8/27/2024,Indika Gunathilaka,Jaffna,Manipay,Northern,3360,2369,5729,134400,94760,229160
8/28/2024,Indika Gunathilaka,Jaffna,Manipay,Northern,1158,1087,2245,46320,43480,89800
8/29/2024,Indika Gunathilaka,Jaffna,Manipay,Northern,2019,8272,10291,80760,330880,411640
8/30/2024,Indika Gunathilaka,Jaffna,Manipay,Northern,3777,3854,7631,151080,154160,305240
8/31/2024,Indika Gunathilaka,Jaffna,Manipay,Northern,3917,6435,10352,156680,257400,414080
9/1/2024,Indika Gunathilaka,Jaffna,Manipay,Northern,6561,510,7071,262440,20400,282840
9/2/2024,Indika Gunathilaka,Jaffna,Manipay,Northern,4012,1867,5879,160480,74680,235160
9/3/2024,Indika Gunathilaka,Jaffna,Manipay,Northern,8021,6780,14801,320840,271200,592040
9/4/2024,Indika Gunathilaka,Jaffna,Manipay,Northern,2270,1917,4187,90800,76680,167480
9/5/2024,Indika Gunathilaka,Jaffna,Manipay,Northern,5466,6912,12378,218640,276480,495120
9/6/2024,Indika Gunathilaka,Jaffna,Manipay,Northern,9943,6105,16048,397720,244200,641920
9/7/2024,Indika Gunathilaka,Jaffna,Manipay,Northern,8679,6307,14986,347160,252280,599440
9/8/2024,Indika Gunathilaka,Jaffna,Manipay,Northern,8305,1173,9478,332200,46920,379120
9/9/2024,Indika Gunathilaka,Jaffna,Manipay,Northern,3118,5580,8698,124720,223200,347920
9/10/2024,Indika Gunathilaka,Jaffna,Manipay,Northern,5546,3106,8652,221840,124240,346080
9/11/2024,Indika Gunathilaka,Jaffna,Manipay,Northern,6742,7106,13848,269680,284240,553920
9/12/2024,Indika Gunathilaka,Jaffna,Manipay,Northern,1609,3954,5563,64360,158160,222520
9/13/2024,Indika Gunathilaka,Jaffna,Manipay,Northern,3589,4359,7948,143560,174360,317920
9/14/2024,Indika Gunathilaka,Jaffna,Manipay,Northern,799,7603,8402,31960,304120,336080
9/15/2024,Indika Gunathilaka,Jaffna,Manipay,Northern,7763,9433,17196,310520,377320,687840
9/16/2024,Indika Gunathilaka,Jaffna,Manipay,Northern,6402,8040,14442,256080,321600,577680
9/17/2024,Indika Gunathilaka,Jaffna,Manipay,Northern,745,7053,7798,29800,282120,311920
9/18/2024,Indika Gunathilaka,Jaffna,Manipay,Northern,5481,2253,7734,219240,90120,309360
9/19/2024,Indika Gunathilaka,Jaffna,Manipay,Northern,6768,5269,12037,270720,210760,481480
9/20/2024,Indika Gunathilaka,Jaffna,Manipay,Northern,541,4649,5190,21640,185960,207600
9/21/2024,Indika Gunathilaka,Jaffna,Manipay,Northern,2270,6666,8936,90800,266640,357440
9/22/2024,Indika Gunathilaka,Jaffna,Manipay,Northern,7108,7074,14182,284320,282960,567280
9/23/2024,Indika Gunathilaka,Jaffna,Manipay,Northern,8278,734,9012,331120,29360,360480
9/24/2024,Indika Gunathilaka,Jaffna,Manipay,Northern,8457,4158,12615,338280,166320,504600
9/25/2024,Indika Gunathilaka,Jaffna,Manipay,Northern,1647,6781,8428,65880,271240,337120
9/26/2024,Indika Gunathilaka,Jaffna,Manipay,Northern,4574,3288,7862,182960,131520,314480
9/27/2024,Indika Gunathilaka,Jaffna,Manipay,Northern,6992,1783,8775,279680,71320,351000
9/28/2024,Indika Gunathilaka,Jaffna,Manipay,Northern,8379,1146,9525,335160,45840,381000
9/29/2024,Indika Gunathilaka,Jaffna,Manipay,Northern,5480,6590,12070,219200,263600,482800
9/30/2024,Indika Gunathilaka,Jaffna,Manipay,Northern,6137,9651,15788,245480,386040,631520
10/1/2024,Indika Gunathilaka,Jaffna,Manipay,Northern,7340,9482,16822,293600,379280,672880
10/2/2024,Indika Gunathilaka,Jaffna,Manipay,Northern,7115,3136,10251,284600,125440,410040
10/3/2024,Indika Gunathilaka,Jaffna,Manipay,Northern,3113,1802,4915,124520,72080,196600
10/4/2024,Indika Gunathilaka,Jaffna,Manipay,Northern,1797,9813,11610,71880,392520,464400
10/5/2024,Indika Gunathilaka,Jaffna,Manipay,Northern,619,3269,3888,24760,130760,155520
10/6/2024,Indika Gunathilaka,Jaffna,Manipay,Northern,6298,4883,11181,251920,195320,447240
10/7/2024,Indika Gunathilaka,Jaffna,Manipay,Northern,8378,3008,11386,335120,120320,455440
10/8/2024,Indika Gunathilaka,Jaffna,Manipay,Northern,6736,9882,16618,269440,395280,664720
10/9/2024,Indika Gunathilaka,Jaffna,Manipay,Northern,4506,1140,5646,180240,45600,225840
10/10/2024,Indika Gunathilaka,Jaffna,Manipay,Northern,5696,8623,14319,227840,344920,572760
10/11/2024,Indika Gunathilaka,Jaffna,Manipay,Northern,56,5488,5544,2240,219520,221760
10/12/2024,Indika Gunathilaka,Jaffna,Manipay,Northern,5870,6177,12047,234800,247080,481880
10/13/2024,Indika Gunathilaka,Jaffna,Manipay,Northern,9530,6922,16452,381200,276880,658080
10/14/2024,Indika Gunathilaka,Jaffna,Manipay,Northern,2034,9027,11061,81360,361080,442440
10/15/2024,Indika Gunathilaka,Jaffna,Manipay,Northern,3933,3816,7749,157320,152640,309960
10/16/2024,Indika Gunathilaka,Jaffna,Manipay,Northern,993,5747,6740,39720,229880,269600
10/17/2024,Indika Gunathilaka,Jaffna,Manipay,Northern,4678,9333,14011,187120,373320,560440
10/18/2024,Indika Gunathilaka,Jaffna,Manipay,Northern,6856,2269,9125,274240,90760,365000
10/19/2024,Indika Gunathilaka,Jaffna,Manipay,Northern,9837,7109,16946,393480,284360,677840
10/20/2024,Indika Gunathilaka,Jaffna,Manipay,Northern,594,9696,10290,23760,387840,411600
10/21/2024,Indika Gunathilaka,Jaffna,Manipay,Northern,9192,8614,17806,367680,344560,712240
10/22/2024,Indika Gunathilaka,Jaffna,Manipay,Northern,911,4707,5618,36440,188280,224720
10/23/2024,Indika Gunathilaka,Jaffna,Manipay,Northern,1546,234,1780,61840,9360,71200
10/24/2024,Indika Gunathilaka,Jaffna,Manipay,Northern,6277,589,6866,251080,23560,274640
10/25/2024,Indika Gunathilaka,Jaffna,Manipay,Northern,1997,7470,9467,79880,298800,378680
10/26/2024,Indika Gunathilaka,Jaffna,Manipay,Northern,9726,7325,17051,389040,293000,682040
10/27/2024,Indika Gunathilaka,Jaffna,Manipay,Northern,7504,8839,16343,300160,353560,653720
10/28/2024,Indika Gunathilaka,Jaffna,Manipay,Northern,3475,1461,4936,139000,58440,197440
10/29/2024,Indika Gunathilaka,Jaffna,Manipay,Northern,6812,5717,12529,272480,228680,501160
10/30/2024,Indika Gunathilaka,Jaffna,Manipay,Northern,9007,9988,18995,360280,399520,759800
10/31/2024,Indika Gunathilaka,Jaffna,Manipay,Northern,6914,6321,13235,276560,252840,529400
11/1/2024,Indika Gunathilaka,Jaffna,Manipay,Northern,2993,1705,4698,119720,68200,187920
11/2/2024,Indika Gunathilaka,Jaffna,Manipay,Northern,6168,7739,13907,246720,309560,556280
11/3/2024,Indika Gunathilaka,Jaffna,Manipay,Northern,9533,5989,15522,381320,239560,620880
11/4/2024,Indika Gunathilaka,Jaffna,Manipay,Northern,7859,1254,9113,314360,50160,364520
11/5/2024,Indika Gunathilaka,Jaffna,Manipay,Northern,742,2020,2762,29680,80800,110480
11/6/2024,Indika Gunathilaka,Jaffna,Manipay,Northern,9277,5745,15022,371080,229800,600880
11/7/2024,Indika Gunathilaka,Jaffna,Manipay,Northern,1232,7714,8946,49280,308560,357840
11/8/2024,Indika Gunathilaka,Jaffna,Manipay,Northern,4317,529,4846,172680,21160,193840
11/9/2024,Indika Gunathilaka,Jaffna,Manipay,Northern,1363,24,1387,54520,960,55480
11/10/2024,Indika Gunathilaka,Jaffna,Manipay,Northern,163,5838,6001,6520,233520,240040
11/11/2024,Indika Gunathilaka,Jaffna,Manipay,Northern,8476,2759,11235,339040,110360,449400
11/12/2024,Indika Gunathilaka,Jaffna,Manipay,Northern,4886,870,5756,195440,34800,230240
11/13/2024,Indika Gunathilaka,Jaffna,Manipay,Northern,4793,1974,6767,191720,78960,270680
11/14/2024,Indika Gunathilaka,Jaffna,Manipay,Northern,7503,611,8114,300120,24440,324560
11/15/2024,Indika Gunathilaka,Jaffna,Manipay,Northern,5052,5114,10166,202080,204560,406640
11/16/2024,Indika Gunathilaka,Jaffna,Manipay,Northern,6100,6266,12366,244000,250640,494640
11/17/2024,Indika Gunathilaka,Jaffna,Manipay,Northern,2387,2663,5050,95480,106520,202000
11/18/2024,Indika Gunathilaka,Jaffna,Manipay,Northern,3650,4649,8299,146000,185960,331960
11/19/2024,Indika Gunathilaka,Jaffna,Manipay,Northern,5508,3435,8943,220320,137400,357720
11/20/2024,Indika Gunathilaka,Jaffna,Manipay,Northern,9447,4672,14119,377880,186880,564760
11/21/2024,Indika Gunathilaka,Jaffna,Manipay,Northern,5918,4529,10447,236720,181160,417880
11/22/2024,Indika Gunathilaka,Jaffna,Manipay,Northern,1992,1978,3970,79680,79120,158800
11/23/2024,Indika Gunathilaka,Jaffna,Manipay,Northern,6627,8014,14641,265080,320560,585640
11/24/2024,Indika Gunathilaka,Jaffna,Manipay,Northern,9233,6657,15890,369320,266280,635600
11/25/2024,Indika Gunathilaka,Jaffna,Manipay,Northern,2736,9533,12269,109440,381320,490760
11/26/2024,Indika Gunathilaka,Jaffna,Manipay,Northern,4077,9903,13980,163080,396120,559200
11/27/2024,Indika Gunathilaka,Jaffna,Manipay,Northern,9036,5946,14982,361440,237840,599280
11/28/2024,Indika Gunathilaka,Jaffna,Manipay,Northern,6104,4920,11024,244160,196800,440960
11/29/2024,Indika Gunathilaka,Jaffna,Manipay,Northern,1845,4903,6748,73800,196120,269920
11/30/2024,Indika Gunathilaka,Jaffna,Manipay,Northern,5338,7258,12596,213520,290320,503840
12/1/2024,Indika Gunathilaka,Jaffna,Manipay,Northern,3923,582,4505,156920,23280,180200
12/2/2024,Indika Gunathilaka,Jaffna,Manipay,Northern,9792,7771,17563,391680,310840,702520
12/3/2024,Indika Gunathilaka,Jaffna,Manipay,Northern,7134,2563,9697,285360,102520,387880
12/4/2024,Indika Gunathilaka,Jaffna,Manipay,Northern,1057,4751,5808,42280,190040,232320
12/5/2024,Indika Gunathilaka,Jaffna,Manipay,Northern,3541,7855,11396,141640,314200,455840
12/6/2024,Indika Gunathilaka,Jaffna,Manipay,Northern,1067,4966,6033,42680,198640,241320
12/7/2024,Indika Gunathilaka,Jaffna,Manipay,Northern,309,4705,5014,12360,188200,200560
12/8/2024,Indika Gunathilaka,Jaffna,Manipay,Northern,9533,5583,15116,381320,223320,604640
12/9/2024,Indika Gunathilaka,Jaffna,Manipay,Northern,6608,9422,16030,264320,376880,641200
12/10/2024,Indika Gunathilaka,Jaffna,Manipay,Northern,6317,8383,14700,252680,335320,588000
12/11/2024,Indika Gunathilaka,Jaffna,Manipay,Northern,9797,5134,14931,391880,205360,597240
12/12/2024,Indika Gunathilaka,Jaffna,Manipay,Northern,2424,3044,5468,96960,121760,218720
12/13/2024,Indika Gunathilaka,Jaffna,Manipay,Northern,1575,4421,5996,63000,176840,239840
12/14/2024,Indika Gunathilaka,Jaffna,Manipay,Northern,3967,4064,8031,158680,162560,321240
12/15/2024,Indika Gunathilaka,Jaffna,Manipay,Northern,3123,1539,4662,124920,61560,186480
12/16/2024,Indika Gunathilaka,Jaffna,Manipay,Northern,5567,2867,8434,222680,114680,337360
12/17/2024,Indika Gunathilaka,Jaffna,Manipay,Northern,2046,6295,8341,81840,251800,333640
12/18/2024,Indika Gunathilaka,Jaffna,Manipay,Northern,5298,1633,6931,211920,65320,277240
12/19/2024,Indika Gunathilaka,Jaffna,Manipay,Northern,160,7368,7528,6400,294720,301120
12/20/2024,Indika Gunathilaka,Jaffna,Manipay,Northern,9314,1541,10855,372560,61640,434200
12/21/2024,Indika Gunathilaka,Jaffna,Manipay,Northern,7122,4871,11993,284880,194840,479720
12/22/2024,Indika Gunathilaka,Jaffna,Manipay,Northern,909,1376,2285,36360,55040,91400
12/23/2024,Indika Gunathilaka,Jaffna,Manipay,Northern,589,5203,5792,23560,208120,231680
12/24/2024,Indika Gunathilaka,Jaffna,Manipay,Northern,6559,9910,16469,262360,396400,658760
12/25/2024,Indika Gunathilaka,Jaffna,Manipay,Northern,5868,3354,9222,234720,134160,368880
12/26/2024,Indika Gunathilaka,Jaffna,Manipay,Northern,7190,7695,14885,287600,307800,595400
12/27/2024,Indika Gunathilaka,Jaffna,Manipay,Northern,6199,7878,14077,247960,315120,563080
12/28/2024,Indika Gunathilaka,Jaffna,Manipay,Northern,1592,7689,9281,63680,307560,371240
12/29/2024,Indika Gunathilaka,Jaffna,Manipay,Northern,2873,8726,11599,114920,349040,463960
12/30/2024,Indika Gunathilaka,Jaffna,Manipay,Northern,8862,9803,18665,354480,392120,746600
12/31/2024,Indika Gunathilaka,Jaffna,Manipay,Northern,3740,6797,10537,149600,271880,421480
1/1/2025,Indika Gunathilaka,Jaffna,Manipay,Northern,8206,4028,12234,328240,161120,489360
1/2/2025,Indika Gunathilaka,Jaffna,Manipay,Northern,796,6634,7430,31840,265360,297200
1/3/2025,Indika Gunathilaka,Jaffna,Manipay,Northern,5296,6307,11603,211840,252280,464120
1/4/2025,Indika Gunathilaka,Jaffna,Manipay,Northern,4353,3806,8159,174120,152240,326360
1/5/2025,Indika Gunathilaka,Jaffna,Manipay,Northern,1217,5502,6719,48680,220080,268760
1/6/2025,Indika Gunathilaka,Jaffna,Manipay,Northern,7349,5413,12762,293960,216520,510480
1/7/2025,Indika Gunathilaka,Jaffna,Manipay,Northern,3400,3532,6932,136000,141280,277280
1/8/2025,Indika Gunathilaka,Jaffna,Manipay,Northern,8411,22,8433,336440,880,337320
1/9/2025,Indika Gunathilaka,Jaffna,Manipay,Northern,4980,4985,9965,199200,199400,398600
1/10/2025,Indika Gunathilaka,Jaffna,Manipay,Northern,690,1357,2047,27600,54280,81880
1/11/2025,Indika Gunathilaka,Jaffna,Manipay,Northern,6941,3272,10213,277640,130880,408520
1/12/2025,Indika Gunathilaka,Jaffna,Manipay,Northern,4126,686,4812,165040,27440,192480
1/13/2025,Indika Gunathilaka,Jaffna,Manipay,Northern,7227,9085,16312,289080,363400,652480
1/14/2025,Indika Gunathilaka,Jaffna,Manipay,Northern,2878,9942,12820,115120,397680,512800
1/15/2025,Indika Gunathilaka,Jaffna,Manipay,Northern,4026,7629,11655,161040,305160,466200
1/16/2025,Indika Gunathilaka,Jaffna,Manipay,Northern,4802,6566,11368,192080,262640,454720
1/17/2025,Indika Gunathilaka,Jaffna,Manipay,Northern,2422,539,2961,96880,21560,118440
1/18/2025,Indika Gunathilaka,Jaffna,Manipay,Northern,7026,46,7072,281040,1840,282880
1/19/2025,Indika Gunathilaka,Jaffna,Manipay,Northern,8625,1425,10050,345000,57000,402000
1/20/2025,Indika Gunathilaka,Jaffna,Manipay,Northern,3643,5204,8847,145720,208160,353880
1/21/2025,Indika Gunathilaka,Jaffna,Manipay,Northern,299,7776,8075,11960,311040,323000
1/22/2025,Indika Gunathilaka,Jaffna,Manipay,Northern,9769,5800,15569,390760,232000,622760
1/23/2025,Indika Gunathilaka,Jaffna,Manipay,Northern,4434,8650,13084,177360,346000,523360
1/24/2025,Indika Gunathilaka,Jaffna,Manipay,Northern,2839,6631,9470,113560,265240,378800
1/25/2025,Indika Gunathilaka,Jaffna,Manipay,Northern,6509,7739,14248,260360,309560,569920
1/26/2025,Indika Gunathilaka,Jaffna,Manipay,Northern,315,5433,5748,12600,217320,229920
1/27/2025,Indika Gunathilaka,Jaffna,Manipay,Northern,4935,8563,13498,197400,342520,539920
1/28/2025,Indika Gunathilaka,Jaffna,Manipay,Northern,9781,7562,17343,391240,302480,693720
1/29/2025,Indika Gunathilaka,Jaffna,Manipay,Northern,9428,8032,17460,377120,321280,698400
1/30/2025,Indika Gunathilaka,Jaffna,Manipay,Northern,3076,4137,7213,123040,165480,288520
1/31/2025,Indika Gunathilaka,Jaffna,Manipay,Northern,2668,4541,7209,106720,181640,288360
2/1/2025,Indika Gunathilaka,Jaffna,Manipay,Northern,7288,7538,14826,291520,301520,593040
2/2/2025,Indika Gunathilaka,Jaffna,Manipay,Northern,2130,6346,8476,85200,253840,339040
2/3/2025,Indika Gunathilaka,Jaffna,Manipay,Northern,4413,8477,12890,176520,339080,515600
2/4/2025,Indika Gunathilaka,Jaffna,Manipay,Northern,6956,6301,13257,278240,252040,530280
2/5/2025,Indika Gunathilaka,Jaffna,Manipay,Northern,396,2238,2634,15840,89520,105360
2/6/2025,Indika Gunathilaka,Jaffna,Manipay,Northern,3863,4404,8267,154520,176160,330680
2/7/2025,Indika Gunathilaka,Jaffna,Manipay,Northern,1694,9440,11134,67760,377600,445360
2/8/2025,Indika Gunathilaka,Jaffna,Manipay,Northern,1961,3881,5842,78440,155240,233680
2/9/2025,Indika Gunathilaka,Jaffna,Manipay,Northern,4676,132,4808,187040,5280,192320
2/10/2025,Indika Gunathilaka,Jaffna,Manipay,Northern,8087,7115,15202,323480,284600,608080
2/11/2025,Indika Gunathilaka,Jaffna,Manipay,Northern,2723,9395,12118,108920,375800,484720
2/12/2025,Indika Gunathilaka,Jaffna,Manipay,Northern,4498,9048,13546,179920,361920,541840
2/13/2025,Indika Gunathilaka,Jaffna,Manipay,Northern,9077,5564,14641,363080,222560,585640
2/14/2025,Indika Gunathilaka,Jaffna,Manipay,Northern,1453,8242,9695,58120,329680,387800
2/15/2025,Indika Gunathilaka,Jaffna,Manipay,Northern,8689,8945,17634,347560,357800,705360
2/16/2025,Indika Gunathilaka,Jaffna,Manipay,Northern,2721,8492,11213,108840,339680,448520
2/17/2025,Indika Gunathilaka,Jaffna,Manipay,Northern,4429,6698,11127,177160,267920,445080
2/18/2025,Indika Gunathilaka,Jaffna,Manipay,Northern,709,3028,3737,28360,121120,149480
2/19/2025,Indika Gunathilaka,Jaffna,Manipay,Northern,6561,1254,7815,262440,50160,312600
2/20/2025,Indika Gunathilaka,Jaffna,Manipay,Northern,684,8866,9550,27360,354640,382000
2/21/2025,Indika Gunathilaka,Jaffna,Manipay,Northern,2801,5698,8499,112040,227920,339960
2/22/2025,Indika Gunathilaka,Jaffna,Manipay,Northern,700,4704,5404,28000,188160,216160
2/23/2025,Indika Gunathilaka,Jaffna,Manipay,Northern,13,4281,4294,520,171240,171760
2/24/2025,Indika Gunathilaka,Jaffna,Manipay,Northern,9661,7324,16985,386440,292960,679400
2/25/2025,Indika Gunathilaka,Jaffna,Manipay,Northern,4730,8242,12972,189200,329680,518880
2/26/2025,Indika Gunathilaka,Jaffna,Manipay,Northern,558,7215,7773,22320,288600,310920
2/27/2025,Indika Gunathilaka,Jaffna,Manipay,Northern,3431,8052,11483,137240,322080,459320
2/28/2025,Indika Gunathilaka,Jaffna,Manipay,Northern,7100,8899,15999,284000,355960,639960
3/1/2025,Indika Gunathilaka,Jaffna,Manipay,Northern,1133,821,1954,45320,32840,78160
3/2/2025,Indika Gunathilaka,Jaffna,Manipay,Northern,1584,7173,8757,63360,286920,350280
3/3/2025,Indika Gunathilaka,Jaffna,Manipay,Northern,1040,3862,4902,41600,154480,196080
3/4/2025,Indika Gunathilaka,Jaffna,Manipay,Northern,9009,3724,12733,360360,148960,509320
3/5/2025,Indika Gunathilaka,Jaffna,Manipay,Northern,1912,8817,10729,76480,352680,429160
3/6/2025,Indika Gunathilaka,Jaffna,Manipay,Northern,6480,6701,13181,259200,268040,527240
3/7/2025,Indika Gunathilaka,Jaffna,Manipay,Northern,541,1721,2262,21640,68840,90480
3/8/2025,Indika Gunathilaka,Jaffna,Manipay,Northern,5531,5925,11456,221240,237000,458240
3/9/2025,Indika Gunathilaka,Jaffna,Manipay,Northern,7976,2614,10590,319040,104560,423600
3/10/2025,Indika Gunathilaka,Jaffna,Manipay,Northern,1501,364,1865,60040,14560,74600
3/11/2025,Indika Gunathilaka,Jaffna,Manipay,Northern,1092,8375,9467,43680,335000,378680
3/12/2025,Indika Gunathilaka,Jaffna,Manipay,Northern,8843,2115,10958,353720,84600,438320
3/13/2025,Indika Gunathilaka,Jaffna,Manipay,Northern,9500,732,10232,380000,29280,409280
3/14/2025,Indika Gunathilaka,Jaffna,Manipay,Northern,4375,9503,13878,175000,380120,555120
3/15/2025,Indika Gunathilaka,Jaffna,Manipay,Northern,3049,2586,5635,121960,103440,225400
3/16/2025,Indika Gunathilaka,Jaffna,Manipay,Northern,2322,3701,6023,92880,148040,240920
3/17/2025,Indika Gunathilaka,Jaffna,Manipay,Northern,2750,146,2896,110000,5840,115840
3/18/2025,Indika Gunathilaka,Jaffna,Manipay,Northern,4123,7447,11570,164920,297880,462800
3/19/2025,Indika Gunathilaka,Jaffna,Manipay,Northern,4653,9174,13827,186120,366960,553080
3/20/2025,Indika Gunathilaka,Jaffna,Manipay,Northern,2836,8208,11044,113440,328320,441760
3/21/2025,Indika Gunathilaka,Jaffna,Manipay,Northern,5844,219,6063,233760,8760,242520
3/22/2025,Indika Gunathilaka,Jaffna,Manipay,Northern,8299,1095,9394,331960,43800,375760
3/23/2025,Indika Gunathilaka,Jaffna,Manipay,Northern,3703,1589,5292,148120,63560,211680
3/25/2024,Ravindra Liyanage,Matara,Tangalle,Southern,4450,6989,11439,178000,279560,457560
3/26/2024,Ravindra Liyanage,Matara,Tangalle,Southern,7868,5692,13560,314720,227680,542400
3/27/2024,Ravindra Liyanage,Matara,Tangalle,Southern,7634,2864,10498,305360,114560,419920
3/28/2024,Ravindra Liyanage,Matara,Tangalle,Southern,3064,9589,12653,122560,383560,506120
3/29/2024,Ravindra Liyanage,Matara,Tangalle,Southern,6831,7543,14374,273240,301720,574960
3/30/2024,Ravindra Liyanage,Matara,Tangalle,Southern,9563,4155,13718,382520,166200,548720
3/31/2024,Ravindra Liyanage,Matara,Tangalle,Southern,9842,8553,18395,393680,342120,735800
4/1/2024,Ravindra Liyanage,Matara,Tangalle,Southern,8578,5686,14264,343120,227440,570560
4/2/2024,Ravindra Liyanage,Matara,Tangalle,Southern,2371,1976,4347,94840,79040,173880
4/3/2024,Ravindra Liyanage,Matara,Tangalle,Southern,6927,7430,14357,277080,297200,574280
4/4/2024,Ravindra Liyanage,Matara,Tangalle,Southern,604,2661,3265,24160,106440,130600
4/5/2024,Ravindra Liyanage,Matara,Tangalle,Southern,8059,8609,16668,322360,344360,666720
4/6/2024,Ravindra Liyanage,Matara,Tangalle,Southern,9351,7888,17239,374040,315520,689560
4/7/2024,Ravindra Liyanage,Matara,Tangalle,Southern,5576,3349,8925,223040,133960,357000
4/8/2024,Ravindra Liyanage,Matara,Tangalle,Southern,7462,9430,16892,298480,377200,675680
4/9/2024,Ravindra Liyanage,Matara,Tangalle,Southern,7183,2463,9646,287320,98520,385840
4/10/2024,Ravindra Liyanage,Matara,Tangalle,Southern,2334,6291,8625,93360,251640,345000
4/11/2024,Ravindra Liyanage,Matara,Tangalle,Southern,2466,6697,9163,98640,267880,366520
4/19/2024,Ravindra Liyanage,Matara,Tangalle,Southern,8080,9448,17528,323200,377920,701120
4/20/2024,Ravindra Liyanage,Matara,Tangalle,Southern,1373,2323,3696,54920,92920,147840
4/21/2024,Ravindra Liyanage,Matara,Tangalle,Southern,9007,8530,17537,360280,341200,701480
4/22/2024,Ravindra Liyanage,Matara,Tangalle,Southern,1169,5341,6510,46760,213640,260400
4/23/2024,Ravindra Liyanage,Matara,Tangalle,Southern,7811,4529,12340,312440,181160,493600
4/24/2024,Ravindra Liyanage,Matara,Tangalle,Southern,468,885,1353,18720,35400,54120
4/25/2024,Ravindra Liyanage,Matara,Tangalle,Southern,7001,3730,10731,280040,149200,429240
4/26/2024,Ravindra Liyanage,Matara,Tangalle,Southern,2848,5556,8404,113920,222240,336160
4/27/2024,Ravindra Liyanage,Matara,Tangalle,Southern,9783,6061,15844,391320,242440,633760
4/28/2024,Ravindra Liyanage,Matara,Tangalle,Southern,8452,6106,14558,338080,244240,582320
4/29/2024,Ravindra Liyanage,Matara,Tangalle,Southern,9342,3152,12494,373680,126080,499760
4/30/2024,Ravindra Liyanage,Matara,Tangalle,Southern,4620,6896,11516,184800,275840,460640
5/1/2024,Ravindra Liyanage,Matara,Tangalle,Southern,5524,5989,11513,220960,239560,460520
5/2/2024,Ravindra Liyanage,Matara,Tangalle,Southern,2272,9340,11612,90880,373600,464480
5/3/2024,Ravindra Liyanage,Matara,Tangalle,Southern,3563,7425,10988,142520,297000,439520
5/4/2024,Ravindra Liyanage,Matara,Tangalle,Southern,754,3767,4521,30160,150680,180840
5/5/2024,Ravindra Liyanage,Matara,Tangalle,Southern,2934,1447,4381,117360,57880,175240
5/6/2024,Ravindra Liyanage,Matara,Tangalle,Southern,8815,2759,11574,352600,110360,462960
5/7/2024,Ravindra Liyanage,Matara,Tangalle,Southern,5171,9851,15022,206840,394040,600880
5/8/2024,Ravindra Liyanage,Matara,Tangalle,Southern,530,4731,5261,21200,189240,210440
5/9/2024,Ravindra Liyanage,Matara,Tangalle,Southern,3845,7656,11501,153800,306240,460040
5/10/2024,Ravindra Liyanage,Matara,Tangalle,Southern,9363,2949,12312,374520,117960,492480
5/11/2024,Ravindra Liyanage,Matara,Tangalle,Southern,3228,8058,11286,129120,322320,451440
5/12/2024,Ravindra Liyanage,Matara,Tangalle,Southern,9345,9900,19245,373800,396000,769800
5/13/2024,Ravindra Liyanage,Matara,Tangalle,Southern,9833,7690,17523,393320,307600,700920
5/14/2024,Ravindra Liyanage,Matara,Tangalle,Southern,1904,9222,11126,76160,368880,445040
5/15/2024,Ravindra Liyanage,Matara,Tangalle,Southern,3451,9415,12866,138040,376600,514640
5/16/2024,Ravindra Liyanage,Matara,Tangalle,Southern,7837,4254,12091,313480,170160,483640
5/17/2024,Ravindra Liyanage,Matara,Tangalle,Southern,1236,3693,4929,49440,147720,197160
5/18/2024,Ravindra Liyanage,Matara,Tangalle,Southern,3606,9591,13197,144240,383640,527880
5/19/2024,Ravindra Liyanage,Matara,Tangalle,Southern,7389,3387,10776,295560,135480,431040
5/20/2024,Ravindra Liyanage,Matara,Tangalle,Southern,2284,5203,7487,91360,208120,299480
5/21/2024,Ravindra Liyanage,Matara,Tangalle,Southern,550,3998,4548,22000,159920,181920
5/22/2024,Ravindra Liyanage,Matara,Tangalle,Southern,4842,2564,7406,193680,102560,296240
5/24/2024,Ravindra Liyanage,Matara,Tangalle,Southern,8687,1900,10587,347480,76000,423480
5/25/2024,Ravindra Liyanage,Matara,Tangalle,Southern,715,4494,5209,28600,179760,208360
5/26/2024,Ravindra Liyanage,Matara,Tangalle,Southern,7745,9424,17169,309800,376960,686760
5/27/2024,Ravindra Liyanage,Matara,Tangalle,Southern,5840,2768,8608,233600,110720,344320
5/28/2024,Ravindra Liyanage,Matara,Tangalle,Southern,9843,973,10816,393720,38920,432640
5/29/2024,Ravindra Liyanage,Matara,Tangalle,Southern,6199,9373,15572,247960,374920,622880
5/30/2024,Ravindra Liyanage,Matara,Tangalle,Southern,634,7916,8550,25360,316640,342000
5/31/2024,Ravindra Liyanage,Matara,Tangalle,Southern,8923,8424,17347,356920,336960,693880
6/1/2024,Ravindra Liyanage,Matara,Tangalle,Southern,7638,6305,13943,305520,252200,557720
6/2/2024,Ravindra Liyanage,Matara,Tangalle,Southern,5215,1787,7002,208600,71480,280080
6/3/2024,Ravindra Liyanage,Matara,Tangalle,Southern,2795,3806,6601,111800,152240,264040
6/4/2024,Ravindra Liyanage,Matara,Tangalle,Southern,6980,7345,14325,279200,293800,573000
6/5/2024,Ravindra Liyanage,Matara,Tangalle,Southern,4057,4109,8166,162280,164360,326640
6/6/2024,Ravindra Liyanage,Matara,Tangalle,Southern,4177,2474,6651,167080,98960,266040
6/7/2024,Ravindra Liyanage,Matara,Tangalle,Southern,7519,9348,16867,300760,373920,674680
6/8/2024,Ravindra Liyanage,Matara,Tangalle,Southern,3848,5762,9610,153920,230480,384400
6/9/2024,Ravindra Liyanage,Matara,Tangalle,Southern,135,7087,7222,5400,283480,288880
6/10/2024,Ravindra Liyanage,Matara,Tangalle,Southern,2812,8950,11762,112480,358000,470480
6/11/2024,Ravindra Liyanage,Matara,Tangalle,Southern,6122,6578,12700,244880,263120,508000
6/12/2024,Ravindra Liyanage,Matara,Tangalle,Southern,8032,4651,12683,321280,186040,507320
6/13/2024,Ravindra Liyanage,Matara,Tangalle,Southern,9203,5400,14603,368120,216000,584120
6/14/2024,Ravindra Liyanage,Matara,Tangalle,Southern,4541,8259,12800,181640,330360,512000
6/15/2024,Ravindra Liyanage,Matara,Tangalle,Southern,1375,7323,8698,55000,292920,347920
6/16/2024,Ravindra Liyanage,Matara,Tangalle,Southern,711,7387,8098,28440,295480,323920
6/17/2024,Ravindra Liyanage,Matara,Tangalle,Southern,8571,8112,16683,342840,324480,667320
6/18/2024,Ravindra Liyanage,Matara,Tangalle,Southern,2796,9748,12544,111840,389920,501760
6/19/2024,Ravindra Liyanage,Matara,Tangalle,Southern,2403,3588,5991,96120,143520,239640
6/20/2024,Ravindra Liyanage,Matara,Tangalle,Southern,8061,4800,12861,322440,192000,514440
6/21/2024,Ravindra Liyanage,Matara,Tangalle,Southern,4224,2934,7158,168960,117360,286320
6/22/2024,Ravindra Liyanage,Matara,Tangalle,Southern,6743,5836,12579,269720,233440,503160
6/23/2024,Ravindra Liyanage,Matara,Tangalle,Southern,9996,3131,13127,399840,125240,525080
6/24/2024,Ravindra Liyanage,Matara,Tangalle,Southern,955,8730,9685,38200,349200,387400
6/25/2024,Ravindra Liyanage,Matara,Tangalle,Southern,2259,5658,7917,90360,226320,316680
6/26/2024,Ravindra Liyanage,Matara,Tangalle,Southern,3655,6721,10376,146200,268840,415040
6/27/2024,Ravindra Liyanage,Matara,Tangalle,Southern,3469,5647,9116,138760,225880,364640
6/28/2024,Ravindra Liyanage,Matara,Tangalle,Southern,2860,6943,9803,114400,277720,392120
6/29/2024,Ravindra Liyanage,Matara,Tangalle,Southern,2066,6636,8702,82640,265440,348080
6/30/2024,Ravindra Liyanage,Matara,Tangalle,Southern,4744,2267,7011,189760,90680,280440
7/1/2024,Ravindra Liyanage,Matara,Tangalle,Southern,9171,330,9501,366840,13200,380040
7/2/2024,Ravindra Liyanage,Matara,Tangalle,Southern,8397,1351,9748,335880,54040,389920
7/3/2024,Ravindra Liyanage,Matara,Tangalle,Southern,6390,6607,12997,255600,264280,519880
7/4/2024,Ravindra Liyanage,Matara,Tangalle,Southern,6769,1414,8183,270760,56560,327320
7/5/2024,Ravindra Liyanage,Matara,Tangalle,Southern,3723,4271,7994,148920,170840,319760
7/6/2024,Ravindra Liyanage,Matara,Tangalle,Southern,5339,420,5759,213560,16800,230360
7/7/2024,Ravindra Liyanage,Matara,Tangalle,Southern,3806,8142,11948,152240,325680,477920
7/8/2024,Ravindra Liyanage,Matara,Tangalle,Southern,3734,1425,5159,149360,57000,206360
7/9/2024,Ravindra Liyanage,Matara,Tangalle,Southern,2953,1459,4412,118120,58360,176480
7/10/2024,Ravindra Liyanage,Matara,Tangalle,Southern,2461,8446,10907,98440,337840,436280
7/11/2024,Ravindra Liyanage,Matara,Tangalle,Southern,8080,8981,17061,323200,359240,682440
7/12/2024,Ravindra Liyanage,Matara,Tangalle,Southern,545,8239,8784,21800,329560,351360
7/13/2024,Ravindra Liyanage,Matara,Tangalle,Southern,9431,8371,17802,377240,334840,712080
7/14/2024,Ravindra Liyanage,Matara,Tangalle,Southern,3808,4115,7923,152320,164600,316920
7/15/2024,Ravindra Liyanage,Matara,Tangalle,Southern,3226,9024,12250,129040,360960,490000
7/16/2024,Ravindra Liyanage,Matara,Tangalle,Southern,3811,1227,5038,152440,49080,201520
7/17/2024,Ravindra Liyanage,Matara,Tangalle,Southern,9438,2404,11842,377520,96160,473680
7/18/2024,Ravindra Liyanage,Matara,Tangalle,Southern,9394,8004,17398,375760,320160,695920
7/19/2024,Ravindra Liyanage,Matara,Tangalle,Southern,7782,6239,14021,311280,249560,560840
7/20/2024,Ravindra Liyanage,Matara,Tangalle,Southern,1288,8126,9414,51520,325040,376560
7/21/2024,Ravindra Liyanage,Matara,Tangalle,Southern,4899,5972,10871,195960,238880,434840
7/22/2024,Ravindra Liyanage,Matara,Tangalle,Southern,2634,9931,12565,105360,397240,502600
7/23/2024,Ravindra Liyanage,Matara,Tangalle,Southern,8667,4497,13164,346680,179880,526560
7/24/2024,Ravindra Liyanage,Matara,Tangalle,Southern,1615,5249,6864,64600,209960,274560
7/25/2024,Ravindra Liyanage,Matara,Tangalle,Southern,8760,2094,10854,350400,83760,434160
7/26/2024,Ravindra Liyanage,Matara,Tangalle,Southern,3089,1838,4927,123560,73520,197080
7/27/2024,Ravindra Liyanage,Matara,Tangalle,Southern,1778,1608,3386,71120,64320,135440
7/28/2024,Ravindra Liyanage,Matara,Tangalle,Southern,2556,5949,8505,102240,237960,340200
7/29/2024,Ravindra Liyanage,Matara,Tangalle,Southern,2766,6199,8965,110640,247960,358600
7/30/2024,Ravindra Liyanage,Matara,Tangalle,Southern,9758,9084,18842,390320,363360,753680
7/31/2024,Ravindra Liyanage,Matara,Tangalle,Southern,149,3245,3394,5960,129800,135760
8/1/2024,Ravindra Liyanage,Matara,Tangalle,Southern,1604,7490,9094,64160,299600,363760
8/2/2024,Ravindra Liyanage,Matara,Tangalle,Southern,334,6328,6662,13360,253120,266480
8/3/2024,Ravindra Liyanage,Matara,Tangalle,Southern,5343,3945,9288,213720,157800,371520
8/4/2024,Ravindra Liyanage,Matara,Tangalle,Southern,6079,1319,7398,243160,52760,295920
8/5/2024,Ravindra Liyanage,Matara,Tangalle,Southern,3594,6268,9862,143760,250720,394480
8/6/2024,Ravindra Liyanage,Matara,Tangalle,Southern,5831,9422,15253,233240,376880,610120
8/7/2024,Ravindra Liyanage,Matara,Tangalle,Southern,4951,7347,12298,198040,293880,491920
8/8/2024,Ravindra Liyanage,Matara,Tangalle,Southern,7121,1651,8772,284840,66040,350880
8/9/2024,Ravindra Liyanage,Matara,Tangalle,Southern,1697,8662,10359,67880,346480,414360
8/10/2024,Ravindra Liyanage,Matara,Tangalle,Southern,2427,7680,10107,97080,307200,404280
8/11/2024,Ravindra Liyanage,Matara,Tangalle,Southern,5033,3071,8104,201320,122840,324160
8/12/2024,Ravindra Liyanage,Matara,Tangalle,Southern,7620,5598,13218,304800,223920,528720
8/13/2024,Ravindra Liyanage,Matara,Tangalle,Southern,5399,9966,15365,215960,398640,614600
8/14/2024,Ravindra Liyanage,Matara,Tangalle,Southern,5623,6043,11666,224920,241720,466640
8/15/2024,Ravindra Liyanage,Matara,Tangalle,Southern,3253,8118,11371,130120,324720,454840
8/16/2024,Ravindra Liyanage,Matara,Tangalle,Southern,2636,4994,7630,105440,199760,305200
8/17/2024,Ravindra Liyanage,Matara,Tangalle,Southern,5168,6876,12044,206720,275040,481760
8/18/2024,Ravindra Liyanage,Matara,Tangalle,Southern,6117,1677,7794,244680,67080,311760
8/19/2024,Ravindra Liyanage,Matara,Tangalle,Southern,5719,9952,15671,228760,398080,626840
8/20/2024,Ravindra Liyanage,Matara,Tangalle,Southern,8612,7156,15768,344480,286240,630720
8/21/2024,Ravindra Liyanage,Matara,Tangalle,Southern,5497,7348,12845,219880,293920,513800
8/22/2024,Ravindra Liyanage,Matara,Tangalle,Southern,7668,9997,17665,306720,399880,706600
8/23/2024,Ravindra Liyanage,Matara,Tangalle,Southern,9278,2211,11489,371120,88440,459560
8/24/2024,Ravindra Liyanage,Matara,Tangalle,Southern,4304,2862,7166,172160,114480,286640
8/25/2024,Ravindra Liyanage,Matara,Tangalle,Southern,606,3806,4412,24240,152240,176480
8/26/2024,Ravindra Liyanage,Matara,Tangalle,Southern,7053,2849,9902,282120,113960,396080
8/27/2024,Ravindra Liyanage,Matara,Tangalle,Southern,5114,6468,11582,204560,258720,463280
8/28/2024,Ravindra Liyanage,Matara,Tangalle,Southern,455,6569,7024,18200,262760,280960
8/29/2024,Ravindra Liyanage,Matara,Tangalle,Southern,5042,3246,8288,201680,129840,331520
8/30/2024,Ravindra Liyanage,Matara,Tangalle,Southern,5142,9621,14763,205680,384840,590520
8/31/2024,Ravindra Liyanage,Matara,Tangalle,Southern,4953,921,5874,198120,36840,234960
9/1/2024,Ravindra Liyanage,Matara,Tangalle,Southern,5669,5347,11016,226760,213880,440640
9/2/2024,Ravindra Liyanage,Matara,Tangalle,Southern,8496,764,9260,339840,30560,370400
9/3/2024,Ravindra Liyanage,Matara,Tangalle,Southern,6871,550,7421,274840,22000,296840
9/4/2024,Ravindra Liyanage,Matara,Tangalle,Southern,8964,7278,16242,358560,291120,649680
9/5/2024,Ravindra Liyanage,Matara,Tangalle,Southern,8555,4358,12913,342200,174320,516520
9/6/2024,Ravindra Liyanage,Matara,Tangalle,Southern,8295,6100,14395,331800,244000,575800
9/7/2024,Ravindra Liyanage,Matara,Tangalle,Southern,9029,6135,15164,361160,245400,606560
9/8/2024,Ravindra Liyanage,Matara,Tangalle,Southern,432,8068,8500,17280,322720,340000
9/9/2024,Ravindra Liyanage,Matara,Tangalle,Southern,5144,723,5867,205760,28920,234680
9/10/2024,Ravindra Liyanage,Matara,Tangalle,Southern,5910,1495,7405,236400,59800,296200
9/11/2024,Ravindra Liyanage,Matara,Tangalle,Southern,3567,4813,8380,142680,192520,335200
9/12/2024,Ravindra Liyanage,Matara,Tangalle,Southern,7307,2707,10014,292280,108280,400560
9/13/2024,Ravindra Liyanage,Matara,Tangalle,Southern,7803,416,8219,312120,16640,328760
9/14/2024,Ravindra Liyanage,Matara,Tangalle,Southern,8301,6797,15098,332040,271880,603920
9/15/2024,Ravindra Liyanage,Matara,Tangalle,Southern,1547,6630,8177,61880,265200,327080
9/16/2024,Ravindra Liyanage,Matara,Tangalle,Southern,4173,3688,7861,166920,147520,314440
9/17/2024,Ravindra Liyanage,Matara,Tangalle,Southern,16,979,995,640,39160,39800
9/18/2024,Ravindra Liyanage,Matara,Tangalle,Southern,2076,4854,6930,83040,194160,277200
9/19/2024,Ravindra Liyanage,Matara,Tangalle,Southern,9108,9665,18773,364320,386600,750920
9/20/2024,Ravindra Liyanage,Matara,Tangalle,Southern,1557,63,1620,62280,2520,64800
9/21/2024,Ravindra Liyanage,Matara,Tangalle,Southern,7798,1770,9568,311920,70800,382720
9/22/2024,Ravindra Liyanage,Matara,Tangalle,Southern,274,9175,9449,10960,367000,377960
9/23/2024,Ravindra Liyanage,Matara,Tangalle,Southern,2162,4960,7122,86480,198400,284880
9/24/2024,Ravindra Liyanage,Matara,Tangalle,Southern,7057,2255,9312,282280,90200,372480
9/25/2024,Ravindra Liyanage,Matara,Tangalle,Southern,7967,6255,14222,318680,250200,568880
9/26/2024,Ravindra Liyanage,Matara,Tangalle,Southern,33,2361,2394,1320,94440,95760
9/27/2024,Ravindra Liyanage,Matara,Tangalle,Southern,23,3891,3914,920,155640,156560
9/28/2024,Ravindra Liyanage,Matara,Tangalle,Southern,854,3581,4435,34160,143240,177400
9/29/2024,Ravindra Liyanage,Matara,Tangalle,Southern,1787,9606,11393,71480,384240,455720
9/30/2024,Ravindra Liyanage,Matara,Tangalle,Southern,5450,5687,11137,218000,227480,445480
10/1/2024,Ravindra Liyanage,Matara,Tangalle,Southern,2628,9809,12437,105120,392360,497480
10/2/2024,Ravindra Liyanage,Matara,Tangalle,Southern,6751,2821,9572,270040,112840,382880
10/3/2024,Ravindra Liyanage,Matara,Tangalle,Southern,5568,4551,10119,222720,182040,404760
10/4/2024,Ravindra Liyanage,Matara,Tangalle,Southern,1371,7273,8644,54840,290920,345760
10/5/2024,Ravindra Liyanage,Matara,Tangalle,Southern,6233,6887,13120,249320,275480,524800
10/6/2024,Ravindra Liyanage,Matara,Tangalle,Southern,1462,3407,4869,58480,136280,194760
10/7/2024,Ravindra Liyanage,Matara,Tangalle,Southern,2860,4985,7845,114400,199400,313800
10/8/2024,Ravindra Liyanage,Matara,Tangalle,Southern,5182,250,5432,207280,10000,217280
10/9/2024,Ravindra Liyanage,Matara,Tangalle,Southern,7644,4210,11854,305760,168400,474160
10/10/2024,Ravindra Liyanage,Matara,Tangalle,Southern,4207,8527,12734,168280,341080,509360
10/11/2024,Ravindra Liyanage,Matara,Tangalle,Southern,5961,3036,8997,238440,121440,359880
10/12/2024,Ravindra Liyanage,Matara,Tangalle,Southern,3606,1528,5134,144240,61120,205360
10/13/2024,Ravindra Liyanage,Matara,Tangalle,Southern,7759,3576,11335,310360,143040,453400
10/14/2024,Ravindra Liyanage,Matara,Tangalle,Southern,3596,5307,8903,143840,212280,356120
10/15/2024,Ravindra Liyanage,Matara,Tangalle,Southern,4075,3967,8042,163000,158680,321680
10/16/2024,Ravindra Liyanage,Matara,Tangalle,Southern,3626,4201,7827,145040,168040,313080
10/17/2024,Ravindra Liyanage,Matara,Tangalle,Southern,9097,410,9507,363880,16400,380280
10/18/2024,Ravindra Liyanage,Matara,Tangalle,Southern,981,5717,6698,39240,228680,267920
10/19/2024,Ravindra Liyanage,Matara,Tangalle,Southern,9483,3172,12655,379320,126880,506200
10/20/2024,Ravindra Liyanage,Matara,Tangalle,Southern,8799,6920,15719,351960,276800,628760
10/21/2024,Ravindra Liyanage,Matara,Tangalle,Southern,2718,6130,8848,108720,245200,353920
10/22/2024,Ravindra Liyanage,Matara,Tangalle,Southern,9797,4133,13930,391880,165320,557200
10/23/2024,Ravindra Liyanage,Matara,Tangalle,Southern,4766,5477,10243,190640,219080,409720
10/24/2024,Ravindra Liyanage,Matara,Tangalle,Southern,3789,1810,5599,151560,72400,223960
10/25/2024,Ravindra Liyanage,Matara,Tangalle,Southern,4705,154,4859,188200,6160,194360
10/26/2024,Ravindra Liyanage,Matara,Tangalle,Southern,9855,7633,17488,394200,305320,699520
10/27/2024,Ravindra Liyanage,Matara,Tangalle,Southern,4452,1093,5545,178080,43720,221800
10/28/2024,Ravindra Liyanage,Matara,Tangalle,Southern,8246,5947,14193,329840,237880,567720
10/29/2024,Ravindra Liyanage,Matara,Tangalle,Southern,5892,5192,11084,235680,207680,443360
10/30/2024,Ravindra Liyanage,Matara,Tangalle,Southern,4099,6826,10925,163960,273040,437000
10/31/2024,Ravindra Liyanage,Matara,Tangalle,Southern,9015,9764,18779,360600,390560,751160
11/1/2024,Ravindra Liyanage,Matara,Tangalle,Southern,6010,5458,11468,240400,218320,458720
11/2/2024,Ravindra Liyanage,Matara,Tangalle,Southern,6749,2412,9161,269960,96480,366440
11/3/2024,Ravindra Liyanage,Matara,Tangalle,Southern,5697,8271,13968,227880,330840,558720
11/4/2024,Ravindra Liyanage,Matara,Tangalle,Southern,9813,162,9975,392520,6480,399000
11/5/2024,Ravindra Liyanage,Matara,Tangalle,Southern,4314,9622,13936,172560,384880,557440
11/6/2024,Ravindra Liyanage,Matara,Tangalle,Southern,1063,7769,8832,42520,310760,353280
11/7/2024,Ravindra Liyanage,Matara,Tangalle,Southern,9029,5265,14294,361160,210600,571760
11/8/2024,Ravindra Liyanage,Matara,Tangalle,Southern,1499,1049,2548,59960,41960,101920
11/9/2024,Ravindra Liyanage,Matara,Tangalle,Southern,5736,5894,11630,229440,235760,465200
11/10/2024,Ravindra Liyanage,Matara,Tangalle,Southern,3570,4231,7801,142800,169240,312040
11/11/2024,Ravindra Liyanage,Matara,Tangalle,Southern,6678,8766,15444,267120,350640,617760
11/12/2024,Ravindra Liyanage,Matara,Tangalle,Southern,4194,3672,7866,167760,146880,314640
11/13/2024,Ravindra Liyanage,Matara,Tangalle,Southern,8618,7981,16599,344720,319240,663960
11/14/2024,Ravindra Liyanage,Matara,Tangalle,Southern,11,1041,1052,440,41640,42080
11/15/2024,Ravindra Liyanage,Matara,Tangalle,Southern,2988,2192,5180,119520,87680,207200
11/16/2024,Ravindra Liyanage,Matara,Tangalle,Southern,3237,5006,8243,129480,200240,329720
11/17/2024,Ravindra Liyanage,Matara,Tangalle,Southern,9262,5567,14829,370480,222680,593160
11/18/2024,Ravindra Liyanage,Matara,Tangalle,Southern,2088,3837,5925,83520,153480,237000
11/19/2024,Ravindra Liyanage,Matara,Tangalle,Southern,107,4115,4222,4280,164600,168880
11/20/2024,Ravindra Liyanage,Matara,Tangalle,Southern,1839,6985,8824,73560,279400,352960
11/21/2024,Ravindra Liyanage,Matara,Tangalle,Southern,7656,1083,8739,306240,43320,349560
11/22/2024,Ravindra Liyanage,Matara,Tangalle,Southern,5859,2442,8301,234360,97680,332040
11/23/2024,Ravindra Liyanage,Matara,Tangalle,Southern,3778,5486,9264,151120,219440,370560
11/24/2024,Ravindra Liyanage,Matara,Tangalle,Southern,2704,4942,7646,108160,197680,305840
11/25/2024,Ravindra Liyanage,Matara,Tangalle,Southern,2746,7976,10722,109840,319040,428880
11/26/2024,Ravindra Liyanage,Matara,Tangalle,Southern,2254,5980,8234,90160,239200,329360
11/27/2024,Ravindra Liyanage,Matara,Tangalle,Southern,6028,2242,8270,241120,89680,330800
11/28/2024,Ravindra Liyanage,Matara,Tangalle,Southern,4732,9415,14147,189280,376600,565880
11/29/2024,Ravindra Liyanage,Matara,Tangalle,Southern,3286,9629,12915,131440,385160,516600
11/30/2024,Ravindra Liyanage,Matara,Tangalle,Southern,9699,2481,12180,387960,99240,487200
12/1/2024,Ravindra Liyanage,Matara,Tangalle,Southern,6892,2348,9240,275680,93920,369600
12/2/2024,Ravindra Liyanage,Matara,Tangalle,Southern,89,3670,3759,3560,146800,150360
12/3/2024,Ravindra Liyanage,Matara,Tangalle,Southern,5083,4204,9287,203320,168160,371480
12/4/2024,Ravindra Liyanage,Matara,Tangalle,Southern,634,5614,6248,25360,224560,249920
12/5/2024,Ravindra Liyanage,Matara,Tangalle,Southern,3021,2580,5601,120840,103200,224040
12/6/2024,Ravindra Liyanage,Matara,Tangalle,Southern,8140,7180,15320,325600,287200,612800
12/7/2024,Ravindra Liyanage,Matara,Tangalle,Southern,8673,5597,14270,346920,223880,570800
12/8/2024,Ravindra Liyanage,Matara,Tangalle,Southern,7083,4786,11869,283320,191440,474760
12/9/2024,Ravindra Liyanage,Matara,Tangalle,Southern,2902,6000,8902,116080,240000,356080
12/10/2024,Ravindra Liyanage,Matara,Tangalle,Southern,9095,5390,14485,363800,215600,579400
12/11/2024,Ravindra Liyanage,Matara,Tangalle,Southern,2572,6842,9414,102880,273680,376560
12/12/2024,Ravindra Liyanage,Matara,Tangalle,Southern,9173,8774,17947,366920,350960,717880
12/13/2024,Ravindra Liyanage,Matara,Tangalle,Southern,4186,988,5174,167440,39520,206960
12/14/2024,Ravindra Liyanage,Matara,Tangalle,Southern,7498,9344,16842,299920,373760,673680
12/15/2024,Ravindra Liyanage,Matara,Tangalle,Southern,7573,3251,10824,302920,130040,432960
12/16/2024,Ravindra Liyanage,Matara,Tangalle,Southern,5978,7045,13023,239120,281800,520920
12/17/2024,Ravindra Liyanage,Matara,Tangalle,Southern,321,1861,2182,12840,74440,87280
12/18/2024,Ravindra Liyanage,Matara,Tangalle,Southern,9321,8289,17610,372840,331560,704400
12/19/2024,Ravindra Liyanage,Matara,Tangalle,Southern,2037,4538,6575,81480,181520,263000
12/20/2024,Ravindra Liyanage,Matara,Tangalle,Southern,7524,3844,11368,300960,153760,454720
12/21/2024,Ravindra Liyanage,Matara,Tangalle,Southern,5394,7550,12944,215760,302000,517760
12/22/2024,Ravindra Liyanage,Matara,Tangalle,Southern,2236,5982,8218,89440,239280,328720
12/23/2024,Ravindra Liyanage,Matara,Tangalle,Southern,3401,5874,9275,136040,234960,371000
12/24/2024,Ravindra Liyanage,Matara,Tangalle,Southern,7335,4806,12141,293400,192240,485640
12/25/2024,Ravindra Liyanage,Matara,Tangalle,Southern,6094,5268,11362,243760,210720,454480
12/26/2024,Ravindra Liyanage,Matara,Tangalle,Southern,2219,3912,6131,88760,156480,245240
12/27/2024,Ravindra Liyanage,Matara,Tangalle,Southern,1829,1657,3486,73160,66280,139440
12/28/2024,Ravindra Liyanage,Matara,Tangalle,Southern,8979,7143,16122,359160,285720,644880
12/29/2024,Ravindra Liyanage,Matara,Tangalle,Southern,8690,1883,10573,347600,75320,422920
12/30/2024,Ravindra Liyanage,Matara,Tangalle,Southern,4627,6427,11054,185080,257080,442160
12/31/2024,Ravindra Liyanage,Matara,Tangalle,Southern,4106,318,4424,164240,12720,176960
1/1/2025,Ravindra Liyanage,Matara,Tangalle,Southern,2786,6468,9254,111440,258720,370160
1/2/2025,Ravindra Liyanage,Matara,Tangalle,Southern,7863,8598,16461,314520,343920,658440
1/3/2025,Ravindra Liyanage,Matara,Tangalle,Southern,1632,941,2573,65280,37640,102920
1/4/2025,Ravindra Liyanage,Matara,Tangalle,Southern,1817,840,2657,72680,33600,106280
1/5/2025,Ravindra Liyanage,Matara,Tangalle,Southern,4353,6099,10452,174120,243960,418080
1/6/2025,Ravindra Liyanage,Matara,Tangalle,Southern,475,6139,6614,19000,245560,264560
1/7/2025,Ravindra Liyanage,Matara,Tangalle,Southern,9031,56,9087,361240,2240,363480
1/8/2025,Ravindra Liyanage,Matara,Tangalle,Southern,9580,8238,17818,383200,329520,712720
1/9/2025,Ravindra Liyanage,Matara,Tangalle,Southern,1726,9480,11206,69040,379200,448240
1/10/2025,Ravindra Liyanage,Matara,Tangalle,Southern,3810,36,3846,152400,1440,153840
1/11/2025,Ravindra Liyanage,Matara,Tangalle,Southern,7508,5522,13030,300320,220880,521200
1/12/2025,Ravindra Liyanage,Matara,Tangalle,Southern,2166,1689,3855,86640,67560,154200
1/13/2025,Ravindra Liyanage,Matara,Tangalle,Southern,3085,9422,12507,123400,376880,500280
1/14/2025,Ravindra Liyanage,Matara,Tangalle,Southern,1118,7398,8516,44720,295920,340640
1/15/2025,Ravindra Liyanage,Matara,Tangalle,Southern,1181,8701,9882,47240,348040,395280
1/16/2025,Ravindra Liyanage,Matara,Tangalle,Southern,8815,8188,17003,352600,327520,680120
1/17/2025,Ravindra Liyanage,Matara,Tangalle,Southern,7497,809,8306,299880,32360,332240
1/18/2025,Ravindra Liyanage,Matara,Tangalle,Southern,648,1086,1734,25920,43440,69360
1/19/2025,Ravindra Liyanage,Matara,Tangalle,Southern,8452,3103,11555,338080,124120,462200
1/20/2025,Ravindra Liyanage,Matara,Tangalle,Southern,7886,692,8578,315440,27680,343120
1/21/2025,Ravindra Liyanage,Matara,Tangalle,Southern,7709,8379,16088,308360,335160,643520
1/22/2025,Ravindra Liyanage,Matara,Tangalle,Southern,1227,932,2159,49080,37280,86360
1/23/2025,Ravindra Liyanage,Matara,Tangalle,Southern,1235,7440,8675,49400,297600,347000
1/24/2025,Ravindra Liyanage,Matara,Tangalle,Southern,1556,4762,6318,62240,190480,252720
1/25/2025,Ravindra Liyanage,Matara,Tangalle,Southern,8048,199,8247,321920,7960,329880
1/26/2025,Ravindra Liyanage,Matara,Tangalle,Southern,4045,223,4268,161800,8920,170720
1/27/2025,Ravindra Liyanage,Matara,Tangalle,Southern,3768,5824,9592,150720,232960,383680
1/28/2025,Ravindra Liyanage,Matara,Tangalle,Southern,2555,6034,8589,102200,241360,343560
1/29/2025,Ravindra Liyanage,Matara,Tangalle,Southern,2980,718,3698,119200,28720,147920
1/30/2025,Ravindra Liyanage,Matara,Tangalle,Southern,7050,1898,8948,282000,75920,357920
1/31/2025,Ravindra Liyanage,Matara,Tangalle,Southern,5786,8199,13985,231440,327960,559400
2/1/2025,Ravindra Liyanage,Matara,Tangalle,Southern,5226,1688,6914,209040,67520,276560
2/2/2025,Ravindra Liyanage,Matara,Tangalle,Southern,1851,7031,8882,74040,281240,355280
2/3/2025,Ravindra Liyanage,Matara,Tangalle,Southern,7453,9565,17018,298120,382600,680720
2/4/2025,Ravindra Liyanage,Matara,Tangalle,Southern,5707,8652,14359,228280,346080,574360
2/5/2025,Ravindra Liyanage,Matara,Tangalle,Southern,8227,4221,12448,329080,168840,497920
2/6/2025,Ravindra Liyanage,Matara,Tangalle,Southern,5245,9436,14681,209800,377440,587240
2/7/2025,Ravindra Liyanage,Matara,Tangalle,Southern,850,7422,8272,34000,296880,330880
2/8/2025,Ravindra Liyanage,Matara,Tangalle,Southern,7447,5586,13033,297880,223440,521320
2/9/2025,Ravindra Liyanage,Matara,Tangalle,Southern,7038,1101,8139,281520,44040,325560
2/10/2025,Ravindra Liyanage,Matara,Tangalle,Southern,9150,9789,18939,366000,391560,757560
2/11/2025,Ravindra Liyanage,Matara,Tangalle,Southern,6254,590,6844,250160,23600,273760
2/12/2025,Ravindra Liyanage,Matara,Tangalle,Southern,8245,4847,13092,329800,193880,523680
2/13/2025,Ravindra Liyanage,Matara,Tangalle,Southern,5476,324,5800,219040,12960,232000
2/14/2025,Ravindra Liyanage,Matara,Tangalle,Southern,5518,3273,8791,220720,130920,351640
2/15/2025,Ravindra Liyanage,Matara,Tangalle,Southern,9574,5071,14645,382960,202840,585800
2/16/2025,Ravindra Liyanage,Matara,Tangalle,Southern,8548,4256,12804,341920,170240,512160
2/17/2025,Ravindra Liyanage,Matara,Tangalle,Southern,4601,8288,12889,184040,331520,515560
2/18/2025,Ravindra Liyanage,Matara,Tangalle,Southern,9876,4572,14448,395040,182880,577920
2/19/2025,Ravindra Liyanage,Matara,Tangalle,Southern,4921,4446,9367,196840,177840,374680
2/20/2025,Ravindra Liyanage,Matara,Tangalle,Southern,2523,164,2687,100920,6560,107480
2/21/2025,Ravindra Liyanage,Matara,Tangalle,Southern,8571,6966,15537,342840,278640,621480
2/22/2025,Ravindra Liyanage,Matara,Tangalle,Southern,6047,4894,10941,241880,195760,437640
2/23/2025,Ravindra Liyanage,Matara,Tangalle,Southern,4850,3038,7888,194000,121520,315520
2/24/2025,Ravindra Liyanage,Matara,Tangalle,Southern,9690,1178,10868,387600,47120,434720
2/25/2025,Ravindra Liyanage,Matara,Tangalle,Southern,1101,7814,8915,44040,312560,356600
2/26/2025,Ravindra Liyanage,Matara,Tangalle,Southern,1506,1989,3495,60240,79560,139800
2/27/2025,Ravindra Liyanage,Matara,Tangalle,Southern,3883,8504,12387,155320,340160,495480
2/28/2025,Ravindra Liyanage,Matara,Tangalle,Southern,4693,6408,11101,187720,256320,444040
3/1/2025,Ravindra Liyanage,Matara,Tangalle,Southern,4667,4466,9133,186680,178640,365320
3/2/2025,Ravindra Liyanage,Matara,Tangalle,Southern,9504,5399,14903,380160,215960,596120
3/3/2025,Ravindra Liyanage,Matara,Tangalle,Southern,2951,2420,5371,118040,96800,214840
3/4/2025,Ravindra Liyanage,Matara,Tangalle,Southern,8318,2808,11126,332720,112320,445040
3/5/2025,Ravindra Liyanage,Matara,Tangalle,Southern,7883,3531,11414,315320,141240,456560
3/6/2025,Ravindra Liyanage,Matara,Tangalle,Southern,719,6481,7200,28760,259240,288000
3/7/2025,Ravindra Liyanage,Matara,Tangalle,Southern,4319,8332,12651,172760,333280,506040
3/8/2025,Ravindra Liyanage,Matara,Tangalle,Southern,3946,9937,13883,157840,397480,555320
3/9/2025,Ravindra Liyanage,Matara,Tangalle,Southern,3407,2023,5430,136280,80920,217200
3/10/2025,Ravindra Liyanage,Matara,Tangalle,Southern,9573,5890,15463,382920,235600,618520
3/11/2025,Ravindra Liyanage,Matara,Tangalle,Southern,2466,7887,10353,98640,315480,414120
3/12/2025,Ravindra Liyanage,Matara,Tangalle,Southern,5154,7896,13050,206160,315840,522000
3/13/2025,Ravindra Liyanage,Matara,Tangalle,Southern,1045,5498,6543,41800,219920,261720
3/14/2025,Ravindra Liyanage,Matara,Tangalle,Southern,6156,6343,12499,246240,253720,499960
3/15/2025,Ravindra Liyanage,Matara,Tangalle,Southern,4357,9797,14154,174280,391880,566160
3/16/2025,Ravindra Liyanage,Matara,Tangalle,Southern,4942,9792,14734,197680,391680,589360
3/17/2025,Ravindra Liyanage,Matara,Tangalle,Southern,8345,9189,17534,333800,367560,701360
3/18/2025,Ravindra Liyanage,Matara,Tangalle,Southern,7148,4728,11876,285920,189120,475040
3/19/2025,Ravindra Liyanage,Matara,Tangalle,Southern,776,8631,9407,31040,345240,376280
3/20/2025,Ravindra Liyanage,Matara,Tangalle,Southern,9680,2329,12009,387200,93160,480360
3/21/2025,Ravindra Liyanage,Matara,Tangalle,Southern,6084,8650,14734,243360,346000,589360
3/22/2025,Ravindra Liyanage,Matara,Tangalle,Southern,646,353,999,25840,14120,39960
3/23/2025,Ravindra Liyanage,Matara,Tangalle,Southern,1622,2181,3803,64880,87240,152120
3/25/2024,Chamikara Wijesiri,Kurunegala,Puttalam,North Western,2531,7856,10387,101240,314240,415480
3/26/2024,Chamikara Wijesiri,Kurunegala,Puttalam,North Western,2446,3407,5853,97840,136280,234120
3/27/2024,Chamikara Wijesiri,Kurunegala,Puttalam,North Western,3164,4710,7874,126560,188400,314960
3/28/2024,Chamikara Wijesiri,Kurunegala,Puttalam,North Western,4425,6220,10645,177000,248800,425800
3/29/2024,Chamikara Wijesiri,Kurunegala,Puttalam,North Western,9760,2998,12758,390400,119920,510320
3/30/2024,Chamikara Wijesiri,Kurunegala,Puttalam,North Western,1036,3071,4107,41440,122840,164280
3/31/2024,Chamikara Wijesiri,Kurunegala,Puttalam,North Western,175,2314,2489,7000,92560,99560
4/1/2024,Chamikara Wijesiri,Kurunegala,Puttalam,North Western,5867,2780,8647,234680,111200,345880
4/2/2024,Chamikara Wijesiri,Kurunegala,Puttalam,North Western,2248,8542,10790,89920,341680,431600
4/3/2024,Chamikara Wijesiri,Kurunegala,Puttalam,North Western,1582,1292,2874,63280,51680,114960
4/4/2024,Chamikara Wijesiri,Kurunegala,Puttalam,North Western,2307,4329,6636,92280,173160,265440
4/5/2024,Chamikara Wijesiri,Kurunegala,Puttalam,North Western,2218,5077,7295,88720,203080,291800
4/6/2024,Chamikara Wijesiri,Kurunegala,Puttalam,North Western,756,5332,6088,30240,213280,243520
4/7/2024,Chamikara Wijesiri,Kurunegala,Puttalam,North Western,3750,4405,8155,150000,176200,326200
4/8/2024,Chamikara Wijesiri,Kurunegala,Puttalam,North Western,6633,8350,14983,265320,334000,599320
4/9/2024,Chamikara Wijesiri,Kurunegala,Puttalam,North Western,3711,6891,10602,148440,275640,424080
4/10/2024,Chamikara Wijesiri,Kurunegala,Puttalam,North Western,7912,1396,9308,316480,55840,372320
4/11/2024,Chamikara Wijesiri,Kurunegala,Puttalam,North Western,4959,910,5869,198360,36400,234760
4/19/2024,Chamikara Wijesiri,Kurunegala,Puttalam,North Western,9863,3479,13342,394520,139160,533680
4/20/2024,Chamikara Wijesiri,Kurunegala,Puttalam,North Western,6547,6709,13256,261880,268360,530240
4/21/2024,Chamikara Wijesiri,Kurunegala,Puttalam,North Western,8840,5422,14262,353600,216880,570480
4/22/2024,Chamikara Wijesiri,Kurunegala,Puttalam,North Western,5919,2987,8906,236760,119480,356240
4/23/2024,Chamikara Wijesiri,Kurunegala,Puttalam,North Western,3850,8980,12830,154000,359200,513200
4/24/2024,Chamikara Wijesiri,Kurunegala,Puttalam,North Western,5081,3454,8535,203240,138160,341400
4/25/2024,Chamikara Wijesiri,Kurunegala,Puttalam,North Western,3240,522,3762,129600,20880,150480
4/26/2024,Chamikara Wijesiri,Kurunegala,Puttalam,North Western,638,2671,3309,25520,106840,132360
4/27/2024,Chamikara Wijesiri,Kurunegala,Puttalam,North Western,1179,9535,10714,47160,381400,428560
4/28/2024,Chamikara Wijesiri,Kurunegala,Puttalam,North Western,7783,5386,13169,311320,215440,526760
4/29/2024,Chamikara Wijesiri,Kurunegala,Puttalam,North Western,2248,6146,8394,89920,245840,335760
4/30/2024,Chamikara Wijesiri,Kurunegala,Puttalam,North Western,2600,6366,8966,104000,254640,358640
5/1/2024,Chamikara Wijesiri,Kurunegala,Puttalam,North Western,75,7295,7370,3000,291800,294800
5/2/2024,Chamikara Wijesiri,Kurunegala,Puttalam,North Western,8324,8479,16803,332960,339160,672120
5/3/2024,Chamikara Wijesiri,Kurunegala,Puttalam,North Western,6746,7389,14135,269840,295560,565400
5/4/2024,Chamikara Wijesiri,Kurunegala,Puttalam,North Western,6829,4837,11666,273160,193480,466640
5/5/2024,Chamikara Wijesiri,Kurunegala,Puttalam,North Western,2869,4944,7813,114760,197760,312520
5/6/2024,Chamikara Wijesiri,Kurunegala,Puttalam,North Western,6064,2633,8697,242560,105320,347880
5/7/2024,Chamikara Wijesiri,Kurunegala,Puttalam,North Western,4463,4226,8689,178520,169040,347560
5/8/2024,Chamikara Wijesiri,Kurunegala,Puttalam,North Western,1522,2877,4399,60880,115080,175960
5/9/2024,Chamikara Wijesiri,Kurunegala,Puttalam,North Western,5700,1983,7683,228000,79320,307320
5/10/2024,Chamikara Wijesiri,Kurunegala,Puttalam,North Western,683,1961,2644,27320,78440,105760
5/11/2024,Chamikara Wijesiri,Kurunegala,Puttalam,North Western,2561,816,3377,102440,32640,135080
5/12/2024,Chamikara Wijesiri,Kurunegala,Puttalam,North Western,8440,5804,14244,337600,232160,569760
5/13/2024,Chamikara Wijesiri,Kurunegala,Puttalam,North Western,3625,745,4370,145000,29800,174800
5/14/2024,Chamikara Wijesiri,Kurunegala,Puttalam,North Western,7014,6297,13311,280560,251880,532440
5/15/2024,Chamikara Wijesiri,Kurunegala,Puttalam,North Western,5512,7362,12874,220480,294480,514960
5/16/2024,Chamikara Wijesiri,Kurunegala,Puttalam,North Western,9332,5530,14862,373280,221200,594480
5/17/2024,Chamikara Wijesiri,Kurunegala,Puttalam,North Western,1194,1848,3042,47760,73920,121680
5/18/2024,Chamikara Wijesiri,Kurunegala,Puttalam,North Western,6034,807,6841,241360,32280,273640
5/19/2024,Chamikara Wijesiri,Kurunegala,Puttalam,North Western,4084,9743,13827,163360,389720,553080
5/20/2024,Chamikara Wijesiri,Kurunegala,Puttalam,North Western,6434,3113,9547,257360,124520,381880
5/21/2024,Chamikara Wijesiri,Kurunegala,Puttalam,North Western,8381,7481,15862,335240,299240,634480
5/22/2024,Chamikara Wijesiri,Kurunegala,Puttalam,North Western,5101,5971,11072,204040,238840,442880
5/24/2024,Chamikara Wijesiri,Kurunegala,Puttalam,North Western,6272,992,7264,250880,39680,290560
5/25/2024,Chamikara Wijesiri,Kurunegala,Puttalam,North Western,4269,9417,13686,170760,376680,547440
5/26/2024,Chamikara Wijesiri,Kurunegala,Puttalam,North Western,2224,6233,8457,88960,249320,338280
5/27/2024,Chamikara Wijesiri,Kurunegala,Puttalam,North Western,1100,5947,7047,44000,237880,281880
5/28/2024,Chamikara Wijesiri,Kurunegala,Puttalam,North Western,8568,8485,17053,342720,339400,682120
5/29/2024,Chamikara Wijesiri,Kurunegala,Puttalam,North Western,500,2223,2723,20000,88920,108920
5/30/2024,Chamikara Wijesiri,Kurunegala,Puttalam,North Western,6113,3308,9421,244520,132320,376840
5/31/2024,Chamikara Wijesiri,Kurunegala,Puttalam,North Western,4148,5239,9387,165920,209560,375480
6/1/2024,Chamikara Wijesiri,Kurunegala,Puttalam,North Western,7176,7741,14917,287040,309640,596680
6/2/2024,Chamikara Wijesiri,Kurunegala,Puttalam,North Western,3194,6720,9914,127760,268800,396560
6/3/2024,Chamikara Wijesiri,Kurunegala,Puttalam,North Western,8773,7721,16494,350920,308840,659760
6/4/2024,Chamikara Wijesiri,Kurunegala,Puttalam,North Western,8255,6259,14514,330200,250360,580560
6/5/2024,Chamikara Wijesiri,Kurunegala,Puttalam,North Western,3977,2280,6257,159080,91200,250280
6/6/2024,Chamikara Wijesiri,Kurunegala,Puttalam,North Western,899,3392,4291,35960,135680,171640
6/7/2024,Chamikara Wijesiri,Kurunegala,Puttalam,North Western,9453,4911,14364,378120,196440,574560
6/8/2024,Chamikara Wijesiri,Kurunegala,Puttalam,North Western,9054,6225,15279,362160,249000,611160
6/9/2024,Chamikara Wijesiri,Kurunegala,Puttalam,North Western,303,4799,5102,12120,191960,204080
6/10/2024,Chamikara Wijesiri,Kurunegala,Puttalam,North Western,5958,9651,15609,238320,386040,624360
6/11/2024,Chamikara Wijesiri,Kurunegala,Puttalam,North Western,8945,1734,10679,357800,69360,427160
6/12/2024,Chamikara Wijesiri,Kurunegala,Puttalam,North Western,900,3938,4838,36000,157520,193520
6/13/2024,Chamikara Wijesiri,Kurunegala,Puttalam,North Western,5883,6293,12176,235320,251720,487040
6/14/2024,Chamikara Wijesiri,Kurunegala,Puttalam,North Western,1439,3752,5191,57560,150080,207640
6/15/2024,Chamikara Wijesiri,Kurunegala,Puttalam,North Western,8606,4952,13558,344240,198080,542320
6/16/2024,Chamikara Wijesiri,Kurunegala,Puttalam,North Western,6981,9885,16866,279240,395400,674640
6/17/2024,Chamikara Wijesiri,Kurunegala,Puttalam,North Western,8417,4360,12777,336680,174400,511080
6/18/2024,Chamikara Wijesiri,Kurunegala,Puttalam,North Western,8918,439,9357,356720,17560,374280
6/19/2024,Chamikara Wijesiri,Kurunegala,Puttalam,North Western,7148,8854,16002,285920,354160,640080
6/20/2024,Chamikara Wijesiri,Kurunegala,Puttalam,North Western,9312,4655,13967,372480,186200,558680
6/21/2024,Chamikara Wijesiri,Kurunegala,Puttalam,North Western,7161,6118,13279,286440,244720,531160
6/22/2024,Chamikara Wijesiri,Kurunegala,Puttalam,North Western,8041,3014,11055,321640,120560,442200
6/23/2024,Chamikara Wijesiri,Kurunegala,Puttalam,North Western,7265,5800,13065,290600,232000,522600
6/24/2024,Chamikara Wijesiri,Kurunegala,Puttalam,North Western,8678,5266,13944,347120,210640,557760
6/25/2024,Chamikara Wijesiri,Kurunegala,Puttalam,North Western,7578,1281,8859,303120,51240,354360
6/26/2024,Chamikara Wijesiri,Kurunegala,Puttalam,North Western,5789,1926,7715,231560,77040,308600
6/27/2024,Chamikara Wijesiri,Kurunegala,Puttalam,North Western,2773,1611,4384,110920,64440,175360
6/28/2024,Chamikara Wijesiri,Kurunegala,Puttalam,North Western,2302,9325,11627,92080,373000,465080
6/29/2024,Chamikara Wijesiri,Kurunegala,Puttalam,North Western,9477,5650,15127,379080,226000,605080
6/30/2024,Chamikara Wijesiri,Kurunegala,Puttalam,North Western,721,3980,4701,28840,159200,188040
7/1/2024,Chamikara Wijesiri,Kurunegala,Puttalam,North Western,6546,6712,13258,261840,268480,530320
7/2/2024,Chamikara Wijesiri,Kurunegala,Puttalam,North Western,1541,4027,5568,61640,161080,222720
7/3/2024,Chamikara Wijesiri,Kurunegala,Puttalam,North Western,3684,369,4053,147360,14760,162120
7/4/2024,Chamikara Wijesiri,Kurunegala,Puttalam,North Western,6774,4385,11159,270960,175400,446360
7/5/2024,Chamikara Wijesiri,Kurunegala,Puttalam,North Western,2860,4970,7830,114400,198800,313200
7/6/2024,Chamikara Wijesiri,Kurunegala,Puttalam,North Western,5687,2588,8275,227480,103520,331000
7/7/2024,Chamikara Wijesiri,Kurunegala,Puttalam,North Western,2056,5365,7421,82240,214600,296840
7/8/2024,Chamikara Wijesiri,Kurunegala,Puttalam,North Western,1216,9100,10316,48640,364000,412640
7/9/2024,Chamikara Wijesiri,Kurunegala,Puttalam,North Western,6115,9990,16105,244600,399600,644200
7/10/2024,Chamikara Wijesiri,Kurunegala,Puttalam,North Western,9249,5906,15155,369960,236240,606200
7/11/2024,Chamikara Wijesiri,Kurunegala,Puttalam,North Western,1422,6912,8334,56880,276480,333360
7/12/2024,Chamikara Wijesiri,Kurunegala,Puttalam,North Western,2412,9967,12379,96480,398680,495160
7/13/2024,Chamikara Wijesiri,Kurunegala,Puttalam,North Western,8379,9303,17682,335160,372120,707280
7/14/2024,Chamikara Wijesiri,Kurunegala,Puttalam,North Western,7417,381,7798,296680,15240,311920
7/15/2024,Chamikara Wijesiri,Kurunegala,Puttalam,North Western,9239,9067,18306,369560,362680,732240
7/16/2024,Chamikara Wijesiri,Kurunegala,Puttalam,North Western,8768,7253,16021,350720,290120,640840
7/17/2024,Chamikara Wijesiri,Kurunegala,Puttalam,North Western,8154,27,8181,326160,1080,327240
7/18/2024,Chamikara Wijesiri,Kurunegala,Puttalam,North Western,1979,2778,4757,79160,111120,190280
7/19/2024,Chamikara Wijesiri,Kurunegala,Puttalam,North Western,4137,7041,11178,165480,281640,447120
7/20/2024,Chamikara Wijesiri,Kurunegala,Puttalam,North Western,8638,678,9316,345520,27120,372640
7/21/2024,Chamikara Wijesiri,Kurunegala,Puttalam,North Western,2077,5254,7331,83080,210160,293240
7/22/2024,Chamikara Wijesiri,Kurunegala,Puttalam,North Western,1796,6518,8314,71840,260720,332560
7/23/2024,Chamikara Wijesiri,Kurunegala,Puttalam,North Western,6564,7303,13867,262560,292120,554680
7/24/2024,Chamikara Wijesiri,Kurunegala,Puttalam,North Western,2678,3061,5739,107120,122440,229560
7/25/2024,Chamikara Wijesiri,Kurunegala,Puttalam,North Western,8134,5886,14020,325360,235440,560800
7/26/2024,Chamikara Wijesiri,Kurunegala,Puttalam,North Western,2840,4805,7645,113600,192200,305800
7/27/2024,Chamikara Wijesiri,Kurunegala,Puttalam,North Western,7957,8982,16939,318280,359280,677560
7/28/2024,Chamikara Wijesiri,Kurunegala,Puttalam,North Western,2160,44,2204,86400,1760,88160
7/29/2024,Chamikara Wijesiri,Kurunegala,Puttalam,North Western,1256,6439,7695,50240,257560,307800
7/30/2024,Chamikara Wijesiri,Kurunegala,Puttalam,North Western,1027,3420,4447,41080,136800,177880
7/31/2024,Chamikara Wijesiri,Kurunegala,Puttalam,North Western,1553,79,1632,62120,3160,65280
8/1/2024,Chamikara Wijesiri,Kurunegala,Puttalam,North Western,653,8735,9388,26120,349400,375520
8/2/2024,Chamikara Wijesiri,Kurunegala,Puttalam,North Western,8380,6734,15114,335200,269360,604560
8/3/2024,Chamikara Wijesiri,Kurunegala,Puttalam,North Western,1816,5893,7709,72640,235720,308360
8/4/2024,Chamikara Wijesiri,Kurunegala,Puttalam,North Western,778,2207,2985,31120,88280,119400
8/5/2024,Chamikara Wijesiri,Kurunegala,Puttalam,North Western,7543,2903,10446,301720,116120,417840
8/6/2024,Chamikara Wijesiri,Kurunegala,Puttalam,North Western,5829,4746,10575,233160,189840,423000
8/7/2024,Chamikara Wijesiri,Kurunegala,Puttalam,North Western,6518,3858,10376,260720,154320,415040
8/8/2024,Chamikara Wijesiri,Kurunegala,Puttalam,North Western,1580,9443,11023,63200,377720,440920
8/9/2024,Chamikara Wijesiri,Kurunegala,Puttalam,North Western,3106,2271,5377,124240,90840,215080
8/10/2024,Chamikara Wijesiri,Kurunegala,Puttalam,North Western,5213,2650,7863,208520,106000,314520
8/11/2024,Chamikara Wijesiri,Kurunegala,Puttalam,North Western,5908,8766,14674,236320,350640,586960
8/12/2024,Chamikara Wijesiri,Kurunegala,Puttalam,North Western,739,6700,7439,29560,268000,297560
8/13/2024,Chamikara Wijesiri,Kurunegala,Puttalam,North Western,3941,3263,7204,157640,130520,288160
8/14/2024,Chamikara Wijesiri,Kurunegala,Puttalam,North Western,3422,9896,13318,136880,395840,532720
8/15/2024,Chamikara Wijesiri,Kurunegala,Puttalam,North Western,3624,6510,10134,144960,260400,405360
8/16/2024,Chamikara Wijesiri,Kurunegala,Puttalam,North Western,2437,4744,7181,97480,189760,287240
8/17/2024,Chamikara Wijesiri,Kurunegala,Puttalam,North Western,977,1486,2463,39080,59440,98520
8/18/2024,Chamikara Wijesiri,Kurunegala,Puttalam,North Western,4387,7098,11485,175480,283920,459400
8/19/2024,Chamikara Wijesiri,Kurunegala,Puttalam,North Western,5516,8949,14465,220640,357960,578600
8/20/2024,Chamikara Wijesiri,Kurunegala,Puttalam,North Western,9335,3989,13324,373400,159560,532960
8/21/2024,Chamikara Wijesiri,Kurunegala,Puttalam,North Western,8331,3329,11660,333240,133160,466400
8/22/2024,Chamikara Wijesiri,Kurunegala,Puttalam,North Western,4257,6909,11166,170280,276360,446640
8/23/2024,Chamikara Wijesiri,Kurunegala,Puttalam,North Western,2562,5196,7758,102480,207840,310320
8/24/2024,Chamikara Wijesiri,Kurunegala,Puttalam,North Western,2083,8739,10822,83320,349560,432880
8/25/2024,Chamikara Wijesiri,Kurunegala,Puttalam,North Western,8858,2178,11036,354320,87120,441440
8/26/2024,Chamikara Wijesiri,Kurunegala,Puttalam,North Western,9700,8926,18626,388000,357040,745040
8/27/2024,Chamikara Wijesiri,Kurunegala,Puttalam,North Western,9605,3601,13206,384200,144040,528240
8/28/2024,Chamikara Wijesiri,Kurunegala,Puttalam,North Western,6149,4769,10918,245960,190760,436720
8/29/2024,Chamikara Wijesiri,Kurunegala,Puttalam,North Western,5203,5873,11076,208120,234920,443040
8/30/2024,Chamikara Wijesiri,Kurunegala,Puttalam,North Western,9720,9115,18835,388800,364600,753400
8/31/2024,Chamikara Wijesiri,Kurunegala,Puttalam,North Western,4655,6659,11314,186200,266360,452560
9/1/2024,Chamikara Wijesiri,Kurunegala,Puttalam,North Western,1236,8260,9496,49440,330400,379840
9/2/2024,Chamikara Wijesiri,Kurunegala,Puttalam,North Western,817,6759,7576,32680,270360,303040
9/3/2024,Chamikara Wijesiri,Kurunegala,Puttalam,North Western,7528,1580,9108,301120,63200,364320
9/4/2024,Chamikara Wijesiri,Kurunegala,Puttalam,North Western,6179,1707,7886,247160,68280,315440
9/5/2024,Chamikara Wijesiri,Kurunegala,Puttalam,North Western,5589,5197,10786,223560,207880,431440
9/6/2024,Chamikara Wijesiri,Kurunegala,Puttalam,North Western,4045,6416,10461,161800,256640,418440
9/7/2024,Chamikara Wijesiri,Kurunegala,Puttalam,North Western,661,1163,1824,26440,46520,72960
9/8/2024,Chamikara Wijesiri,Kurunegala,Puttalam,North Western,7136,151,7287,285440,6040,291480
9/9/2024,Chamikara Wijesiri,Kurunegala,Puttalam,North Western,2467,2671,5138,98680,106840,205520
9/10/2024,Chamikara Wijesiri,Kurunegala,Puttalam,North Western,20,3278,3298,800,131120,131920
9/11/2024,Chamikara Wijesiri,Kurunegala,Puttalam,North Western,6011,1942,7953,240440,77680,318120
9/12/2024,Chamikara Wijesiri,Kurunegala,Puttalam,North Western,6323,6826,13149,252920,273040,525960
9/13/2024,Chamikara Wijesiri,Kurunegala,Puttalam,North Western,563,6890,7453,22520,275600,298120
9/14/2024,Chamikara Wijesiri,Kurunegala,Puttalam,North Western,9824,2337,12161,392960,93480,486440
9/15/2024,Chamikara Wijesiri,Kurunegala,Puttalam,North Western,6549,9723,16272,261960,388920,650880
9/16/2024,Chamikara Wijesiri,Kurunegala,Puttalam,North Western,6718,9080,15798,268720,363200,631920
9/17/2024,Chamikara Wijesiri,Kurunegala,Puttalam,North Western,1358,9926,11284,54320,397040,451360
9/18/2024,Chamikara Wijesiri,Kurunegala,Puttalam,North Western,8758,728,9486,350320,29120,379440
9/19/2024,Chamikara Wijesiri,Kurunegala,Puttalam,North Western,8490,2307,10797,339600,92280,431880
9/20/2024,Chamikara Wijesiri,Kurunegala,Puttalam,North Western,3078,3320,6398,123120,132800,255920
9/21/2024,Chamikara Wijesiri,Kurunegala,Puttalam,North Western,5109,6858,11967,204360,274320,478680
9/22/2024,Chamikara Wijesiri,Kurunegala,Puttalam,North Western,2965,3308,6273,118600,132320,250920
9/23/2024,Chamikara Wijesiri,Kurunegala,Puttalam,North Western,3610,5023,8633,144400,200920,345320
9/24/2024,Chamikara Wijesiri,Kurunegala,Puttalam,North Western,4900,7068,11968,196000,282720,478720
9/25/2024,Chamikara Wijesiri,Kurunegala,Puttalam,North Western,3489,5225,8714,139560,209000,348560
9/26/2024,Chamikara Wijesiri,Kurunegala,Puttalam,North Western,1699,3019,4718,67960,120760,188720
9/27/2024,Chamikara Wijesiri,Kurunegala,Puttalam,North Western,390,9792,10182,15600,391680,407280
9/28/2024,Chamikara Wijesiri,Kurunegala,Puttalam,North Western,6847,9637,16484,273880,385480,659360
9/29/2024,Chamikara Wijesiri,Kurunegala,Puttalam,North Western,6812,5176,11988,272480,207040,479520
9/30/2024,Chamikara Wijesiri,Kurunegala,Puttalam,North Western,7063,449,7512,282520,17960,300480
10/1/2024,Chamikara Wijesiri,Kurunegala,Puttalam,North Western,8507,5417,13924,340280,216680,556960
10/2/2024,Chamikara Wijesiri,Kurunegala,Puttalam,North Western,8688,6890,15578,347520,275600,623120
10/3/2024,Chamikara Wijesiri,Kurunegala,Puttalam,North Western,4399,4277,8676,175960,171080,347040
10/4/2024,Chamikara Wijesiri,Kurunegala,Puttalam,North Western,3448,1134,4582,137920,45360,183280
10/5/2024,Chamikara Wijesiri,Kurunegala,Puttalam,North Western,9300,3269,12569,372000,130760,502760
10/6/2024,Chamikara Wijesiri,Kurunegala,Puttalam,North Western,4996,8318,13314,199840,332720,532560
10/7/2024,Chamikara Wijesiri,Kurunegala,Puttalam,North Western,1925,7434,9359,77000,297360,374360
10/8/2024,Chamikara Wijesiri,Kurunegala,Puttalam,North Western,2795,8253,11048,111800,330120,441920
10/9/2024,Chamikara Wijesiri,Kurunegala,Puttalam,North Western,7524,3582,11106,300960,143280,444240
10/10/2024,Chamikara Wijesiri,Kurunegala,Puttalam,North Western,4436,9499,13935,177440,379960,557400
10/11/2024,Chamikara Wijesiri,Kurunegala,Puttalam,North Western,5807,9776,15583,232280,391040,623320
10/12/2024,Chamikara Wijesiri,Kurunegala,Puttalam,North Western,9912,9277,19189,396480,371080,767560
10/13/2024,Chamikara Wijesiri,Kurunegala,Puttalam,North Western,5249,3363,8612,209960,134520,344480
10/14/2024,Chamikara Wijesiri,Kurunegala,Puttalam,North Western,4424,4762,9186,176960,190480,367440
10/15/2024,Chamikara Wijesiri,Kurunegala,Puttalam,North Western,157,5417,5574,6280,216680,222960
10/16/2024,Chamikara Wijesiri,Kurunegala,Puttalam,North Western,2871,8299,11170,114840,331960,446800
10/17/2024,Chamikara Wijesiri,Kurunegala,Puttalam,North Western,9367,8598,17965,374680,343920,718600
10/18/2024,Chamikara Wijesiri,Kurunegala,Puttalam,North Western,9269,2866,12135,370760,114640,485400
10/19/2024,Chamikara Wijesiri,Kurunegala,Puttalam,North Western,3474,6575,10049,138960,263000,401960
10/20/2024,Chamikara Wijesiri,Kurunegala,Puttalam,North Western,3918,123,4041,156720,4920,161640
10/21/2024,Chamikara Wijesiri,Kurunegala,Puttalam,North Western,9444,687,10131,377760,27480,405240
10/22/2024,Chamikara Wijesiri,Kurunegala,Puttalam,North Western,8472,2397,10869,338880,95880,434760
10/23/2024,Chamikara Wijesiri,Kurunegala,Puttalam,North Western,3701,6303,10004,148040,252120,400160
10/24/2024,Chamikara Wijesiri,Kurunegala,Puttalam,North Western,2050,8238,10288,82000,329520,411520
10/25/2024,Chamikara Wijesiri,Kurunegala,Puttalam,North Western,9663,4177,13840,386520,167080,553600
10/26/2024,Chamikara Wijesiri,Kurunegala,Puttalam,North Western,7339,176,7515,293560,7040,300600
10/27/2024,Chamikara Wijesiri,Kurunegala,Puttalam,North Western,3209,7442,10651,128360,297680,426040
10/28/2024,Chamikara Wijesiri,Kurunegala,Puttalam,North Western,4761,4629,9390,190440,185160,375600
10/29/2024,Chamikara Wijesiri,Kurunegala,Puttalam,North Western,2009,6223,8232,80360,248920,329280
10/30/2024,Chamikara Wijesiri,Kurunegala,Puttalam,North Western,6040,4427,10467,241600,177080,418680
10/31/2024,Chamikara Wijesiri,Kurunegala,Puttalam,North Western,4721,9796,14517,188840,391840,580680
11/1/2024,Chamikara Wijesiri,Kurunegala,Puttalam,North Western,7017,3930,10947,280680,157200,437880
11/2/2024,Chamikara Wijesiri,Kurunegala,Puttalam,North Western,3983,3476,7459,159320,139040,298360
11/3/2024,Chamikara Wijesiri,Kurunegala,Puttalam,North Western,8013,7808,15821,320520,312320,632840
11/4/2024,Chamikara Wijesiri,Kurunegala,Puttalam,North Western,9795,1048,10843,391800,41920,433720
11/5/2024,Chamikara Wijesiri,Kurunegala,Puttalam,North Western,643,6388,7031,25720,255520,281240
11/6/2024,Chamikara Wijesiri,Kurunegala,Puttalam,North Western,2234,4942,7176,89360,197680,287040
11/7/2024,Chamikara Wijesiri,Kurunegala,Puttalam,North Western,6375,322,6697,255000,12880,267880
11/8/2024,Chamikara Wijesiri,Kurunegala,Puttalam,North Western,7440,6225,13665,297600,249000,546600
11/9/2024,Chamikara Wijesiri,Kurunegala,Puttalam,North Western,1192,1190,2382,47680,47600,95280
11/10/2024,Chamikara Wijesiri,Kurunegala,Puttalam,North Western,6323,5155,11478,252920,206200,459120
11/11/2024,Chamikara Wijesiri,Kurunegala,Puttalam,North Western,3520,3367,6887,140800,134680,275480
11/12/2024,Chamikara Wijesiri,Kurunegala,Puttalam,North Western,229,6812,7041,9160,272480,281640
11/13/2024,Chamikara Wijesiri,Kurunegala,Puttalam,North Western,4142,83,4225,165680,3320,169000
11/14/2024,Chamikara Wijesiri,Kurunegala,Puttalam,North Western,4292,4555,8847,171680,182200,353880
11/15/2024,Chamikara Wijesiri,Kurunegala,Puttalam,North Western,3043,3626,6669,121720,145040,266760
11/16/2024,Chamikara Wijesiri,Kurunegala,Puttalam,North Western,1642,791,2433,65680,31640,97320
11/17/2024,Chamikara Wijesiri,Kurunegala,Puttalam,North Western,4517,2391,6908,180680,95640,276320
11/18/2024,Chamikara Wijesiri,Kurunegala,Puttalam,North Western,2971,4077,7048,118840,163080,281920
11/19/2024,Chamikara Wijesiri,Kurunegala,Puttalam,North Western,6882,6952,13834,275280,278080,553360
11/20/2024,Chamikara Wijesiri,Kurunegala,Puttalam,North Western,3874,8438,12312,154960,337520,492480
11/21/2024,Chamikara Wijesiri,Kurunegala,Puttalam,North Western,7949,7058,15007,317960,282320,600280
11/22/2024,Chamikara Wijesiri,Kurunegala,Puttalam,North Western,7222,337,7559,288880,13480,302360
11/23/2024,Chamikara Wijesiri,Kurunegala,Puttalam,North Western,9269,7130,16399,370760,285200,655960
11/24/2024,Chamikara Wijesiri,Kurunegala,Puttalam,North Western,2138,9203,11341,85520,368120,453640
11/25/2024,Chamikara Wijesiri,Kurunegala,Puttalam,North Western,4715,1277,5992,188600,51080,239680
11/26/2024,Chamikara Wijesiri,Kurunegala,Puttalam,North Western,7383,3054,10437,295320,122160,417480
11/27/2024,Chamikara Wijesiri,Kurunegala,Puttalam,North Western,2469,6405,8874,98760,256200,354960
11/28/2024,Chamikara Wijesiri,Kurunegala,Puttalam,North Western,7325,4666,11991,293000,186640,479640
11/29/2024,Chamikara Wijesiri,Kurunegala,Puttalam,North Western,6208,9810,16018,248320,392400,640720
11/30/2024,Chamikara Wijesiri,Kurunegala,Puttalam,North Western,840,1212,2052,33600,48480,82080
12/1/2024,Chamikara Wijesiri,Kurunegala,Puttalam,North Western,7817,4963,12780,312680,198520,511200
12/2/2024,Chamikara Wijesiri,Kurunegala,Puttalam,North Western,174,2134,2308,6960,85360,92320
12/3/2024,Chamikara Wijesiri,Kurunegala,Puttalam,North Western,2084,1412,3496,83360,56480,139840
12/4/2024,Chamikara Wijesiri,Kurunegala,Puttalam,North Western,1751,3979,5730,70040,159160,229200
12/5/2024,Chamikara Wijesiri,Kurunegala,Puttalam,North Western,7881,2658,10539,315240,106320,421560
12/6/2024,Chamikara Wijesiri,Kurunegala,Puttalam,North Western,1479,5332,6811,59160,213280,272440
12/7/2024,Chamikara Wijesiri,Kurunegala,Puttalam,North Western,1765,7579,9344,70600,303160,373760
12/8/2024,Chamikara Wijesiri,Kurunegala,Puttalam,North Western,5382,8246,13628,215280,329840,545120
12/9/2024,Chamikara Wijesiri,Kurunegala,Puttalam,North Western,5758,6294,12052,230320,251760,482080
12/10/2024,Chamikara Wijesiri,Kurunegala,Puttalam,North Western,1783,323,2106,71320,12920,84240
12/11/2024,Chamikara Wijesiri,Kurunegala,Puttalam,North Western,1040,6748,7788,41600,269920,311520
12/12/2024,Chamikara Wijesiri,Kurunegala,Puttalam,North Western,8510,5023,13533,340400,200920,541320
12/13/2024,Chamikara Wijesiri,Kurunegala,Puttalam,North Western,5017,2626,7643,200680,105040,305720
12/14/2024,Chamikara Wijesiri,Kurunegala,Puttalam,North Western,9106,6118,15224,364240,244720,608960
12/15/2024,Chamikara Wijesiri,Kurunegala,Puttalam,North Western,4536,9989,14525,181440,399560,581000
12/16/2024,Chamikara Wijesiri,Kurunegala,Puttalam,North Western,4278,8577,12855,171120,343080,514200
12/17/2024,Chamikara Wijesiri,Kurunegala,Puttalam,North Western,409,7532,7941,16360,301280,317640
12/18/2024,Chamikara Wijesiri,Kurunegala,Puttalam,North Western,5843,6153,11996,233720,246120,479840
12/19/2024,Chamikara Wijesiri,Kurunegala,Puttalam,North Western,9995,6276,16271,399800,251040,650840
12/20/2024,Chamikara Wijesiri,Kurunegala,Puttalam,North Western,4163,1617,5780,166520,64680,231200
12/21/2024,Chamikara Wijesiri,Kurunegala,Puttalam,North Western,1556,4602,6158,62240,184080,246320
12/22/2024,Chamikara Wijesiri,Kurunegala,Puttalam,North Western,2002,3304,5306,80080,132160,212240
12/23/2024,Chamikara Wijesiri,Kurunegala,Puttalam,North Western,2682,9153,11835,107280,366120,473400
12/24/2024,Chamikara Wijesiri,Kurunegala,Puttalam,North Western,8913,5617,14530,356520,224680,581200
12/25/2024,Chamikara Wijesiri,Kurunegala,Puttalam,North Western,7145,8719,15864,285800,348760,634560
12/26/2024,Chamikara Wijesiri,Kurunegala,Puttalam,North Western,5463,629,6092,218520,25160,243680
12/27/2024,Chamikara Wijesiri,Kurunegala,Puttalam,North Western,6096,2964,9060,243840,118560,362400
12/28/2024,Chamikara Wijesiri,Kurunegala,Puttalam,North Western,5561,7196,12757,222440,287840,510280
12/29/2024,Chamikara Wijesiri,Kurunegala,Puttalam,North Western,9753,6436,16189,390120,257440,647560
12/30/2024,Chamikara Wijesiri,Kurunegala,Puttalam,North Western,9575,653,10228,383000,26120,409120
12/31/2024,Chamikara Wijesiri,Kurunegala,Puttalam,North Western,5569,5301,10870,222760,212040,434800
1/1/2025,Chamikara Wijesiri,Kurunegala,Puttalam,North Western,7787,8454,16241,311480,338160,649640
1/2/2025,Chamikara Wijesiri,Kurunegala,Puttalam,North Western,6755,2556,9311,270200,102240,372440
1/3/2025,Chamikara Wijesiri,Kurunegala,Puttalam,North Western,3636,6399,10035,145440,255960,401400
1/4/2025,Chamikara Wijesiri,Kurunegala,Puttalam,North Western,3787,9357,13144,151480,374280,525760
1/5/2025,Chamikara Wijesiri,Kurunegala,Puttalam,North Western,5940,2763,8703,237600,110520,348120
1/6/2025,Chamikara Wijesiri,Kurunegala,Puttalam,North Western,2097,8401,10498,83880,336040,419920
1/7/2025,Chamikara Wijesiri,Kurunegala,Puttalam,North Western,2909,552,3461,116360,22080,138440
1/8/2025,Chamikara Wijesiri,Kurunegala,Puttalam,North Western,4698,8328,13026,187920,333120,521040
1/9/2025,Chamikara Wijesiri,Kurunegala,Puttalam,North Western,1877,3002,4879,75080,120080,195160
1/10/2025,Chamikara Wijesiri,Kurunegala,Puttalam,North Western,3135,6889,10024,125400,275560,400960
1/11/2025,Chamikara Wijesiri,Kurunegala,Puttalam,North Western,412,4601,5013,16480,184040,200520
1/12/2025,Chamikara Wijesiri,Kurunegala,Puttalam,North Western,3261,3419,6680,130440,136760,267200
1/13/2025,Chamikara Wijesiri,Kurunegala,Puttalam,North Western,3658,1211,4869,146320,48440,194760
1/14/2025,Chamikara Wijesiri,Kurunegala,Puttalam,North Western,1300,2440,3740,52000,97600,149600
1/15/2025,Chamikara Wijesiri,Kurunegala,Puttalam,North Western,7710,6458,14168,308400,258320,566720
1/16/2025,Chamikara Wijesiri,Kurunegala,Puttalam,North Western,8716,5845,14561,348640,233800,582440
1/17/2025,Chamikara Wijesiri,Kurunegala,Puttalam,North Western,9616,8735,18351,384640,349400,734040
1/18/2025,Chamikara Wijesiri,Kurunegala,Puttalam,North Western,4051,5711,9762,162040,228440,390480
1/19/2025,Chamikara Wijesiri,Kurunegala,Puttalam,North Western,7574,892,8466,302960,35680,338640
1/20/2025,Chamikara Wijesiri,Kurunegala,Puttalam,North Western,5663,3447,9110,226520,137880,364400
1/21/2025,Chamikara Wijesiri,Kurunegala,Puttalam,North Western,3566,5146,8712,142640,205840,348480
1/22/2025,Chamikara Wijesiri,Kurunegala,Puttalam,North Western,201,9733,9934,8040,389320,397360
1/23/2025,Chamikara Wijesiri,Kurunegala,Puttalam,North Western,8122,3597,11719,324880,143880,468760
1/24/2025,Chamikara Wijesiri,Kurunegala,Puttalam,North Western,9966,7963,17929,398640,318520,717160
1/25/2025,Chamikara Wijesiri,Kurunegala,Puttalam,North Western,3613,8090,11703,144520,323600,468120
1/26/2025,Chamikara Wijesiri,Kurunegala,Puttalam,North Western,428,6373,6801,17120,254920,272040
1/27/2025,Chamikara Wijesiri,Kurunegala,Puttalam,North Western,1083,3983,5066,43320,159320,202640
1/28/2025,Chamikara Wijesiri,Kurunegala,Puttalam,North Western,4592,159,4751,183680,6360,190040
1/29/2025,Chamikara Wijesiri,Kurunegala,Puttalam,North Western,1207,8559,9766,48280,342360,390640
1/30/2025,Chamikara Wijesiri,Kurunegala,Puttalam,North Western,4721,1074,5795,188840,42960,231800
1/31/2025,Chamikara Wijesiri,Kurunegala,Puttalam,North Western,6627,1790,8417,265080,71600,336680
2/1/2025,Chamikara Wijesiri,Kurunegala,Puttalam,North Western,8136,8601,16737,325440,344040,669480
2/2/2025,Chamikara Wijesiri,Kurunegala,Puttalam,North Western,2970,9157,12127,118800,366280,485080
2/3/2025,Chamikara Wijesiri,Kurunegala,Puttalam,North Western,2911,3263,6174,116440,130520,246960
2/4/2025,Chamikara Wijesiri,Kurunegala,Puttalam,North Western,4110,8072,12182,164400,322880,487280
2/5/2025,Chamikara Wijesiri,Kurunegala,Puttalam,North Western,6092,9331,15423,243680,373240,616920
2/6/2025,Chamikara Wijesiri,Kurunegala,Puttalam,North Western,7830,3640,11470,313200,145600,458800
2/7/2025,Chamikara Wijesiri,Kurunegala,Puttalam,North Western,2800,9851,12651,112000,394040,506040
2/8/2025,Chamikara Wijesiri,Kurunegala,Puttalam,North Western,5826,9434,15260,233040,377360,610400
2/9/2025,Chamikara Wijesiri,Kurunegala,Puttalam,North Western,9903,8824,18727,396120,352960,749080
2/10/2025,Chamikara Wijesiri,Kurunegala,Puttalam,North Western,5905,2840,8745,236200,113600,349800
2/11/2025,Chamikara Wijesiri,Kurunegala,Puttalam,North Western,6483,678,7161,259320,27120,286440
2/12/2025,Chamikara Wijesiri,Kurunegala,Puttalam,North Western,2102,7557,9659,84080,302280,386360
2/13/2025,Chamikara Wijesiri,Kurunegala,Puttalam,North Western,2227,7175,9402,89080,287000,376080
2/14/2025,Chamikara Wijesiri,Kurunegala,Puttalam,North Western,2448,4785,7233,97920,191400,289320
2/15/2025,Chamikara Wijesiri,Kurunegala,Puttalam,North Western,2213,4823,7036,88520,192920,281440
2/16/2025,Chamikara Wijesiri,Kurunegala,Puttalam,North Western,8603,6601,15204,344120,264040,608160
2/17/2025,Chamikara Wijesiri,Kurunegala,Puttalam,North Western,707,3787,4494,28280,151480,179760
2/18/2025,Chamikara Wijesiri,Kurunegala,Puttalam,North Western,3804,3846,7650,152160,153840,306000
2/19/2025,Chamikara Wijesiri,Kurunegala,Puttalam,North Western,6590,9624,16214,263600,384960,648560
2/20/2025,Chamikara Wijesiri,Kurunegala,Puttalam,North Western,8975,1649,10624,359000,65960,424960
2/21/2025,Chamikara Wijesiri,Kurunegala,Puttalam,North Western,9009,559,9568,360360,22360,382720
2/22/2025,Chamikara Wijesiri,Kurunegala,Puttalam,North Western,9489,9910,19399,379560,396400,775960
2/23/2025,Chamikara Wijesiri,Kurunegala,Puttalam,North Western,3972,2233,6205,158880,89320,248200
2/24/2025,Chamikara Wijesiri,Kurunegala,Puttalam,North Western,859,7783,8642,34360,311320,345680
2/25/2025,Chamikara Wijesiri,Kurunegala,Puttalam,North Western,8489,6051,14540,339560,242040,581600
2/26/2025,Chamikara Wijesiri,Kurunegala,Puttalam,North Western,2145,3165,5310,85800,126600,212400
2/27/2025,Chamikara Wijesiri,Kurunegala,Puttalam,North Western,4794,4319,9113,191760,172760,364520
2/28/2025,Chamikara Wijesiri,Kurunegala,Puttalam,North Western,7026,1507,8533,281040,60280,341320
3/1/2025,Chamikara Wijesiri,Kurunegala,Puttalam,North Western,5822,3295,9117,232880,131800,364680
3/2/2025,Chamikara Wijesiri,Kurunegala,Puttalam,North Western,9852,6332,16184,394080,253280,647360
3/3/2025,Chamikara Wijesiri,Kurunegala,Puttalam,North Western,9082,3361,12443,363280,134440,497720
3/4/2025,Chamikara Wijesiri,Kurunegala,Puttalam,North Western,3598,4801,8399,143920,192040,335960
3/5/2025,Chamikara Wijesiri,Kurunegala,Puttalam,North Western,4225,8173,12398,169000,326920,495920
3/6/2025,Chamikara Wijesiri,Kurunegala,Puttalam,North Western,8893,114,9007,355720,4560,360280
3/7/2025,Chamikara Wijesiri,Kurunegala,Puttalam,North Western,7601,3404,11005,304040,136160,440200
3/8/2025,Chamikara Wijesiri,Kurunegala,Puttalam,North Western,4353,4111,8464,174120,164440,338560
3/9/2025,Chamikara Wijesiri,Kurunegala,Puttalam,North Western,6435,4058,10493,257400,162320,419720
3/10/2025,Chamikara Wijesiri,Kurunegala,Puttalam,North Western,4089,2697,6786,163560,107880,271440
3/11/2025,Chamikara Wijesiri,Kurunegala,Puttalam,North Western,2033,197,2230,81320,7880,89200
3/12/2025,Chamikara Wijesiri,Kurunegala,Puttalam,North Western,9846,6286,16132,393840,251440,645280
3/13/2025,Chamikara Wijesiri,Kurunegala,Puttalam,North Western,1117,6645,7762,44680,265800,310480
3/14/2025,Chamikara Wijesiri,Kurunegala,Puttalam,North Western,1163,1857,3020,46520,74280,120800
3/15/2025,Chamikara Wijesiri,Kurunegala,Puttalam,North Western,2674,601,3275,106960,24040,131000
3/16/2025,Chamikara Wijesiri,Kurunegala,Puttalam,North Western,8858,2293,11151,354320,91720,446040
3/17/2025,Chamikara Wijesiri,Kurunegala,Puttalam,North Western,8584,6318,14902,343360,252720,596080
3/18/2025,Chamikara Wijesiri,Kurunegala,Puttalam,North Western,2009,7759,9768,80360,310360,390720
3/19/2025,Chamikara Wijesiri,Kurunegala,Puttalam,North Western,3793,9632,13425,151720,385280,537000
3/20/2025,Chamikara Wijesiri,Kurunegala,Puttalam,North Western,4236,1605,5841,169440,64200,233640
3/21/2025,Chamikara Wijesiri,Kurunegala,Puttalam,North Western,4816,2723,7539,192640,108920,301560
3/22/2025,Chamikara Wijesiri,Kurunegala,Puttalam,North Western,1827,6319,8146,73080,252760,325840
3/23/2025,Chamikara Wijesiri,Kurunegala,Puttalam,North Western,8283,8908,17191,331320,356320,687640
3/25/2024,Sujan Fernando,Ampara,Uhana,Eastern,4488,3856,8344,179520,154240,333760
3/26/2024,Sujan Fernando,Ampara,Uhana,Eastern,3820,6771,10591,152800,270840,423640
3/27/2024,Sujan Fernando,Ampara,Uhana,Eastern,7766,6114,13880,310640,244560,555200
3/28/2024,Sujan Fernando,Ampara,Uhana,Eastern,1739,7963,9702,69560,318520,388080
3/29/2024,Sujan Fernando,Ampara,Uhana,Eastern,5573,9244,14817,222920,369760,592680
3/30/2024,Sujan Fernando,Ampara,Uhana,Eastern,1557,6231,7788,62280,249240,311520
3/31/2024,Sujan Fernando,Ampara,Uhana,Eastern,3444,3126,6570,137760,125040,262800
4/1/2024,Sujan Fernando,Ampara,Uhana,Eastern,1932,2613,4545,77280,104520,181800
4/2/2024,Sujan Fernando,Ampara,Uhana,Eastern,1739,211,1950,69560,8440,78000
4/3/2024,Sujan Fernando,Ampara,Uhana,Eastern,2246,9824,12070,89840,392960,482800
4/4/2024,Sujan Fernando,Ampara,Uhana,Eastern,6582,3670,10252,263280,146800,410080
4/5/2024,Sujan Fernando,Ampara,Uhana,Eastern,7506,8540,16046,300240,341600,641840
4/6/2024,Sujan Fernando,Ampara,Uhana,Eastern,7900,221,8121,316000,8840,324840
4/7/2024,Sujan Fernando,Ampara,Uhana,Eastern,4691,5514,10205,187640,220560,408200
4/8/2024,Sujan Fernando,Ampara,Uhana,Eastern,9608,7979,17587,384320,319160,703480
4/9/2024,Sujan Fernando,Ampara,Uhana,Eastern,216,2377,2593,8640,95080,103720
4/10/2024,Sujan Fernando,Ampara,Uhana,Eastern,7143,6094,13237,285720,243760,529480
4/11/2024,Sujan Fernando,Ampara,Uhana,Eastern,6289,9488,15777,251560,379520,631080
4/19/2024,Sujan Fernando,Ampara,Uhana,Eastern,8823,9249,18072,352920,369960,722880
4/20/2024,Sujan Fernando,Ampara,Uhana,Eastern,4240,4050,8290,169600,162000,331600
4/21/2024,Sujan Fernando,Ampara,Uhana,Eastern,2293,718,3011,91720,28720,120440
4/22/2024,Sujan Fernando,Ampara,Uhana,Eastern,9604,6691,16295,384160,267640,651800
4/23/2024,Sujan Fernando,Ampara,Uhana,Eastern,1883,1058,2941,75320,42320,117640
4/24/2024,Sujan Fernando,Ampara,Uhana,Eastern,5228,7559,12787,209120,302360,511480
4/25/2024,Sujan Fernando,Ampara,Uhana,Eastern,868,5002,5870,34720,200080,234800
4/26/2024,Sujan Fernando,Ampara,Uhana,Eastern,9810,1894,11704,392400,75760,468160
4/27/2024,Sujan Fernando,Ampara,Uhana,Eastern,3771,2626,6397,150840,105040,255880
4/28/2024,Sujan Fernando,Ampara,Uhana,Eastern,5750,228,5978,230000,9120,239120
4/29/2024,Sujan Fernando,Ampara,Uhana,Eastern,3928,3272,7200,157120,130880,288000
4/30/2024,Sujan Fernando,Ampara,Uhana,Eastern,7805,856,8661,312200,34240,346440
5/1/2024,Sujan Fernando,Ampara,Uhana,Eastern,5602,5408,11010,224080,216320,440400
5/2/2024,Sujan Fernando,Ampara,Uhana,Eastern,4129,2738,6867,165160,109520,274680
5/3/2024,Sujan Fernando,Ampara,Uhana,Eastern,196,6145,6341,7840,245800,253640
5/4/2024,Sujan Fernando,Ampara,Uhana,Eastern,5957,5171,11128,238280,206840,445120
5/5/2024,Sujan Fernando,Ampara,Uhana,Eastern,7807,9309,17116,312280,372360,684640
5/6/2024,Sujan Fernando,Ampara,Uhana,Eastern,8298,8026,16324,331920,321040,652960
5/7/2024,Sujan Fernando,Ampara,Uhana,Eastern,603,7213,7816,24120,288520,312640
5/8/2024,Sujan Fernando,Ampara,Uhana,Eastern,896,6362,7258,35840,254480,290320
5/9/2024,Sujan Fernando,Ampara,Uhana,Eastern,8706,557,9263,348240,22280,370520
5/10/2024,Sujan Fernando,Ampara,Uhana,Eastern,8684,9066,17750,347360,362640,710000
5/11/2024,Sujan Fernando,Ampara,Uhana,Eastern,2885,6056,8941,115400,242240,357640
5/12/2024,Sujan Fernando,Ampara,Uhana,Eastern,7057,9200,16257,282280,368000,650280
5/13/2024,Sujan Fernando,Ampara,Uhana,Eastern,8358,2629,10987,334320,105160,439480
5/14/2024,Sujan Fernando,Ampara,Uhana,Eastern,8110,9064,17174,324400,362560,686960
5/15/2024,Sujan Fernando,Ampara,Uhana,Eastern,766,7415,8181,30640,296600,327240
5/16/2024,Sujan Fernando,Ampara,Uhana,Eastern,2933,1462,4395,117320,58480,175800
5/17/2024,Sujan Fernando,Ampara,Uhana,Eastern,9625,2660,12285,385000,106400,491400
5/18/2024,Sujan Fernando,Ampara,Uhana,Eastern,2553,5678,8231,102120,227120,329240
5/19/2024,Sujan Fernando,Ampara,Uhana,Eastern,165,1010,1175,6600,40400,47000
5/20/2024,Sujan Fernando,Ampara,Uhana,Eastern,9101,5239,14340,364040,209560,573600
5/21/2024,Sujan Fernando,Ampara,Uhana,Eastern,5587,9759,15346,223480,390360,613840
5/22/2024,Sujan Fernando,Ampara,Uhana,Eastern,365,8495,8860,14600,339800,354400
5/24/2024,Sujan Fernando,Ampara,Uhana,Eastern,2580,4443,7023,103200,177720,280920
5/25/2024,Sujan Fernando,Ampara,Uhana,Eastern,9778,4671,14449,391120,186840,577960
5/26/2024,Sujan Fernando,Ampara,Uhana,Eastern,9456,9328,18784,378240,373120,751360
5/27/2024,Sujan Fernando,Ampara,Uhana,Eastern,8075,7781,15856,323000,311240,634240
5/28/2024,Sujan Fernando,Ampara,Uhana,Eastern,9458,2922,12380,378320,116880,495200
5/29/2024,Sujan Fernando,Ampara,Uhana,Eastern,7213,1522,8735,288520,60880,349400
5/30/2024,Sujan Fernando,Ampara,Uhana,Eastern,8655,521,9176,346200,20840,367040
5/31/2024,Sujan Fernando,Ampara,Uhana,Eastern,8590,7496,16086,343600,299840,643440
6/1/2024,Sujan Fernando,Ampara,Uhana,Eastern,4237,125,4362,169480,5000,174480
6/2/2024,Sujan Fernando,Ampara,Uhana,Eastern,100,2858,2958,4000,114320,118320
6/3/2024,Sujan Fernando,Ampara,Uhana,Eastern,7399,6628,14027,295960,265120,561080
6/4/2024,Sujan Fernando,Ampara,Uhana,Eastern,5628,9863,15491,225120,394520,619640
6/5/2024,Sujan Fernando,Ampara,Uhana,Eastern,7517,9091,16608,300680,363640,664320
6/6/2024,Sujan Fernando,Ampara,Uhana,Eastern,1681,2000,3681,67240,80000,147240
6/7/2024,Sujan Fernando,Ampara,Uhana,Eastern,8971,4862,13833,358840,194480,553320
6/8/2024,Sujan Fernando,Ampara,Uhana,Eastern,7582,103,7685,303280,4120,307400
6/9/2024,Sujan Fernando,Ampara,Uhana,Eastern,6798,8979,15777,271920,359160,631080
6/10/2024,Sujan Fernando,Ampara,Uhana,Eastern,6390,9258,15648,255600,370320,625920
6/11/2024,Sujan Fernando,Ampara,Uhana,Eastern,9727,840,10567,389080,33600,422680
6/12/2024,Sujan Fernando,Ampara,Uhana,Eastern,5765,192,5957,230600,7680,238280
6/13/2024,Sujan Fernando,Ampara,Uhana,Eastern,6618,8002,14620,264720,320080,584800
6/14/2024,Sujan Fernando,Ampara,Uhana,Eastern,4780,6242,11022,191200,249680,440880
6/15/2024,Sujan Fernando,Ampara,Uhana,Eastern,4856,5432,10288,194240,217280,411520
6/16/2024,Sujan Fernando,Ampara,Uhana,Eastern,3390,7520,10910,135600,300800,436400
6/17/2024,Sujan Fernando,Ampara,Uhana,Eastern,4900,7866,12766,196000,314640,510640
6/18/2024,Sujan Fernando,Ampara,Uhana,Eastern,8048,2057,10105,321920,82280,404200
6/19/2024,Sujan Fernando,Ampara,Uhana,Eastern,9973,5632,15605,398920,225280,624200
6/20/2024,Sujan Fernando,Ampara,Uhana,Eastern,5053,3262,8315,202120,130480,332600
6/21/2024,Sujan Fernando,Ampara,Uhana,Eastern,4651,6707,11358,186040,268280,454320
6/22/2024,Sujan Fernando,Ampara,Uhana,Eastern,473,2521,2994,18920,100840,119760
6/23/2024,Sujan Fernando,Ampara,Uhana,Eastern,3606,9803,13409,144240,392120,536360
6/24/2024,Sujan Fernando,Ampara,Uhana,Eastern,8850,2969,11819,354000,118760,472760
6/25/2024,Sujan Fernando,Ampara,Uhana,Eastern,6395,9063,15458,255800,362520,618320
6/26/2024,Sujan Fernando,Ampara,Uhana,Eastern,9949,596,10545,397960,23840,421800
6/27/2024,Sujan Fernando,Ampara,Uhana,Eastern,9546,2224,11770,381840,88960,470800
6/28/2024,Sujan Fernando,Ampara,Uhana,Eastern,8167,6971,15138,326680,278840,605520
6/29/2024,Sujan Fernando,Ampara,Uhana,Eastern,99,5452,5551,3960,218080,222040
6/30/2024,Sujan Fernando,Ampara,Uhana,Eastern,1411,9553,10964,56440,382120,438560
7/1/2024,Sujan Fernando,Ampara,Uhana,Eastern,8203,2801,11004,328120,112040,440160
7/2/2024,Sujan Fernando,Ampara,Uhana,Eastern,1597,2985,4582,63880,119400,183280
7/3/2024,Sujan Fernando,Ampara,Uhana,Eastern,6372,3247,9619,254880,129880,384760
7/4/2024,Sujan Fernando,Ampara,Uhana,Eastern,612,4217,4829,24480,168680,193160
7/5/2024,Sujan Fernando,Ampara,Uhana,Eastern,6578,5760,12338,263120,230400,493520
7/6/2024,Sujan Fernando,Ampara,Uhana,Eastern,8710,2681,11391,348400,107240,455640
7/7/2024,Sujan Fernando,Ampara,Uhana,Eastern,4003,3787,7790,160120,151480,311600
7/8/2024,Sujan Fernando,Ampara,Uhana,Eastern,1711,9691,11402,68440,387640,456080
7/9/2024,Sujan Fernando,Ampara,Uhana,Eastern,5498,9269,14767,219920,370760,590680
7/10/2024,Sujan Fernando,Ampara,Uhana,Eastern,4324,5921,10245,172960,236840,409800
7/11/2024,Sujan Fernando,Ampara,Uhana,Eastern,3136,6561,9697,125440,262440,387880
7/12/2024,Sujan Fernando,Ampara,Uhana,Eastern,7816,7489,15305,312640,299560,612200
7/13/2024,Sujan Fernando,Ampara,Uhana,Eastern,7690,1782,9472,307600,71280,378880
7/14/2024,Sujan Fernando,Ampara,Uhana,Eastern,5999,4579,10578,239960,183160,423120
7/15/2024,Sujan Fernando,Ampara,Uhana,Eastern,3728,679,4407,149120,27160,176280
7/16/2024,Sujan Fernando,Ampara,Uhana,Eastern,3144,6438,9582,125760,257520,383280
7/17/2024,Sujan Fernando,Ampara,Uhana,Eastern,6683,8286,14969,267320,331440,598760
7/18/2024,Sujan Fernando,Ampara,Uhana,Eastern,500,172,672,20000,6880,26880
7/19/2024,Sujan Fernando,Ampara,Uhana,Eastern,301,7451,7752,12040,298040,310080
7/20/2024,Sujan Fernando,Ampara,Uhana,Eastern,4419,3051,7470,176760,122040,298800
7/21/2024,Sujan Fernando,Ampara,Uhana,Eastern,8341,3857,12198,333640,154280,487920
7/22/2024,Sujan Fernando,Ampara,Uhana,Eastern,9781,940,10721,391240,37600,428840
7/23/2024,Sujan Fernando,Ampara,Uhana,Eastern,1654,2019,3673,66160,80760,146920
7/24/2024,Sujan Fernando,Ampara,Uhana,Eastern,2573,5155,7728,102920,206200,309120
7/25/2024,Sujan Fernando,Ampara,Uhana,Eastern,1871,9292,11163,74840,371680,446520
7/26/2024,Sujan Fernando,Ampara,Uhana,Eastern,9034,264,9298,361360,10560,371920
7/27/2024,Sujan Fernando,Ampara,Uhana,Eastern,1201,889,2090,48040,35560,83600
7/28/2024,Sujan Fernando,Ampara,Uhana,Eastern,7505,1646,9151,300200,65840,366040
7/29/2024,Sujan Fernando,Ampara,Uhana,Eastern,1609,3290,4899,64360,131600,195960
7/30/2024,Sujan Fernando,Ampara,Uhana,Eastern,7825,747,8572,313000,29880,342880
7/31/2024,Sujan Fernando,Ampara,Uhana,Eastern,4177,8612,12789,167080,344480,511560
8/1/2024,Sujan Fernando,Ampara,Uhana,Eastern,7250,6820,14070,290000,272800,562800
8/2/2024,Sujan Fernando,Ampara,Uhana,Eastern,5869,9193,15062,234760,367720,602480
8/3/2024,Sujan Fernando,Ampara,Uhana,Eastern,2887,482,3369,115480,19280,134760
8/4/2024,Sujan Fernando,Ampara,Uhana,Eastern,6849,7391,14240,273960,295640,569600
8/5/2024,Sujan Fernando,Ampara,Uhana,Eastern,1637,9389,11026,65480,375560,441040
8/6/2024,Sujan Fernando,Ampara,Uhana,Eastern,1512,6918,8430,60480,276720,337200
8/7/2024,Sujan Fernando,Ampara,Uhana,Eastern,343,6093,6436,13720,243720,257440
8/8/2024,Sujan Fernando,Ampara,Uhana,Eastern,8462,8204,16666,338480,328160,666640
8/9/2024,Sujan Fernando,Ampara,Uhana,Eastern,404,1275,1679,16160,51000,67160
8/10/2024,Sujan Fernando,Ampara,Uhana,Eastern,6770,9878,16648,270800,395120,665920
8/11/2024,Sujan Fernando,Ampara,Uhana,Eastern,1767,884,2651,70680,35360,106040
8/12/2024,Sujan Fernando,Ampara,Uhana,Eastern,9200,6626,15826,368000,265040,633040
8/13/2024,Sujan Fernando,Ampara,Uhana,Eastern,9046,5550,14596,361840,222000,583840
8/14/2024,Sujan Fernando,Ampara,Uhana,Eastern,5286,5494,10780,211440,219760,431200
8/15/2024,Sujan Fernando,Ampara,Uhana,Eastern,8754,2061,10815,350160,82440,432600
8/16/2024,Sujan Fernando,Ampara,Uhana,Eastern,5901,8041,13942,236040,321640,557680
8/17/2024,Sujan Fernando,Ampara,Uhana,Eastern,2138,573,2711,85520,22920,108440
8/18/2024,Sujan Fernando,Ampara,Uhana,Eastern,224,8620,8844,8960,344800,353760
8/19/2024,Sujan Fernando,Ampara,Uhana,Eastern,5158,8449,13607,206320,337960,544280
8/20/2024,Sujan Fernando,Ampara,Uhana,Eastern,6580,9927,16507,263200,397080,660280
8/21/2024,Sujan Fernando,Ampara,Uhana,Eastern,1868,5753,7621,74720,230120,304840
8/22/2024,Sujan Fernando,Ampara,Uhana,Eastern,6231,7183,13414,249240,287320,536560
8/23/2024,Sujan Fernando,Ampara,Uhana,Eastern,1897,691,2588,75880,27640,103520
8/24/2024,Sujan Fernando,Ampara,Uhana,Eastern,8470,1594,10064,338800,63760,402560
8/25/2024,Sujan Fernando,Ampara,Uhana,Eastern,4362,1048,5410,174480,41920,216400
8/26/2024,Sujan Fernando,Ampara,Uhana,Eastern,9722,2113,11835,388880,84520,473400
8/27/2024,Sujan Fernando,Ampara,Uhana,Eastern,8812,9720,18532,352480,388800,741280
8/28/2024,Sujan Fernando,Ampara,Uhana,Eastern,4640,1414,6054,185600,56560,242160
8/29/2024,Sujan Fernando,Ampara,Uhana,Eastern,2260,8466,10726,90400,338640,429040
8/30/2024,Sujan Fernando,Ampara,Uhana,Eastern,2258,3871,6129,90320,154840,245160
8/31/2024,Sujan Fernando,Ampara,Uhana,Eastern,4488,5438,9926,179520,217520,397040
9/1/2024,Sujan Fernando,Ampara,Uhana,Eastern,1272,4083,5355,50880,163320,214200
9/2/2024,Sujan Fernando,Ampara,Uhana,Eastern,6999,7633,14632,279960,305320,585280
9/3/2024,Sujan Fernando,Ampara,Uhana,Eastern,9626,7945,17571,385040,317800,702840
9/4/2024,Sujan Fernando,Ampara,Uhana,Eastern,5675,8819,14494,227000,352760,579760
9/5/2024,Sujan Fernando,Ampara,Uhana,Eastern,2900,5509,8409,116000,220360,336360
9/6/2024,Sujan Fernando,Ampara,Uhana,Eastern,1858,9937,11795,74320,397480,471800
9/7/2024,Sujan Fernando,Ampara,Uhana,Eastern,7263,7858,15121,290520,314320,604840
9/8/2024,Sujan Fernando,Ampara,Uhana,Eastern,7062,4857,11919,282480,194280,476760
9/9/2024,Sujan Fernando,Ampara,Uhana,Eastern,3481,4901,8382,139240,196040,335280
9/10/2024,Sujan Fernando,Ampara,Uhana,Eastern,1447,1913,3360,57880,76520,134400
9/11/2024,Sujan Fernando,Ampara,Uhana,Eastern,7744,6198,13942,309760,247920,557680
9/12/2024,Sujan Fernando,Ampara,Uhana,Eastern,2005,5990,7995,80200,239600,319800
9/13/2024,Sujan Fernando,Ampara,Uhana,Eastern,5667,9148,14815,226680,365920,592600
9/14/2024,Sujan Fernando,Ampara,Uhana,Eastern,1974,729,2703,78960,29160,108120
9/15/2024,Sujan Fernando,Ampara,Uhana,Eastern,9785,5880,15665,391400,235200,626600
9/16/2024,Sujan Fernando,Ampara,Uhana,Eastern,2809,985,3794,112360,39400,151760
9/17/2024,Sujan Fernando,Ampara,Uhana,Eastern,8212,5209,13421,328480,208360,536840
9/18/2024,Sujan Fernando,Ampara,Uhana,Eastern,2146,2170,4316,85840,86800,172640
9/19/2024,Sujan Fernando,Ampara,Uhana,Eastern,7876,8092,15968,315040,323680,638720
9/20/2024,Sujan Fernando,Ampara,Uhana,Eastern,3024,9881,12905,120960,395240,516200
9/21/2024,Sujan Fernando,Ampara,Uhana,Eastern,9690,631,10321,387600,25240,412840
9/22/2024,Sujan Fernando,Ampara,Uhana,Eastern,3062,117,3179,122480,4680,127160
9/23/2024,Sujan Fernando,Ampara,Uhana,Eastern,2435,4102,6537,97400,164080,261480
9/24/2024,Sujan Fernando,Ampara,Uhana,Eastern,6211,576,6787,248440,23040,271480
9/25/2024,Sujan Fernando,Ampara,Uhana,Eastern,4777,6738,11515,191080,269520,460600
9/26/2024,Sujan Fernando,Ampara,Uhana,Eastern,5083,9992,15075,203320,399680,603000
9/27/2024,Sujan Fernando,Ampara,Uhana,Eastern,1701,414,2115,68040,16560,84600
9/28/2024,Sujan Fernando,Ampara,Uhana,Eastern,3008,9642,12650,120320,385680,506000
9/29/2024,Sujan Fernando,Ampara,Uhana,Eastern,8469,7437,15906,338760,297480,636240
9/30/2024,Sujan Fernando,Ampara,Uhana,Eastern,3151,8176,11327,126040,327040,453080
10/1/2024,Sujan Fernando,Ampara,Uhana,Eastern,5385,6626,12011,215400,265040,480440
10/2/2024,Sujan Fernando,Ampara,Uhana,Eastern,3822,7012,10834,152880,280480,433360
10/3/2024,Sujan Fernando,Ampara,Uhana,Eastern,2785,9967,12752,111400,398680,510080
10/4/2024,Sujan Fernando,Ampara,Uhana,Eastern,253,6354,6607,10120,254160,264280
10/5/2024,Sujan Fernando,Ampara,Uhana,Eastern,2248,2023,4271,89920,80920,170840
10/6/2024,Sujan Fernando,Ampara,Uhana,Eastern,3666,244,3910,146640,9760,156400
10/7/2024,Sujan Fernando,Ampara,Uhana,Eastern,7919,4977,12896,316760,199080,515840
10/8/2024,Sujan Fernando,Ampara,Uhana,Eastern,6997,9063,16060,279880,362520,642400
10/9/2024,Sujan Fernando,Ampara,Uhana,Eastern,3675,5633,9308,147000,225320,372320
10/10/2024,Sujan Fernando,Ampara,Uhana,Eastern,3333,5313,8646,133320,212520,345840
10/11/2024,Sujan Fernando,Ampara,Uhana,Eastern,228,2119,2347,9120,84760,93880
10/12/2024,Sujan Fernando,Ampara,Uhana,Eastern,1731,8224,9955,69240,328960,398200
10/13/2024,Sujan Fernando,Ampara,Uhana,Eastern,98,785,883,3920,31400,35320
10/14/2024,Sujan Fernando,Ampara,Uhana,Eastern,365,1297,1662,14600,51880,66480
10/15/2024,Sujan Fernando,Ampara,Uhana,Eastern,9385,2140,11525,375400,85600,461000
10/16/2024,Sujan Fernando,Ampara,Uhana,Eastern,1197,7882,9079,47880,315280,363160
10/17/2024,Sujan Fernando,Ampara,Uhana,Eastern,7172,2577,9749,286880,103080,389960
10/18/2024,Sujan Fernando,Ampara,Uhana,Eastern,2306,3427,5733,92240,137080,229320
10/19/2024,Sujan Fernando,Ampara,Uhana,Eastern,8925,4187,13112,357000,167480,524480
10/20/2024,Sujan Fernando,Ampara,Uhana,Eastern,7270,3469,10739,290800,138760,429560
10/21/2024,Sujan Fernando,Ampara,Uhana,Eastern,842,1736,2578,33680,69440,103120
10/22/2024,Sujan Fernando,Ampara,Uhana,Eastern,1917,2449,4366,76680,97960,174640
10/23/2024,Sujan Fernando,Ampara,Uhana,Eastern,5506,3870,9376,220240,154800,375040
10/24/2024,Sujan Fernando,Ampara,Uhana,Eastern,6442,4656,11098,257680,186240,443920
10/25/2024,Sujan Fernando,Ampara,Uhana,Eastern,6980,7015,13995,279200,280600,559800
10/26/2024,Sujan Fernando,Ampara,Uhana,Eastern,1193,8031,9224,47720,321240,368960
10/27/2024,Sujan Fernando,Ampara,Uhana,Eastern,7589,8412,16001,303560,336480,640040
10/28/2024,Sujan Fernando,Ampara,Uhana,Eastern,4182,4813,8995,167280,192520,359800
10/29/2024,Sujan Fernando,Ampara,Uhana,Eastern,1937,7687,9624,77480,307480,384960
10/30/2024,Sujan Fernando,Ampara,Uhana,Eastern,8096,6288,14384,323840,251520,575360
10/31/2024,Sujan Fernando,Ampara,Uhana,Eastern,8626,3677,12303,345040,147080,492120
11/1/2024,Sujan Fernando,Ampara,Uhana,Eastern,7030,711,7741,281200,28440,309640
11/2/2024,Sujan Fernando,Ampara,Uhana,Eastern,2522,9632,12154,100880,385280,486160
11/3/2024,Sujan Fernando,Ampara,Uhana,Eastern,2927,4537,7464,117080,181480,298560
11/4/2024,Sujan Fernando,Ampara,Uhana,Eastern,1657,1957,3614,66280,78280,144560
11/5/2024,Sujan Fernando,Ampara,Uhana,Eastern,9801,9138,18939,392040,365520,757560
11/6/2024,Sujan Fernando,Ampara,Uhana,Eastern,4531,8244,12775,181240,329760,511000
11/7/2024,Sujan Fernando,Ampara,Uhana,Eastern,3908,8790,12698,156320,351600,507920
11/8/2024,Sujan Fernando,Ampara,Uhana,Eastern,9623,8826,18449,384920,353040,737960
11/9/2024,Sujan Fernando,Ampara,Uhana,Eastern,6021,1782,7803,240840,71280,312120
11/10/2024,Sujan Fernando,Ampara,Uhana,Eastern,2662,6743,9405,106480,269720,376200
11/11/2024,Sujan Fernando,Ampara,Uhana,Eastern,9706,7177,16883,388240,287080,675320
11/12/2024,Sujan Fernando,Ampara,Uhana,Eastern,2604,8139,10743,104160,325560,429720
11/13/2024,Sujan Fernando,Ampara,Uhana,Eastern,4938,536,5474,197520,21440,218960
11/14/2024,Sujan Fernando,Ampara,Uhana,Eastern,6576,3747,10323,263040,149880,412920
11/15/2024,Sujan Fernando,Ampara,Uhana,Eastern,8176,245,8421,327040,9800,336840
11/16/2024,Sujan Fernando,Ampara,Uhana,Eastern,4522,7488,12010,180880,299520,480400
11/17/2024,Sujan Fernando,Ampara,Uhana,Eastern,9460,7678,17138,378400,307120,685520
11/18/2024,Sujan Fernando,Ampara,Uhana,Eastern,7369,7106,14475,294760,284240,579000
11/19/2024,Sujan Fernando,Ampara,Uhana,Eastern,819,5412,6231,32760,216480,249240
11/20/2024,Sujan Fernando,Ampara,Uhana,Eastern,6203,1813,8016,248120,72520,320640
11/21/2024,Sujan Fernando,Ampara,Uhana,Eastern,8859,6164,15023,354360,246560,600920
11/22/2024,Sujan Fernando,Ampara,Uhana,Eastern,9912,2196,12108,396480,87840,484320
11/23/2024,Sujan Fernando,Ampara,Uhana,Eastern,9941,2633,12574,397640,105320,502960
11/24/2024,Sujan Fernando,Ampara,Uhana,Eastern,5707,9237,14944,228280,369480,597760
11/25/2024,Sujan Fernando,Ampara,Uhana,Eastern,3769,6189,9958,150760,247560,398320
11/26/2024,Sujan Fernando,Ampara,Uhana,Eastern,8881,2289,11170,355240,91560,446800
11/27/2024,Sujan Fernando,Ampara,Uhana,Eastern,2614,77,2691,104560,3080,107640
11/28/2024,Sujan Fernando,Ampara,Uhana,Eastern,567,1735,2302,22680,69400,92080
11/29/2024,Sujan Fernando,Ampara,Uhana,Eastern,9012,7130,16142,360480,285200,645680
11/30/2024,Sujan Fernando,Ampara,Uhana,Eastern,410,5974,6384,16400,238960,255360
12/1/2024,Sujan Fernando,Ampara,Uhana,Eastern,4645,4747,9392,185800,189880,375680
12/2/2024,Sujan Fernando,Ampara,Uhana,Eastern,7926,6202,14128,317040,248080,565120
12/3/2024,Sujan Fernando,Ampara,Uhana,Eastern,8851,2589,11440,354040,103560,457600
12/4/2024,Sujan Fernando,Ampara,Uhana,Eastern,1914,2888,4802,76560,115520,192080
12/5/2024,Sujan Fernando,Ampara,Uhana,Eastern,5103,9860,14963,204120,394400,598520
12/6/2024,Sujan Fernando,Ampara,Uhana,Eastern,5210,4506,9716,208400,180240,388640
12/7/2024,Sujan Fernando,Ampara,Uhana,Eastern,6902,5068,11970,276080,202720,478800
12/8/2024,Sujan Fernando,Ampara,Uhana,Eastern,3118,559,3677,124720,22360,147080
12/9/2024,Sujan Fernando,Ampara,Uhana,Eastern,1617,7344,8961,64680,293760,358440
12/10/2024,Sujan Fernando,Ampara,Uhana,Eastern,1886,5815,7701,75440,232600,308040
12/11/2024,Sujan Fernando,Ampara,Uhana,Eastern,3211,2350,5561,128440,94000,222440
12/12/2024,Sujan Fernando,Ampara,Uhana,Eastern,2545,2551,5096,101800,102040,203840
12/13/2024,Sujan Fernando,Ampara,Uhana,Eastern,9960,7000,16960,398400,280000,678400
12/14/2024,Sujan Fernando,Ampara,Uhana,Eastern,1927,4777,6704,77080,191080,268160
12/15/2024,Sujan Fernando,Ampara,Uhana,Eastern,1137,9280,10417,45480,371200,416680
12/16/2024,Sujan Fernando,Ampara,Uhana,Eastern,4215,8448,12663,168600,337920,506520
12/17/2024,Sujan Fernando,Ampara,Uhana,Eastern,8916,1699,10615,356640,67960,424600
12/18/2024,Sujan Fernando,Ampara,Uhana,Eastern,517,5453,5970,20680,218120,238800
12/19/2024,Sujan Fernando,Ampara,Uhana,Eastern,8623,4582,13205,344920,183280,528200
12/20/2024,Sujan Fernando,Ampara,Uhana,Eastern,6140,3052,9192,245600,122080,367680
12/21/2024,Sujan Fernando,Ampara,Uhana,Eastern,4875,8416,13291,195000,336640,531640
12/22/2024,Sujan Fernando,Ampara,Uhana,Eastern,8618,9301,17919,344720,372040,716760
12/23/2024,Sujan Fernando,Ampara,Uhana,Eastern,6929,5623,12552,277160,224920,502080
12/24/2024,Sujan Fernando,Ampara,Uhana,Eastern,621,3490,4111,24840,139600,164440
12/25/2024,Sujan Fernando,Ampara,Uhana,Eastern,4974,269,5243,198960,10760,209720
12/26/2024,Sujan Fernando,Ampara,Uhana,Eastern,2157,2405,4562,86280,96200,182480
12/27/2024,Sujan Fernando,Ampara,Uhana,Eastern,2616,8217,10833,104640,328680,433320
12/28/2024,Sujan Fernando,Ampara,Uhana,Eastern,891,2749,3640,35640,109960,145600
12/29/2024,Sujan Fernando,Ampara,Uhana,Eastern,3829,7613,11442,153160,304520,457680
12/30/2024,Sujan Fernando,Ampara,Uhana,Eastern,8392,5060,13452,335680,202400,538080
12/31/2024,Sujan Fernando,Ampara,Uhana,Eastern,4116,9429,13545,164640,377160,541800
1/1/2025,Sujan Fernando,Ampara,Uhana,Eastern,1517,563,2080,60680,22520,83200
1/2/2025,Sujan Fernando,Ampara,Uhana,Eastern,5346,2961,8307,213840,118440,332280
1/3/2025,Sujan Fernando,Ampara,Uhana,Eastern,9711,7658,17369,388440,306320,694760
1/4/2025,Sujan Fernando,Ampara,Uhana,Eastern,4453,8319,12772,178120,332760,510880
1/5/2025,Sujan Fernando,Ampara,Uhana,Eastern,5237,2216,7453,209480,88640,298120
1/6/2025,Sujan Fernando,Ampara,Uhana,Eastern,8450,822,9272,338000,32880,370880
1/7/2025,Sujan Fernando,Ampara,Uhana,Eastern,7842,7,7849,313680,280,313960
1/8/2025,Sujan Fernando,Ampara,Uhana,Eastern,2483,2685,5168,99320,107400,206720
1/9/2025,Sujan Fernando,Ampara,Uhana,Eastern,2853,1793,4646,114120,71720,185840
1/10/2025,Sujan Fernando,Ampara,Uhana,Eastern,5244,9820,15064,209760,392800,602560
1/11/2025,Sujan Fernando,Ampara,Uhana,Eastern,4961,104,5065,198440,4160,202600
1/12/2025,Sujan Fernando,Ampara,Uhana,Eastern,6774,7195,13969,270960,287800,558760
1/13/2025,Sujan Fernando,Ampara,Uhana,Eastern,9059,5194,14253,362360,207760,570120
1/14/2025,Sujan Fernando,Ampara,Uhana,Eastern,9018,7289,16307,360720,291560,652280
1/15/2025,Sujan Fernando,Ampara,Uhana,Eastern,9769,5596,15365,390760,223840,614600
1/16/2025,Sujan Fernando,Ampara,Uhana,Eastern,2152,1585,3737,86080,63400,149480
1/17/2025,Sujan Fernando,Ampara,Uhana,Eastern,4236,7775,12011,169440,311000,480440
1/18/2025,Sujan Fernando,Ampara,Uhana,Eastern,3983,751,4734,159320,30040,189360
1/19/2025,Sujan Fernando,Ampara,Uhana,Eastern,267,134,401,10680,5360,16040
1/20/2025,Sujan Fernando,Ampara,Uhana,Eastern,5209,2046,7255,208360,81840,290200
1/21/2025,Sujan Fernando,Ampara,Uhana,Eastern,7977,3040,11017,319080,121600,440680
1/22/2025,Sujan Fernando,Ampara,Uhana,Eastern,5198,8789,13987,207920,351560,559480
1/23/2025,Sujan Fernando,Ampara,Uhana,Eastern,6616,1473,8089,264640,58920,323560
1/24/2025,Sujan Fernando,Ampara,Uhana,Eastern,5770,6393,12163,230800,255720,486520
1/25/2025,Sujan Fernando,Ampara,Uhana,Eastern,8622,8632,17254,344880,345280,690160
1/26/2025,Sujan Fernando,Ampara,Uhana,Eastern,8062,1177,9239,322480,47080,369560
1/27/2025,Sujan Fernando,Ampara,Uhana,Eastern,4562,4099,8661,182480,163960,346440
1/28/2025,Sujan Fernando,Ampara,Uhana,Eastern,2355,6873,9228,94200,274920,369120
1/29/2025,Sujan Fernando,Ampara,Uhana,Eastern,9040,9289,18329,361600,371560,733160
1/30/2025,Sujan Fernando,Ampara,Uhana,Eastern,7676,4301,11977,307040,172040,479080
1/31/2025,Sujan Fernando,Ampara,Uhana,Eastern,8177,2209,10386,327080,88360,415440
2/1/2025,Sujan Fernando,Ampara,Uhana,Eastern,4388,7337,11725,175520,293480,469000
2/2/2025,Sujan Fernando,Ampara,Uhana,Eastern,594,8565,9159,23760,342600,366360
2/3/2025,Sujan Fernando,Ampara,Uhana,Eastern,3512,7367,10879,140480,294680,435160
2/4/2025,Sujan Fernando,Ampara,Uhana,Eastern,7700,6920,14620,308000,276800,584800
2/5/2025,Sujan Fernando,Ampara,Uhana,Eastern,753,3528,4281,30120,141120,171240
2/6/2025,Sujan Fernando,Ampara,Uhana,Eastern,7693,1138,8831,307720,45520,353240
2/7/2025,Sujan Fernando,Ampara,Uhana,Eastern,9716,2171,11887,388640,86840,475480
2/8/2025,Sujan Fernando,Ampara,Uhana,Eastern,8899,9986,18885,355960,399440,755400
2/9/2025,Sujan Fernando,Ampara,Uhana,Eastern,5195,6309,11504,207800,252360,460160
2/10/2025,Sujan Fernando,Ampara,Uhana,Eastern,8232,9544,17776,329280,381760,711040
2/11/2025,Sujan Fernando,Ampara,Uhana,Eastern,8127,5337,13464,325080,213480,538560
2/12/2025,Sujan Fernando,Ampara,Uhana,Eastern,9258,5709,14967,370320,228360,598680
2/13/2025,Sujan Fernando,Ampara,Uhana,Eastern,6916,3708,10624,276640,148320,424960
2/14/2025,Sujan Fernando,Ampara,Uhana,Eastern,8027,6245,14272,321080,249800,570880
2/15/2025,Sujan Fernando,Ampara,Uhana,Eastern,2632,5405,8037,105280,216200,321480
2/16/2025,Sujan Fernando,Ampara,Uhana,Eastern,9666,7649,17315,386640,305960,692600
2/17/2025,Sujan Fernando,Ampara,Uhana,Eastern,9338,2684,12022,373520,107360,480880
2/18/2025,Sujan Fernando,Ampara,Uhana,Eastern,5912,9063,14975,236480,362520,599000
2/19/2025,Sujan Fernando,Ampara,Uhana,Eastern,2684,6031,8715,107360,241240,348600
2/20/2025,Sujan Fernando,Ampara,Uhana,Eastern,1466,7175,8641,58640,287000,345640
2/21/2025,Sujan Fernando,Ampara,Uhana,Eastern,7602,1266,8868,304080,50640,354720
2/22/2025,Sujan Fernando,Ampara,Uhana,Eastern,4950,2665,7615,198000,106600,304600
2/23/2025,Sujan Fernando,Ampara,Uhana,Eastern,9096,9952,19048,363840,398080,761920
2/24/2025,Sujan Fernando,Ampara,Uhana,Eastern,7850,9583,17433,314000,383320,697320
2/25/2025,Sujan Fernando,Ampara,Uhana,Eastern,3895,927,4822,155800,37080,192880
2/26/2025,Sujan Fernando,Ampara,Uhana,Eastern,5643,7452,13095,225720,298080,523800
2/27/2025,Sujan Fernando,Ampara,Uhana,Eastern,5788,423,6211,231520,16920,248440
2/28/2025,Sujan Fernando,Ampara,Uhana,Eastern,3989,5455,9444,159560,218200,377760
3/1/2025,Sujan Fernando,Ampara,Uhana,Eastern,4930,9914,14844,197200,396560,593760
3/2/2025,Sujan Fernando,Ampara,Uhana,Eastern,5093,6145,11238,203720,245800,449520
3/3/2025,Sujan Fernando,Ampara,Uhana,Eastern,8218,263,8481,328720,10520,339240
3/4/2025,Sujan Fernando,Ampara,Uhana,Eastern,4659,8196,12855,186360,327840,514200
3/5/2025,Sujan Fernando,Ampara,Uhana,Eastern,2262,5791,8053,90480,231640,322120
3/6/2025,Sujan Fernando,Ampara,Uhana,Eastern,1990,6579,8569,79600,263160,342760
3/7/2025,Sujan Fernando,Ampara,Uhana,Eastern,5231,4408,9639,209240,176320,385560
3/8/2025,Sujan Fernando,Ampara,Uhana,Eastern,5605,9261,14866,224200,370440,594640
3/9/2025,Sujan Fernando,Ampara,Uhana,Eastern,408,7533,7941,16320,301320,317640
3/10/2025,Sujan Fernando,Ampara,Uhana,Eastern,4677,8081,12758,187080,323240,510320
3/11/2025,Sujan Fernando,Ampara,Uhana,Eastern,2931,722,3653,117240,28880,146120
3/12/2025,Sujan Fernando,Ampara,Uhana,Eastern,935,6182,7117,37400,247280,284680
3/13/2025,Sujan Fernando,Ampara,Uhana,Eastern,9270,6912,16182,370800,276480,647280
3/14/2025,Sujan Fernando,Ampara,Uhana,Eastern,7988,152,8140,319520,6080,325600
3/15/2025,Sujan Fernando,Ampara,Uhana,Eastern,1860,5303,7163,74400,212120,286520
3/16/2025,Sujan Fernando,Ampara,Uhana,Eastern,3834,4905,8739,153360,196200,349560
3/17/2025,Sujan Fernando,Ampara,Uhana,Eastern,2240,6357,8597,89600,254280,343880
3/18/2025,Sujan Fernando,Ampara,Uhana,Eastern,2012,3312,5324,80480,132480,212960
3/19/2025,Sujan Fernando,Ampara,Uhana,Eastern,630,1793,2423,25200,71720,96920
3/20/2025,Sujan Fernando,Ampara,Uhana,Eastern,497,7005,7502,19880,280200,300080
3/21/2025,Sujan Fernando,Ampara,Uhana,Eastern,7552,6186,13738,302080,247440,549520
3/22/2025,Sujan Fernando,Ampara,Uhana,Eastern,7205,6529,13734,288200,261160,549360
3/23/2025,Sujan Fernando,Ampara,Uhana,Eastern,8272,818,9090,330880,32720,363600
3/25/2024,Madhuri Harischandra,Moneragala,Moneragala,Uva,4709,2552,7261,188360,102080,290440
3/26/2024,Madhuri Harischandra,Moneragala,Moneragala,Uva,1740,8882,10622,69600,355280,424880
3/27/2024,Madhuri Harischandra,Moneragala,Moneragala,Uva,3723,2503,6226,148920,100120,249040
3/28/2024,Madhuri Harischandra,Moneragala,Moneragala,Uva,1874,7237,9111,74960,289480,364440
3/29/2024,Madhuri Harischandra,Moneragala,Moneragala,Uva,5292,6344,11636,211680,253760,465440
3/30/2024,Madhuri Harischandra,Moneragala,Moneragala,Uva,7254,8074,15328,290160,322960,613120
3/31/2024,Madhuri Harischandra,Moneragala,Moneragala,Uva,1097,5711,6808,43880,228440,272320
4/1/2024,Madhuri Harischandra,Moneragala,Moneragala,Uva,8918,316,9234,356720,12640,369360
4/2/2024,Madhuri Harischandra,Moneragala,Moneragala,Uva,6204,6056,12260,248160,242240,490400
4/3/2024,Madhuri Harischandra,Moneragala,Moneragala,Uva,1870,3297,5167,74800,131880,206680
4/4/2024,Madhuri Harischandra,Moneragala,Moneragala,Uva,8114,305,8419,324560,12200,336760
4/5/2024,Madhuri Harischandra,Moneragala,Moneragala,Uva,7939,2482,10421,317560,99280,416840
4/6/2024,Madhuri Harischandra,Moneragala,Moneragala,Uva,816,2496,3312,32640,99840,132480
4/7/2024,Madhuri Harischandra,Moneragala,Moneragala,Uva,9707,2651,12358,388280,106040,494320
4/8/2024,Madhuri Harischandra,Moneragala,Moneragala,Uva,9903,2026,11929,396120,81040,477160
4/9/2024,Madhuri Harischandra,Moneragala,Moneragala,Uva,9037,7479,16516,361480,299160,660640
4/10/2024,Madhuri Harischandra,Moneragala,Moneragala,Uva,510,380,890,20400,15200,35600
4/11/2024,Madhuri Harischandra,Moneragala,Moneragala,Uva,7389,6230,13619,295560,249200,544760
4/19/2024,Madhuri Harischandra,Moneragala,Moneragala,Uva,7681,6738,14419,307240,269520,576760
4/20/2024,Madhuri Harischandra,Moneragala,Moneragala,Uva,5230,6514,11744,209200,260560,469760
4/21/2024,Madhuri Harischandra,Moneragala,Moneragala,Uva,2719,5097,7816,108760,203880,312640
4/22/2024,Madhuri Harischandra,Moneragala,Moneragala,Uva,5311,4938,10249,212440,197520,409960
4/23/2024,Madhuri Harischandra,Moneragala,Moneragala,Uva,2978,3721,6699,119120,148840,267960
4/24/2024,Madhuri Harischandra,Moneragala,Moneragala,Uva,9517,3391,12908,380680,135640,516320
4/25/2024,Madhuri Harischandra,Moneragala,Moneragala,Uva,6975,5227,12202,279000,209080,488080
4/26/2024,Madhuri Harischandra,Moneragala,Moneragala,Uva,6354,8245,14599,254160,329800,583960
4/27/2024,Madhuri Harischandra,Moneragala,Moneragala,Uva,7028,9562,16590,281120,382480,663600
4/28/2024,Madhuri Harischandra,Moneragala,Moneragala,Uva,1127,5980,7107,45080,239200,284280
4/29/2024,Madhuri Harischandra,Moneragala,Moneragala,Uva,2895,2298,5193,115800,91920,207720
4/30/2024,Madhuri Harischandra,Moneragala,Moneragala,Uva,6391,8479,14870,255640,339160,594800
5/1/2024,Madhuri Harischandra,Moneragala,Moneragala,Uva,9306,6552,15858,372240,262080,634320
5/2/2024,Madhuri Harischandra,Moneragala,Moneragala,Uva,9091,4687,13778,363640,187480,551120
5/3/2024,Madhuri Harischandra,Moneragala,Moneragala,Uva,441,410,851,17640,16400,34040
5/4/2024,Madhuri Harischandra,Moneragala,Moneragala,Uva,2288,5587,7875,91520,223480,315000
5/5/2024,Madhuri Harischandra,Moneragala,Moneragala,Uva,1529,4746,6275,61160,189840,251000
5/6/2024,Madhuri Harischandra,Moneragala,Moneragala,Uva,723,6901,7624,28920,276040,304960
5/7/2024,Madhuri Harischandra,Moneragala,Moneragala,Uva,1659,1711,3370,66360,68440,134800
5/8/2024,Madhuri Harischandra,Moneragala,Moneragala,Uva,6339,3283,9622,253560,131320,384880
5/9/2024,Madhuri Harischandra,Moneragala,Moneragala,Uva,711,7898,8609,28440,315920,344360
5/10/2024,Madhuri Harischandra,Moneragala,Moneragala,Uva,8818,310,9128,352720,12400,365120
5/11/2024,Madhuri Harischandra,Moneragala,Moneragala,Uva,2541,5193,7734,101640,207720,309360
5/12/2024,Madhuri Harischandra,Moneragala,Moneragala,Uva,72,7024,7096,2880,280960,283840
5/13/2024,Madhuri Harischandra,Moneragala,Moneragala,Uva,6811,3484,10295,272440,139360,411800
5/14/2024,Madhuri Harischandra,Moneragala,Moneragala,Uva,8537,7269,15806,341480,290760,632240
5/15/2024,Madhuri Harischandra,Moneragala,Moneragala,Uva,824,8832,9656,32960,353280,386240
5/16/2024,Madhuri Harischandra,Moneragala,Moneragala,Uva,5369,5565,10934,214760,222600,437360
5/17/2024,Madhuri Harischandra,Moneragala,Moneragala,Uva,1970,1248,3218,78800,49920,128720
5/18/2024,Madhuri Harischandra,Moneragala,Moneragala,Uva,3502,7760,11262,140080,310400,450480
5/19/2024,Madhuri Harischandra,Moneragala,Moneragala,Uva,3837,43,3880,153480,1720,155200
5/20/2024,Madhuri Harischandra,Moneragala,Moneragala,Uva,6231,6474,12705,249240,258960,508200
5/21/2024,Madhuri Harischandra,Moneragala,Moneragala,Uva,9315,2528,11843,372600,101120,473720
5/22/2024,Madhuri Harischandra,Moneragala,Moneragala,Uva,1226,1759,2985,49040,70360,119400
5/24/2024,Madhuri Harischandra,Moneragala,Moneragala,Uva,2406,6148,8554,96240,245920,342160
5/25/2024,Madhuri Harischandra,Moneragala,Moneragala,Uva,2879,7467,10346,115160,298680,413840
5/26/2024,Madhuri Harischandra,Moneragala,Moneragala,Uva,5625,3340,8965,225000,133600,358600
5/27/2024,Madhuri Harischandra,Moneragala,Moneragala,Uva,3954,7952,11906,158160,318080,476240
5/28/2024,Madhuri Harischandra,Moneragala,Moneragala,Uva,1180,3744,4924,47200,149760,196960
5/29/2024,Madhuri Harischandra,Moneragala,Moneragala,Uva,3506,4307,7813,140240,172280,312520
5/30/2024,Madhuri Harischandra,Moneragala,Moneragala,Uva,3894,1507,5401,155760,60280,216040
5/31/2024,Madhuri Harischandra,Moneragala,Moneragala,Uva,188,2566,2754,7520,102640,110160
6/1/2024,Madhuri Harischandra,Moneragala,Moneragala,Uva,7827,2002,9829,313080,80080,393160
6/2/2024,Madhuri Harischandra,Moneragala,Moneragala,Uva,2660,6341,9001,106400,253640,360040
6/3/2024,Madhuri Harischandra,Moneragala,Moneragala,Uva,2500,7390,9890,100000,295600,395600
6/4/2024,Madhuri Harischandra,Moneragala,Moneragala,Uva,9919,296,10215,396760,11840,408600
6/5/2024,Madhuri Harischandra,Moneragala,Moneragala,Uva,8739,977,9716,349560,39080,388640
6/6/2024,Madhuri Harischandra,Moneragala,Moneragala,Uva,5977,6752,12729,239080,270080,509160
6/7/2024,Madhuri Harischandra,Moneragala,Moneragala,Uva,3578,6577,10155,143120,263080,406200
6/8/2024,Madhuri Harischandra,Moneragala,Moneragala,Uva,8960,1453,10413,358400,58120,416520
6/9/2024,Madhuri Harischandra,Moneragala,Moneragala,Uva,9868,1916,11784,394720,76640,471360
6/10/2024,Madhuri Harischandra,Moneragala,Moneragala,Uva,9882,5571,15453,395280,222840,618120
6/11/2024,Madhuri Harischandra,Moneragala,Moneragala,Uva,4133,1184,5317,165320,47360,212680
6/12/2024,Madhuri Harischandra,Moneragala,Moneragala,Uva,5228,313,5541,209120,12520,221640
6/13/2024,Madhuri Harischandra,Moneragala,Moneragala,Uva,3161,5487,8648,126440,219480,345920
6/14/2024,Madhuri Harischandra,Moneragala,Moneragala,Uva,3643,684,4327,145720,27360,173080
6/15/2024,Madhuri Harischandra,Moneragala,Moneragala,Uva,9414,9807,19221,376560,392280,768840
6/16/2024,Madhuri Harischandra,Moneragala,Moneragala,Uva,21,276,297,840,11040,11880
6/17/2024,Madhuri Harischandra,Moneragala,Moneragala,Uva,3592,7704,11296,143680,308160,451840
6/18/2024,Madhuri Harischandra,Moneragala,Moneragala,Uva,4998,613,5611,199920,24520,224440
6/19/2024,Madhuri Harischandra,Moneragala,Moneragala,Uva,8406,7962,16368,336240,318480,654720
6/20/2024,Madhuri Harischandra,Moneragala,Moneragala,Uva,5909,815,6724,236360,32600,268960
6/21/2024,Madhuri Harischandra,Moneragala,Moneragala,Uva,9860,6064,15924,394400,242560,636960
6/22/2024,Madhuri Harischandra,Moneragala,Moneragala,Uva,1625,5916,7541,65000,236640,301640
6/23/2024,Madhuri Harischandra,Moneragala,Moneragala,Uva,583,4889,5472,23320,195560,218880
6/24/2024,Madhuri Harischandra,Moneragala,Moneragala,Uva,5319,5079,10398,212760,203160,415920
6/25/2024,Madhuri Harischandra,Moneragala,Moneragala,Uva,1657,4160,5817,66280,166400,232680
6/26/2024,Madhuri Harischandra,Moneragala,Moneragala,Uva,817,4207,5024,32680,168280,200960
6/27/2024,Madhuri Harischandra,Moneragala,Moneragala,Uva,5133,4454,9587,205320,178160,383480
6/28/2024,Madhuri Harischandra,Moneragala,Moneragala,Uva,1346,2367,3713,53840,94680,148520
6/29/2024,Madhuri Harischandra,Moneragala,Moneragala,Uva,1904,15,1919,76160,600,76760
6/30/2024,Madhuri Harischandra,Moneragala,Moneragala,Uva,6654,2028,8682,266160,81120,347280
7/1/2024,Madhuri Harischandra,Moneragala,Moneragala,Uva,4303,6313,10616,172120,252520,424640
7/2/2024,Madhuri Harischandra,Moneragala,Moneragala,Uva,2690,3939,6629,107600,157560,265160
7/3/2024,Madhuri Harischandra,Moneragala,Moneragala,Uva,677,9865,10542,27080,394600,421680
7/4/2024,Madhuri Harischandra,Moneragala,Moneragala,Uva,7963,2866,10829,318520,114640,433160
7/5/2024,Madhuri Harischandra,Moneragala,Moneragala,Uva,4551,6294,10845,182040,251760,433800
7/6/2024,Madhuri Harischandra,Moneragala,Moneragala,Uva,2948,1157,4105,117920,46280,164200
7/7/2024,Madhuri Harischandra,Moneragala,Moneragala,Uva,1143,1204,2347,45720,48160,93880
7/8/2024,Madhuri Harischandra,Moneragala,Moneragala,Uva,278,1100,1378,11120,44000,55120
7/9/2024,Madhuri Harischandra,Moneragala,Moneragala,Uva,5622,2075,7697,224880,83000,307880
7/10/2024,Madhuri Harischandra,Moneragala,Moneragala,Uva,5240,6442,11682,209600,257680,467280
7/11/2024,Madhuri Harischandra,Moneragala,Moneragala,Uva,8167,6298,14465,326680,251920,578600
7/12/2024,Madhuri Harischandra,Moneragala,Moneragala,Uva,9390,2116,11506,375600,84640,460240
7/13/2024,Madhuri Harischandra,Moneragala,Moneragala,Uva,729,8648,9377,29160,345920,375080
7/14/2024,Madhuri Harischandra,Moneragala,Moneragala,Uva,4584,550,5134,183360,22000,205360
7/15/2024,Madhuri Harischandra,Moneragala,Moneragala,Uva,4570,7288,11858,182800,291520,474320
7/16/2024,Madhuri Harischandra,Moneragala,Moneragala,Uva,6104,4740,10844,244160,189600,433760
7/17/2024,Madhuri Harischandra,Moneragala,Moneragala,Uva,8,7198,7206,320,287920,288240
7/18/2024,Madhuri Harischandra,Moneragala,Moneragala,Uva,6391,5041,11432,255640,201640,457280
7/19/2024,Madhuri Harischandra,Moneragala,Moneragala,Uva,91,8869,8960,3640,354760,358400
7/20/2024,Madhuri Harischandra,Moneragala,Moneragala,Uva,3455,324,3779,138200,12960,151160
7/21/2024,Madhuri Harischandra,Moneragala,Moneragala,Uva,5089,3494,8583,203560,139760,343320
7/22/2024,Madhuri Harischandra,Moneragala,Moneragala,Uva,6160,7934,14094,246400,317360,563760
7/23/2024,Madhuri Harischandra,Moneragala,Moneragala,Uva,4126,657,4783,165040,26280,191320
7/24/2024,Madhuri Harischandra,Moneragala,Moneragala,Uva,5626,2778,8404,225040,111120,336160
7/25/2024,Madhuri Harischandra,Moneragala,Moneragala,Uva,6433,7259,13692,257320,290360,547680
7/26/2024,Madhuri Harischandra,Moneragala,Moneragala,Uva,484,2003,2487,19360,80120,99480
7/27/2024,Madhuri Harischandra,Moneragala,Moneragala,Uva,5941,2775,8716,237640,111000,348640
7/28/2024,Madhuri Harischandra,Moneragala,Moneragala,Uva,3890,2165,6055,155600,86600,242200
7/29/2024,Madhuri Harischandra,Moneragala,Moneragala,Uva,3204,1676,4880,128160,67040,195200
7/30/2024,Madhuri Harischandra,Moneragala,Moneragala,Uva,2219,9946,12165,88760,397840,486600
7/31/2024,Madhuri Harischandra,Moneragala,Moneragala,Uva,2817,6412,9229,112680,256480,369160
8/1/2024,Madhuri Harischandra,Moneragala,Moneragala,Uva,6973,5299,12272,278920,211960,490880
8/2/2024,Madhuri Harischandra,Moneragala,Moneragala,Uva,9600,3639,13239,384000,145560,529560
8/3/2024,Madhuri Harischandra,Moneragala,Moneragala,Uva,4837,3048,7885,193480,121920,315400
8/4/2024,Madhuri Harischandra,Moneragala,Moneragala,Uva,8961,5584,14545,358440,223360,581800
8/5/2024,Madhuri Harischandra,Moneragala,Moneragala,Uva,6630,1588,8218,265200,63520,328720
8/6/2024,Madhuri Harischandra,Moneragala,Moneragala,Uva,3303,5393,8696,132120,215720,347840
8/7/2024,Madhuri Harischandra,Moneragala,Moneragala,Uva,674,3815,4489,26960,152600,179560
8/8/2024,Madhuri Harischandra,Moneragala,Moneragala,Uva,9479,7060,16539,379160,282400,661560
8/9/2024,Madhuri Harischandra,Moneragala,Moneragala,Uva,774,3785,4559,30960,151400,182360
8/10/2024,Madhuri Harischandra,Moneragala,Moneragala,Uva,9436,4286,13722,377440,171440,548880
8/11/2024,Madhuri Harischandra,Moneragala,Moneragala,Uva,713,3233,3946,28520,129320,157840
8/12/2024,Madhuri Harischandra,Moneragala,Moneragala,Uva,2405,9945,12350,96200,397800,494000
8/13/2024,Madhuri Harischandra,Moneragala,Moneragala,Uva,7606,7378,14984,304240,295120,599360
8/14/2024,Madhuri Harischandra,Moneragala,Moneragala,Uva,8375,258,8633,335000,10320,345320
8/15/2024,Madhuri Harischandra,Moneragala,Moneragala,Uva,4193,3272,7465,167720,130880,298600
8/16/2024,Madhuri Harischandra,Moneragala,Moneragala,Uva,3774,8008,11782,150960,320320,471280
8/17/2024,Madhuri Harischandra,Moneragala,Moneragala,Uva,1621,6516,8137,64840,260640,325480
8/18/2024,Madhuri Harischandra,Moneragala,Moneragala,Uva,9616,7613,17229,384640,304520,689160
8/19/2024,Madhuri Harischandra,Moneragala,Moneragala,Uva,7213,5271,12484,288520,210840,499360
8/20/2024,Madhuri Harischandra,Moneragala,Moneragala,Uva,974,8954,9928,38960,358160,397120
8/21/2024,Madhuri Harischandra,Moneragala,Moneragala,Uva,6875,7734,14609,275000,309360,584360
8/22/2024,Madhuri Harischandra,Moneragala,Moneragala,Uva,6323,2352,8675,252920,94080,347000
8/23/2024,Madhuri Harischandra,Moneragala,Moneragala,Uva,90,4114,4204,3600,164560,168160
8/24/2024,Madhuri Harischandra,Moneragala,Moneragala,Uva,6958,1929,8887,278320,77160,355480
8/25/2024,Madhuri Harischandra,Moneragala,Moneragala,Uva,9341,8463,17804,373640,338520,712160
8/26/2024,Madhuri Harischandra,Moneragala,Moneragala,Uva,1239,1709,2948,49560,68360,117920
8/27/2024,Madhuri Harischandra,Moneragala,Moneragala,Uva,6442,6432,12874,257680,257280,514960
8/28/2024,Madhuri Harischandra,Moneragala,Moneragala,Uva,2000,4878,6878,80000,195120,275120
8/29/2024,Madhuri Harischandra,Moneragala,Moneragala,Uva,9131,1926,11057,365240,77040,442280
8/30/2024,Madhuri Harischandra,Moneragala,Moneragala,Uva,1273,1732,3005,50920,69280,120200
8/31/2024,Madhuri Harischandra,Moneragala,Moneragala,Uva,7041,6001,13042,281640,240040,521680
9/1/2024,Madhuri Harischandra,Moneragala,Moneragala,Uva,3946,6778,10724,157840,271120,428960
9/2/2024,Madhuri Harischandra,Moneragala,Moneragala,Uva,8256,699,8955,330240,27960,358200
9/3/2024,Madhuri Harischandra,Moneragala,Moneragala,Uva,4045,6205,10250,161800,248200,410000
9/4/2024,Madhuri Harischandra,Moneragala,Moneragala,Uva,7989,6826,14815,319560,273040,592600
9/5/2024,Madhuri Harischandra,Moneragala,Moneragala,Uva,1306,1585,2891,52240,63400,115640
9/6/2024,Madhuri Harischandra,Moneragala,Moneragala,Uva,9191,9992,19183,367640,399680,767320
9/7/2024,Madhuri Harischandra,Moneragala,Moneragala,Uva,7176,747,7923,287040,29880,316920
9/8/2024,Madhuri Harischandra,Moneragala,Moneragala,Uva,4768,7343,12111,190720,293720,484440
9/9/2024,Madhuri Harischandra,Moneragala,Moneragala,Uva,5846,5603,11449,233840,224120,457960
9/10/2024,Madhuri Harischandra,Moneragala,Moneragala,Uva,1370,5503,6873,54800,220120,274920
9/11/2024,Madhuri Harischandra,Moneragala,Moneragala,Uva,2110,2704,4814,84400,108160,192560
9/12/2024,Madhuri Harischandra,Moneragala,Moneragala,Uva,3733,3169,6902,149320,126760,276080
9/13/2024,Madhuri Harischandra,Moneragala,Moneragala,Uva,4111,8859,12970,164440,354360,518800
9/14/2024,Madhuri Harischandra,Moneragala,Moneragala,Uva,9780,3198,12978,391200,127920,519120
9/15/2024,Madhuri Harischandra,Moneragala,Moneragala,Uva,3340,4566,7906,133600,182640,316240
9/16/2024,Madhuri Harischandra,Moneragala,Moneragala,Uva,407,9291,9698,16280,371640,387920
9/17/2024,Madhuri Harischandra,Moneragala,Moneragala,Uva,264,8894,9158,10560,355760,366320
9/18/2024,Madhuri Harischandra,Moneragala,Moneragala,Uva,2132,3762,5894,85280,150480,235760
9/19/2024,Madhuri Harischandra,Moneragala,Moneragala,Uva,6628,735,7363,265120,29400,294520
9/20/2024,Madhuri Harischandra,Moneragala,Moneragala,Uva,3427,7257,10684,137080,290280,427360
9/21/2024,Madhuri Harischandra,Moneragala,Moneragala,Uva,9529,9483,19012,381160,379320,760480
9/22/2024,Madhuri Harischandra,Moneragala,Moneragala,Uva,6397,1437,7834,255880,57480,313360
9/23/2024,Madhuri Harischandra,Moneragala,Moneragala,Uva,8763,6487,15250,350520,259480,610000
9/24/2024,Madhuri Harischandra,Moneragala,Moneragala,Uva,5663,4987,10650,226520,199480,426000
9/25/2024,Madhuri Harischandra,Moneragala,Moneragala,Uva,1125,7969,9094,45000,318760,363760
9/26/2024,Madhuri Harischandra,Moneragala,Moneragala,Uva,444,3631,4075,17760,145240,163000
9/27/2024,Madhuri Harischandra,Moneragala,Moneragala,Uva,2324,6188,8512,92960,247520,340480
9/28/2024,Madhuri Harischandra,Moneragala,Moneragala,Uva,9066,3688,12754,362640,147520,510160
9/29/2024,Madhuri Harischandra,Moneragala,Moneragala,Uva,9421,3060,12481,376840,122400,499240
9/30/2024,Madhuri Harischandra,Moneragala,Moneragala,Uva,4949,5093,10042,197960,203720,401680
10/1/2024,Madhuri Harischandra,Moneragala,Moneragala,Uva,1236,9395,10631,49440,375800,425240
10/2/2024,Madhuri Harischandra,Moneragala,Moneragala,Uva,1609,8740,10349,64360,349600,413960
10/3/2024,Madhuri Harischandra,Moneragala,Moneragala,Uva,8347,7381,15728,333880,295240,629120
10/4/2024,Madhuri Harischandra,Moneragala,Moneragala,Uva,9464,284,9748,378560,11360,389920
10/5/2024,Madhuri Harischandra,Moneragala,Moneragala,Uva,4858,9851,14709,194320,394040,588360
10/6/2024,Madhuri Harischandra,Moneragala,Moneragala,Uva,1032,4940,5972,41280,197600,238880
10/7/2024,Madhuri Harischandra,Moneragala,Moneragala,Uva,8741,5781,14522,349640,231240,580880
10/8/2024,Madhuri Harischandra,Moneragala,Moneragala,Uva,5630,5209,10839,225200,208360,433560
10/9/2024,Madhuri Harischandra,Moneragala,Moneragala,Uva,3506,7863,11369,140240,314520,454760
10/10/2024,Madhuri Harischandra,Moneragala,Moneragala,Uva,44,5926,5970,1760,237040,238800
10/11/2024,Madhuri Harischandra,Moneragala,Moneragala,Uva,7848,8612,16460,313920,344480,658400
10/12/2024,Madhuri Harischandra,Moneragala,Moneragala,Uva,6585,9496,16081,263400,379840,643240
10/13/2024,Madhuri Harischandra,Moneragala,Moneragala,Uva,1037,8842,9879,41480,353680,395160
10/14/2024,Madhuri Harischandra,Moneragala,Moneragala,Uva,2111,7960,10071,84440,318400,402840
10/15/2024,Madhuri Harischandra,Moneragala,Moneragala,Uva,1562,5293,6855,62480,211720,274200
10/16/2024,Madhuri Harischandra,Moneragala,Moneragala,Uva,6758,731,7489,270320,29240,299560
10/17/2024,Madhuri Harischandra,Moneragala,Moneragala,Uva,8964,8594,17558,358560,343760,702320
10/18/2024,Madhuri Harischandra,Moneragala,Moneragala,Uva,4460,7253,11713,178400,290120,468520
10/19/2024,Madhuri Harischandra,Moneragala,Moneragala,Uva,6765,899,7664,270600,35960,306560
10/20/2024,Madhuri Harischandra,Moneragala,Moneragala,Uva,1016,8079,9095,40640,323160,363800
10/21/2024,Madhuri Harischandra,Moneragala,Moneragala,Uva,1089,3737,4826,43560,149480,193040
10/22/2024,Madhuri Harischandra,Moneragala,Moneragala,Uva,6421,8213,14634,256840,328520,585360
10/23/2024,Madhuri Harischandra,Moneragala,Moneragala,Uva,3921,5132,9053,156840,205280,362120
10/24/2024,Madhuri Harischandra,Moneragala,Moneragala,Uva,1972,4303,6275,78880,172120,251000
10/25/2024,Madhuri Harischandra,Moneragala,Moneragala,Uva,2933,8280,11213,117320,331200,448520
10/26/2024,Madhuri Harischandra,Moneragala,Moneragala,Uva,7205,3108,10313,288200,124320,412520
10/27/2024,Madhuri Harischandra,Moneragala,Moneragala,Uva,1496,2455,3951,59840,98200,158040
10/28/2024,Madhuri Harischandra,Moneragala,Moneragala,Uva,647,3572,4219,25880,142880,168760
10/29/2024,Madhuri Harischandra,Moneragala,Moneragala,Uva,8227,9957,18184,329080,398280,727360
10/30/2024,Madhuri Harischandra,Moneragala,Moneragala,Uva,4916,1321,6237,196640,52840,249480
10/31/2024,Madhuri Harischandra,Moneragala,Moneragala,Uva,3423,4254,7677,136920,170160,307080
11/1/2024,Madhuri Harischandra,Moneragala,Moneragala,Uva,8499,5218,13717,339960,208720,548680
11/2/2024,Madhuri Harischandra,Moneragala,Moneragala,Uva,882,5748,6630,35280,229920,265200
11/3/2024,Madhuri Harischandra,Moneragala,Moneragala,Uva,2099,6123,8222,83960,244920,328880
11/4/2024,Madhuri Harischandra,Moneragala,Moneragala,Uva,5993,2076,8069,239720,83040,322760
11/5/2024,Madhuri Harischandra,Moneragala,Moneragala,Uva,1908,4780,6688,76320,191200,267520
11/6/2024,Madhuri Harischandra,Moneragala,Moneragala,Uva,3985,1296,5281,159400,51840,211240
11/7/2024,Madhuri Harischandra,Moneragala,Moneragala,Uva,9632,5139,14771,385280,205560,590840
11/8/2024,Madhuri Harischandra,Moneragala,Moneragala,Uva,9131,684,9815,365240,27360,392600
11/9/2024,Madhuri Harischandra,Moneragala,Moneragala,Uva,9688,5683,15371,387520,227320,614840
11/10/2024,Madhuri Harischandra,Moneragala,Moneragala,Uva,5562,7589,13151,222480,303560,526040
11/11/2024,Madhuri Harischandra,Moneragala,Moneragala,Uva,5115,3811,8926,204600,152440,357040
11/12/2024,Madhuri Harischandra,Moneragala,Moneragala,Uva,6903,1280,8183,276120,51200,327320
11/13/2024,Madhuri Harischandra,Moneragala,Moneragala,Uva,5816,6105,11921,232640,244200,476840
11/14/2024,Madhuri Harischandra,Moneragala,Moneragala,Uva,1527,8026,9553,61080,321040,382120
11/15/2024,Madhuri Harischandra,Moneragala,Moneragala,Uva,6561,2928,9489,262440,117120,379560
11/16/2024,Madhuri Harischandra,Moneragala,Moneragala,Uva,1598,5857,7455,63920,234280,298200
11/17/2024,Madhuri Harischandra,Moneragala,Moneragala,Uva,5869,2129,7998,234760,85160,319920
11/18/2024,Madhuri Harischandra,Moneragala,Moneragala,Uva,6815,1855,8670,272600,74200,346800
11/19/2024,Madhuri Harischandra,Moneragala,Moneragala,Uva,7497,2957,10454,299880,118280,418160
11/20/2024,Madhuri Harischandra,Moneragala,Moneragala,Uva,1132,2034,3166,45280,81360,126640
11/21/2024,Madhuri Harischandra,Moneragala,Moneragala,Uva,7454,5319,12773,298160,212760,510920
11/22/2024,Madhuri Harischandra,Moneragala,Moneragala,Uva,7207,5678,12885,288280,227120,515400
11/23/2024,Madhuri Harischandra,Moneragala,Moneragala,Uva,5529,7817,13346,221160,312680,533840
11/24/2024,Madhuri Harischandra,Moneragala,Moneragala,Uva,9283,2474,11757,371320,98960,470280
11/25/2024,Madhuri Harischandra,Moneragala,Moneragala,Uva,1348,228,1576,53920,9120,63040
11/26/2024,Madhuri Harischandra,Moneragala,Moneragala,Uva,2480,214,2694,99200,8560,107760
11/27/2024,Madhuri Harischandra,Moneragala,Moneragala,Uva,64,5559,5623,2560,222360,224920
11/28/2024,Madhuri Harischandra,Moneragala,Moneragala,Uva,9443,4519,13962,377720,180760,558480
11/29/2024,Madhuri Harischandra,Moneragala,Moneragala,Uva,8170,7570,15740,326800,302800,629600
11/30/2024,Madhuri Harischandra,Moneragala,Moneragala,Uva,6796,5728,12524,271840,229120,500960
12/1/2024,Madhuri Harischandra,Moneragala,Moneragala,Uva,1939,2532,4471,77560,101280,178840
12/2/2024,Madhuri Harischandra,Moneragala,Moneragala,Uva,83,7608,7691,3320,304320,307640
12/3/2024,Madhuri Harischandra,Moneragala,Moneragala,Uva,933,3905,4838,37320,156200,193520
12/4/2024,Madhuri Harischandra,Moneragala,Moneragala,Uva,362,108,470,14480,4320,18800
12/5/2024,Madhuri Harischandra,Moneragala,Moneragala,Uva,7889,5476,13365,315560,219040,534600
12/6/2024,Madhuri Harischandra,Moneragala,Moneragala,Uva,4881,8481,13362,195240,339240,534480
12/7/2024,Madhuri Harischandra,Moneragala,Moneragala,Uva,7021,6723,13744,280840,268920,549760
12/8/2024,Madhuri Harischandra,Moneragala,Moneragala,Uva,3671,2973,6644,146840,118920,265760
12/9/2024,Madhuri Harischandra,Moneragala,Moneragala,Uva,7106,1817,8923,284240,72680,356920
12/10/2024,Madhuri Harischandra,Moneragala,Moneragala,Uva,2174,4172,6346,86960,166880,253840
12/11/2024,Madhuri Harischandra,Moneragala,Moneragala,Uva,6207,4642,10849,248280,185680,433960
12/12/2024,Madhuri Harischandra,Moneragala,Moneragala,Uva,9793,7229,17022,391720,289160,680880
12/13/2024,Madhuri Harischandra,Moneragala,Moneragala,Uva,6913,5529,12442,276520,221160,497680
12/14/2024,Madhuri Harischandra,Moneragala,Moneragala,Uva,7645,927,8572,305800,37080,342880
12/15/2024,Madhuri Harischandra,Moneragala,Moneragala,Uva,3957,9216,13173,158280,368640,526920
12/16/2024,Madhuri Harischandra,Moneragala,Moneragala,Uva,273,3436,3709,10920,137440,148360
12/17/2024,Madhuri Harischandra,Moneragala,Moneragala,Uva,2594,824,3418,103760,32960,136720
12/18/2024,Madhuri Harischandra,Moneragala,Moneragala,Uva,307,1301,1608,12280,52040,64320
12/19/2024,Madhuri Harischandra,Moneragala,Moneragala,Uva,346,4765,5111,13840,190600,204440
12/20/2024,Madhuri Harischandra,Moneragala,Moneragala,Uva,8365,5509,13874,334600,220360,554960
12/21/2024,Madhuri Harischandra,Moneragala,Moneragala,Uva,929,2693,3622,37160,107720,144880
12/22/2024,Madhuri Harischandra,Moneragala,Moneragala,Uva,9151,3148,12299,366040,125920,491960
12/23/2024,Madhuri Harischandra,Moneragala,Moneragala,Uva,2865,7960,10825,114600,318400,433000
12/24/2024,Madhuri Harischandra,Moneragala,Moneragala,Uva,8331,4491,12822,333240,179640,512880
12/25/2024,Madhuri Harischandra,Moneragala,Moneragala,Uva,9274,9826,19100,370960,393040,764000
12/26/2024,Madhuri Harischandra,Moneragala,Moneragala,Uva,8977,6425,15402,359080,257000,616080
12/27/2024,Madhuri Harischandra,Moneragala,Moneragala,Uva,4501,2631,7132,180040,105240,285280
12/28/2024,Madhuri Harischandra,Moneragala,Moneragala,Uva,9969,156,10125,398760,6240,405000
12/29/2024,Madhuri Harischandra,Moneragala,Moneragala,Uva,614,3228,3842,24560,129120,153680
12/30/2024,Madhuri Harischandra,Moneragala,Moneragala,Uva,9257,7987,17244,370280,319480,689760
12/31/2024,Madhuri Harischandra,Moneragala,Moneragala,Uva,1590,1669,3259,63600,66760,130360
1/1/2025,Madhuri Harischandra,Moneragala,Moneragala,Uva,2819,2509,5328,112760,100360,213120
1/2/2025,Madhuri Harischandra,Moneragala,Moneragala,Uva,5814,3083,8897,232560,123320,355880
1/3/2025,Madhuri Harischandra,Moneragala,Moneragala,Uva,5158,9267,14425,206320,370680,577000
1/4/2025,Madhuri Harischandra,Moneragala,Moneragala,Uva,5673,9649,15322,226920,385960,612880
1/5/2025,Madhuri Harischandra,Moneragala,Moneragala,Uva,289,4251,4540,11560,170040,181600
1/6/2025,Madhuri Harischandra,Moneragala,Moneragala,Uva,1828,7099,8927,73120,283960,357080
1/7/2025,Madhuri Harischandra,Moneragala,Moneragala,Uva,1456,476,1932,58240,19040,77280
1/8/2025,Madhuri Harischandra,Moneragala,Moneragala,Uva,1742,127,1869,69680,5080,74760
1/9/2025,Madhuri Harischandra,Moneragala,Moneragala,Uva,9042,7046,16088,361680,281840,643520
1/10/2025,Madhuri Harischandra,Moneragala,Moneragala,Uva,105,3822,3927,4200,152880,157080
1/11/2025,Madhuri Harischandra,Moneragala,Moneragala,Uva,5697,4503,10200,227880,180120,408000
1/12/2025,Madhuri Harischandra,Moneragala,Moneragala,Uva,4894,6580,11474,195760,263200,458960
1/13/2025,Madhuri Harischandra,Moneragala,Moneragala,Uva,3628,2016,5644,145120,80640,225760
1/14/2025,Madhuri Harischandra,Moneragala,Moneragala,Uva,8161,753,8914,326440,30120,356560
1/15/2025,Madhuri Harischandra,Moneragala,Moneragala,Uva,4797,4229,9026,191880,169160,361040
1/16/2025,Madhuri Harischandra,Moneragala,Moneragala,Uva,2463,6372,8835,98520,254880,353400
1/17/2025,Madhuri Harischandra,Moneragala,Moneragala,Uva,6070,5371,11441,242800,214840,457640
1/18/2025,Madhuri Harischandra,Moneragala,Moneragala,Uva,2,8954,8956,80,358160,358240
1/19/2025,Madhuri Harischandra,Moneragala,Moneragala,Uva,6071,808,6879,242840,32320,275160
1/20/2025,Madhuri Harischandra,Moneragala,Moneragala,Uva,8726,159,8885,349040,6360,355400
1/21/2025,Madhuri Harischandra,Moneragala,Moneragala,Uva,6731,3154,9885,269240,126160,395400
1/22/2025,Madhuri Harischandra,Moneragala,Moneragala,Uva,5795,6418,12213,231800,256720,488520
1/23/2025,Madhuri Harischandra,Moneragala,Moneragala,Uva,1135,1404,2539,45400,56160,101560
1/24/2025,Madhuri Harischandra,Moneragala,Moneragala,Uva,3279,8072,11351,131160,322880,454040
1/25/2025,Madhuri Harischandra,Moneragala,Moneragala,Uva,3449,2122,5571,137960,84880,222840
1/26/2025,Madhuri Harischandra,Moneragala,Moneragala,Uva,5203,678,5881,208120,27120,235240
1/27/2025,Madhuri Harischandra,Moneragala,Moneragala,Uva,959,5422,6381,38360,216880,255240
1/28/2025,Madhuri Harischandra,Moneragala,Moneragala,Uva,1746,1954,3700,69840,78160,148000
1/29/2025,Madhuri Harischandra,Moneragala,Moneragala,Uva,1197,3175,4372,47880,127000,174880
1/30/2025,Madhuri Harischandra,Moneragala,Moneragala,Uva,5353,4498,9851,214120,179920,394040
1/31/2025,Madhuri Harischandra,Moneragala,Moneragala,Uva,7199,7405,14604,287960,296200,584160
2/1/2025,Madhuri Harischandra,Moneragala,Moneragala,Uva,2003,933,2936,80120,37320,117440
2/2/2025,Madhuri Harischandra,Moneragala,Moneragala,Uva,1615,810,2425,64600,32400,97000
2/3/2025,Madhuri Harischandra,Moneragala,Moneragala,Uva,7211,4825,12036,288440,193000,481440
2/4/2025,Madhuri Harischandra,Moneragala,Moneragala,Uva,1523,5017,6540,60920,200680,261600
2/5/2025,Madhuri Harischandra,Moneragala,Moneragala,Uva,8662,3824,12486,346480,152960,499440
2/6/2025,Madhuri Harischandra,Moneragala,Moneragala,Uva,4581,7793,12374,183240,311720,494960
2/7/2025,Madhuri Harischandra,Moneragala,Moneragala,Uva,2299,1106,3405,91960,44240,136200
2/8/2025,Madhuri Harischandra,Moneragala,Moneragala,Uva,8538,7205,15743,341520,288200,629720
2/9/2025,Madhuri Harischandra,Moneragala,Moneragala,Uva,919,5854,6773,36760,234160,270920
2/10/2025,Madhuri Harischandra,Moneragala,Moneragala,Uva,3582,5829,9411,143280,233160,376440
2/11/2025,Madhuri Harischandra,Moneragala,Moneragala,Uva,6519,2442,8961,260760,97680,358440
2/12/2025,Madhuri Harischandra,Moneragala,Moneragala,Uva,6870,8984,15854,274800,359360,634160
2/13/2025,Madhuri Harischandra,Moneragala,Moneragala,Uva,903,4167,5070,36120,166680,202800
2/14/2025,Madhuri Harischandra,Moneragala,Moneragala,Uva,6567,3078,9645,262680,123120,385800
2/15/2025,Madhuri Harischandra,Moneragala,Moneragala,Uva,9183,3571,12754,367320,142840,510160
2/16/2025,Madhuri Harischandra,Moneragala,Moneragala,Uva,8489,1345,9834,339560,53800,393360
2/17/2025,Madhuri Harischandra,Moneragala,Moneragala,Uva,4028,2398,6426,161120,95920,257040
2/18/2025,Madhuri Harischandra,Moneragala,Moneragala,Uva,8619,3697,12316,344760,147880,492640
2/19/2025,Madhuri Harischandra,Moneragala,Moneragala,Uva,8876,5608,14484,355040,224320,579360
2/20/2025,Madhuri Harischandra,Moneragala,Moneragala,Uva,1158,9092,10250,46320,363680,410000
2/21/2025,Madhuri Harischandra,Moneragala,Moneragala,Uva,3890,5568,9458,155600,222720,378320
2/22/2025,Madhuri Harischandra,Moneragala,Moneragala,Uva,9739,4331,14070,389560,173240,562800
2/23/2025,Madhuri Harischandra,Moneragala,Moneragala,Uva,913,218,1131,36520,8720,45240
2/24/2025,Madhuri Harischandra,Moneragala,Moneragala,Uva,7352,640,7992,294080,25600,319680
2/25/2025,Madhuri Harischandra,Moneragala,Moneragala,Uva,3431,8064,11495,137240,322560,459800
2/26/2025,Madhuri Harischandra,Moneragala,Moneragala,Uva,9889,7687,17576,395560,307480,703040
2/27/2025,Madhuri Harischandra,Moneragala,Moneragala,Uva,9474,9227,18701,378960,369080,748040
2/28/2025,Madhuri Harischandra,Moneragala,Moneragala,Uva,8947,7102,16049,357880,284080,641960
3/1/2025,Madhuri Harischandra,Moneragala,Moneragala,Uva,6010,1405,7415,240400,56200,296600
3/2/2025,Madhuri Harischandra,Moneragala,Moneragala,Uva,620,7484,8104,24800,299360,324160
3/3/2025,Madhuri Harischandra,Moneragala,Moneragala,Uva,1852,6721,8573,74080,268840,342920
3/4/2025,Madhuri Harischandra,Moneragala,Moneragala,Uva,3282,94,3376,131280,3760,135040
3/5/2025,Madhuri Harischandra,Moneragala,Moneragala,Uva,8880,377,9257,355200,15080,370280
3/6/2025,Madhuri Harischandra,Moneragala,Moneragala,Uva,6520,9503,16023,260800,380120,640920
3/7/2025,Madhuri Harischandra,Moneragala,Moneragala,Uva,6722,1075,7797,268880,43000,311880
3/8/2025,Madhuri Harischandra,Moneragala,Moneragala,Uva,9976,8312,18288,399040,332480,731520
3/9/2025,Madhuri Harischandra,Moneragala,Moneragala,Uva,9121,5069,14190,364840,202760,567600
3/10/2025,Madhuri Harischandra,Moneragala,Moneragala,Uva,3403,3328,6731,136120,133120,269240
3/11/2025,Madhuri Harischandra,Moneragala,Moneragala,Uva,6564,1721,8285,262560,68840,331400
3/12/2025,Madhuri Harischandra,Moneragala,Moneragala,Uva,8677,9459,18136,347080,378360,725440
3/13/2025,Madhuri Harischandra,Moneragala,Moneragala,Uva,6416,5010,11426,256640,200400,457040
3/14/2025,Madhuri Harischandra,Moneragala,Moneragala,Uva,6249,360,6609,249960,14400,264360
3/15/2025,Madhuri Harischandra,Moneragala,Moneragala,Uva,9071,3886,12957,362840,155440,518280
3/16/2025,Madhuri Harischandra,Moneragala,Moneragala,Uva,5200,5285,10485,208000,211400,419400
3/17/2025,Madhuri Harischandra,Moneragala,Moneragala,Uva,1109,7037,8146,44360,281480,325840
3/18/2025,Madhuri Harischandra,Moneragala,Moneragala,Uva,2247,3400,5647,89880,136000,225880
3/19/2025,Madhuri Harischandra,Moneragala,Moneragala,Uva,5360,8850,14210,214400,354000,568400
3/20/2025,Madhuri Harischandra,Moneragala,Moneragala,Uva,6932,7907,14839,277280,316280,593560
3/21/2025,Madhuri Harischandra,Moneragala,Moneragala,Uva,1818,3525,5343,72720,141000,213720
3/22/2025,Madhuri Harischandra,Moneragala,Moneragala,Uva,7397,8969,16366,295880,358760,654640
3/23/2025,Madhuri Harischandra,Moneragala,Moneragala,Uva,9405,1328,10733,376200,53120,429320
3/25/2024,Subodhani Dissanayake,Kurunegala,Dambulla,North Western,2993,7287,10280,119720,291480,411200
3/26/2024,Subodhani Dissanayake,Kurunegala,Dambulla,North Western,2195,2490,4685,87800,99600,187400
3/27/2024,Subodhani Dissanayake,Kurunegala,Dambulla,North Western,7252,5049,12301,290080,201960,492040
3/28/2024,Subodhani Dissanayake,Kurunegala,Dambulla,North Western,5958,4482,10440,238320,179280,417600
3/29/2024,Subodhani Dissanayake,Kurunegala,Dambulla,North Western,9106,2396,11502,364240,95840,460080
3/30/2024,Subodhani Dissanayake,Kurunegala,Dambulla,North Western,6891,8458,15349,275640,338320,613960
3/31/2024,Subodhani Dissanayake,Kurunegala,Dambulla,North Western,788,3498,4286,31520,139920,171440
4/1/2024,Subodhani Dissanayake,Kurunegala,Dambulla,North Western,8520,6288,14808,340800,251520,592320
4/2/2024,Subodhani Dissanayake,Kurunegala,Dambulla,North Western,794,4710,5504,31760,188400,220160
4/3/2024,Subodhani Dissanayake,Kurunegala,Dambulla,North Western,327,5273,5600,13080,210920,224000
4/4/2024,Subodhani Dissanayake,Kurunegala,Dambulla,North Western,6808,9257,16065,272320,370280,642600
4/5/2024,Subodhani Dissanayake,Kurunegala,Dambulla,North Western,1178,2030,3208,47120,81200,128320
4/6/2024,Subodhani Dissanayake,Kurunegala,Dambulla,North Western,9811,321,10132,392440,12840,405280
4/7/2024,Subodhani Dissanayake,Kurunegala,Dambulla,North Western,5177,9666,14843,207080,386640,593720
4/8/2024,Subodhani Dissanayake,Kurunegala,Dambulla,North Western,854,7462,8316,34160,298480,332640
4/9/2024,Subodhani Dissanayake,Kurunegala,Dambulla,North Western,1566,6656,8222,62640,266240,328880
4/10/2024,Subodhani Dissanayake,Kurunegala,Dambulla,North Western,2637,8359,10996,105480,334360,439840
4/11/2024,Subodhani Dissanayake,Kurunegala,Dambulla,North Western,5414,9234,14648,216560,369360,585920
4/19/2024,Subodhani Dissanayake,Kurunegala,Dambulla,North Western,2219,6676,8895,88760,267040,355800
4/20/2024,Subodhani Dissanayake,Kurunegala,Dambulla,North Western,2351,8613,10964,94040,344520,438560
4/21/2024,Subodhani Dissanayake,Kurunegala,Dambulla,North Western,728,8413,9141,29120,336520,365640
4/22/2024,Subodhani Dissanayake,Kurunegala,Dambulla,North Western,3405,3802,7207,136200,152080,288280
4/23/2024,Subodhani Dissanayake,Kurunegala,Dambulla,North Western,1348,5142,6490,53920,205680,259600
4/24/2024,Subodhani Dissanayake,Kurunegala,Dambulla,North Western,6576,8051,14627,263040,322040,585080
4/25/2024,Subodhani Dissanayake,Kurunegala,Dambulla,North Western,3111,3672,6783,124440,146880,271320
4/26/2024,Subodhani Dissanayake,Kurunegala,Dambulla,North Western,148,427,575,5920,17080,23000
4/27/2024,Subodhani Dissanayake,Kurunegala,Dambulla,North Western,6955,1716,8671,278200,68640,346840
4/28/2024,Subodhani Dissanayake,Kurunegala,Dambulla,North Western,916,9111,10027,36640,364440,401080
4/29/2024,Subodhani Dissanayake,Kurunegala,Dambulla,North Western,8317,8718,17035,332680,348720,681400
4/30/2024,Subodhani Dissanayake,Kurunegala,Dambulla,North Western,2577,3705,6282,103080,148200,251280
5/1/2024,Subodhani Dissanayake,Kurunegala,Dambulla,North Western,2781,7131,9912,111240,285240,396480
5/2/2024,Subodhani Dissanayake,Kurunegala,Dambulla,North Western,5662,5344,11006,226480,213760,440240
5/3/2024,Subodhani Dissanayake,Kurunegala,Dambulla,North Western,9732,4524,14256,389280,180960,570240
5/4/2024,Subodhani Dissanayake,Kurunegala,Dambulla,North Western,946,5658,6604,37840,226320,264160
5/5/2024,Subodhani Dissanayake,Kurunegala,Dambulla,North Western,6382,2616,8998,255280,104640,359920
5/6/2024,Subodhani Dissanayake,Kurunegala,Dambulla,North Western,3830,9318,13148,153200,372720,525920
5/7/2024,Subodhani Dissanayake,Kurunegala,Dambulla,North Western,4334,3672,8006,173360,146880,320240
5/8/2024,Subodhani Dissanayake,Kurunegala,Dambulla,North Western,5628,7521,13149,225120,300840,525960
5/9/2024,Subodhani Dissanayake,Kurunegala,Dambulla,North Western,8894,227,9121,355760,9080,364840
5/10/2024,Subodhani Dissanayake,Kurunegala,Dambulla,North Western,3748,1750,5498,149920,70000,219920
5/11/2024,Subodhani Dissanayake,Kurunegala,Dambulla,North Western,6424,5611,12035,256960,224440,481400
5/12/2024,Subodhani Dissanayake,Kurunegala,Dambulla,North Western,8143,2850,10993,325720,114000,439720
5/13/2024,Subodhani Dissanayake,Kurunegala,Dambulla,North Western,9276,3215,12491,371040,128600,499640
5/14/2024,Subodhani Dissanayake,Kurunegala,Dambulla,North Western,5676,872,6548,227040,34880,261920
5/15/2024,Subodhani Dissanayake,Kurunegala,Dambulla,North Western,9057,4796,13853,362280,191840,554120
5/16/2024,Subodhani Dissanayake,Kurunegala,Dambulla,North Western,6831,4971,11802,273240,198840,472080
5/17/2024,Subodhani Dissanayake,Kurunegala,Dambulla,North Western,7110,6272,13382,284400,250880,535280
5/18/2024,Subodhani Dissanayake,Kurunegala,Dambulla,North Western,8820,4204,13024,352800,168160,520960
5/19/2024,Subodhani Dissanayake,Kurunegala,Dambulla,North Western,2589,1203,3792,103560,48120,151680
5/20/2024,Subodhani Dissanayake,Kurunegala,Dambulla,North Western,4259,5114,9373,170360,204560,374920
5/21/2024,Subodhani Dissanayake,Kurunegala,Dambulla,North Western,9084,3785,12869,363360,151400,514760
5/22/2024,Subodhani Dissanayake,Kurunegala,Dambulla,North Western,1077,8656,9733,43080,346240,389320
5/24/2024,Subodhani Dissanayake,Kurunegala,Dambulla,North Western,4363,6264,10627,174520,250560,425080
5/25/2024,Subodhani Dissanayake,Kurunegala,Dambulla,North Western,2106,3311,5417,84240,132440,216680
5/26/2024,Subodhani Dissanayake,Kurunegala,Dambulla,North Western,7141,1278,8419,285640,51120,336760
5/27/2024,Subodhani Dissanayake,Kurunegala,Dambulla,North Western,6248,4123,10371,249920,164920,414840
5/28/2024,Subodhani Dissanayake,Kurunegala,Dambulla,North Western,6841,8012,14853,273640,320480,594120
5/29/2024,Subodhani Dissanayake,Kurunegala,Dambulla,North Western,1736,7758,9494,69440,310320,379760
5/30/2024,Subodhani Dissanayake,Kurunegala,Dambulla,North Western,7525,6618,14143,301000,264720,565720
5/31/2024,Subodhani Dissanayake,Kurunegala,Dambulla,North Western,2843,8125,10968,113720,325000,438720
6/1/2024,Subodhani Dissanayake,Kurunegala,Dambulla,North Western,8179,1196,9375,327160,47840,375000
6/2/2024,Subodhani Dissanayake,Kurunegala,Dambulla,North Western,1993,8003,9996,79720,320120,399840
6/3/2024,Subodhani Dissanayake,Kurunegala,Dambulla,North Western,3985,5265,9250,159400,210600,370000
6/4/2024,Subodhani Dissanayake,Kurunegala,Dambulla,North Western,9095,6945,16040,363800,277800,641600
6/5/2024,Subodhani Dissanayake,Kurunegala,Dambulla,North Western,1327,3042,4369,53080,121680,174760
6/6/2024,Subodhani Dissanayake,Kurunegala,Dambulla,North Western,9425,4735,14160,377000,189400,566400
6/7/2024,Subodhani Dissanayake,Kurunegala,Dambulla,North Western,6732,7920,14652,269280,316800,586080
6/8/2024,Subodhani Dissanayake,Kurunegala,Dambulla,North Western,8221,7225,15446,328840,289000,617840
6/9/2024,Subodhani Dissanayake,Kurunegala,Dambulla,North Western,2934,810,3744,117360,32400,149760
6/10/2024,Subodhani Dissanayake,Kurunegala,Dambulla,North Western,4787,2411,7198,191480,96440,287920
6/11/2024,Subodhani Dissanayake,Kurunegala,Dambulla,North Western,8632,1858,10490,345280,74320,419600
6/12/2024,Subodhani Dissanayake,Kurunegala,Dambulla,North Western,5529,8214,13743,221160,328560,549720
6/13/2024,Subodhani Dissanayake,Kurunegala,Dambulla,North Western,7855,7134,14989,314200,285360,599560
6/14/2024,Subodhani Dissanayake,Kurunegala,Dambulla,North Western,5989,1616,7605,239560,64640,304200
6/15/2024,Subodhani Dissanayake,Kurunegala,Dambulla,North Western,1823,413,2236,72920,16520,89440
6/16/2024,Subodhani Dissanayake,Kurunegala,Dambulla,North Western,5864,5959,11823,234560,238360,472920
6/17/2024,Subodhani Dissanayake,Kurunegala,Dambulla,North Western,7910,4224,12134,316400,168960,485360
6/18/2024,Subodhani Dissanayake,Kurunegala,Dambulla,North Western,9321,3027,12348,372840,121080,493920
6/19/2024,Subodhani Dissanayake,Kurunegala,Dambulla,North Western,9284,7624,16908,371360,304960,676320
6/20/2024,Subodhani Dissanayake,Kurunegala,Dambulla,North Western,8448,1845,10293,337920,73800,411720
6/21/2024,Subodhani Dissanayake,Kurunegala,Dambulla,North Western,5261,756,6017,210440,30240,240680
6/22/2024,Subodhani Dissanayake,Kurunegala,Dambulla,North Western,9135,3673,12808,365400,146920,512320
6/23/2024,Subodhani Dissanayake,Kurunegala,Dambulla,North Western,2558,1966,4524,102320,78640,180960
6/24/2024,Subodhani Dissanayake,Kurunegala,Dambulla,North Western,6766,1190,7956,270640,47600,318240
6/25/2024,Subodhani Dissanayake,Kurunegala,Dambulla,North Western,1008,1207,2215,40320,48280,88600
6/26/2024,Subodhani Dissanayake,Kurunegala,Dambulla,North Western,3802,4525,8327,152080,181000,333080
6/27/2024,Subodhani Dissanayake,Kurunegala,Dambulla,North Western,8633,7577,16210,345320,303080,648400
6/28/2024,Subodhani Dissanayake,Kurunegala,Dambulla,North Western,7993,9158,17151,319720,366320,686040
6/29/2024,Subodhani Dissanayake,Kurunegala,Dambulla,North Western,9869,8251,18120,394760,330040,724800
6/30/2024,Subodhani Dissanayake,Kurunegala,Dambulla,North Western,5695,8135,13830,227800,325400,553200
7/1/2024,Subodhani Dissanayake,Kurunegala,Dambulla,North Western,195,7396,7591,7800,295840,303640
7/2/2024,Subodhani Dissanayake,Kurunegala,Dambulla,North Western,1304,2756,4060,52160,110240,162400
7/3/2024,Subodhani Dissanayake,Kurunegala,Dambulla,North Western,7428,3673,11101,297120,146920,444040
7/4/2024,Subodhani Dissanayake,Kurunegala,Dambulla,North Western,1837,619,2456,73480,24760,98240
7/5/2024,Subodhani Dissanayake,Kurunegala,Dambulla,North Western,4713,5790,10503,188520,231600,420120
7/6/2024,Subodhani Dissanayake,Kurunegala,Dambulla,North Western,4212,8599,12811,168480,343960,512440
7/7/2024,Subodhani Dissanayake,Kurunegala,Dambulla,North Western,40,3895,3935,1600,155800,157400
7/8/2024,Subodhani Dissanayake,Kurunegala,Dambulla,North Western,160,366,526,6400,14640,21040
7/9/2024,Subodhani Dissanayake,Kurunegala,Dambulla,North Western,9047,1314,10361,361880,52560,414440
7/10/2024,Subodhani Dissanayake,Kurunegala,Dambulla,North Western,5053,5049,10102,202120,201960,404080
7/11/2024,Subodhani Dissanayake,Kurunegala,Dambulla,North Western,1545,1289,2834,61800,51560,113360
7/12/2024,Subodhani Dissanayake,Kurunegala,Dambulla,North Western,4513,2527,7040,180520,101080,281600
7/13/2024,Subodhani Dissanayake,Kurunegala,Dambulla,North Western,8947,3354,12301,357880,134160,492040
7/14/2024,Subodhani Dissanayake,Kurunegala,Dambulla,North Western,6980,4615,11595,279200,184600,463800
7/15/2024,Subodhani Dissanayake,Kurunegala,Dambulla,North Western,1385,75,1460,55400,3000,58400
7/16/2024,Subodhani Dissanayake,Kurunegala,Dambulla,North Western,1848,1827,3675,73920,73080,147000
7/17/2024,Subodhani Dissanayake,Kurunegala,Dambulla,North Western,8779,9648,18427,351160,385920,737080
7/18/2024,Subodhani Dissanayake,Kurunegala,Dambulla,North Western,2154,3632,5786,86160,145280,231440
7/19/2024,Subodhani Dissanayake,Kurunegala,Dambulla,North Western,332,2778,3110,13280,111120,124400
7/20/2024,Subodhani Dissanayake,Kurunegala,Dambulla,North Western,8751,8634,17385,350040,345360,695400
7/21/2024,Subodhani Dissanayake,Kurunegala,Dambulla,North Western,7890,1068,8958,315600,42720,358320
7/22/2024,Subodhani Dissanayake,Kurunegala,Dambulla,North Western,9731,9111,18842,389240,364440,753680
7/23/2024,Subodhani Dissanayake,Kurunegala,Dambulla,North Western,2002,1875,3877,80080,75000,155080
7/24/2024,Subodhani Dissanayake,Kurunegala,Dambulla,North Western,2044,3728,5772,81760,149120,230880
7/25/2024,Subodhani Dissanayake,Kurunegala,Dambulla,North Western,5922,5308,11230,236880,212320,449200
7/26/2024,Subodhani Dissanayake,Kurunegala,Dambulla,North Western,7999,7668,15667,319960,306720,626680
7/27/2024,Subodhani Dissanayake,Kurunegala,Dambulla,North Western,8365,2447,10812,334600,97880,432480
7/28/2024,Subodhani Dissanayake,Kurunegala,Dambulla,North Western,2713,8620,11333,108520,344800,453320
7/29/2024,Subodhani Dissanayake,Kurunegala,Dambulla,North Western,3732,5287,9019,149280,211480,360760
7/30/2024,Subodhani Dissanayake,Kurunegala,Dambulla,North Western,4534,3840,8374,181360,153600,334960
7/31/2024,Subodhani Dissanayake,Kurunegala,Dambulla,North Western,1167,9780,10947,46680,391200,437880
8/1/2024,Subodhani Dissanayake,Kurunegala,Dambulla,North Western,8355,2195,10550,334200,87800,422000
8/2/2024,Subodhani Dissanayake,Kurunegala,Dambulla,North Western,9961,1045,11006,398440,41800,440240
8/3/2024,Subodhani Dissanayake,Kurunegala,Dambulla,North Western,8156,9237,17393,326240,369480,695720
8/4/2024,Subodhani Dissanayake,Kurunegala,Dambulla,North Western,5719,9107,14826,228760,364280,593040
8/5/2024,Subodhani Dissanayake,Kurunegala,Dambulla,North Western,9935,1757,11692,397400,70280,467680
8/6/2024,Subodhani Dissanayake,Kurunegala,Dambulla,North Western,5518,8924,14442,220720,356960,577680
8/7/2024,Subodhani Dissanayake,Kurunegala,Dambulla,North Western,1930,193,2123,77200,7720,84920
8/8/2024,Subodhani Dissanayake,Kurunegala,Dambulla,North Western,951,9341,10292,38040,373640,411680
8/9/2024,Subodhani Dissanayake,Kurunegala,Dambulla,North Western,8069,7985,16054,322760,319400,642160
8/10/2024,Subodhani Dissanayake,Kurunegala,Dambulla,North Western,1006,3840,4846,40240,153600,193840
8/11/2024,Subodhani Dissanayake,Kurunegala,Dambulla,North Western,4999,1228,6227,199960,49120,249080
8/12/2024,Subodhani Dissanayake,Kurunegala,Dambulla,North Western,4229,6361,10590,169160,254440,423600
8/13/2024,Subodhani Dissanayake,Kurunegala,Dambulla,North Western,4506,5477,9983,180240,219080,399320
8/14/2024,Subodhani Dissanayake,Kurunegala,Dambulla,North Western,3208,9811,13019,128320,392440,520760
8/15/2024,Subodhani Dissanayake,Kurunegala,Dambulla,North Western,4483,6561,11044,179320,262440,441760
8/16/2024,Subodhani Dissanayake,Kurunegala,Dambulla,North Western,4612,1173,5785,184480,46920,231400
8/17/2024,Subodhani Dissanayake,Kurunegala,Dambulla,North Western,8897,4180,13077,355880,167200,523080
8/18/2024,Subodhani Dissanayake,Kurunegala,Dambulla,North Western,8186,7452,15638,327440,298080,625520
8/19/2024,Subodhani Dissanayake,Kurunegala,Dambulla,North Western,6170,2128,8298,246800,85120,331920
8/20/2024,Subodhani Dissanayake,Kurunegala,Dambulla,North Western,9158,6048,15206,366320,241920,608240
8/21/2024,Subodhani Dissanayake,Kurunegala,Dambulla,North Western,7681,5744,13425,307240,229760,537000
8/22/2024,Subodhani Dissanayake,Kurunegala,Dambulla,North Western,1278,2371,3649,51120,94840,145960
8/23/2024,Subodhani Dissanayake,Kurunegala,Dambulla,North Western,1841,4588,6429,73640,183520,257160
8/24/2024,Subodhani Dissanayake,Kurunegala,Dambulla,North Western,7621,9994,17615,304840,399760,704600
8/25/2024,Subodhani Dissanayake,Kurunegala,Dambulla,North Western,2687,5488,8175,107480,219520,327000
8/26/2024,Subodhani Dissanayake,Kurunegala,Dambulla,North Western,6817,6916,13733,272680,276640,549320
8/27/2024,Subodhani Dissanayake,Kurunegala,Dambulla,North Western,7217,8259,15476,288680,330360,619040
8/28/2024,Subodhani Dissanayake,Kurunegala,Dambulla,North Western,4372,8471,12843,174880,338840,513720
8/29/2024,Subodhani Dissanayake,Kurunegala,Dambulla,North Western,3725,3422,7147,149000,136880,285880
8/30/2024,Subodhani Dissanayake,Kurunegala,Dambulla,North Western,5342,8288,13630,213680,331520,545200
8/31/2024,Subodhani Dissanayake,Kurunegala,Dambulla,North Western,7429,2741,10170,297160,109640,406800
9/1/2024,Subodhani Dissanayake,Kurunegala,Dambulla,North Western,2794,8422,11216,111760,336880,448640
9/2/2024,Subodhani Dissanayake,Kurunegala,Dambulla,North Western,1624,4639,6263,64960,185560,250520
9/3/2024,Subodhani Dissanayake,Kurunegala,Dambulla,North Western,5335,4091,9426,213400,163640,377040
9/4/2024,Subodhani Dissanayake,Kurunegala,Dambulla,North Western,2941,8144,11085,117640,325760,443400
9/5/2024,Subodhani Dissanayake,Kurunegala,Dambulla,North Western,1016,4330,5346,40640,173200,213840
9/6/2024,Subodhani Dissanayake,Kurunegala,Dambulla,North Western,7323,2852,10175,292920,114080,407000
9/7/2024,Subodhani Dissanayake,Kurunegala,Dambulla,North Western,6936,5949,12885,277440,237960,515400
9/8/2024,Subodhani Dissanayake,Kurunegala,Dambulla,North Western,7065,2768,9833,282600,110720,393320
9/9/2024,Subodhani Dissanayake,Kurunegala,Dambulla,North Western,1248,1027,2275,49920,41080,91000
9/10/2024,Subodhani Dissanayake,Kurunegala,Dambulla,North Western,1547,4091,5638,61880,163640,225520
9/11/2024,Subodhani Dissanayake,Kurunegala,Dambulla,North Western,4060,6301,10361,162400,252040,414440
9/12/2024,Subodhani Dissanayake,Kurunegala,Dambulla,North Western,6404,3034,9438,256160,121360,377520
9/13/2024,Subodhani Dissanayake,Kurunegala,Dambulla,North Western,4578,3010,7588,183120,120400,303520
9/14/2024,Subodhani Dissanayake,Kurunegala,Dambulla,North Western,648,1941,2589,25920,77640,103560
9/15/2024,Subodhani Dissanayake,Kurunegala,Dambulla,North Western,7592,3285,10877,303680,131400,435080
9/16/2024,Subodhani Dissanayake,Kurunegala,Dambulla,North Western,3927,7078,11005,157080,283120,440200
9/17/2024,Subodhani Dissanayake,Kurunegala,Dambulla,North Western,1647,2147,3794,65880,85880,151760
9/18/2024,Subodhani Dissanayake,Kurunegala,Dambulla,North Western,5135,261,5396,205400,10440,215840
9/19/2024,Subodhani Dissanayake,Kurunegala,Dambulla,North Western,1242,9729,10971,49680,389160,438840
9/20/2024,Subodhani Dissanayake,Kurunegala,Dambulla,North Western,3439,887,4326,137560,35480,173040
9/21/2024,Subodhani Dissanayake,Kurunegala,Dambulla,North Western,2238,3856,6094,89520,154240,243760
9/22/2024,Subodhani Dissanayake,Kurunegala,Dambulla,North Western,7762,2918,10680,310480,116720,427200
9/23/2024,Subodhani Dissanayake,Kurunegala,Dambulla,North Western,6857,9889,16746,274280,395560,669840
9/24/2024,Subodhani Dissanayake,Kurunegala,Dambulla,North Western,1916,5322,7238,76640,212880,289520
9/25/2024,Subodhani Dissanayake,Kurunegala,Dambulla,North Western,3463,838,4301,138520,33520,172040
9/26/2024,Subodhani Dissanayake,Kurunegala,Dambulla,North Western,7475,6731,14206,299000,269240,568240
9/27/2024,Subodhani Dissanayake,Kurunegala,Dambulla,North Western,3888,5599,9487,155520,223960,379480
9/28/2024,Subodhani Dissanayake,Kurunegala,Dambulla,North Western,2688,9182,11870,107520,367280,474800
9/29/2024,Subodhani Dissanayake,Kurunegala,Dambulla,North Western,5529,9334,14863,221160,373360,594520
9/30/2024,Subodhani Dissanayake,Kurunegala,Dambulla,North Western,6340,8519,14859,253600,340760,594360
10/1/2024,Subodhani Dissanayake,Kurunegala,Dambulla,North Western,1829,7779,9608,73160,311160,384320
10/2/2024,Subodhani Dissanayake,Kurunegala,Dambulla,North Western,4977,4706,9683,199080,188240,387320
10/3/2024,Subodhani Dissanayake,Kurunegala,Dambulla,North Western,3644,4527,8171,145760,181080,326840
10/4/2024,Subodhani Dissanayake,Kurunegala,Dambulla,North Western,2009,7893,9902,80360,315720,396080
10/5/2024,Subodhani Dissanayake,Kurunegala,Dambulla,North Western,5854,3134,8988,234160,125360,359520
10/6/2024,Subodhani Dissanayake,Kurunegala,Dambulla,North Western,1278,2122,3400,51120,84880,136000
10/7/2024,Subodhani Dissanayake,Kurunegala,Dambulla,North Western,1303,6892,8195,52120,275680,327800
10/8/2024,Subodhani Dissanayake,Kurunegala,Dambulla,North Western,9797,1790,11587,391880,71600,463480
10/9/2024,Subodhani Dissanayake,Kurunegala,Dambulla,North Western,8497,4358,12855,339880,174320,514200
10/10/2024,Subodhani Dissanayake,Kurunegala,Dambulla,North Western,9883,733,10616,395320,29320,424640
10/11/2024,Subodhani Dissanayake,Kurunegala,Dambulla,North Western,1242,7759,9001,49680,310360,360040
10/12/2024,Subodhani Dissanayake,Kurunegala,Dambulla,North Western,1767,6111,7878,70680,244440,315120
10/13/2024,Subodhani Dissanayake,Kurunegala,Dambulla,North Western,6530,3577,10107,261200,143080,404280
10/14/2024,Subodhani Dissanayake,Kurunegala,Dambulla,North Western,4822,9670,14492,192880,386800,579680
10/15/2024,Subodhani Dissanayake,Kurunegala,Dambulla,North Western,8317,9734,18051,332680,389360,722040
10/16/2024,Subodhani Dissanayake,Kurunegala,Dambulla,North Western,5277,9684,14961,211080,387360,598440
10/17/2024,Subodhani Dissanayake,Kurunegala,Dambulla,North Western,1215,7952,9167,48600,318080,366680
10/18/2024,Subodhani Dissanayake,Kurunegala,Dambulla,North Western,3417,9979,13396,136680,399160,535840
10/19/2024,Subodhani Dissanayake,Kurunegala,Dambulla,North Western,722,5484,6206,28880,219360,248240
10/20/2024,Subodhani Dissanayake,Kurunegala,Dambulla,North Western,5127,6270,11397,205080,250800,455880
10/21/2024,Subodhani Dissanayake,Kurunegala,Dambulla,North Western,643,5986,6629,25720,239440,265160
10/22/2024,Subodhani Dissanayake,Kurunegala,Dambulla,North Western,6349,2678,9027,253960,107120,361080
10/23/2024,Subodhani Dissanayake,Kurunegala,Dambulla,North Western,3336,4888,8224,133440,195520,328960
10/24/2024,Subodhani Dissanayake,Kurunegala,Dambulla,North Western,8621,8514,17135,344840,340560,685400
10/25/2024,Subodhani Dissanayake,Kurunegala,Dambulla,North Western,7743,9509,17252,309720,380360,690080
10/26/2024,Subodhani Dissanayake,Kurunegala,Dambulla,North Western,3791,1876,5667,151640,75040,226680
10/27/2024,Subodhani Dissanayake,Kurunegala,Dambulla,North Western,9439,3510,12949,377560,140400,517960
10/28/2024,Subodhani Dissanayake,Kurunegala,Dambulla,North Western,818,1862,2680,32720,74480,107200
10/29/2024,Subodhani Dissanayake,Kurunegala,Dambulla,North Western,6479,3848,10327,259160,153920,413080
10/30/2024,Subodhani Dissanayake,Kurunegala,Dambulla,North Western,8246,3623,11869,329840,144920,474760
10/31/2024,Subodhani Dissanayake,Kurunegala,Dambulla,North Western,2078,1685,3763,83120,67400,150520
11/1/2024,Subodhani Dissanayake,Kurunegala,Dambulla,North Western,5772,4511,10283,230880,180440,411320
11/2/2024,Subodhani Dissanayake,Kurunegala,Dambulla,North Western,3838,7492,11330,153520,299680,453200
11/3/2024,Subodhani Dissanayake,Kurunegala,Dambulla,North Western,5184,8252,13436,207360,330080,537440
11/4/2024,Subodhani Dissanayake,Kurunegala,Dambulla,North Western,3330,7658,10988,133200,306320,439520
11/5/2024,Subodhani Dissanayake,Kurunegala,Dambulla,North Western,3500,2299,5799,140000,91960,231960
11/6/2024,Subodhani Dissanayake,Kurunegala,Dambulla,North Western,3381,9674,13055,135240,386960,522200
11/7/2024,Subodhani Dissanayake,Kurunegala,Dambulla,North Western,7920,5830,13750,316800,233200,550000
11/8/2024,Subodhani Dissanayake,Kurunegala,Dambulla,North Western,4607,5435,10042,184280,217400,401680
11/9/2024,Subodhani Dissanayake,Kurunegala,Dambulla,North Western,2490,3559,6049,99600,142360,241960
11/10/2024,Subodhani Dissanayake,Kurunegala,Dambulla,North Western,3071,4075,7146,122840,163000,285840
11/11/2024,Subodhani Dissanayake,Kurunegala,Dambulla,North Western,8067,3112,11179,322680,124480,447160
11/12/2024,Subodhani Dissanayake,Kurunegala,Dambulla,North Western,7385,943,8328,295400,37720,333120
11/13/2024,Subodhani Dissanayake,Kurunegala,Dambulla,North Western,3130,6483,9613,125200,259320,384520
11/14/2024,Subodhani Dissanayake,Kurunegala,Dambulla,North Western,6243,5379,11622,249720,215160,464880
11/15/2024,Subodhani Dissanayake,Kurunegala,Dambulla,North Western,9021,2407,11428,360840,96280,457120
11/16/2024,Subodhani Dissanayake,Kurunegala,Dambulla,North Western,1161,3458,4619,46440,138320,184760
11/17/2024,Subodhani Dissanayake,Kurunegala,Dambulla,North Western,261,2153,2414,10440,86120,96560
11/18/2024,Subodhani Dissanayake,Kurunegala,Dambulla,North Western,7329,6937,14266,293160,277480,570640
11/19/2024,Subodhani Dissanayake,Kurunegala,Dambulla,North Western,6871,7021,13892,274840,280840,555680
11/20/2024,Subodhani Dissanayake,Kurunegala,Dambulla,North Western,599,8923,9522,23960,356920,380880
11/21/2024,Subodhani Dissanayake,Kurunegala,Dambulla,North Western,7283,7702,14985,291320,308080,599400
11/22/2024,Subodhani Dissanayake,Kurunegala,Dambulla,North Western,9393,6160,15553,375720,246400,622120
11/23/2024,Subodhani Dissanayake,Kurunegala,Dambulla,North Western,1907,750,2657,76280,30000,106280
11/24/2024,Subodhani Dissanayake,Kurunegala,Dambulla,North Western,2306,7980,10286,92240,319200,411440
11/25/2024,Subodhani Dissanayake,Kurunegala,Dambulla,North Western,5639,3546,9185,225560,141840,367400
11/26/2024,Subodhani Dissanayake,Kurunegala,Dambulla,North Western,9214,8381,17595,368560,335240,703800
11/27/2024,Subodhani Dissanayake,Kurunegala,Dambulla,North Western,869,3181,4050,34760,127240,162000
11/28/2024,Subodhani Dissanayake,Kurunegala,Dambulla,North Western,861,939,1800,34440,37560,72000
11/29/2024,Subodhani Dissanayake,Kurunegala,Dambulla,North Western,4318,4770,9088,172720,190800,363520
11/30/2024,Subodhani Dissanayake,Kurunegala,Dambulla,North Western,8671,9999,18670,346840,399960,746800
12/1/2024,Subodhani Dissanayake,Kurunegala,Dambulla,North Western,2028,8283,10311,81120,331320,412440
12/2/2024,Subodhani Dissanayake,Kurunegala,Dambulla,North Western,7602,7079,14681,304080,283160,587240
12/3/2024,Subodhani Dissanayake,Kurunegala,Dambulla,North Western,5756,6336,12092,230240,253440,483680
12/4/2024,Subodhani Dissanayake,Kurunegala,Dambulla,North Western,1270,9351,10621,50800,374040,424840
12/5/2024,Subodhani Dissanayake,Kurunegala,Dambulla,North Western,4398,5156,9554,175920,206240,382160
12/6/2024,Subodhani Dissanayake,Kurunegala,Dambulla,North Western,1095,3620,4715,43800,144800,188600
12/7/2024,Subodhani Dissanayake,Kurunegala,Dambulla,North Western,3525,2564,6089,141000,102560,243560
12/8/2024,Subodhani Dissanayake,Kurunegala,Dambulla,North Western,2990,9497,12487,119600,379880,499480
12/9/2024,Subodhani Dissanayake,Kurunegala,Dambulla,North Western,8544,5144,13688,341760,205760,547520
12/10/2024,Subodhani Dissanayake,Kurunegala,Dambulla,North Western,8914,934,9848,356560,37360,393920
12/11/2024,Subodhani Dissanayake,Kurunegala,Dambulla,North Western,4314,14,4328,172560,560,173120
12/12/2024,Subodhani Dissanayake,Kurunegala,Dambulla,North Western,7262,4121,11383,290480,164840,455320
12/13/2024,Subodhani Dissanayake,Kurunegala,Dambulla,North Western,5738,2310,8048,229520,92400,321920
12/14/2024,Subodhani Dissanayake,Kurunegala,Dambulla,North Western,5441,760,6201,217640,30400,248040
12/15/2024,Subodhani Dissanayake,Kurunegala,Dambulla,North Western,4024,9069,13093,160960,362760,523720
12/16/2024,Subodhani Dissanayake,Kurunegala,Dambulla,North Western,7798,5824,13622,311920,232960,544880
12/17/2024,Subodhani Dissanayake,Kurunegala,Dambulla,North Western,9338,5918,15256,373520,236720,610240
12/18/2024,Subodhani Dissanayake,Kurunegala,Dambulla,North Western,7001,2207,9208,280040,88280,368320
12/19/2024,Subodhani Dissanayake,Kurunegala,Dambulla,North Western,3102,7600,10702,124080,304000,428080
12/20/2024,Subodhani Dissanayake,Kurunegala,Dambulla,North Western,2227,2438,4665,89080,97520,186600
12/21/2024,Subodhani Dissanayake,Kurunegala,Dambulla,North Western,9703,6187,15890,388120,247480,635600
12/22/2024,Subodhani Dissanayake,Kurunegala,Dambulla,North Western,926,3361,4287,37040,134440,171480
12/23/2024,Subodhani Dissanayake,Kurunegala,Dambulla,North Western,3601,7475,11076,144040,299000,443040
12/24/2024,Subodhani Dissanayake,Kurunegala,Dambulla,North Western,8516,6279,14795,340640,251160,591800
12/25/2024,Subodhani Dissanayake,Kurunegala,Dambulla,North Western,9411,4079,13490,376440,163160,539600
12/26/2024,Subodhani Dissanayake,Kurunegala,Dambulla,North Western,5317,6373,11690,212680,254920,467600
12/27/2024,Subodhani Dissanayake,Kurunegala,Dambulla,North Western,4489,5107,9596,179560,204280,383840
12/28/2024,Subodhani Dissanayake,Kurunegala,Dambulla,North Western,9672,8080,17752,386880,323200,710080
12/29/2024,Subodhani Dissanayake,Kurunegala,Dambulla,North Western,3494,9270,12764,139760,370800,510560
12/30/2024,Subodhani Dissanayake,Kurunegala,Dambulla,North Western,7641,915,8556,305640,36600,342240
12/31/2024,Subodhani Dissanayake,Kurunegala,Dambulla,North Western,5856,1708,7564,234240,68320,302560
1/1/2025,Subodhani Dissanayake,Kurunegala,Dambulla,North Western,6991,4415,11406,279640,176600,456240
1/2/2025,Subodhani Dissanayake,Kurunegala,Dambulla,North Western,4272,9019,13291,170880,360760,531640
1/3/2025,Subodhani Dissanayake,Kurunegala,Dambulla,North Western,2541,2732,5273,101640,109280,210920
1/4/2025,Subodhani Dissanayake,Kurunegala,Dambulla,North Western,9812,5288,15100,392480,211520,604000
1/5/2025,Subodhani Dissanayake,Kurunegala,Dambulla,North Western,7463,2303,9766,298520,92120,390640
1/6/2025,Subodhani Dissanayake,Kurunegala,Dambulla,North Western,1803,1583,3386,72120,63320,135440
1/7/2025,Subodhani Dissanayake,Kurunegala,Dambulla,North Western,4086,5274,9360,163440,210960,374400
1/8/2025,Subodhani Dissanayake,Kurunegala,Dambulla,North Western,1007,2752,3759,40280,110080,150360
1/9/2025,Subodhani Dissanayake,Kurunegala,Dambulla,North Western,2492,1196,3688,99680,47840,147520
1/10/2025,Subodhani Dissanayake,Kurunegala,Dambulla,North Western,4032,1848,5880,161280,73920,235200
1/11/2025,Subodhani Dissanayake,Kurunegala,Dambulla,North Western,6056,7671,13727,242240,306840,549080
1/12/2025,Subodhani Dissanayake,Kurunegala,Dambulla,North Western,3207,8081,11288,128280,323240,451520
1/13/2025,Subodhani Dissanayake,Kurunegala,Dambulla,North Western,201,4495,4696,8040,179800,187840
1/14/2025,Subodhani Dissanayake,Kurunegala,Dambulla,North Western,58,7997,8055,2320,319880,322200
1/15/2025,Subodhani Dissanayake,Kurunegala,Dambulla,North Western,5638,9770,15408,225520,390800,616320
1/16/2025,Subodhani Dissanayake,Kurunegala,Dambulla,North Western,4718,3258,7976,188720,130320,319040
1/17/2025,Subodhani Dissanayake,Kurunegala,Dambulla,North Western,1573,7956,9529,62920,318240,381160
1/18/2025,Subodhani Dissanayake,Kurunegala,Dambulla,North Western,1253,7813,9066,50120,312520,362640
1/19/2025,Subodhani Dissanayake,Kurunegala,Dambulla,North Western,3951,9678,13629,158040,387120,545160
1/20/2025,Subodhani Dissanayake,Kurunegala,Dambulla,North Western,9521,2754,12275,380840,110160,491000
1/21/2025,Subodhani Dissanayake,Kurunegala,Dambulla,North Western,1445,2774,4219,57800,110960,168760
1/22/2025,Subodhani Dissanayake,Kurunegala,Dambulla,North Western,8823,5616,14439,352920,224640,577560
1/23/2025,Subodhani Dissanayake,Kurunegala,Dambulla,North Western,4937,995,5932,197480,39800,237280
1/24/2025,Subodhani Dissanayake,Kurunegala,Dambulla,North Western,9163,2209,11372,366520,88360,454880
1/25/2025,Subodhani Dissanayake,Kurunegala,Dambulla,North Western,8860,7048,15908,354400,281920,636320
1/26/2025,Subodhani Dissanayake,Kurunegala,Dambulla,North Western,1287,9997,11284,51480,399880,451360
1/27/2025,Subodhani Dissanayake,Kurunegala,Dambulla,North Western,8567,1898,10465,342680,75920,418600
1/28/2025,Subodhani Dissanayake,Kurunegala,Dambulla,North Western,1356,4501,5857,54240,180040,234280
1/29/2025,Subodhani Dissanayake,Kurunegala,Dambulla,North Western,1337,953,2290,53480,38120,91600
1/30/2025,Subodhani Dissanayake,Kurunegala,Dambulla,North Western,8946,8339,17285,357840,333560,691400
1/31/2025,Subodhani Dissanayake,Kurunegala,Dambulla,North Western,5068,8536,13604,202720,341440,544160
2/1/2025,Subodhani Dissanayake,Kurunegala,Dambulla,North Western,5545,4771,10316,221800,190840,412640
2/2/2025,Subodhani Dissanayake,Kurunegala,Dambulla,North Western,8367,8320,16687,334680,332800,667480
2/3/2025,Subodhani Dissanayake,Kurunegala,Dambulla,North Western,4075,372,4447,163000,14880,177880
2/4/2025,Subodhani Dissanayake,Kurunegala,Dambulla,North Western,218,5102,5320,8720,204080,212800
2/5/2025,Subodhani Dissanayake,Kurunegala,Dambulla,North Western,5826,1271,7097,233040,50840,283880
2/6/2025,Subodhani Dissanayake,Kurunegala,Dambulla,North Western,28,9619,9647,1120,384760,385880
2/7/2025,Subodhani Dissanayake,Kurunegala,Dambulla,North Western,2523,10000,12523,100920,400000,500920
2/8/2025,Subodhani Dissanayake,Kurunegala,Dambulla,North Western,2740,2450,5190,109600,98000,207600
2/9/2025,Subodhani Dissanayake,Kurunegala,Dambulla,North Western,4288,3667,7955,171520,146680,318200
2/10/2025,Subodhani Dissanayake,Kurunegala,Dambulla,North Western,136,1576,1712,5440,63040,68480
2/11/2025,Subodhani Dissanayake,Kurunegala,Dambulla,North Western,1967,8207,10174,78680,328280,406960
2/12/2025,Subodhani Dissanayake,Kurunegala,Dambulla,North Western,2625,6102,8727,105000,244080,349080
2/13/2025,Subodhani Dissanayake,Kurunegala,Dambulla,North Western,4942,8180,13122,197680,327200,524880
2/14/2025,Subodhani Dissanayake,Kurunegala,Dambulla,North Western,5907,136,6043,236280,5440,241720
2/15/2025,Subodhani Dissanayake,Kurunegala,Dambulla,North Western,4535,6052,10587,181400,242080,423480
2/16/2025,Subodhani Dissanayake,Kurunegala,Dambulla,North Western,8884,4231,13115,355360,169240,524600
2/17/2025,Subodhani Dissanayake,Kurunegala,Dambulla,North Western,3535,6132,9667,141400,245280,386680
2/18/2025,Subodhani Dissanayake,Kurunegala,Dambulla,North Western,7731,8970,16701,309240,358800,668040
2/19/2025,Subodhani Dissanayake,Kurunegala,Dambulla,North Western,6750,2995,9745,270000,119800,389800
2/20/2025,Subodhani Dissanayake,Kurunegala,Dambulla,North Western,8233,3766,11999,329320,150640,479960
2/21/2025,Subodhani Dissanayake,Kurunegala,Dambulla,North Western,2628,2928,5556,105120,117120,222240
2/22/2025,Subodhani Dissanayake,Kurunegala,Dambulla,North Western,325,9991,10316,13000,399640,412640
2/23/2025,Subodhani Dissanayake,Kurunegala,Dambulla,North Western,7515,5018,12533,300600,200720,501320
2/24/2025,Subodhani Dissanayake,Kurunegala,Dambulla,North Western,8103,5227,13330,324120,209080,533200
2/25/2025,Subodhani Dissanayake,Kurunegala,Dambulla,North Western,9613,5355,14968,384520,214200,598720
2/26/2025,Subodhani Dissanayake,Kurunegala,Dambulla,North Western,356,8421,8777,14240,336840,351080
2/27/2025,Subodhani Dissanayake,Kurunegala,Dambulla,North Western,4678,2644,7322,187120,105760,292880
2/28/2025,Subodhani Dissanayake,Kurunegala,Dambulla,North Western,3726,7365,11091,149040,294600,443640
3/1/2025,Subodhani Dissanayake,Kurunegala,Dambulla,North Western,8402,5099,13501,336080,203960,540040
3/2/2025,Subodhani Dissanayake,Kurunegala,Dambulla,North Western,5301,2920,8221,212040,116800,328840
3/3/2025,Subodhani Dissanayake,Kurunegala,Dambulla,North Western,1769,1718,3487,70760,68720,139480
3/4/2025,Subodhani Dissanayake,Kurunegala,Dambulla,North Western,7396,4607,12003,295840,184280,480120
3/5/2025,Subodhani Dissanayake,Kurunegala,Dambulla,North Western,2709,8941,11650,108360,357640,466000
3/6/2025,Subodhani Dissanayake,Kurunegala,Dambulla,North Western,9038,1577,10615,361520,63080,424600
3/7/2025,Subodhani Dissanayake,Kurunegala,Dambulla,North Western,6845,533,7378,273800,21320,295120
3/8/2025,Subodhani Dissanayake,Kurunegala,Dambulla,North Western,6534,6408,12942,261360,256320,517680
3/9/2025,Subodhani Dissanayake,Kurunegala,Dambulla,North Western,5701,9595,15296,228040,383800,611840
3/10/2025,Subodhani Dissanayake,Kurunegala,Dambulla,North Western,6799,3629,10428,271960,145160,417120
3/11/2025,Subodhani Dissanayake,Kurunegala,Dambulla,North Western,9592,805,10397,383680,32200,415880
3/12/2025,Subodhani Dissanayake,Kurunegala,Dambulla,North Western,9914,7118,17032,396560,284720,681280
3/13/2025,Subodhani Dissanayake,Kurunegala,Dambulla,North Western,7262,1975,9237,290480,79000,369480
3/14/2025,Subodhani Dissanayake,Kurunegala,Dambulla,North Western,4090,1532,5622,163600,61280,224880
3/15/2025,Subodhani Dissanayake,Kurunegala,Dambulla,North Western,4967,1972,6939,198680,78880,277560
3/16/2025,Subodhani Dissanayake,Kurunegala,Dambulla,North Western,3138,8504,11642,125520,340160,465680
3/17/2025,Subodhani Dissanayake,Kurunegala,Dambulla,North Western,3176,1208,4384,127040,48320,175360
3/18/2025,Subodhani Dissanayake,Kurunegala,Dambulla,North Western,7182,3702,10884,287280,148080,435360
3/19/2025,Subodhani Dissanayake,Kurunegala,Dambulla,North Western,2755,6972,9727,110200,278880,389080
3/20/2025,Subodhani Dissanayake,Kurunegala,Dambulla,North Western,9093,7792,16885,363720,311680,675400
3/21/2025,Subodhani Dissanayake,Kurunegala,Dambulla,North Western,6813,8989,15802,272520,359560,632080
3/22/2025,Subodhani Dissanayake,Kurunegala,Dambulla,North Western,5276,7340,12616,211040,293600,504640
3/23/2025,Subodhani Dissanayake,Kurunegala,Dambulla,North Western,5984,5364,11348,239360,214560,453920
3/25/2024,Kaveesha Rathnayake,Galle,Hikkaduwa,Southern,9306,8905,18211,372240,356200,728440
3/26/2024,Kaveesha Rathnayake,Galle,Hikkaduwa,Southern,9838,2238,12076,393520,89520,483040
3/27/2024,Kaveesha Rathnayake,Galle,Hikkaduwa,Southern,4600,5448,10048,184000,217920,401920
3/28/2024,Kaveesha Rathnayake,Galle,Hikkaduwa,Southern,1402,8421,9823,56080,336840,392920
3/29/2024,Kaveesha Rathnayake,Galle,Hikkaduwa,Southern,5630,6295,11925,225200,251800,477000
3/30/2024,Kaveesha Rathnayake,Galle,Hikkaduwa,Southern,9610,3494,13104,384400,139760,524160
3/31/2024,Kaveesha Rathnayake,Galle,Hikkaduwa,Southern,864,939,1803,34560,37560,72120
4/1/2024,Kaveesha Rathnayake,Galle,Hikkaduwa,Southern,3169,3123,6292,126760,124920,251680
4/2/2024,Kaveesha Rathnayake,Galle,Hikkaduwa,Southern,6507,211,6718,260280,8440,268720
4/3/2024,Kaveesha Rathnayake,Galle,Hikkaduwa,Southern,2577,8150,10727,103080,326000,429080
4/4/2024,Kaveesha Rathnayake,Galle,Hikkaduwa,Southern,9092,3416,12508,363680,136640,500320
4/5/2024,Kaveesha Rathnayake,Galle,Hikkaduwa,Southern,8297,613,8910,331880,24520,356400
4/6/2024,Kaveesha Rathnayake,Galle,Hikkaduwa,Southern,6312,5631,11943,252480,225240,477720
4/7/2024,Kaveesha Rathnayake,Galle,Hikkaduwa,Southern,3155,191,3346,126200,7640,133840
4/8/2024,Kaveesha Rathnayake,Galle,Hikkaduwa,Southern,5774,6882,12656,230960,275280,506240
4/9/2024,Kaveesha Rathnayake,Galle,Hikkaduwa,Southern,6377,8450,14827,255080,338000,593080
4/10/2024,Kaveesha Rathnayake,Galle,Hikkaduwa,Southern,3462,2243,5705,138480,89720,228200
4/11/2024,Kaveesha Rathnayake,Galle,Hikkaduwa,Southern,7474,6391,13865,298960,255640,554600
4/19/2024,Kaveesha Rathnayake,Galle,Hikkaduwa,Southern,7449,8537,15986,297960,341480,639440
4/20/2024,Kaveesha Rathnayake,Galle,Hikkaduwa,Southern,1464,9387,10851,58560,375480,434040
4/21/2024,Kaveesha Rathnayake,Galle,Hikkaduwa,Southern,2589,6719,9308,103560,268760,372320
4/22/2024,Kaveesha Rathnayake,Galle,Hikkaduwa,Southern,8291,8205,16496,331640,328200,659840
4/23/2024,Kaveesha Rathnayake,Galle,Hikkaduwa,Southern,8073,8888,16961,322920,355520,678440
4/24/2024,Kaveesha Rathnayake,Galle,Hikkaduwa,Southern,8145,8472,16617,325800,338880,664680
4/25/2024,Kaveesha Rathnayake,Galle,Hikkaduwa,Southern,8394,3598,11992,335760,143920,479680
4/26/2024,Kaveesha Rathnayake,Galle,Hikkaduwa,Southern,2862,2969,5831,114480,118760,233240
4/27/2024,Kaveesha Rathnayake,Galle,Hikkaduwa,Southern,7236,2605,9841,289440,104200,393640
4/28/2024,Kaveesha Rathnayake,Galle,Hikkaduwa,Southern,5996,3722,9718,239840,148880,388720
4/29/2024,Kaveesha Rathnayake,Galle,Hikkaduwa,Southern,8570,5072,13642,342800,202880,545680
4/30/2024,Kaveesha Rathnayake,Galle,Hikkaduwa,Southern,7878,7261,15139,315120,290440,605560
5/1/2024,Kaveesha Rathnayake,Galle,Hikkaduwa,Southern,5135,719,5854,205400,28760,234160
5/2/2024,Kaveesha Rathnayake,Galle,Hikkaduwa,Southern,6096,5738,11834,243840,229520,473360
5/3/2024,Kaveesha Rathnayake,Galle,Hikkaduwa,Southern,383,5686,6069,15320,227440,242760
5/4/2024,Kaveesha Rathnayake,Galle,Hikkaduwa,Southern,4118,119,4237,164720,4760,169480
5/5/2024,Kaveesha Rathnayake,Galle,Hikkaduwa,Southern,3556,232,3788,142240,9280,151520
5/6/2024,Kaveesha Rathnayake,Galle,Hikkaduwa,Southern,4365,2192,6557,174600,87680,262280
5/7/2024,Kaveesha Rathnayake,Galle,Hikkaduwa,Southern,1155,7891,9046,46200,315640,361840
5/8/2024,Kaveesha Rathnayake,Galle,Hikkaduwa,Southern,1089,5136,6225,43560,205440,249000
5/9/2024,Kaveesha Rathnayake,Galle,Hikkaduwa,Southern,1702,7906,9608,68080,316240,384320
5/10/2024,Kaveesha Rathnayake,Galle,Hikkaduwa,Southern,6931,457,7388,277240,18280,295520
5/11/2024,Kaveesha Rathnayake,Galle,Hikkaduwa,Southern,9855,3686,13541,394200,147440,541640
5/12/2024,Kaveesha Rathnayake,Galle,Hikkaduwa,Southern,5048,4128,9176,201920,165120,367040
5/13/2024,Kaveesha Rathnayake,Galle,Hikkaduwa,Southern,7075,2442,9517,283000,97680,380680
5/14/2024,Kaveesha Rathnayake,Galle,Hikkaduwa,Southern,772,4688,5460,30880,187520,218400
5/15/2024,Kaveesha Rathnayake,Galle,Hikkaduwa,Southern,2912,3842,6754,116480,153680,270160
5/16/2024,Kaveesha Rathnayake,Galle,Hikkaduwa,Southern,9445,6766,16211,377800,270640,648440
5/17/2024,Kaveesha Rathnayake,Galle,Hikkaduwa,Southern,6110,2904,9014,244400,116160,360560
5/18/2024,Kaveesha Rathnayake,Galle,Hikkaduwa,Southern,2545,4688,7233,101800,187520,289320
5/19/2024,Kaveesha Rathnayake,Galle,Hikkaduwa,Southern,4080,7271,11351,163200,290840,454040
5/20/2024,Kaveesha Rathnayake,Galle,Hikkaduwa,Southern,3696,3904,7600,147840,156160,304000
5/21/2024,Kaveesha Rathnayake,Galle,Hikkaduwa,Southern,7007,5327,12334,280280,213080,493360
5/22/2024,Kaveesha Rathnayake,Galle,Hikkaduwa,Southern,8756,6644,15400,350240,265760,616000
5/24/2024,Kaveesha Rathnayake,Galle,Hikkaduwa,Southern,7415,203,7618,296600,8120,304720
5/25/2024,Kaveesha Rathnayake,Galle,Hikkaduwa,Southern,3444,5925,9369,137760,237000,374760
5/26/2024,Kaveesha Rathnayake,Galle,Hikkaduwa,Southern,5009,7528,12537,200360,301120,501480
5/27/2024,Kaveesha Rathnayake,Galle,Hikkaduwa,Southern,5293,1744,7037,211720,69760,281480
5/28/2024,Kaveesha Rathnayake,Galle,Hikkaduwa,Southern,821,8834,9655,32840,353360,386200
5/29/2024,Kaveesha Rathnayake,Galle,Hikkaduwa,Southern,8226,5038,13264,329040,201520,530560
5/30/2024,Kaveesha Rathnayake,Galle,Hikkaduwa,Southern,4471,775,5246,178840,31000,209840
5/31/2024,Kaveesha Rathnayake,Galle,Hikkaduwa,Southern,9551,2574,12125,382040,102960,485000
6/1/2024,Kaveesha Rathnayake,Galle,Hikkaduwa,Southern,8067,2636,10703,322680,105440,428120
6/2/2024,Kaveesha Rathnayake,Galle,Hikkaduwa,Southern,900,3715,4615,36000,148600,184600
6/3/2024,Kaveesha Rathnayake,Galle,Hikkaduwa,Southern,8017,9161,17178,320680,366440,687120
6/4/2024,Kaveesha Rathnayake,Galle,Hikkaduwa,Southern,133,5767,5900,5320,230680,236000
6/5/2024,Kaveesha Rathnayake,Galle,Hikkaduwa,Southern,3239,8035,11274,129560,321400,450960
6/6/2024,Kaveesha Rathnayake,Galle,Hikkaduwa,Southern,3584,1856,5440,143360,74240,217600
6/7/2024,Kaveesha Rathnayake,Galle,Hikkaduwa,Southern,8748,2072,10820,349920,82880,432800
6/8/2024,Kaveesha Rathnayake,Galle,Hikkaduwa,Southern,5293,4757,10050,211720,190280,402000
6/9/2024,Kaveesha Rathnayake,Galle,Hikkaduwa,Southern,8984,1717,10701,359360,68680,428040
6/10/2024,Kaveesha Rathnayake,Galle,Hikkaduwa,Southern,8976,8853,17829,359040,354120,713160
6/11/2024,Kaveesha Rathnayake,Galle,Hikkaduwa,Southern,6217,751,6968,248680,30040,278720
6/12/2024,Kaveesha Rathnayake,Galle,Hikkaduwa,Southern,366,5752,6118,14640,230080,244720
6/13/2024,Kaveesha Rathnayake,Galle,Hikkaduwa,Southern,6675,214,6889,267000,8560,275560
6/14/2024,Kaveesha Rathnayake,Galle,Hikkaduwa,Southern,7636,7402,15038,305440,296080,601520
6/15/2024,Kaveesha Rathnayake,Galle,Hikkaduwa,Southern,1107,6768,7875,44280,270720,315000
6/16/2024,Kaveesha Rathnayake,Galle,Hikkaduwa,Southern,8046,5760,13806,321840,230400,552240
6/17/2024,Kaveesha Rathnayake,Galle,Hikkaduwa,Southern,3455,8876,12331,138200,355040,493240
6/18/2024,Kaveesha Rathnayake,Galle,Hikkaduwa,Southern,5449,7351,12800,217960,294040,512000
6/19/2024,Kaveesha Rathnayake,Galle,Hikkaduwa,Southern,2506,2113,4619,100240,84520,184760
6/20/2024,Kaveesha Rathnayake,Galle,Hikkaduwa,Southern,1480,5080,6560,59200,203200,262400
6/21/2024,Kaveesha Rathnayake,Galle,Hikkaduwa,Southern,1715,4068,5783,68600,162720,231320
6/22/2024,Kaveesha Rathnayake,Galle,Hikkaduwa,Southern,3630,5123,8753,145200,204920,350120
6/23/2024,Kaveesha Rathnayake,Galle,Hikkaduwa,Southern,3967,9698,13665,158680,387920,546600
6/24/2024,Kaveesha Rathnayake,Galle,Hikkaduwa,Southern,4373,684,5057,174920,27360,202280
6/25/2024,Kaveesha Rathnayake,Galle,Hikkaduwa,Southern,6261,1010,7271,250440,40400,290840
6/26/2024,Kaveesha Rathnayake,Galle,Hikkaduwa,Southern,7433,6195,13628,297320,247800,545120
6/27/2024,Kaveesha Rathnayake,Galle,Hikkaduwa,Southern,4555,7092,11647,182200,283680,465880
6/28/2024,Kaveesha Rathnayake,Galle,Hikkaduwa,Southern,3391,4061,7452,135640,162440,298080
6/29/2024,Kaveesha Rathnayake,Galle,Hikkaduwa,Southern,3788,8037,11825,151520,321480,473000
6/30/2024,Kaveesha Rathnayake,Galle,Hikkaduwa,Southern,193,4900,5093,7720,196000,203720
7/1/2024,Kaveesha Rathnayake,Galle,Hikkaduwa,Southern,3335,3837,7172,133400,153480,286880
7/2/2024,Kaveesha Rathnayake,Galle,Hikkaduwa,Southern,3690,2099,5789,147600,83960,231560
7/3/2024,Kaveesha Rathnayake,Galle,Hikkaduwa,Southern,8696,838,9534,347840,33520,381360
7/4/2024,Kaveesha Rathnayake,Galle,Hikkaduwa,Southern,1815,4731,6546,72600,189240,261840
7/5/2024,Kaveesha Rathnayake,Galle,Hikkaduwa,Southern,2476,8549,11025,99040,341960,441000
7/6/2024,Kaveesha Rathnayake,Galle,Hikkaduwa,Southern,9572,4433,14005,382880,177320,560200
7/7/2024,Kaveesha Rathnayake,Galle,Hikkaduwa,Southern,2700,375,3075,108000,15000,123000
7/8/2024,Kaveesha Rathnayake,Galle,Hikkaduwa,Southern,6551,4831,11382,262040,193240,455280
7/9/2024,Kaveesha Rathnayake,Galle,Hikkaduwa,Southern,2062,7663,9725,82480,306520,389000
7/10/2024,Kaveesha Rathnayake,Galle,Hikkaduwa,Southern,9405,1869,11274,376200,74760,450960
7/11/2024,Kaveesha Rathnayake,Galle,Hikkaduwa,Southern,1024,3031,4055,40960,121240,162200
7/12/2024,Kaveesha Rathnayake,Galle,Hikkaduwa,Southern,7689,706,8395,307560,28240,335800
7/13/2024,Kaveesha Rathnayake,Galle,Hikkaduwa,Southern,1885,5647,7532,75400,225880,301280
7/14/2024,Kaveesha Rathnayake,Galle,Hikkaduwa,Southern,8984,2939,11923,359360,117560,476920
7/15/2024,Kaveesha Rathnayake,Galle,Hikkaduwa,Southern,1731,9146,10877,69240,365840,435080
7/16/2024,Kaveesha Rathnayake,Galle,Hikkaduwa,Southern,1544,3359,4903,61760,134360,196120
7/17/2024,Kaveesha Rathnayake,Galle,Hikkaduwa,Southern,3935,4173,8108,157400,166920,324320
7/18/2024,Kaveesha Rathnayake,Galle,Hikkaduwa,Southern,8536,6797,15333,341440,271880,613320
7/19/2024,Kaveesha Rathnayake,Galle,Hikkaduwa,Southern,6062,1125,7187,242480,45000,287480
7/20/2024,Kaveesha Rathnayake,Galle,Hikkaduwa,Southern,3999,5678,9677,159960,227120,387080
7/21/2024,Kaveesha Rathnayake,Galle,Hikkaduwa,Southern,9525,4111,13636,381000,164440,545440
7/22/2024,Kaveesha Rathnayake,Galle,Hikkaduwa,Southern,6560,2705,9265,262400,108200,370600
7/23/2024,Kaveesha Rathnayake,Galle,Hikkaduwa,Southern,9074,9175,18249,362960,367000,729960
7/24/2024,Kaveesha Rathnayake,Galle,Hikkaduwa,Southern,9441,5836,15277,377640,233440,611080
7/25/2024,Kaveesha Rathnayake,Galle,Hikkaduwa,Southern,7342,8661,16003,293680,346440,640120
7/26/2024,Kaveesha Rathnayake,Galle,Hikkaduwa,Southern,2213,1923,4136,88520,76920,165440
7/27/2024,Kaveesha Rathnayake,Galle,Hikkaduwa,Southern,2543,7194,9737,101720,287760,389480
7/28/2024,Kaveesha Rathnayake,Galle,Hikkaduwa,Southern,6059,5894,11953,242360,235760,478120
7/29/2024,Kaveesha Rathnayake,Galle,Hikkaduwa,Southern,7497,1520,9017,299880,60800,360680
7/30/2024,Kaveesha Rathnayake,Galle,Hikkaduwa,Southern,278,3845,4123,11120,153800,164920
7/31/2024,Kaveesha Rathnayake,Galle,Hikkaduwa,Southern,8513,4016,12529,340520,160640,501160
8/1/2024,Kaveesha Rathnayake,Galle,Hikkaduwa,Southern,7839,2803,10642,313560,112120,425680
8/2/2024,Kaveesha Rathnayake,Galle,Hikkaduwa,Southern,699,7026,7725,27960,281040,309000
8/3/2024,Kaveesha Rathnayake,Galle,Hikkaduwa,Southern,4273,6208,10481,170920,248320,419240
8/4/2024,Kaveesha Rathnayake,Galle,Hikkaduwa,Southern,254,3324,3578,10160,132960,143120
8/5/2024,Kaveesha Rathnayake,Galle,Hikkaduwa,Southern,7481,5574,13055,299240,222960,522200
8/6/2024,Kaveesha Rathnayake,Galle,Hikkaduwa,Southern,3471,9091,12562,138840,363640,502480
8/7/2024,Kaveesha Rathnayake,Galle,Hikkaduwa,Southern,8595,8770,17365,343800,350800,694600
8/8/2024,Kaveesha Rathnayake,Galle,Hikkaduwa,Southern,5889,3539,9428,235560,141560,377120
8/9/2024,Kaveesha Rathnayake,Galle,Hikkaduwa,Southern,2998,7698,10696,119920,307920,427840
8/10/2024,Kaveesha Rathnayake,Galle,Hikkaduwa,Southern,9571,9966,19537,382840,398640,781480
8/11/2024,Kaveesha Rathnayake,Galle,Hikkaduwa,Southern,2517,5799,8316,100680,231960,332640
8/12/2024,Kaveesha Rathnayake,Galle,Hikkaduwa,Southern,7742,2155,9897,309680,86200,395880
8/13/2024,Kaveesha Rathnayake,Galle,Hikkaduwa,Southern,4647,9053,13700,185880,362120,548000
8/14/2024,Kaveesha Rathnayake,Galle,Hikkaduwa,Southern,8357,1078,9435,334280,43120,377400
8/15/2024,Kaveesha Rathnayake,Galle,Hikkaduwa,Southern,7483,6134,13617,299320,245360,544680
8/16/2024,Kaveesha Rathnayake,Galle,Hikkaduwa,Southern,1791,7044,8835,71640,281760,353400
8/17/2024,Kaveesha Rathnayake,Galle,Hikkaduwa,Southern,3459,512,3971,138360,20480,158840
8/18/2024,Kaveesha Rathnayake,Galle,Hikkaduwa,Southern,8201,226,8427,328040,9040,337080
8/19/2024,Kaveesha Rathnayake,Galle,Hikkaduwa,Southern,2859,6347,9206,114360,253880,368240
8/20/2024,Kaveesha Rathnayake,Galle,Hikkaduwa,Southern,1260,5990,7250,50400,239600,290000
8/21/2024,Kaveesha Rathnayake,Galle,Hikkaduwa,Southern,9037,1962,10999,361480,78480,439960
8/22/2024,Kaveesha Rathnayake,Galle,Hikkaduwa,Southern,3993,7891,11884,159720,315640,475360
8/23/2024,Kaveesha Rathnayake,Galle,Hikkaduwa,Southern,4578,8605,13183,183120,344200,527320
8/24/2024,Kaveesha Rathnayake,Galle,Hikkaduwa,Southern,2175,3624,5799,87000,144960,231960
8/25/2024,Kaveesha Rathnayake,Galle,Hikkaduwa,Southern,1520,5446,6966,60800,217840,278640
8/26/2024,Kaveesha Rathnayake,Galle,Hikkaduwa,Southern,6176,4871,11047,247040,194840,441880
8/27/2024,Kaveesha Rathnayake,Galle,Hikkaduwa,Southern,2992,2910,5902,119680,116400,236080
8/28/2024,Kaveesha Rathnayake,Galle,Hikkaduwa,Southern,7070,7176,14246,282800,287040,569840
8/29/2024,Kaveesha Rathnayake,Galle,Hikkaduwa,Southern,6745,2853,9598,269800,114120,383920
8/30/2024,Kaveesha Rathnayake,Galle,Hikkaduwa,Southern,3181,6694,9875,127240,267760,395000
8/31/2024,Kaveesha Rathnayake,Galle,Hikkaduwa,Southern,2247,9457,11704,89880,378280,468160
9/1/2024,Kaveesha Rathnayake,Galle,Hikkaduwa,Southern,1806,5050,6856,72240,202000,274240
9/2/2024,Kaveesha Rathnayake,Galle,Hikkaduwa,Southern,2939,9625,12564,117560,385000,502560
9/3/2024,Kaveesha Rathnayake,Galle,Hikkaduwa,Southern,6368,3010,9378,254720,120400,375120
9/4/2024,Kaveesha Rathnayake,Galle,Hikkaduwa,Southern,3174,2882,6056,126960,115280,242240
9/5/2024,Kaveesha Rathnayake,Galle,Hikkaduwa,Southern,8748,6813,15561,349920,272520,622440
9/6/2024,Kaveesha Rathnayake,Galle,Hikkaduwa,Southern,6759,7488,14247,270360,299520,569880
9/7/2024,Kaveesha Rathnayake,Galle,Hikkaduwa,Southern,9895,3943,13838,395800,157720,553520
9/8/2024,Kaveesha Rathnayake,Galle,Hikkaduwa,Southern,6417,6367,12784,256680,254680,511360
9/9/2024,Kaveesha Rathnayake,Galle,Hikkaduwa,Southern,1555,4,1559,62200,160,62360
9/10/2024,Kaveesha Rathnayake,Galle,Hikkaduwa,Southern,9347,3362,12709,373880,134480,508360
9/11/2024,Kaveesha Rathnayake,Galle,Hikkaduwa,Southern,2059,4078,6137,82360,163120,245480
9/12/2024,Kaveesha Rathnayake,Galle,Hikkaduwa,Southern,3324,3772,7096,132960,150880,283840
9/13/2024,Kaveesha Rathnayake,Galle,Hikkaduwa,Southern,203,7949,8152,8120,317960,326080
9/14/2024,Kaveesha Rathnayake,Galle,Hikkaduwa,Southern,5422,6838,12260,216880,273520,490400
9/15/2024,Kaveesha Rathnayake,Galle,Hikkaduwa,Southern,1946,5167,7113,77840,206680,284520
9/16/2024,Kaveesha Rathnayake,Galle,Hikkaduwa,Southern,6912,2620,9532,276480,104800,381280
9/17/2024,Kaveesha Rathnayake,Galle,Hikkaduwa,Southern,3065,6813,9878,122600,272520,395120
9/18/2024,Kaveesha Rathnayake,Galle,Hikkaduwa,Southern,8948,1014,9962,357920,40560,398480
9/19/2024,Kaveesha Rathnayake,Galle,Hikkaduwa,Southern,1540,7641,9181,61600,305640,367240
9/20/2024,Kaveesha Rathnayake,Galle,Hikkaduwa,Southern,5595,615,6210,223800,24600,248400
9/21/2024,Kaveesha Rathnayake,Galle,Hikkaduwa,Southern,3031,3179,6210,121240,127160,248400
9/22/2024,Kaveesha Rathnayake,Galle,Hikkaduwa,Southern,4282,5273,9555,171280,210920,382200
9/23/2024,Kaveesha Rathnayake,Galle,Hikkaduwa,Southern,7857,6505,14362,314280,260200,574480
9/24/2024,Kaveesha Rathnayake,Galle,Hikkaduwa,Southern,496,9547,10043,19840,381880,401720
9/25/2024,Kaveesha Rathnayake,Galle,Hikkaduwa,Southern,4506,3234,7740,180240,129360,309600
9/26/2024,Kaveesha Rathnayake,Galle,Hikkaduwa,Southern,9973,2692,12665,398920,107680,506600
9/27/2024,Kaveesha Rathnayake,Galle,Hikkaduwa,Southern,1927,9053,10980,77080,362120,439200
9/28/2024,Kaveesha Rathnayake,Galle,Hikkaduwa,Southern,5998,7607,13605,239920,304280,544200
9/29/2024,Kaveesha Rathnayake,Galle,Hikkaduwa,Southern,219,8715,8934,8760,348600,357360
9/30/2024,Kaveesha Rathnayake,Galle,Hikkaduwa,Southern,7796,1669,9465,311840,66760,378600
10/1/2024,Kaveesha Rathnayake,Galle,Hikkaduwa,Southern,4368,4849,9217,174720,193960,368680
10/2/2024,Kaveesha Rathnayake,Galle,Hikkaduwa,Southern,6659,9975,16634,266360,399000,665360
10/3/2024,Kaveesha Rathnayake,Galle,Hikkaduwa,Southern,2816,5400,8216,112640,216000,328640
10/4/2024,Kaveesha Rathnayake,Galle,Hikkaduwa,Southern,5174,9664,14838,206960,386560,593520
10/5/2024,Kaveesha Rathnayake,Galle,Hikkaduwa,Southern,887,1002,1889,35480,40080,75560
10/6/2024,Kaveesha Rathnayake,Galle,Hikkaduwa,Southern,6402,8258,14660,256080,330320,586400
10/7/2024,Kaveesha Rathnayake,Galle,Hikkaduwa,Southern,4473,6136,10609,178920,245440,424360
10/8/2024,Kaveesha Rathnayake,Galle,Hikkaduwa,Southern,5817,6732,12549,232680,269280,501960
10/9/2024,Kaveesha Rathnayake,Galle,Hikkaduwa,Southern,3451,3337,6788,138040,133480,271520
10/10/2024,Kaveesha Rathnayake,Galle,Hikkaduwa,Southern,8408,2749,11157,336320,109960,446280
10/11/2024,Kaveesha Rathnayake,Galle,Hikkaduwa,Southern,946,4166,5112,37840,166640,204480
10/12/2024,Kaveesha Rathnayake,Galle,Hikkaduwa,Southern,7466,1912,9378,298640,76480,375120
10/13/2024,Kaveesha Rathnayake,Galle,Hikkaduwa,Southern,5975,5108,11083,239000,204320,443320
10/14/2024,Kaveesha Rathnayake,Galle,Hikkaduwa,Southern,4338,7714,12052,173520,308560,482080
10/15/2024,Kaveesha Rathnayake,Galle,Hikkaduwa,Southern,5433,8719,14152,217320,348760,566080
10/16/2024,Kaveesha Rathnayake,Galle,Hikkaduwa,Southern,6261,6263,12524,250440,250520,500960
10/17/2024,Kaveesha Rathnayake,Galle,Hikkaduwa,Southern,8231,9545,17776,329240,381800,711040
10/18/2024,Kaveesha Rathnayake,Galle,Hikkaduwa,Southern,5530,2903,8433,221200,116120,337320
10/19/2024,Kaveesha Rathnayake,Galle,Hikkaduwa,Southern,1660,1159,2819,66400,46360,112760
10/20/2024,Kaveesha Rathnayake,Galle,Hikkaduwa,Southern,6391,3790,10181,255640,151600,407240
10/21/2024,Kaveesha Rathnayake,Galle,Hikkaduwa,Southern,576,8027,8603,23040,321080,344120
10/22/2024,Kaveesha Rathnayake,Galle,Hikkaduwa,Southern,1265,1729,2994,50600,69160,119760
10/23/2024,Kaveesha Rathnayake,Galle,Hikkaduwa,Southern,1347,3867,5214,53880,154680,208560
10/24/2024,Kaveesha Rathnayake,Galle,Hikkaduwa,Southern,1382,6305,7687,55280,252200,307480
10/25/2024,Kaveesha Rathnayake,Galle,Hikkaduwa,Southern,860,7413,8273,34400,296520,330920
10/26/2024,Kaveesha Rathnayake,Galle,Hikkaduwa,Southern,4389,1011,5400,175560,40440,216000
10/27/2024,Kaveesha Rathnayake,Galle,Hikkaduwa,Southern,163,3732,3895,6520,149280,155800
10/28/2024,Kaveesha Rathnayake,Galle,Hikkaduwa,Southern,1039,4429,5468,41560,177160,218720
10/29/2024,Kaveesha Rathnayake,Galle,Hikkaduwa,Southern,3398,4585,7983,135920,183400,319320
10/30/2024,Kaveesha Rathnayake,Galle,Hikkaduwa,Southern,8912,7414,16326,356480,296560,653040
10/31/2024,Kaveesha Rathnayake,Galle,Hikkaduwa,Southern,7685,7192,14877,307400,287680,595080
11/1/2024,Kaveesha Rathnayake,Galle,Hikkaduwa,Southern,6745,8878,15623,269800,355120,624920
11/2/2024,Kaveesha Rathnayake,Galle,Hikkaduwa,Southern,7151,5648,12799,286040,225920,511960
11/3/2024,Kaveesha Rathnayake,Galle,Hikkaduwa,Southern,1845,4772,6617,73800,190880,264680
11/4/2024,Kaveesha Rathnayake,Galle,Hikkaduwa,Southern,5385,8534,13919,215400,341360,556760
11/5/2024,Kaveesha Rathnayake,Galle,Hikkaduwa,Southern,737,487,1224,29480,19480,48960
11/6/2024,Kaveesha Rathnayake,Galle,Hikkaduwa,Southern,7279,6903,14182,291160,276120,567280
11/7/2024,Kaveesha Rathnayake,Galle,Hikkaduwa,Southern,3842,9149,12991,153680,365960,519640
11/8/2024,Kaveesha Rathnayake,Galle,Hikkaduwa,Southern,7129,7478,14607,285160,299120,584280
11/9/2024,Kaveesha Rathnayake,Galle,Hikkaduwa,Southern,5603,7912,13515,224120,316480,540600
11/10/2024,Kaveesha Rathnayake,Galle,Hikkaduwa,Southern,9745,1595,11340,389800,63800,453600
11/11/2024,Kaveesha Rathnayake,Galle,Hikkaduwa,Southern,7190,4199,11389,287600,167960,455560
11/12/2024,Kaveesha Rathnayake,Galle,Hikkaduwa,Southern,7123,2471,9594,284920,98840,383760
11/13/2024,Kaveesha Rathnayake,Galle,Hikkaduwa,Southern,9540,7391,16931,381600,295640,677240
11/14/2024,Kaveesha Rathnayake,Galle,Hikkaduwa,Southern,7665,6245,13910,306600,249800,556400
11/15/2024,Kaveesha Rathnayake,Galle,Hikkaduwa,Southern,3621,8152,11773,144840,326080,470920
11/16/2024,Kaveesha Rathnayake,Galle,Hikkaduwa,Southern,6606,6843,13449,264240,273720,537960
11/17/2024,Kaveesha Rathnayake,Galle,Hikkaduwa,Southern,2938,4425,7363,117520,177000,294520
11/18/2024,Kaveesha Rathnayake,Galle,Hikkaduwa,Southern,1804,2993,4797,72160,119720,191880
11/19/2024,Kaveesha Rathnayake,Galle,Hikkaduwa,Southern,4029,9292,13321,161160,371680,532840
11/20/2024,Kaveesha Rathnayake,Galle,Hikkaduwa,Southern,9507,4001,13508,380280,160040,540320
11/21/2024,Kaveesha Rathnayake,Galle,Hikkaduwa,Southern,6338,9055,15393,253520,362200,615720
11/22/2024,Kaveesha Rathnayake,Galle,Hikkaduwa,Southern,2767,803,3570,110680,32120,142800
11/23/2024,Kaveesha Rathnayake,Galle,Hikkaduwa,Southern,8935,7174,16109,357400,286960,644360
11/24/2024,Kaveesha Rathnayake,Galle,Hikkaduwa,Southern,5985,8089,14074,239400,323560,562960
11/25/2024,Kaveesha Rathnayake,Galle,Hikkaduwa,Southern,9449,1064,10513,377960,42560,420520
11/26/2024,Kaveesha Rathnayake,Galle,Hikkaduwa,Southern,5738,8639,14377,229520,345560,575080
11/27/2024,Kaveesha Rathnayake,Galle,Hikkaduwa,Southern,2453,2788,5241,98120,111520,209640
11/28/2024,Kaveesha Rathnayake,Galle,Hikkaduwa,Southern,2673,5069,7742,106920,202760,309680
11/29/2024,Kaveesha Rathnayake,Galle,Hikkaduwa,Southern,4623,9499,14122,184920,379960,564880
11/30/2024,Kaveesha Rathnayake,Galle,Hikkaduwa,Southern,3456,7585,11041,138240,303400,441640
12/1/2024,Kaveesha Rathnayake,Galle,Hikkaduwa,Southern,1616,1336,2952,64640,53440,118080
12/2/2024,Kaveesha Rathnayake,Galle,Hikkaduwa,Southern,9945,3749,13694,397800,149960,547760
12/3/2024,Kaveesha Rathnayake,Galle,Hikkaduwa,Southern,66,7578,7644,2640,303120,305760
12/4/2024,Kaveesha Rathnayake,Galle,Hikkaduwa,Southern,5905,5549,11454,236200,221960,458160
12/5/2024,Kaveesha Rathnayake,Galle,Hikkaduwa,Southern,854,3818,4672,34160,152720,186880
12/6/2024,Kaveesha Rathnayake,Galle,Hikkaduwa,Southern,8391,8543,16934,335640,341720,677360
12/7/2024,Kaveesha Rathnayake,Galle,Hikkaduwa,Southern,7495,7312,14807,299800,292480,592280
12/8/2024,Kaveesha Rathnayake,Galle,Hikkaduwa,Southern,816,3100,3916,32640,124000,156640
12/9/2024,Kaveesha Rathnayake,Galle,Hikkaduwa,Southern,9946,5180,15126,397840,207200,605040
12/10/2024,Kaveesha Rathnayake,Galle,Hikkaduwa,Southern,4198,3643,7841,167920,145720,313640
12/11/2024,Kaveesha Rathnayake,Galle,Hikkaduwa,Southern,8527,643,9170,341080,25720,366800
12/12/2024,Kaveesha Rathnayake,Galle,Hikkaduwa,Southern,4542,4902,9444,181680,196080,377760
12/13/2024,Kaveesha Rathnayake,Galle,Hikkaduwa,Southern,846,1640,2486,33840,65600,99440
12/14/2024,Kaveesha Rathnayake,Galle,Hikkaduwa,Southern,187,4001,4188,7480,160040,167520
12/15/2024,Kaveesha Rathnayake,Galle,Hikkaduwa,Southern,8212,1247,9459,328480,49880,378360
12/16/2024,Kaveesha Rathnayake,Galle,Hikkaduwa,Southern,3184,8817,12001,127360,352680,480040
12/17/2024,Kaveesha Rathnayake,Galle,Hikkaduwa,Southern,4297,8593,12890,171880,343720,515600
12/18/2024,Kaveesha Rathnayake,Galle,Hikkaduwa,Southern,867,4183,5050,34680,167320,202000
12/19/2024,Kaveesha Rathnayake,Galle,Hikkaduwa,Southern,9197,1666,10863,367880,66640,434520
12/20/2024,Kaveesha Rathnayake,Galle,Hikkaduwa,Southern,4849,280,5129,193960,11200,205160
12/21/2024,Kaveesha Rathnayake,Galle,Hikkaduwa,Southern,3447,4691,8138,137880,187640,325520
12/22/2024,Kaveesha Rathnayake,Galle,Hikkaduwa,Southern,7017,4187,11204,280680,167480,448160
12/23/2024,Kaveesha Rathnayake,Galle,Hikkaduwa,Southern,6879,8636,15515,275160,345440,620600
12/24/2024,Kaveesha Rathnayake,Galle,Hikkaduwa,Southern,7434,3072,10506,297360,122880,420240
12/25/2024,Kaveesha Rathnayake,Galle,Hikkaduwa,Southern,3242,8438,11680,129680,337520,467200
12/26/2024,Kaveesha Rathnayake,Galle,Hikkaduwa,Southern,1267,6810,8077,50680,272400,323080
12/27/2024,Kaveesha Rathnayake,Galle,Hikkaduwa,Southern,9223,4608,13831,368920,184320,553240
12/28/2024,Kaveesha Rathnayake,Galle,Hikkaduwa,Southern,5748,686,6434,229920,27440,257360
12/29/2024,Kaveesha Rathnayake,Galle,Hikkaduwa,Southern,2024,1191,3215,80960,47640,128600
12/30/2024,Kaveesha Rathnayake,Galle,Hikkaduwa,Southern,787,3384,4171,31480,135360,166840
12/31/2024,Kaveesha Rathnayake,Galle,Hikkaduwa,Southern,5874,4935,10809,234960,197400,432360
1/1/2025,Kaveesha Rathnayake,Galle,Hikkaduwa,Southern,4721,4679,9400,188840,187160,376000
1/2/2025,Kaveesha Rathnayake,Galle,Hikkaduwa,Southern,6770,3299,10069,270800,131960,402760
1/3/2025,Kaveesha Rathnayake,Galle,Hikkaduwa,Southern,7052,1574,8626,282080,62960,345040
1/4/2025,Kaveesha Rathnayake,Galle,Hikkaduwa,Southern,2569,6200,8769,102760,248000,350760
1/5/2025,Kaveesha Rathnayake,Galle,Hikkaduwa,Southern,8638,9194,17832,345520,367760,713280
1/6/2025,Kaveesha Rathnayake,Galle,Hikkaduwa,Southern,9057,4556,13613,362280,182240,544520
1/7/2025,Kaveesha Rathnayake,Galle,Hikkaduwa,Southern,999,3961,4960,39960,158440,198400
1/8/2025,Kaveesha Rathnayake,Galle,Hikkaduwa,Southern,2732,9198,11930,109280,367920,477200
1/9/2025,Kaveesha Rathnayake,Galle,Hikkaduwa,Southern,7308,1713,9021,292320,68520,360840
1/10/2025,Kaveesha Rathnayake,Galle,Hikkaduwa,Southern,5511,5930,11441,220440,237200,457640
1/11/2025,Kaveesha Rathnayake,Galle,Hikkaduwa,Southern,3263,9731,12994,130520,389240,519760
1/12/2025,Kaveesha Rathnayake,Galle,Hikkaduwa,Southern,4101,287,4388,164040,11480,175520
1/13/2025,Kaveesha Rathnayake,Galle,Hikkaduwa,Southern,5649,4273,9922,225960,170920,396880
1/14/2025,Kaveesha Rathnayake,Galle,Hikkaduwa,Southern,450,809,1259,18000,32360,50360
1/15/2025,Kaveesha Rathnayake,Galle,Hikkaduwa,Southern,5989,2504,8493,239560,100160,339720
1/16/2025,Kaveesha Rathnayake,Galle,Hikkaduwa,Southern,1412,4004,5416,56480,160160,216640
1/17/2025,Kaveesha Rathnayake,Galle,Hikkaduwa,Southern,8274,6482,14756,330960,259280,590240
1/18/2025,Kaveesha Rathnayake,Galle,Hikkaduwa,Southern,5624,6259,11883,224960,250360,475320
1/19/2025,Kaveesha Rathnayake,Galle,Hikkaduwa,Southern,2757,1572,4329,110280,62880,173160
1/20/2025,Kaveesha Rathnayake,Galle,Hikkaduwa,Southern,6542,6335,12877,261680,253400,515080
1/21/2025,Kaveesha Rathnayake,Galle,Hikkaduwa,Southern,189,8233,8422,7560,329320,336880
1/22/2025,Kaveesha Rathnayake,Galle,Hikkaduwa,Southern,948,6983,7931,37920,279320,317240
1/23/2025,Kaveesha Rathnayake,Galle,Hikkaduwa,Southern,9360,7939,17299,374400,317560,691960
1/24/2025,Kaveesha Rathnayake,Galle,Hikkaduwa,Southern,4475,385,4860,179000,15400,194400
1/25/2025,Kaveesha Rathnayake,Galle,Hikkaduwa,Southern,6188,9973,16161,247520,398920,646440
1/26/2025,Kaveesha Rathnayake,Galle,Hikkaduwa,Southern,7822,83,7905,312880,3320,316200
1/27/2025,Kaveesha Rathnayake,Galle,Hikkaduwa,Southern,6915,8026,14941,276600,321040,597640
1/28/2025,Kaveesha Rathnayake,Galle,Hikkaduwa,Southern,4370,9205,13575,174800,368200,543000
1/29/2025,Kaveesha Rathnayake,Galle,Hikkaduwa,Southern,4845,4441,9286,193800,177640,371440
1/30/2025,Kaveesha Rathnayake,Galle,Hikkaduwa,Southern,5972,3983,9955,238880,159320,398200
1/31/2025,Kaveesha Rathnayake,Galle,Hikkaduwa,Southern,5131,4428,9559,205240,177120,382360
2/1/2025,Kaveesha Rathnayake,Galle,Hikkaduwa,Southern,2274,5596,7870,90960,223840,314800
2/2/2025,Kaveesha Rathnayake,Galle,Hikkaduwa,Southern,7433,3539,10972,297320,141560,438880
2/3/2025,Kaveesha Rathnayake,Galle,Hikkaduwa,Southern,9684,8145,17829,387360,325800,713160
2/4/2025,Kaveesha Rathnayake,Galle,Hikkaduwa,Southern,5533,9051,14584,221320,362040,583360
2/5/2025,Kaveesha Rathnayake,Galle,Hikkaduwa,Southern,4992,8346,13338,199680,333840,533520
2/6/2025,Kaveesha Rathnayake,Galle,Hikkaduwa,Southern,119,3344,3463,4760,133760,138520
2/7/2025,Kaveesha Rathnayake,Galle,Hikkaduwa,Southern,8403,8857,17260,336120,354280,690400
2/8/2025,Kaveesha Rathnayake,Galle,Hikkaduwa,Southern,9586,2171,11757,383440,86840,470280
2/9/2025,Kaveesha Rathnayake,Galle,Hikkaduwa,Southern,9783,8889,18672,391320,355560,746880
2/10/2025,Kaveesha Rathnayake,Galle,Hikkaduwa,Southern,1251,4884,6135,50040,195360,245400
2/11/2025,Kaveesha Rathnayake,Galle,Hikkaduwa,Southern,6718,8923,15641,268720,356920,625640
2/12/2025,Kaveesha Rathnayake,Galle,Hikkaduwa,Southern,9556,1440,10996,382240,57600,439840
2/13/2025,Kaveesha Rathnayake,Galle,Hikkaduwa,Southern,1708,7169,8877,68320,286760,355080
2/14/2025,Kaveesha Rathnayake,Galle,Hikkaduwa,Southern,9589,565,10154,383560,22600,406160
2/15/2025,Kaveesha Rathnayake,Galle,Hikkaduwa,Southern,897,6814,7711,35880,272560,308440
2/16/2025,Kaveesha Rathnayake,Galle,Hikkaduwa,Southern,451,6536,6987,18040,261440,279480
2/17/2025,Kaveesha Rathnayake,Galle,Hikkaduwa,Southern,9889,2810,12699,395560,112400,507960
2/18/2025,Kaveesha Rathnayake,Galle,Hikkaduwa,Southern,211,5493,5704,8440,219720,228160
2/19/2025,Kaveesha Rathnayake,Galle,Hikkaduwa,Southern,3320,3288,6608,132800,131520,264320
2/20/2025,Kaveesha Rathnayake,Galle,Hikkaduwa,Southern,9799,9429,19228,391960,377160,769120
2/21/2025,Kaveesha Rathnayake,Galle,Hikkaduwa,Southern,1634,1015,2649,65360,40600,105960
2/22/2025,Kaveesha Rathnayake,Galle,Hikkaduwa,Southern,6450,1012,7462,258000,40480,298480
2/23/2025,Kaveesha Rathnayake,Galle,Hikkaduwa,Southern,4157,4569,8726,166280,182760,349040
2/24/2025,Kaveesha Rathnayake,Galle,Hikkaduwa,Southern,9485,5889,15374,379400,235560,614960
2/25/2025,Kaveesha Rathnayake,Galle,Hikkaduwa,Southern,2965,604,3569,118600,24160,142760
2/26/2025,Kaveesha Rathnayake,Galle,Hikkaduwa,Southern,5911,9869,15780,236440,394760,631200
2/27/2025,Kaveesha Rathnayake,Galle,Hikkaduwa,Southern,7615,9335,16950,304600,373400,678000
2/28/2025,Kaveesha Rathnayake,Galle,Hikkaduwa,Southern,2271,1628,3899,90840,65120,155960
3/1/2025,Kaveesha Rathnayake,Galle,Hikkaduwa,Southern,639,2814,3453,25560,112560,138120
3/2/2025,Kaveesha Rathnayake,Galle,Hikkaduwa,Southern,5516,7863,13379,220640,314520,535160
3/3/2025,Kaveesha Rathnayake,Galle,Hikkaduwa,Southern,9264,5525,14789,370560,221000,591560
3/4/2025,Kaveesha Rathnayake,Galle,Hikkaduwa,Southern,936,2328,3264,37440,93120,130560
3/5/2025,Kaveesha Rathnayake,Galle,Hikkaduwa,Southern,6677,6564,13241,267080,262560,529640
3/6/2025,Kaveesha Rathnayake,Galle,Hikkaduwa,Southern,2929,7398,10327,117160,295920,413080
3/7/2025,Kaveesha Rathnayake,Galle,Hikkaduwa,Southern,4501,1943,6444,180040,77720,257760
3/8/2025,Kaveesha Rathnayake,Galle,Hikkaduwa,Southern,1546,1450,2996,61840,58000,119840
3/9/2025,Kaveesha Rathnayake,Galle,Hikkaduwa,Southern,2320,4132,6452,92800,165280,258080
3/10/2025,Kaveesha Rathnayake,Galle,Hikkaduwa,Southern,5298,5267,10565,211920,210680,422600
3/11/2025,Kaveesha Rathnayake,Galle,Hikkaduwa,Southern,7044,2201,9245,281760,88040,369800
3/12/2025,Kaveesha Rathnayake,Galle,Hikkaduwa,Southern,7614,5742,13356,304560,229680,534240
3/13/2025,Kaveesha Rathnayake,Galle,Hikkaduwa,Southern,7392,9211,16603,295680,368440,664120
3/14/2025,Kaveesha Rathnayake,Galle,Hikkaduwa,Southern,6008,1790,7798,240320,71600,311920
3/15/2025,Kaveesha Rathnayake,Galle,Hikkaduwa,Southern,3928,3832,7760,157120,153280,310400
3/16/2025,Kaveesha Rathnayake,Galle,Hikkaduwa,Southern,4108,2533,6641,164320,101320,265640
3/17/2025,Kaveesha Rathnayake,Galle,Hikkaduwa,Southern,40,4440,4480,1600,177600,179200
3/18/2025,Kaveesha Rathnayake,Galle,Hikkaduwa,Southern,8144,8051,16195,325760,322040,647800
3/19/2025,Kaveesha Rathnayake,Galle,Hikkaduwa,Southern,5285,9902,15187,211400,396080,607480
3/20/2025,Kaveesha Rathnayake,Galle,Hikkaduwa,Southern,1814,1490,3304,72560,59600,132160
3/21/2025,Kaveesha Rathnayake,Galle,Hikkaduwa,Southern,1611,3538,5149,64440,141520,205960
3/22/2025,Kaveesha Rathnayake,Galle,Hikkaduwa,Southern,5069,8714,13783,202760,348560,551320
3/23/2025,Kaveesha Rathnayake,Galle,Hikkaduwa,Southern,1483,8954,10437,59320,358160,417480
3/25/2024,Piumi Premarathna,Badulla,Haputale,Uva,5053,1949,7002,202120,77960,280080
3/26/2024,Piumi Premarathna,Badulla,Haputale,Uva,7622,444,8066,304880,17760,322640
3/27/2024,Piumi Premarathna,Badulla,Haputale,Uva,2328,7223,9551,93120,288920,382040
3/28/2024,Piumi Premarathna,Badulla,Haputale,Uva,6775,4516,11291,271000,180640,451640
3/29/2024,Piumi Premarathna,Badulla,Haputale,Uva,3266,9520,12786,130640,380800,511440
3/30/2024,Piumi Premarathna,Badulla,Haputale,Uva,4724,2097,6821,188960,83880,272840
3/31/2024,Piumi Premarathna,Badulla,Haputale,Uva,1611,2535,4146,64440,101400,165840
4/1/2024,Piumi Premarathna,Badulla,Haputale,Uva,7535,207,7742,301400,8280,309680
4/2/2024,Piumi Premarathna,Badulla,Haputale,Uva,3027,3379,6406,121080,135160,256240
4/3/2024,Piumi Premarathna,Badulla,Haputale,Uva,6808,9514,16322,272320,380560,652880
4/4/2024,Piumi Premarathna,Badulla,Haputale,Uva,2234,2619,4853,89360,104760,194120
4/5/2024,Piumi Premarathna,Badulla,Haputale,Uva,8209,5491,13700,328360,219640,548000
4/6/2024,Piumi Premarathna,Badulla,Haputale,Uva,4846,6403,11249,193840,256120,449960
4/7/2024,Piumi Premarathna,Badulla,Haputale,Uva,7545,5059,12604,301800,202360,504160
4/8/2024,Piumi Premarathna,Badulla,Haputale,Uva,6743,786,7529,269720,31440,301160
4/9/2024,Piumi Premarathna,Badulla,Haputale,Uva,281,4157,4438,11240,166280,177520
4/10/2024,Piumi Premarathna,Badulla,Haputale,Uva,1388,8576,9964,55520,343040,398560
4/11/2024,Piumi Premarathna,Badulla,Haputale,Uva,6897,1997,8894,275880,79880,355760
4/19/2024,Piumi Premarathna,Badulla,Haputale,Uva,5011,6816,11827,200440,272640,473080
4/20/2024,Piumi Premarathna,Badulla,Haputale,Uva,5724,3481,9205,228960,139240,368200
4/21/2024,Piumi Premarathna,Badulla,Haputale,Uva,9596,1192,10788,383840,47680,431520
4/22/2024,Piumi Premarathna,Badulla,Haputale,Uva,7992,9819,17811,319680,392760,712440
4/23/2024,Piumi Premarathna,Badulla,Haputale,Uva,1234,6725,7959,49360,269000,318360
4/24/2024,Piumi Premarathna,Badulla,Haputale,Uva,6539,6476,13015,261560,259040,520600
4/25/2024,Piumi Premarathna,Badulla,Haputale,Uva,5007,6241,11248,200280,249640,449920
4/26/2024,Piumi Premarathna,Badulla,Haputale,Uva,8726,3706,12432,349040,148240,497280
4/27/2024,Piumi Premarathna,Badulla,Haputale,Uva,8759,560,9319,350360,22400,372760
4/28/2024,Piumi Premarathna,Badulla,Haputale,Uva,2262,8224,10486,90480,328960,419440
4/29/2024,Piumi Premarathna,Badulla,Haputale,Uva,5529,2549,8078,221160,101960,323120
4/30/2024,Piumi Premarathna,Badulla,Haputale,Uva,245,551,796,9800,22040,31840
5/1/2024,Piumi Premarathna,Badulla,Haputale,Uva,3029,9934,12963,121160,397360,518520
5/2/2024,Piumi Premarathna,Badulla,Haputale,Uva,4938,8606,13544,197520,344240,541760
5/3/2024,Piumi Premarathna,Badulla,Haputale,Uva,3881,6637,10518,155240,265480,420720
5/4/2024,Piumi Premarathna,Badulla,Haputale,Uva,3278,1018,4296,131120,40720,171840
5/5/2024,Piumi Premarathna,Badulla,Haputale,Uva,6656,4611,11267,266240,184440,450680
5/6/2024,Piumi Premarathna,Badulla,Haputale,Uva,7253,6875,14128,290120,275000,565120
5/7/2024,Piumi Premarathna,Badulla,Haputale,Uva,1384,7791,9175,55360,311640,367000
5/8/2024,Piumi Premarathna,Badulla,Haputale,Uva,1663,1922,3585,66520,76880,143400
5/9/2024,Piumi Premarathna,Badulla,Haputale,Uva,9046,3236,12282,361840,129440,491280
5/10/2024,Piumi Premarathna,Badulla,Haputale,Uva,8004,1560,9564,320160,62400,382560
5/11/2024,Piumi Premarathna,Badulla,Haputale,Uva,2720,277,2997,108800,11080,119880
5/12/2024,Piumi Premarathna,Badulla,Haputale,Uva,7944,1636,9580,317760,65440,383200
5/13/2024,Piumi Premarathna,Badulla,Haputale,Uva,8919,7483,16402,356760,299320,656080
5/14/2024,Piumi Premarathna,Badulla,Haputale,Uva,839,6790,7629,33560,271600,305160
5/15/2024,Piumi Premarathna,Badulla,Haputale,Uva,8980,3557,12537,359200,142280,501480
5/16/2024,Piumi Premarathna,Badulla,Haputale,Uva,759,8133,8892,30360,325320,355680
5/17/2024,Piumi Premarathna,Badulla,Haputale,Uva,3100,3139,6239,124000,125560,249560
5/18/2024,Piumi Premarathna,Badulla,Haputale,Uva,9861,7394,17255,394440,295760,690200
5/19/2024,Piumi Premarathna,Badulla,Haputale,Uva,2454,6308,8762,98160,252320,350480
5/20/2024,Piumi Premarathna,Badulla,Haputale,Uva,5412,9216,14628,216480,368640,585120
5/21/2024,Piumi Premarathna,Badulla,Haputale,Uva,2915,7277,10192,116600,291080,407680
5/22/2024,Piumi Premarathna,Badulla,Haputale,Uva,3183,8941,12124,127320,357640,484960
5/24/2024,Piumi Premarathna,Badulla,Haputale,Uva,1560,1014,2574,62400,40560,102960
5/25/2024,Piumi Premarathna,Badulla,Haputale,Uva,427,3192,3619,17080,127680,144760
5/26/2024,Piumi Premarathna,Badulla,Haputale,Uva,4608,5731,10339,184320,229240,413560
5/27/2024,Piumi Premarathna,Badulla,Haputale,Uva,6722,9761,16483,268880,390440,659320
5/28/2024,Piumi Premarathna,Badulla,Haputale,Uva,6826,4807,11633,273040,192280,465320
5/29/2024,Piumi Premarathna,Badulla,Haputale,Uva,1019,6401,7420,40760,256040,296800
5/30/2024,Piumi Premarathna,Badulla,Haputale,Uva,8919,6182,15101,356760,247280,604040
5/31/2024,Piumi Premarathna,Badulla,Haputale,Uva,9503,1893,11396,380120,75720,455840
6/1/2024,Piumi Premarathna,Badulla,Haputale,Uva,7759,5553,13312,310360,222120,532480
6/2/2024,Piumi Premarathna,Badulla,Haputale,Uva,7956,4828,12784,318240,193120,511360
6/3/2024,Piumi Premarathna,Badulla,Haputale,Uva,9557,101,9658,382280,4040,386320
6/4/2024,Piumi Premarathna,Badulla,Haputale,Uva,4401,2752,7153,176040,110080,286120
6/5/2024,Piumi Premarathna,Badulla,Haputale,Uva,6056,5330,11386,242240,213200,455440
6/6/2024,Piumi Premarathna,Badulla,Haputale,Uva,211,2159,2370,8440,86360,94800
6/7/2024,Piumi Premarathna,Badulla,Haputale,Uva,7852,8069,15921,314080,322760,636840
6/8/2024,Piumi Premarathna,Badulla,Haputale,Uva,5101,942,6043,204040,37680,241720
6/9/2024,Piumi Premarathna,Badulla,Haputale,Uva,5997,5051,11048,239880,202040,441920
6/10/2024,Piumi Premarathna,Badulla,Haputale,Uva,191,9118,9309,7640,364720,372360
6/11/2024,Piumi Premarathna,Badulla,Haputale,Uva,9829,1094,10923,393160,43760,436920
6/12/2024,Piumi Premarathna,Badulla,Haputale,Uva,5208,5741,10949,208320,229640,437960
6/13/2024,Piumi Premarathna,Badulla,Haputale,Uva,3697,9820,13517,147880,392800,540680
6/14/2024,Piumi Premarathna,Badulla,Haputale,Uva,697,7271,7968,27880,290840,318720
6/15/2024,Piumi Premarathna,Badulla,Haputale,Uva,6668,4659,11327,266720,186360,453080
6/16/2024,Piumi Premarathna,Badulla,Haputale,Uva,9963,6104,16067,398520,244160,642680
6/17/2024,Piumi Premarathna,Badulla,Haputale,Uva,9744,8468,18212,389760,338720,728480
6/18/2024,Piumi Premarathna,Badulla,Haputale,Uva,9776,7057,16833,391040,282280,673320
6/19/2024,Piumi Premarathna,Badulla,Haputale,Uva,2880,5012,7892,115200,200480,315680
6/20/2024,Piumi Premarathna,Badulla,Haputale,Uva,2805,422,3227,112200,16880,129080
6/21/2024,Piumi Premarathna,Badulla,Haputale,Uva,9818,2191,12009,392720,87640,480360
6/22/2024,Piumi Premarathna,Badulla,Haputale,Uva,8829,844,9673,353160,33760,386920
6/23/2024,Piumi Premarathna,Badulla,Haputale,Uva,2211,3007,5218,88440,120280,208720
6/24/2024,Piumi Premarathna,Badulla,Haputale,Uva,8385,4103,12488,335400,164120,499520
6/25/2024,Piumi Premarathna,Badulla,Haputale,Uva,5024,3828,8852,200960,153120,354080
6/26/2024,Piumi Premarathna,Badulla,Haputale,Uva,4830,935,5765,193200,37400,230600
6/27/2024,Piumi Premarathna,Badulla,Haputale,Uva,4742,9944,14686,189680,397760,587440
6/28/2024,Piumi Premarathna,Badulla,Haputale,Uva,5464,7169,12633,218560,286760,505320
6/29/2024,Piumi Premarathna,Badulla,Haputale,Uva,7009,1248,8257,280360,49920,330280
6/30/2024,Piumi Premarathna,Badulla,Haputale,Uva,8404,4062,12466,336160,162480,498640
7/1/2024,Piumi Premarathna,Badulla,Haputale,Uva,7293,9846,17139,291720,393840,685560
7/2/2024,Piumi Premarathna,Badulla,Haputale,Uva,2254,7126,9380,90160,285040,375200
7/3/2024,Piumi Premarathna,Badulla,Haputale,Uva,8401,3711,12112,336040,148440,484480
7/4/2024,Piumi Premarathna,Badulla,Haputale,Uva,5305,7598,12903,212200,303920,516120
7/5/2024,Piumi Premarathna,Badulla,Haputale,Uva,3499,930,4429,139960,37200,177160
7/6/2024,Piumi Premarathna,Badulla,Haputale,Uva,706,646,1352,28240,25840,54080
7/7/2024,Piumi Premarathna,Badulla,Haputale,Uva,2415,81,2496,96600,3240,99840
7/8/2024,Piumi Premarathna,Badulla,Haputale,Uva,3589,9547,13136,143560,381880,525440
7/9/2024,Piumi Premarathna,Badulla,Haputale,Uva,3880,8970,12850,155200,358800,514000
7/10/2024,Piumi Premarathna,Badulla,Haputale,Uva,5412,3565,8977,216480,142600,359080
7/11/2024,Piumi Premarathna,Badulla,Haputale,Uva,4457,7373,11830,178280,294920,473200
7/12/2024,Piumi Premarathna,Badulla,Haputale,Uva,5388,8906,14294,215520,356240,571760
7/13/2024,Piumi Premarathna,Badulla,Haputale,Uva,5445,8326,13771,217800,333040,550840
7/14/2024,Piumi Premarathna,Badulla,Haputale,Uva,7500,1786,9286,300000,71440,371440
7/15/2024,Piumi Premarathna,Badulla,Haputale,Uva,9266,4625,13891,370640,185000,555640
7/16/2024,Piumi Premarathna,Badulla,Haputale,Uva,666,5074,5740,26640,202960,229600
7/17/2024,Piumi Premarathna,Badulla,Haputale,Uva,4244,2969,7213,169760,118760,288520
7/18/2024,Piumi Premarathna,Badulla,Haputale,Uva,8892,8723,17615,355680,348920,704600
7/19/2024,Piumi Premarathna,Badulla,Haputale,Uva,525,6050,6575,21000,242000,263000
7/20/2024,Piumi Premarathna,Badulla,Haputale,Uva,8868,4634,13502,354720,185360,540080
7/21/2024,Piumi Premarathna,Badulla,Haputale,Uva,1851,3677,5528,74040,147080,221120
7/22/2024,Piumi Premarathna,Badulla,Haputale,Uva,3080,3055,6135,123200,122200,245400
7/23/2024,Piumi Premarathna,Badulla,Haputale,Uva,4764,8560,13324,190560,342400,532960
7/24/2024,Piumi Premarathna,Badulla,Haputale,Uva,8057,3997,12054,322280,159880,482160
7/25/2024,Piumi Premarathna,Badulla,Haputale,Uva,4992,221,5213,199680,8840,208520
7/26/2024,Piumi Premarathna,Badulla,Haputale,Uva,7263,9929,17192,290520,397160,687680
7/27/2024,Piumi Premarathna,Badulla,Haputale,Uva,176,5866,6042,7040,234640,241680
7/28/2024,Piumi Premarathna,Badulla,Haputale,Uva,361,6110,6471,14440,244400,258840
7/29/2024,Piumi Premarathna,Badulla,Haputale,Uva,8696,8755,17451,347840,350200,698040
7/30/2024,Piumi Premarathna,Badulla,Haputale,Uva,4913,8514,13427,196520,340560,537080
7/31/2024,Piumi Premarathna,Badulla,Haputale,Uva,2313,7951,10264,92520,318040,410560
8/1/2024,Piumi Premarathna,Badulla,Haputale,Uva,986,3068,4054,39440,122720,162160
8/2/2024,Piumi Premarathna,Badulla,Haputale,Uva,4747,4215,8962,189880,168600,358480
8/3/2024,Piumi Premarathna,Badulla,Haputale,Uva,888,8607,9495,35520,344280,379800
8/4/2024,Piumi Premarathna,Badulla,Haputale,Uva,2591,7880,10471,103640,315200,418840
8/5/2024,Piumi Premarathna,Badulla,Haputale,Uva,8035,2516,10551,321400,100640,422040
8/6/2024,Piumi Premarathna,Badulla,Haputale,Uva,8082,9309,17391,323280,372360,695640
8/7/2024,Piumi Premarathna,Badulla,Haputale,Uva,746,2820,3566,29840,112800,142640
8/8/2024,Piumi Premarathna,Badulla,Haputale,Uva,2460,9999,12459,98400,399960,498360
8/9/2024,Piumi Premarathna,Badulla,Haputale,Uva,2217,1311,3528,88680,52440,141120
8/10/2024,Piumi Premarathna,Badulla,Haputale,Uva,533,3728,4261,21320,149120,170440
8/11/2024,Piumi Premarathna,Badulla,Haputale,Uva,4016,9169,13185,160640,366760,527400
8/12/2024,Piumi Premarathna,Badulla,Haputale,Uva,3959,6503,10462,158360,260120,418480
8/13/2024,Piumi Premarathna,Badulla,Haputale,Uva,2866,5621,8487,114640,224840,339480
8/14/2024,Piumi Premarathna,Badulla,Haputale,Uva,6719,1052,7771,268760,42080,310840
8/15/2024,Piumi Premarathna,Badulla,Haputale,Uva,469,7494,7963,18760,299760,318520
8/16/2024,Piumi Premarathna,Badulla,Haputale,Uva,9151,1727,10878,366040,69080,435120
8/17/2024,Piumi Premarathna,Badulla,Haputale,Uva,2165,7554,9719,86600,302160,388760
8/18/2024,Piumi Premarathna,Badulla,Haputale,Uva,7364,2778,10142,294560,111120,405680
8/19/2024,Piumi Premarathna,Badulla,Haputale,Uva,8453,2815,11268,338120,112600,450720
8/20/2024,Piumi Premarathna,Badulla,Haputale,Uva,3368,2472,5840,134720,98880,233600
8/21/2024,Piumi Premarathna,Badulla,Haputale,Uva,6781,8969,15750,271240,358760,630000
8/22/2024,Piumi Premarathna,Badulla,Haputale,Uva,9564,3905,13469,382560,156200,538760
8/23/2024,Piumi Premarathna,Badulla,Haputale,Uva,3391,7108,10499,135640,284320,419960
8/24/2024,Piumi Premarathna,Badulla,Haputale,Uva,6198,174,6372,247920,6960,254880
8/25/2024,Piumi Premarathna,Badulla,Haputale,Uva,8521,8676,17197,340840,347040,687880
8/26/2024,Piumi Premarathna,Badulla,Haputale,Uva,4943,965,5908,197720,38600,236320
8/27/2024,Piumi Premarathna,Badulla,Haputale,Uva,2419,75,2494,96760,3000,99760
8/28/2024,Piumi Premarathna,Badulla,Haputale,Uva,966,7045,8011,38640,281800,320440
8/29/2024,Piumi Premarathna,Badulla,Haputale,Uva,4625,4742,9367,185000,189680,374680
8/30/2024,Piumi Premarathna,Badulla,Haputale,Uva,5976,1738,7714,239040,69520,308560
8/31/2024,Piumi Premarathna,Badulla,Haputale,Uva,3458,430,3888,138320,17200,155520
9/1/2024,Piumi Premarathna,Badulla,Haputale,Uva,6866,8920,15786,274640,356800,631440
9/2/2024,Piumi Premarathna,Badulla,Haputale,Uva,5014,9115,14129,200560,364600,565160
9/3/2024,Piumi Premarathna,Badulla,Haputale,Uva,870,9492,10362,34800,379680,414480
9/4/2024,Piumi Premarathna,Badulla,Haputale,Uva,9767,8817,18584,390680,352680,743360
9/5/2024,Piumi Premarathna,Badulla,Haputale,Uva,7178,7159,14337,287120,286360,573480
9/6/2024,Piumi Premarathna,Badulla,Haputale,Uva,6569,1663,8232,262760,66520,329280
9/7/2024,Piumi Premarathna,Badulla,Haputale,Uva,5447,4590,10037,217880,183600,401480
9/8/2024,Piumi Premarathna,Badulla,Haputale,Uva,2148,7797,9945,85920,311880,397800
9/9/2024,Piumi Premarathna,Badulla,Haputale,Uva,4145,589,4734,165800,23560,189360
9/10/2024,Piumi Premarathna,Badulla,Haputale,Uva,27,377,404,1080,15080,16160
9/11/2024,Piumi Premarathna,Badulla,Haputale,Uva,7469,6436,13905,298760,257440,556200
9/12/2024,Piumi Premarathna,Badulla,Haputale,Uva,3747,9285,13032,149880,371400,521280
9/13/2024,Piumi Premarathna,Badulla,Haputale,Uva,8505,9379,17884,340200,375160,715360
9/14/2024,Piumi Premarathna,Badulla,Haputale,Uva,162,1666,1828,6480,66640,73120
9/15/2024,Piumi Premarathna,Badulla,Haputale,Uva,9525,861,10386,381000,34440,415440
9/16/2024,Piumi Premarathna,Badulla,Haputale,Uva,9099,6413,15512,363960,256520,620480
9/17/2024,Piumi Premarathna,Badulla,Haputale,Uva,6695,2646,9341,267800,105840,373640
9/18/2024,Piumi Premarathna,Badulla,Haputale,Uva,2930,750,3680,117200,30000,147200
9/19/2024,Piumi Premarathna,Badulla,Haputale,Uva,3151,6287,9438,126040,251480,377520
9/20/2024,Piumi Premarathna,Badulla,Haputale,Uva,6836,5746,12582,273440,229840,503280
9/21/2024,Piumi Premarathna,Badulla,Haputale,Uva,4533,9105,13638,181320,364200,545520
9/22/2024,Piumi Premarathna,Badulla,Haputale,Uva,9202,8251,17453,368080,330040,698120
9/23/2024,Piumi Premarathna,Badulla,Haputale,Uva,9808,6797,16605,392320,271880,664200
9/24/2024,Piumi Premarathna,Badulla,Haputale,Uva,2206,8957,11163,88240,358280,446520
9/25/2024,Piumi Premarathna,Badulla,Haputale,Uva,4341,2201,6542,173640,88040,261680
9/26/2024,Piumi Premarathna,Badulla,Haputale,Uva,8679,3384,12063,347160,135360,482520
9/27/2024,Piumi Premarathna,Badulla,Haputale,Uva,8411,1565,9976,336440,62600,399040
9/28/2024,Piumi Premarathna,Badulla,Haputale,Uva,6769,9802,16571,270760,392080,662840
9/29/2024,Piumi Premarathna,Badulla,Haputale,Uva,3160,2636,5796,126400,105440,231840
9/30/2024,Piumi Premarathna,Badulla,Haputale,Uva,2273,3590,5863,90920,143600,234520
10/1/2024,Piumi Premarathna,Badulla,Haputale,Uva,6924,6116,13040,276960,244640,521600
10/2/2024,Piumi Premarathna,Badulla,Haputale,Uva,935,3009,3944,37400,120360,157760
10/3/2024,Piumi Premarathna,Badulla,Haputale,Uva,6988,1903,8891,279520,76120,355640
10/4/2024,Piumi Premarathna,Badulla,Haputale,Uva,2675,8917,11592,107000,356680,463680
10/5/2024,Piumi Premarathna,Badulla,Haputale,Uva,550,6073,6623,22000,242920,264920
10/6/2024,Piumi Premarathna,Badulla,Haputale,Uva,1589,7066,8655,63560,282640,346200
10/7/2024,Piumi Premarathna,Badulla,Haputale,Uva,5338,802,6140,213520,32080,245600
10/8/2024,Piumi Premarathna,Badulla,Haputale,Uva,6358,5207,11565,254320,208280,462600
10/9/2024,Piumi Premarathna,Badulla,Haputale,Uva,9022,263,9285,360880,10520,371400
10/10/2024,Piumi Premarathna,Badulla,Haputale,Uva,4599,2988,7587,183960,119520,303480
10/11/2024,Piumi Premarathna,Badulla,Haputale,Uva,3766,2655,6421,150640,106200,256840
10/12/2024,Piumi Premarathna,Badulla,Haputale,Uva,5939,6980,12919,237560,279200,516760
10/13/2024,Piumi Premarathna,Badulla,Haputale,Uva,2997,9919,12916,119880,396760,516640
10/14/2024,Piumi Premarathna,Badulla,Haputale,Uva,623,2819,3442,24920,112760,137680
10/15/2024,Piumi Premarathna,Badulla,Haputale,Uva,1091,3150,4241,43640,126000,169640
10/16/2024,Piumi Premarathna,Badulla,Haputale,Uva,5713,5103,10816,228520,204120,432640
10/17/2024,Piumi Premarathna,Badulla,Haputale,Uva,4286,5606,9892,171440,224240,395680
10/18/2024,Piumi Premarathna,Badulla,Haputale,Uva,3621,9652,13273,144840,386080,530920
10/19/2024,Piumi Premarathna,Badulla,Haputale,Uva,300,9325,9625,12000,373000,385000
10/20/2024,Piumi Premarathna,Badulla,Haputale,Uva,3601,1373,4974,144040,54920,198960
10/21/2024,Piumi Premarathna,Badulla,Haputale,Uva,8637,4021,12658,345480,160840,506320
10/22/2024,Piumi Premarathna,Badulla,Haputale,Uva,9150,7509,16659,366000,300360,666360
10/23/2024,Piumi Premarathna,Badulla,Haputale,Uva,8526,6057,14583,341040,242280,583320
10/24/2024,Piumi Premarathna,Badulla,Haputale,Uva,8451,6405,14856,338040,256200,594240
10/25/2024,Piumi Premarathna,Badulla,Haputale,Uva,7609,2082,9691,304360,83280,387640
10/26/2024,Piumi Premarathna,Badulla,Haputale,Uva,6328,5260,11588,253120,210400,463520
10/27/2024,Piumi Premarathna,Badulla,Haputale,Uva,7366,1043,8409,294640,41720,336360
10/28/2024,Piumi Premarathna,Badulla,Haputale,Uva,9396,6894,16290,375840,275760,651600
10/29/2024,Piumi Premarathna,Badulla,Haputale,Uva,7611,9221,16832,304440,368840,673280
10/30/2024,Piumi Premarathna,Badulla,Haputale,Uva,6721,6122,12843,268840,244880,513720
10/31/2024,Piumi Premarathna,Badulla,Haputale,Uva,8886,7842,16728,355440,313680,669120
11/1/2024,Piumi Premarathna,Badulla,Haputale,Uva,1212,8159,9371,48480,326360,374840
11/2/2024,Piumi Premarathna,Badulla,Haputale,Uva,5160,5582,10742,206400,223280,429680
11/3/2024,Piumi Premarathna,Badulla,Haputale,Uva,2132,432,2564,85280,17280,102560
11/4/2024,Piumi Premarathna,Badulla,Haputale,Uva,2250,622,2872,90000,24880,114880
11/5/2024,Piumi Premarathna,Badulla,Haputale,Uva,1937,4538,6475,77480,181520,259000
11/6/2024,Piumi Premarathna,Badulla,Haputale,Uva,7250,9037,16287,290000,361480,651480
11/7/2024,Piumi Premarathna,Badulla,Haputale,Uva,9043,9795,18838,361720,391800,753520
11/8/2024,Piumi Premarathna,Badulla,Haputale,Uva,6995,1452,8447,279800,58080,337880
11/9/2024,Piumi Premarathna,Badulla,Haputale,Uva,6934,5151,12085,277360,206040,483400
11/10/2024,Piumi Premarathna,Badulla,Haputale,Uva,6454,8600,15054,258160,344000,602160
11/11/2024,Piumi Premarathna,Badulla,Haputale,Uva,5196,167,5363,207840,6680,214520
11/12/2024,Piumi Premarathna,Badulla,Haputale,Uva,616,4394,5010,24640,175760,200400
11/13/2024,Piumi Premarathna,Badulla,Haputale,Uva,3136,5217,8353,125440,208680,334120
11/14/2024,Piumi Premarathna,Badulla,Haputale,Uva,6246,8465,14711,249840,338600,588440
11/15/2024,Piumi Premarathna,Badulla,Haputale,Uva,6439,90,6529,257560,3600,261160
11/16/2024,Piumi Premarathna,Badulla,Haputale,Uva,5903,3761,9664,236120,150440,386560
11/17/2024,Piumi Premarathna,Badulla,Haputale,Uva,9224,2457,11681,368960,98280,467240
11/18/2024,Piumi Premarathna,Badulla,Haputale,Uva,4625,4122,8747,185000,164880,349880
11/19/2024,Piumi Premarathna,Badulla,Haputale,Uva,9191,8468,17659,367640,338720,706360
11/20/2024,Piumi Premarathna,Badulla,Haputale,Uva,723,8623,9346,28920,344920,373840
11/21/2024,Piumi Premarathna,Badulla,Haputale,Uva,9331,4754,14085,373240,190160,563400
11/22/2024,Piumi Premarathna,Badulla,Haputale,Uva,1859,2455,4314,74360,98200,172560
11/23/2024,Piumi Premarathna,Badulla,Haputale,Uva,2630,5337,7967,105200,213480,318680
11/24/2024,Piumi Premarathna,Badulla,Haputale,Uva,9704,1406,11110,388160,56240,444400
11/25/2024,Piumi Premarathna,Badulla,Haputale,Uva,7644,6862,14506,305760,274480,580240
11/26/2024,Piumi Premarathna,Badulla,Haputale,Uva,8510,7780,16290,340400,311200,651600
11/27/2024,Piumi Premarathna,Badulla,Haputale,Uva,1984,1850,3834,79360,74000,153360
11/28/2024,Piumi Premarathna,Badulla,Haputale,Uva,5463,4467,9930,218520,178680,397200
11/29/2024,Piumi Premarathna,Badulla,Haputale,Uva,4723,8289,13012,188920,331560,520480
11/30/2024,Piumi Premarathna,Badulla,Haputale,Uva,5844,2997,8841,233760,119880,353640
12/1/2024,Piumi Premarathna,Badulla,Haputale,Uva,103,5292,5395,4120,211680,215800
12/2/2024,Piumi Premarathna,Badulla,Haputale,Uva,8343,1645,9988,333720,65800,399520
12/3/2024,Piumi Premarathna,Badulla,Haputale,Uva,889,7182,8071,35560,287280,322840
12/4/2024,Piumi Premarathna,Badulla,Haputale,Uva,9665,3375,13040,386600,135000,521600
12/5/2024,Piumi Premarathna,Badulla,Haputale,Uva,3485,5121,8606,139400,204840,344240
12/6/2024,Piumi Premarathna,Badulla,Haputale,Uva,7710,2814,10524,308400,112560,420960
12/7/2024,Piumi Premarathna,Badulla,Haputale,Uva,7017,8515,15532,280680,340600,621280
12/8/2024,Piumi Premarathna,Badulla,Haputale,Uva,1191,2824,4015,47640,112960,160600
12/9/2024,Piumi Premarathna,Badulla,Haputale,Uva,5547,7623,13170,221880,304920,526800
12/10/2024,Piumi Premarathna,Badulla,Haputale,Uva,4203,9939,14142,168120,397560,565680
12/11/2024,Piumi Premarathna,Badulla,Haputale,Uva,1689,2248,3937,67560,89920,157480
12/12/2024,Piumi Premarathna,Badulla,Haputale,Uva,1730,3989,5719,69200,159560,228760
12/13/2024,Piumi Premarathna,Badulla,Haputale,Uva,991,871,1862,39640,34840,74480
12/14/2024,Piumi Premarathna,Badulla,Haputale,Uva,5404,1404,6808,216160,56160,272320
12/15/2024,Piumi Premarathna,Badulla,Haputale,Uva,1549,938,2487,61960,37520,99480
12/16/2024,Piumi Premarathna,Badulla,Haputale,Uva,9079,4480,13559,363160,179200,542360
12/17/2024,Piumi Premarathna,Badulla,Haputale,Uva,6175,9993,16168,247000,399720,646720
12/18/2024,Piumi Premarathna,Badulla,Haputale,Uva,3217,233,3450,128680,9320,138000
12/19/2024,Piumi Premarathna,Badulla,Haputale,Uva,9943,3444,13387,397720,137760,535480
12/20/2024,Piumi Premarathna,Badulla,Haputale,Uva,1494,3643,5137,59760,145720,205480
12/21/2024,Piumi Premarathna,Badulla,Haputale,Uva,5479,3848,9327,219160,153920,373080
12/22/2024,Piumi Premarathna,Badulla,Haputale,Uva,7852,4647,12499,314080,185880,499960
12/23/2024,Piumi Premarathna,Badulla,Haputale,Uva,1283,853,2136,51320,34120,85440
12/24/2024,Piumi Premarathna,Badulla,Haputale,Uva,6313,2944,9257,252520,117760,370280
12/25/2024,Piumi Premarathna,Badulla,Haputale,Uva,9017,3461,12478,360680,138440,499120
12/26/2024,Piumi Premarathna,Badulla,Haputale,Uva,8156,6579,14735,326240,263160,589400
12/27/2024,Piumi Premarathna,Badulla,Haputale,Uva,192,921,1113,7680,36840,44520
12/28/2024,Piumi Premarathna,Badulla,Haputale,Uva,9215,1114,10329,368600,44560,413160
12/29/2024,Piumi Premarathna,Badulla,Haputale,Uva,9475,1016,10491,379000,40640,419640
12/30/2024,Piumi Premarathna,Badulla,Haputale,Uva,9286,6200,15486,371440,248000,619440
12/31/2024,Piumi Premarathna,Badulla,Haputale,Uva,3919,3526,7445,156760,141040,297800
1/1/2025,Piumi Premarathna,Badulla,Haputale,Uva,4920,1089,6009,196800,43560,240360
1/2/2025,Piumi Premarathna,Badulla,Haputale,Uva,4118,2436,6554,164720,97440,262160
1/3/2025,Piumi Premarathna,Badulla,Haputale,Uva,8637,878,9515,345480,35120,380600
1/4/2025,Piumi Premarathna,Badulla,Haputale,Uva,822,3254,4076,32880,130160,163040
1/5/2025,Piumi Premarathna,Badulla,Haputale,Uva,4444,9174,13618,177760,366960,544720
1/6/2025,Piumi Premarathna,Badulla,Haputale,Uva,7246,7456,14702,289840,298240,588080
1/7/2025,Piumi Premarathna,Badulla,Haputale,Uva,8707,6082,14789,348280,243280,591560
1/8/2025,Piumi Premarathna,Badulla,Haputale,Uva,7504,2431,9935,300160,97240,397400
1/9/2025,Piumi Premarathna,Badulla,Haputale,Uva,7287,1009,8296,291480,40360,331840
1/10/2025,Piumi Premarathna,Badulla,Haputale,Uva,5307,5868,11175,212280,234720,447000
1/11/2025,Piumi Premarathna,Badulla,Haputale,Uva,9713,3595,13308,388520,143800,532320
1/12/2025,Piumi Premarathna,Badulla,Haputale,Uva,5222,1249,6471,208880,49960,258840
1/13/2025,Piumi Premarathna,Badulla,Haputale,Uva,4756,54,4810,190240,2160,192400
1/14/2025,Piumi Premarathna,Badulla,Haputale,Uva,2442,1955,4397,97680,78200,175880
1/15/2025,Piumi Premarathna,Badulla,Haputale,Uva,2945,8957,11902,117800,358280,476080
1/16/2025,Piumi Premarathna,Badulla,Haputale,Uva,6425,8437,14862,257000,337480,594480
1/17/2025,Piumi Premarathna,Badulla,Haputale,Uva,7563,3016,10579,302520,120640,423160
1/18/2025,Piumi Premarathna,Badulla,Haputale,Uva,4568,9553,14121,182720,382120,564840
1/19/2025,Piumi Premarathna,Badulla,Haputale,Uva,7050,2674,9724,282000,106960,388960
1/20/2025,Piumi Premarathna,Badulla,Haputale,Uva,8361,2789,11150,334440,111560,446000
1/21/2025,Piumi Premarathna,Badulla,Haputale,Uva,8012,4665,12677,320480,186600,507080
1/22/2025,Piumi Premarathna,Badulla,Haputale,Uva,9521,3037,12558,380840,121480,502320
1/23/2025,Piumi Premarathna,Badulla,Haputale,Uva,902,7297,8199,36080,291880,327960
1/24/2025,Piumi Premarathna,Badulla,Haputale,Uva,8212,3117,11329,328480,124680,453160
1/25/2025,Piumi Premarathna,Badulla,Haputale,Uva,7164,36,7200,286560,1440,288000
1/26/2025,Piumi Premarathna,Badulla,Haputale,Uva,6739,7570,14309,269560,302800,572360
1/27/2025,Piumi Premarathna,Badulla,Haputale,Uva,5605,3035,8640,224200,121400,345600
1/28/2025,Piumi Premarathna,Badulla,Haputale,Uva,60,3822,3882,2400,152880,155280
1/29/2025,Piumi Premarathna,Badulla,Haputale,Uva,3440,5663,9103,137600,226520,364120
1/30/2025,Piumi Premarathna,Badulla,Haputale,Uva,6081,1631,7712,243240,65240,308480
1/31/2025,Piumi Premarathna,Badulla,Haputale,Uva,4974,5739,10713,198960,229560,428520
2/1/2025,Piumi Premarathna,Badulla,Haputale,Uva,9808,9029,18837,392320,361160,753480
2/2/2025,Piumi Premarathna,Badulla,Haputale,Uva,4969,377,5346,198760,15080,213840
2/3/2025,Piumi Premarathna,Badulla,Haputale,Uva,9881,8770,18651,395240,350800,746040
2/4/2025,Piumi Premarathna,Badulla,Haputale,Uva,4068,9900,13968,162720,396000,558720
2/5/2025,Piumi Premarathna,Badulla,Haputale,Uva,9049,6245,15294,361960,249800,611760
2/6/2025,Piumi Premarathna,Badulla,Haputale,Uva,9699,3604,13303,387960,144160,532120
2/7/2025,Piumi Premarathna,Badulla,Haputale,Uva,2648,3348,5996,105920,133920,239840
2/8/2025,Piumi Premarathna,Badulla,Haputale,Uva,230,9111,9341,9200,364440,373640
2/9/2025,Piumi Premarathna,Badulla,Haputale,Uva,4013,714,4727,160520,28560,189080
2/10/2025,Piumi Premarathna,Badulla,Haputale,Uva,9166,499,9665,366640,19960,386600
2/11/2025,Piumi Premarathna,Badulla,Haputale,Uva,1533,5121,6654,61320,204840,266160
2/12/2025,Piumi Premarathna,Badulla,Haputale,Uva,4901,8235,13136,196040,329400,525440
2/13/2025,Piumi Premarathna,Badulla,Haputale,Uva,1656,8739,10395,66240,349560,415800
2/14/2025,Piumi Premarathna,Badulla,Haputale,Uva,7785,8617,16402,311400,344680,656080
2/15/2025,Piumi Premarathna,Badulla,Haputale,Uva,7511,9771,17282,300440,390840,691280
2/16/2025,Piumi Premarathna,Badulla,Haputale,Uva,9490,6640,16130,379600,265600,645200
2/17/2025,Piumi Premarathna,Badulla,Haputale,Uva,7688,8963,16651,307520,358520,666040
2/18/2025,Piumi Premarathna,Badulla,Haputale,Uva,7375,4528,11903,295000,181120,476120
2/19/2025,Piumi Premarathna,Badulla,Haputale,Uva,4886,9001,13887,195440,360040,555480
2/20/2025,Piumi Premarathna,Badulla,Haputale,Uva,6884,586,7470,275360,23440,298800
2/21/2025,Piumi Premarathna,Badulla,Haputale,Uva,725,2949,3674,29000,117960,146960
2/22/2025,Piumi Premarathna,Badulla,Haputale,Uva,4903,7174,12077,196120,286960,483080
2/23/2025,Piumi Premarathna,Badulla,Haputale,Uva,4726,6447,11173,189040,257880,446920
2/24/2025,Piumi Premarathna,Badulla,Haputale,Uva,5396,3530,8926,215840,141200,357040
2/25/2025,Piumi Premarathna,Badulla,Haputale,Uva,9355,5460,14815,374200,218400,592600
2/26/2025,Piumi Premarathna,Badulla,Haputale,Uva,5734,1046,6780,229360,41840,271200
2/27/2025,Piumi Premarathna,Badulla,Haputale,Uva,5802,9861,15663,232080,394440,626520
2/28/2025,Piumi Premarathna,Badulla,Haputale,Uva,9030,9913,18943,361200,396520,757720
3/1/2025,Piumi Premarathna,Badulla,Haputale,Uva,5617,6502,12119,224680,260080,484760
3/2/2025,Piumi Premarathna,Badulla,Haputale,Uva,3664,8512,12176,146560,340480,487040
3/3/2025,Piumi Premarathna,Badulla,Haputale,Uva,6161,9472,15633,246440,378880,625320
3/4/2025,Piumi Premarathna,Badulla,Haputale,Uva,606,1924,2530,24240,76960,101200
3/5/2025,Piumi Premarathna,Badulla,Haputale,Uva,6814,7743,14557,272560,309720,582280
3/6/2025,Piumi Premarathna,Badulla,Haputale,Uva,150,1404,1554,6000,56160,62160
3/7/2025,Piumi Premarathna,Badulla,Haputale,Uva,2835,6818,9653,113400,272720,386120
3/8/2025,Piumi Premarathna,Badulla,Haputale,Uva,4332,7246,11578,173280,289840,463120
3/9/2025,Piumi Premarathna,Badulla,Haputale,Uva,5742,7495,13237,229680,299800,529480
3/10/2025,Piumi Premarathna,Badulla,Haputale,Uva,7587,5556,13143,303480,222240,525720
3/11/2025,Piumi Premarathna,Badulla,Haputale,Uva,4009,1121,5130,160360,44840,205200
3/12/2025,Piumi Premarathna,Badulla,Haputale,Uva,2849,993,3842,113960,39720,153680
3/13/2025,Piumi Premarathna,Badulla,Haputale,Uva,5355,8270,13625,214200,330800,545000
3/14/2025,Piumi Premarathna,Badulla,Haputale,Uva,1497,7505,9002,59880,300200,360080
3/15/2025,Piumi Premarathna,Badulla,Haputale,Uva,9118,1445,10563,364720,57800,422520
3/16/2025,Piumi Premarathna,Badulla,Haputale,Uva,4843,1272,6115,193720,50880,244600
3/17/2025,Piumi Premarathna,Badulla,Haputale,Uva,3656,6922,10578,146240,276880,423120
3/18/2025,Piumi Premarathna,Badulla,Haputale,Uva,5596,8847,14443,223840,353880,577720
3/19/2025,Piumi Premarathna,Badulla,Haputale,Uva,653,8457,9110,26120,338280,364400
3/20/2025,Piumi Premarathna,Badulla,Haputale,Uva,1603,5654,7257,64120,226160,290280
3/21/2025,Piumi Premarathna,Badulla,Haputale,Uva,5240,2808,8048,209600,112320,321920
3/22/2025,Piumi Premarathna,Badulla,Haputale,Uva,3169,806,3975,126760,32240,159000
3/23/2025,Piumi Premarathna,Badulla,Haputale,Uva,9155,5589,14744,366200,223560,589760
3/25/2024,Nayanathara Perera,Galle,Unawatuna,Southern,8812,9547,18359,352480,381880,734360
3/26/2024,Nayanathara Perera,Galle,Unawatuna,Southern,6684,5094,11778,267360,203760,471120
3/27/2024,Nayanathara Perera,Galle,Unawatuna,Southern,5725,4212,9937,229000,168480,397480
3/28/2024,Nayanathara Perera,Galle,Unawatuna,Southern,5028,8537,13565,201120,341480,542600
3/29/2024,Nayanathara Perera,Galle,Unawatuna,Southern,6314,5022,11336,252560,200880,453440
3/30/2024,Nayanathara Perera,Galle,Unawatuna,Southern,3140,8611,11751,125600,344440,470040
3/31/2024,Nayanathara Perera,Galle,Unawatuna,Southern,6202,2520,8722,248080,100800,348880
4/1/2024,Nayanathara Perera,Galle,Unawatuna,Southern,2060,6887,8947,82400,275480,357880
4/2/2024,Nayanathara Perera,Galle,Unawatuna,Southern,1079,4749,5828,43160,189960,233120
4/3/2024,Nayanathara Perera,Galle,Unawatuna,Southern,8616,2915,11531,344640,116600,461240
4/4/2024,Nayanathara Perera,Galle,Unawatuna,Southern,8645,4634,13279,345800,185360,531160
4/5/2024,Nayanathara Perera,Galle,Unawatuna,Southern,1295,6130,7425,51800,245200,297000
4/6/2024,Nayanathara Perera,Galle,Unawatuna,Southern,4766,1834,6600,190640,73360,264000
4/7/2024,Nayanathara Perera,Galle,Unawatuna,Southern,5132,4122,9254,205280,164880,370160
4/8/2024,Nayanathara Perera,Galle,Unawatuna,Southern,2744,2629,5373,109760,105160,214920
4/9/2024,Nayanathara Perera,Galle,Unawatuna,Southern,8470,1734,10204,338800,69360,408160
4/10/2024,Nayanathara Perera,Galle,Unawatuna,Southern,6812,4607,11419,272480,184280,456760
4/11/2024,Nayanathara Perera,Galle,Unawatuna,Southern,3269,4080,7349,130760,163200,293960
4/19/2024,Nayanathara Perera,Galle,Unawatuna,Southern,203,8646,8849,8120,345840,353960
4/20/2024,Nayanathara Perera,Galle,Unawatuna,Southern,7786,9440,17226,311440,377600,689040
4/21/2024,Nayanathara Perera,Galle,Unawatuna,Southern,7523,5123,12646,300920,204920,505840
4/22/2024,Nayanathara Perera,Galle,Unawatuna,Southern,6239,7998,14237,249560,319920,569480
4/23/2024,Nayanathara Perera,Galle,Unawatuna,Southern,3497,4550,8047,139880,182000,321880
4/24/2024,Nayanathara Perera,Galle,Unawatuna,Southern,6723,575,7298,268920,23000,291920
4/25/2024,Nayanathara Perera,Galle,Unawatuna,Southern,7444,1351,8795,297760,54040,351800
4/26/2024,Nayanathara Perera,Galle,Unawatuna,Southern,1319,8188,9507,52760,327520,380280
4/27/2024,Nayanathara Perera,Galle,Unawatuna,Southern,9800,3845,13645,392000,153800,545800
4/28/2024,Nayanathara Perera,Galle,Unawatuna,Southern,4789,7880,12669,191560,315200,506760
4/29/2024,Nayanathara Perera,Galle,Unawatuna,Southern,3692,3175,6867,147680,127000,274680
4/30/2024,Nayanathara Perera,Galle,Unawatuna,Southern,2935,7334,10269,117400,293360,410760
5/1/2024,Nayanathara Perera,Galle,Unawatuna,Southern,9451,7079,16530,378040,283160,661200
5/2/2024,Nayanathara Perera,Galle,Unawatuna,Southern,4486,5475,9961,179440,219000,398440
5/3/2024,Nayanathara Perera,Galle,Unawatuna,Southern,3334,4609,7943,133360,184360,317720
5/4/2024,Nayanathara Perera,Galle,Unawatuna,Southern,4616,5893,10509,184640,235720,420360
5/5/2024,Nayanathara Perera,Galle,Unawatuna,Southern,429,7287,7716,17160,291480,308640
5/6/2024,Nayanathara Perera,Galle,Unawatuna,Southern,4127,1977,6104,165080,79080,244160
5/7/2024,Nayanathara Perera,Galle,Unawatuna,Southern,6541,3752,10293,261640,150080,411720
5/8/2024,Nayanathara Perera,Galle,Unawatuna,Southern,9364,6022,15386,374560,240880,615440
5/9/2024,Nayanathara Perera,Galle,Unawatuna,Southern,750,6552,7302,30000,262080,292080
5/10/2024,Nayanathara Perera,Galle,Unawatuna,Southern,8620,9952,18572,344800,398080,742880
5/11/2024,Nayanathara Perera,Galle,Unawatuna,Southern,8928,6279,15207,357120,251160,608280
5/12/2024,Nayanathara Perera,Galle,Unawatuna,Southern,7406,9877,17283,296240,395080,691320
5/13/2024,Nayanathara Perera,Galle,Unawatuna,Southern,7513,7340,14853,300520,293600,594120
5/14/2024,Nayanathara Perera,Galle,Unawatuna,Southern,8053,831,8884,322120,33240,355360
5/15/2024,Nayanathara Perera,Galle,Unawatuna,Southern,6719,172,6891,268760,6880,275640
5/16/2024,Nayanathara Perera,Galle,Unawatuna,Southern,9163,8577,17740,366520,343080,709600
5/17/2024,Nayanathara Perera,Galle,Unawatuna,Southern,6469,128,6597,258760,5120,263880
5/18/2024,Nayanathara Perera,Galle,Unawatuna,Southern,3497,5303,8800,139880,212120,352000
5/19/2024,Nayanathara Perera,Galle,Unawatuna,Southern,3645,2540,6185,145800,101600,247400
5/20/2024,Nayanathara Perera,Galle,Unawatuna,Southern,8328,8712,17040,333120,348480,681600
5/21/2024,Nayanathara Perera,Galle,Unawatuna,Southern,8886,3414,12300,355440,136560,492000
5/22/2024,Nayanathara Perera,Galle,Unawatuna,Southern,6169,7507,13676,246760,300280,547040
5/24/2024,Nayanathara Perera,Galle,Unawatuna,Southern,2851,2731,5582,114040,109240,223280
5/25/2024,Nayanathara Perera,Galle,Unawatuna,Southern,6864,1275,8139,274560,51000,325560
5/26/2024,Nayanathara Perera,Galle,Unawatuna,Southern,9289,5850,15139,371560,234000,605560
5/27/2024,Nayanathara Perera,Galle,Unawatuna,Southern,5694,8207,13901,227760,328280,556040
5/28/2024,Nayanathara Perera,Galle,Unawatuna,Southern,1727,7794,9521,69080,311760,380840
5/29/2024,Nayanathara Perera,Galle,Unawatuna,Southern,1669,2738,4407,66760,109520,176280
5/30/2024,Nayanathara Perera,Galle,Unawatuna,Southern,4204,7496,11700,168160,299840,468000
5/31/2024,Nayanathara Perera,Galle,Unawatuna,Southern,1080,5943,7023,43200,237720,280920
6/1/2024,Nayanathara Perera,Galle,Unawatuna,Southern,6278,548,6826,251120,21920,273040
6/2/2024,Nayanathara Perera,Galle,Unawatuna,Southern,1896,5964,7860,75840,238560,314400
6/3/2024,Nayanathara Perera,Galle,Unawatuna,Southern,5039,7256,12295,201560,290240,491800
6/4/2024,Nayanathara Perera,Galle,Unawatuna,Southern,1759,7529,9288,70360,301160,371520
6/5/2024,Nayanathara Perera,Galle,Unawatuna,Southern,5590,1793,7383,223600,71720,295320
6/6/2024,Nayanathara Perera,Galle,Unawatuna,Southern,9171,365,9536,366840,14600,381440
6/7/2024,Nayanathara Perera,Galle,Unawatuna,Southern,1637,4042,5679,65480,161680,227160
6/8/2024,Nayanathara Perera,Galle,Unawatuna,Southern,3103,8539,11642,124120,341560,465680
6/9/2024,Nayanathara Perera,Galle,Unawatuna,Southern,965,8314,9279,38600,332560,371160
6/10/2024,Nayanathara Perera,Galle,Unawatuna,Southern,6448,8267,14715,257920,330680,588600
6/11/2024,Nayanathara Perera,Galle,Unawatuna,Southern,3073,8190,11263,122920,327600,450520
6/12/2024,Nayanathara Perera,Galle,Unawatuna,Southern,8872,656,9528,354880,26240,381120
6/13/2024,Nayanathara Perera,Galle,Unawatuna,Southern,5259,8987,14246,210360,359480,569840
6/14/2024,Nayanathara Perera,Galle,Unawatuna,Southern,467,8275,8742,18680,331000,349680
6/15/2024,Nayanathara Perera,Galle,Unawatuna,Southern,6731,8612,15343,269240,344480,613720
6/16/2024,Nayanathara Perera,Galle,Unawatuna,Southern,8885,1437,10322,355400,57480,412880
6/17/2024,Nayanathara Perera,Galle,Unawatuna,Southern,8569,8387,16956,342760,335480,678240
6/18/2024,Nayanathara Perera,Galle,Unawatuna,Southern,4566,6570,11136,182640,262800,445440
6/19/2024,Nayanathara Perera,Galle,Unawatuna,Southern,8647,3968,12615,345880,158720,504600
6/20/2024,Nayanathara Perera,Galle,Unawatuna,Southern,1715,3610,5325,68600,144400,213000
6/21/2024,Nayanathara Perera,Galle,Unawatuna,Southern,8445,2710,11155,337800,108400,446200
6/22/2024,Nayanathara Perera,Galle,Unawatuna,Southern,6195,1727,7922,247800,69080,316880
6/23/2024,Nayanathara Perera,Galle,Unawatuna,Southern,426,1,427,17040,40,17080
6/24/2024,Nayanathara Perera,Galle,Unawatuna,Southern,2271,4311,6582,90840,172440,263280
6/25/2024,Nayanathara Perera,Galle,Unawatuna,Southern,8358,6812,15170,334320,272480,606800
6/26/2024,Nayanathara Perera,Galle,Unawatuna,Southern,5802,9424,15226,232080,376960,609040
6/27/2024,Nayanathara Perera,Galle,Unawatuna,Southern,1811,4249,6060,72440,169960,242400
6/28/2024,Nayanathara Perera,Galle,Unawatuna,Southern,8066,2005,10071,322640,80200,402840
6/29/2024,Nayanathara Perera,Galle,Unawatuna,Southern,4452,3353,7805,178080,134120,312200
6/30/2024,Nayanathara Perera,Galle,Unawatuna,Southern,3156,3618,6774,126240,144720,270960
7/1/2024,Nayanathara Perera,Galle,Unawatuna,Southern,9776,6436,16212,391040,257440,648480
7/2/2024,Nayanathara Perera,Galle,Unawatuna,Southern,395,5455,5850,15800,218200,234000
7/3/2024,Nayanathara Perera,Galle,Unawatuna,Southern,7323,937,8260,292920,37480,330400
7/4/2024,Nayanathara Perera,Galle,Unawatuna,Southern,6511,1384,7895,260440,55360,315800
7/5/2024,Nayanathara Perera,Galle,Unawatuna,Southern,8719,8779,17498,348760,351160,699920
7/6/2024,Nayanathara Perera,Galle,Unawatuna,Southern,3317,4619,7936,132680,184760,317440
7/7/2024,Nayanathara Perera,Galle,Unawatuna,Southern,218,9569,9787,8720,382760,391480
7/8/2024,Nayanathara Perera,Galle,Unawatuna,Southern,4874,1503,6377,194960,60120,255080
7/9/2024,Nayanathara Perera,Galle,Unawatuna,Southern,6767,1561,8328,270680,62440,333120
7/10/2024,Nayanathara Perera,Galle,Unawatuna,Southern,4828,2269,7097,193120,90760,283880
7/11/2024,Nayanathara Perera,Galle,Unawatuna,Southern,1667,8810,10477,66680,352400,419080
7/12/2024,Nayanathara Perera,Galle,Unawatuna,Southern,8820,1773,10593,352800,70920,423720
7/13/2024,Nayanathara Perera,Galle,Unawatuna,Southern,8476,5250,13726,339040,210000,549040
7/14/2024,Nayanathara Perera,Galle,Unawatuna,Southern,8279,9642,17921,331160,385680,716840
7/15/2024,Nayanathara Perera,Galle,Unawatuna,Southern,5962,2278,8240,238480,91120,329600
7/16/2024,Nayanathara Perera,Galle,Unawatuna,Southern,5723,5815,11538,228920,232600,461520
7/17/2024,Nayanathara Perera,Galle,Unawatuna,Southern,7792,1278,9070,311680,51120,362800
7/18/2024,Nayanathara Perera,Galle,Unawatuna,Southern,4790,9734,14524,191600,389360,580960
7/19/2024,Nayanathara Perera,Galle,Unawatuna,Southern,52,5294,5346,2080,211760,213840
7/20/2024,Nayanathara Perera,Galle,Unawatuna,Southern,1812,5218,7030,72480,208720,281200
7/21/2024,Nayanathara Perera,Galle,Unawatuna,Southern,2782,2219,5001,111280,88760,200040
7/22/2024,Nayanathara Perera,Galle,Unawatuna,Southern,7898,3007,10905,315920,120280,436200
7/23/2024,Nayanathara Perera,Galle,Unawatuna,Southern,10000,6698,16698,400000,267920,667920
7/24/2024,Nayanathara Perera,Galle,Unawatuna,Southern,686,6869,7555,27440,274760,302200
7/25/2024,Nayanathara Perera,Galle,Unawatuna,Southern,1267,6151,7418,50680,246040,296720
7/26/2024,Nayanathara Perera,Galle,Unawatuna,Southern,6803,5918,12721,272120,236720,508840
7/27/2024,Nayanathara Perera,Galle,Unawatuna,Southern,2330,7351,9681,93200,294040,387240
7/28/2024,Nayanathara Perera,Galle,Unawatuna,Southern,6006,1703,7709,240240,68120,308360
7/29/2024,Nayanathara Perera,Galle,Unawatuna,Southern,8182,5273,13455,327280,210920,538200
7/30/2024,Nayanathara Perera,Galle,Unawatuna,Southern,6976,8473,15449,279040,338920,617960
7/31/2024,Nayanathara Perera,Galle,Unawatuna,Southern,2116,3495,5611,84640,139800,224440
8/1/2024,Nayanathara Perera,Galle,Unawatuna,Southern,1068,6505,7573,42720,260200,302920
8/2/2024,Nayanathara Perera,Galle,Unawatuna,Southern,1887,7545,9432,75480,301800,377280
8/3/2024,Nayanathara Perera,Galle,Unawatuna,Southern,2006,3414,5420,80240,136560,216800
8/4/2024,Nayanathara Perera,Galle,Unawatuna,Southern,3822,950,4772,152880,38000,190880
8/5/2024,Nayanathara Perera,Galle,Unawatuna,Southern,9878,2638,12516,395120,105520,500640
8/6/2024,Nayanathara Perera,Galle,Unawatuna,Southern,1219,6396,7615,48760,255840,304600
8/7/2024,Nayanathara Perera,Galle,Unawatuna,Southern,5865,5378,11243,234600,215120,449720
8/8/2024,Nayanathara Perera,Galle,Unawatuna,Southern,8441,6738,15179,337640,269520,607160
8/9/2024,Nayanathara Perera,Galle,Unawatuna,Southern,8587,6840,15427,343480,273600,617080
8/10/2024,Nayanathara Perera,Galle,Unawatuna,Southern,1939,7493,9432,77560,299720,377280
8/11/2024,Nayanathara Perera,Galle,Unawatuna,Southern,9210,1298,10508,368400,51920,420320
8/12/2024,Nayanathara Perera,Galle,Unawatuna,Southern,6918,2932,9850,276720,117280,394000
8/13/2024,Nayanathara Perera,Galle,Unawatuna,Southern,2942,8199,11141,117680,327960,445640
8/14/2024,Nayanathara Perera,Galle,Unawatuna,Southern,4825,5633,10458,193000,225320,418320
8/15/2024,Nayanathara Perera,Galle,Unawatuna,Southern,2153,5188,7341,86120,207520,293640
8/16/2024,Nayanathara Perera,Galle,Unawatuna,Southern,9607,9392,18999,384280,375680,759960
8/17/2024,Nayanathara Perera,Galle,Unawatuna,Southern,5877,117,5994,235080,4680,239760
8/18/2024,Nayanathara Perera,Galle,Unawatuna,Southern,5398,8232,13630,215920,329280,545200
8/19/2024,Nayanathara Perera,Galle,Unawatuna,Southern,5496,5526,11022,219840,221040,440880
8/20/2024,Nayanathara Perera,Galle,Unawatuna,Southern,1036,8689,9725,41440,347560,389000
8/21/2024,Nayanathara Perera,Galle,Unawatuna,Southern,43,9559,9602,1720,382360,384080
8/22/2024,Nayanathara Perera,Galle,Unawatuna,Southern,2825,5099,7924,113000,203960,316960
8/23/2024,Nayanathara Perera,Galle,Unawatuna,Southern,5497,6399,11896,219880,255960,475840
8/24/2024,Nayanathara Perera,Galle,Unawatuna,Southern,4813,1585,6398,192520,63400,255920
8/25/2024,Nayanathara Perera,Galle,Unawatuna,Southern,5723,586,6309,228920,23440,252360
8/26/2024,Nayanathara Perera,Galle,Unawatuna,Southern,147,1221,1368,5880,48840,54720
8/27/2024,Nayanathara Perera,Galle,Unawatuna,Southern,1593,8632,10225,63720,345280,409000
8/28/2024,Nayanathara Perera,Galle,Unawatuna,Southern,2876,8555,11431,115040,342200,457240
8/29/2024,Nayanathara Perera,Galle,Unawatuna,Southern,3390,4020,7410,135600,160800,296400
8/30/2024,Nayanathara Perera,Galle,Unawatuna,Southern,1446,7026,8472,57840,281040,338880
8/31/2024,Nayanathara Perera,Galle,Unawatuna,Southern,4169,8948,13117,166760,357920,524680
9/1/2024,Nayanathara Perera,Galle,Unawatuna,Southern,3411,3777,7188,136440,151080,287520
9/2/2024,Nayanathara Perera,Galle,Unawatuna,Southern,8103,8030,16133,324120,321200,645320
9/3/2024,Nayanathara Perera,Galle,Unawatuna,Southern,3656,5635,9291,146240,225400,371640
9/4/2024,Nayanathara Perera,Galle,Unawatuna,Southern,9891,5926,15817,395640,237040,632680
9/5/2024,Nayanathara Perera,Galle,Unawatuna,Southern,9124,9405,18529,364960,376200,741160
9/6/2024,Nayanathara Perera,Galle,Unawatuna,Southern,5710,1367,7077,228400,54680,283080
9/7/2024,Nayanathara Perera,Galle,Unawatuna,Southern,2555,2852,5407,102200,114080,216280
9/8/2024,Nayanathara Perera,Galle,Unawatuna,Southern,988,950,1938,39520,38000,77520
9/9/2024,Nayanathara Perera,Galle,Unawatuna,Southern,5915,6862,12777,236600,274480,511080
9/10/2024,Nayanathara Perera,Galle,Unawatuna,Southern,7701,3179,10880,308040,127160,435200
9/11/2024,Nayanathara Perera,Galle,Unawatuna,Southern,8051,7643,15694,322040,305720,627760
9/12/2024,Nayanathara Perera,Galle,Unawatuna,Southern,9292,7446,16738,371680,297840,669520
9/13/2024,Nayanathara Perera,Galle,Unawatuna,Southern,8132,5931,14063,325280,237240,562520
9/14/2024,Nayanathara Perera,Galle,Unawatuna,Southern,3451,402,3853,138040,16080,154120
9/15/2024,Nayanathara Perera,Galle,Unawatuna,Southern,8540,5871,14411,341600,234840,576440
9/16/2024,Nayanathara Perera,Galle,Unawatuna,Southern,3800,7013,10813,152000,280520,432520
9/17/2024,Nayanathara Perera,Galle,Unawatuna,Southern,6532,5695,12227,261280,227800,489080
9/18/2024,Nayanathara Perera,Galle,Unawatuna,Southern,4299,8424,12723,171960,336960,508920
9/19/2024,Nayanathara Perera,Galle,Unawatuna,Southern,483,7604,8087,19320,304160,323480
9/20/2024,Nayanathara Perera,Galle,Unawatuna,Southern,8025,9104,17129,321000,364160,685160
9/21/2024,Nayanathara Perera,Galle,Unawatuna,Southern,1551,360,1911,62040,14400,76440
9/22/2024,Nayanathara Perera,Galle,Unawatuna,Southern,9010,3688,12698,360400,147520,507920
9/23/2024,Nayanathara Perera,Galle,Unawatuna,Southern,4356,8878,13234,174240,355120,529360
9/24/2024,Nayanathara Perera,Galle,Unawatuna,Southern,1763,1965,3728,70520,78600,149120
9/25/2024,Nayanathara Perera,Galle,Unawatuna,Southern,7683,133,7816,307320,5320,312640
9/26/2024,Nayanathara Perera,Galle,Unawatuna,Southern,9023,6957,15980,360920,278280,639200
9/27/2024,Nayanathara Perera,Galle,Unawatuna,Southern,2960,6496,9456,118400,259840,378240
9/28/2024,Nayanathara Perera,Galle,Unawatuna,Southern,9416,7207,16623,376640,288280,664920
9/29/2024,Nayanathara Perera,Galle,Unawatuna,Southern,5591,2586,8177,223640,103440,327080
9/30/2024,Nayanathara Perera,Galle,Unawatuna,Southern,6340,1360,7700,253600,54400,308000
10/1/2024,Nayanathara Perera,Galle,Unawatuna,Southern,8387,5285,13672,335480,211400,546880
10/2/2024,Nayanathara Perera,Galle,Unawatuna,Southern,5226,7869,13095,209040,314760,523800
10/3/2024,Nayanathara Perera,Galle,Unawatuna,Southern,7241,5219,12460,289640,208760,498400
10/4/2024,Nayanathara Perera,Galle,Unawatuna,Southern,747,6231,6978,29880,249240,279120
10/5/2024,Nayanathara Perera,Galle,Unawatuna,Southern,3604,1986,5590,144160,79440,223600
10/6/2024,Nayanathara Perera,Galle,Unawatuna,Southern,7724,6256,13980,308960,250240,559200
10/7/2024,Nayanathara Perera,Galle,Unawatuna,Southern,9809,350,10159,392360,14000,406360
10/8/2024,Nayanathara Perera,Galle,Unawatuna,Southern,650,6126,6776,26000,245040,271040
10/9/2024,Nayanathara Perera,Galle,Unawatuna,Southern,6470,4994,11464,258800,199760,458560
10/10/2024,Nayanathara Perera,Galle,Unawatuna,Southern,8479,1762,10241,339160,70480,409640
10/11/2024,Nayanathara Perera,Galle,Unawatuna,Southern,8184,8230,16414,327360,329200,656560
10/12/2024,Nayanathara Perera,Galle,Unawatuna,Southern,9930,4808,14738,397200,192320,589520
10/13/2024,Nayanathara Perera,Galle,Unawatuna,Southern,5344,7025,12369,213760,281000,494760
10/14/2024,Nayanathara Perera,Galle,Unawatuna,Southern,5927,4813,10740,237080,192520,429600
10/15/2024,Nayanathara Perera,Galle,Unawatuna,Southern,2167,3167,5334,86680,126680,213360
10/16/2024,Nayanathara Perera,Galle,Unawatuna,Southern,1198,3592,4790,47920,143680,191600
10/17/2024,Nayanathara Perera,Galle,Unawatuna,Southern,6095,2930,9025,243800,117200,361000
10/18/2024,Nayanathara Perera,Galle,Unawatuna,Southern,5778,4305,10083,231120,172200,403320
10/19/2024,Nayanathara Perera,Galle,Unawatuna,Southern,7324,7233,14557,292960,289320,582280
10/20/2024,Nayanathara Perera,Galle,Unawatuna,Southern,4468,1884,6352,178720,75360,254080
10/21/2024,Nayanathara Perera,Galle,Unawatuna,Southern,9694,7202,16896,387760,288080,675840
10/22/2024,Nayanathara Perera,Galle,Unawatuna,Southern,4031,6415,10446,161240,256600,417840
10/23/2024,Nayanathara Perera,Galle,Unawatuna,Southern,3963,2864,6827,158520,114560,273080
10/24/2024,Nayanathara Perera,Galle,Unawatuna,Southern,7054,2261,9315,282160,90440,372600
10/25/2024,Nayanathara Perera,Galle,Unawatuna,Southern,1895,2191,4086,75800,87640,163440
10/26/2024,Nayanathara Perera,Galle,Unawatuna,Southern,7591,6387,13978,303640,255480,559120
10/27/2024,Nayanathara Perera,Galle,Unawatuna,Southern,2131,7881,10012,85240,315240,400480
10/28/2024,Nayanathara Perera,Galle,Unawatuna,Southern,4108,6095,10203,164320,243800,408120
10/29/2024,Nayanathara Perera,Galle,Unawatuna,Southern,1344,7986,9330,53760,319440,373200
10/30/2024,Nayanathara Perera,Galle,Unawatuna,Southern,8020,7048,15068,320800,281920,602720
10/31/2024,Nayanathara Perera,Galle,Unawatuna,Southern,5706,1184,6890,228240,47360,275600
11/1/2024,Nayanathara Perera,Galle,Unawatuna,Southern,723,6740,7463,28920,269600,298520
11/2/2024,Nayanathara Perera,Galle,Unawatuna,Southern,6670,9363,16033,266800,374520,641320
11/3/2024,Nayanathara Perera,Galle,Unawatuna,Southern,1666,4044,5710,66640,161760,228400
11/4/2024,Nayanathara Perera,Galle,Unawatuna,Southern,6150,5819,11969,246000,232760,478760
11/5/2024,Nayanathara Perera,Galle,Unawatuna,Southern,7630,1547,9177,305200,61880,367080
11/6/2024,Nayanathara Perera,Galle,Unawatuna,Southern,9350,8321,17671,374000,332840,706840
11/7/2024,Nayanathara Perera,Galle,Unawatuna,Southern,83,1787,1870,3320,71480,74800
11/8/2024,Nayanathara Perera,Galle,Unawatuna,Southern,9691,3012,12703,387640,120480,508120
11/9/2024,Nayanathara Perera,Galle,Unawatuna,Southern,3985,944,4929,159400,37760,197160
11/10/2024,Nayanathara Perera,Galle,Unawatuna,Southern,2566,2507,5073,102640,100280,202920
11/11/2024,Nayanathara Perera,Galle,Unawatuna,Southern,9304,522,9826,372160,20880,393040
11/12/2024,Nayanathara Perera,Galle,Unawatuna,Southern,9259,8318,17577,370360,332720,703080
11/13/2024,Nayanathara Perera,Galle,Unawatuna,Southern,9737,7032,16769,389480,281280,670760
11/14/2024,Nayanathara Perera,Galle,Unawatuna,Southern,8278,546,8824,331120,21840,352960
11/15/2024,Nayanathara Perera,Galle,Unawatuna,Southern,4715,9600,14315,188600,384000,572600
11/16/2024,Nayanathara Perera,Galle,Unawatuna,Southern,5614,4525,10139,224560,181000,405560
11/17/2024,Nayanathara Perera,Galle,Unawatuna,Southern,163,4049,4212,6520,161960,168480
11/18/2024,Nayanathara Perera,Galle,Unawatuna,Southern,7638,2764,10402,305520,110560,416080
11/19/2024,Nayanathara Perera,Galle,Unawatuna,Southern,9239,8677,17916,369560,347080,716640
11/20/2024,Nayanathara Perera,Galle,Unawatuna,Southern,6435,2941,9376,257400,117640,375040
11/21/2024,Nayanathara Perera,Galle,Unawatuna,Southern,9922,3009,12931,396880,120360,517240
11/22/2024,Nayanathara Perera,Galle,Unawatuna,Southern,3164,8992,12156,126560,359680,486240
11/23/2024,Nayanathara Perera,Galle,Unawatuna,Southern,6857,8063,14920,274280,322520,596800
11/24/2024,Nayanathara Perera,Galle,Unawatuna,Southern,1455,9960,11415,58200,398400,456600
11/25/2024,Nayanathara Perera,Galle,Unawatuna,Southern,9153,2376,11529,366120,95040,461160
11/26/2024,Nayanathara Perera,Galle,Unawatuna,Southern,5379,6453,11832,215160,258120,473280
11/27/2024,Nayanathara Perera,Galle,Unawatuna,Southern,3656,7544,11200,146240,301760,448000
11/28/2024,Nayanathara Perera,Galle,Unawatuna,Southern,6626,5008,11634,265040,200320,465360
11/29/2024,Nayanathara Perera,Galle,Unawatuna,Southern,1159,1588,2747,46360,63520,109880
11/30/2024,Nayanathara Perera,Galle,Unawatuna,Southern,4585,9327,13912,183400,373080,556480
12/1/2024,Nayanathara Perera,Galle,Unawatuna,Southern,9646,9635,19281,385840,385400,771240
12/2/2024,Nayanathara Perera,Galle,Unawatuna,Southern,7207,6972,14179,288280,278880,567160
12/3/2024,Nayanathara Perera,Galle,Unawatuna,Southern,1705,2260,3965,68200,90400,158600
12/4/2024,Nayanathara Perera,Galle,Unawatuna,Southern,4812,4785,9597,192480,191400,383880
12/5/2024,Nayanathara Perera,Galle,Unawatuna,Southern,7537,5789,13326,301480,231560,533040
12/6/2024,Nayanathara Perera,Galle,Unawatuna,Southern,2095,4429,6524,83800,177160,260960
12/7/2024,Nayanathara Perera,Galle,Unawatuna,Southern,4560,4771,9331,182400,190840,373240
12/8/2024,Nayanathara Perera,Galle,Unawatuna,Southern,4451,3486,7937,178040,139440,317480
12/9/2024,Nayanathara Perera,Galle,Unawatuna,Southern,7212,2721,9933,288480,108840,397320
12/10/2024,Nayanathara Perera,Galle,Unawatuna,Southern,3584,1852,5436,143360,74080,217440
12/11/2024,Nayanathara Perera,Galle,Unawatuna,Southern,1517,8174,9691,60680,326960,387640
12/12/2024,Nayanathara Perera,Galle,Unawatuna,Southern,8543,6494,15037,341720,259760,601480
12/13/2024,Nayanathara Perera,Galle,Unawatuna,Southern,4459,7299,11758,178360,291960,470320
12/14/2024,Nayanathara Perera,Galle,Unawatuna,Southern,9077,3643,12720,363080,145720,508800
12/15/2024,Nayanathara Perera,Galle,Unawatuna,Southern,3830,4306,8136,153200,172240,325440
12/16/2024,Nayanathara Perera,Galle,Unawatuna,Southern,6995,442,7437,279800,17680,297480
12/17/2024,Nayanathara Perera,Galle,Unawatuna,Southern,613,9957,10570,24520,398280,422800
12/18/2024,Nayanathara Perera,Galle,Unawatuna,Southern,8604,7878,16482,344160,315120,659280
12/19/2024,Nayanathara Perera,Galle,Unawatuna,Southern,6010,6837,12847,240400,273480,513880
12/20/2024,Nayanathara Perera,Galle,Unawatuna,Southern,7780,9573,17353,311200,382920,694120
12/21/2024,Nayanathara Perera,Galle,Unawatuna,Southern,8961,3321,12282,358440,132840,491280
12/22/2024,Nayanathara Perera,Galle,Unawatuna,Southern,9474,1944,11418,378960,77760,456720
12/23/2024,Nayanathara Perera,Galle,Unawatuna,Southern,1515,1763,3278,60600,70520,131120
12/24/2024,Nayanathara Perera,Galle,Unawatuna,Southern,7423,4492,11915,296920,179680,476600
12/25/2024,Nayanathara Perera,Galle,Unawatuna,Southern,5126,6640,11766,205040,265600,470640
12/26/2024,Nayanathara Perera,Galle,Unawatuna,Southern,1133,1897,3030,45320,75880,121200
12/27/2024,Nayanathara Perera,Galle,Unawatuna,Southern,2555,4645,7200,102200,185800,288000
12/28/2024,Nayanathara Perera,Galle,Unawatuna,Southern,9279,7045,16324,371160,281800,652960
12/29/2024,Nayanathara Perera,Galle,Unawatuna,Southern,5650,1760,7410,226000,70400,296400
12/30/2024,Nayanathara Perera,Galle,Unawatuna,Southern,5711,1326,7037,228440,53040,281480
12/31/2024,Nayanathara Perera,Galle,Unawatuna,Southern,8086,6875,14961,323440,275000,598440
1/1/2025,Nayanathara Perera,Galle,Unawatuna,Southern,1850,4229,6079,74000,169160,243160
1/2/2025,Nayanathara Perera,Galle,Unawatuna,Southern,8789,4253,13042,351560,170120,521680
1/3/2025,Nayanathara Perera,Galle,Unawatuna,Southern,253,3261,3514,10120,130440,140560
1/4/2025,Nayanathara Perera,Galle,Unawatuna,Southern,7594,578,8172,303760,23120,326880
1/5/2025,Nayanathara Perera,Galle,Unawatuna,Southern,5494,813,6307,219760,32520,252280
1/6/2025,Nayanathara Perera,Galle,Unawatuna,Southern,6201,1476,7677,248040,59040,307080
1/7/2025,Nayanathara Perera,Galle,Unawatuna,Southern,7488,482,7970,299520,19280,318800
1/8/2025,Nayanathara Perera,Galle,Unawatuna,Southern,4574,3750,8324,182960,150000,332960
1/9/2025,Nayanathara Perera,Galle,Unawatuna,Southern,5990,2626,8616,239600,105040,344640
1/10/2025,Nayanathara Perera,Galle,Unawatuna,Southern,7379,7626,15005,295160,305040,600200
1/11/2025,Nayanathara Perera,Galle,Unawatuna,Southern,5651,6107,11758,226040,244280,470320
1/12/2025,Nayanathara Perera,Galle,Unawatuna,Southern,1582,1106,2688,63280,44240,107520
1/13/2025,Nayanathara Perera,Galle,Unawatuna,Southern,81,3712,3793,3240,148480,151720
1/14/2025,Nayanathara Perera,Galle,Unawatuna,Southern,15,7992,8007,600,319680,320280
1/15/2025,Nayanathara Perera,Galle,Unawatuna,Southern,1243,1577,2820,49720,63080,112800
1/16/2025,Nayanathara Perera,Galle,Unawatuna,Southern,6399,6346,12745,255960,253840,509800
1/17/2025,Nayanathara Perera,Galle,Unawatuna,Southern,1322,6602,7924,52880,264080,316960
1/18/2025,Nayanathara Perera,Galle,Unawatuna,Southern,2694,162,2856,107760,6480,114240
1/19/2025,Nayanathara Perera,Galle,Unawatuna,Southern,623,9061,9684,24920,362440,387360
1/20/2025,Nayanathara Perera,Galle,Unawatuna,Southern,9965,2142,12107,398600,85680,484280
1/21/2025,Nayanathara Perera,Galle,Unawatuna,Southern,4710,5318,10028,188400,212720,401120
1/22/2025,Nayanathara Perera,Galle,Unawatuna,Southern,4048,5171,9219,161920,206840,368760
1/23/2025,Nayanathara Perera,Galle,Unawatuna,Southern,8152,7905,16057,326080,316200,642280
1/24/2025,Nayanathara Perera,Galle,Unawatuna,Southern,4223,66,4289,168920,2640,171560
1/25/2025,Nayanathara Perera,Galle,Unawatuna,Southern,6194,8526,14720,247760,341040,588800
1/26/2025,Nayanathara Perera,Galle,Unawatuna,Southern,5015,8755,13770,200600,350200,550800
1/27/2025,Nayanathara Perera,Galle,Unawatuna,Southern,2848,8728,11576,113920,349120,463040
1/28/2025,Nayanathara Perera,Galle,Unawatuna,Southern,5165,5638,10803,206600,225520,432120
1/29/2025,Nayanathara Perera,Galle,Unawatuna,Southern,7605,9843,17448,304200,393720,697920
1/30/2025,Nayanathara Perera,Galle,Unawatuna,Southern,97,2847,2944,3880,113880,117760
1/31/2025,Nayanathara Perera,Galle,Unawatuna,Southern,7387,7530,14917,295480,301200,596680
2/1/2025,Nayanathara Perera,Galle,Unawatuna,Southern,1864,4408,6272,74560,176320,250880
2/2/2025,Nayanathara Perera,Galle,Unawatuna,Southern,1348,2649,3997,53920,105960,159880
2/3/2025,Nayanathara Perera,Galle,Unawatuna,Southern,9509,7131,16640,380360,285240,665600
2/4/2025,Nayanathara Perera,Galle,Unawatuna,Southern,2745,2138,4883,109800,85520,195320
2/5/2025,Nayanathara Perera,Galle,Unawatuna,Southern,81,7300,7381,3240,292000,295240
2/6/2025,Nayanathara Perera,Galle,Unawatuna,Southern,3341,6637,9978,133640,265480,399120
2/7/2025,Nayanathara Perera,Galle,Unawatuna,Southern,7798,669,8467,311920,26760,338680
2/8/2025,Nayanathara Perera,Galle,Unawatuna,Southern,2604,4978,7582,104160,199120,303280
2/9/2025,Nayanathara Perera,Galle,Unawatuna,Southern,3660,6156,9816,146400,246240,392640
2/10/2025,Nayanathara Perera,Galle,Unawatuna,Southern,1615,664,2279,64600,26560,91160
2/11/2025,Nayanathara Perera,Galle,Unawatuna,Southern,870,5560,6430,34800,222400,257200
2/12/2025,Nayanathara Perera,Galle,Unawatuna,Southern,8866,7849,16715,354640,313960,668600
2/13/2025,Nayanathara Perera,Galle,Unawatuna,Southern,9013,557,9570,360520,22280,382800
2/14/2025,Nayanathara Perera,Galle,Unawatuna,Southern,1316,2182,3498,52640,87280,139920
2/15/2025,Nayanathara Perera,Galle,Unawatuna,Southern,8695,2558,11253,347800,102320,450120
2/16/2025,Nayanathara Perera,Galle,Unawatuna,Southern,4779,5701,10480,191160,228040,419200
2/17/2025,Nayanathara Perera,Galle,Unawatuna,Southern,5969,8717,14686,238760,348680,587440
2/18/2025,Nayanathara Perera,Galle,Unawatuna,Southern,6496,2836,9332,259840,113440,373280
2/19/2025,Nayanathara Perera,Galle,Unawatuna,Southern,2355,2485,4840,94200,99400,193600
2/20/2025,Nayanathara Perera,Galle,Unawatuna,Southern,9985,1594,11579,399400,63760,463160
2/21/2025,Nayanathara Perera,Galle,Unawatuna,Southern,8004,631,8635,320160,25240,345400
2/22/2025,Nayanathara Perera,Galle,Unawatuna,Southern,1921,6068,7989,76840,242720,319560
2/23/2025,Nayanathara Perera,Galle,Unawatuna,Southern,4709,9145,13854,188360,365800,554160
2/24/2025,Nayanathara Perera,Galle,Unawatuna,Southern,197,815,1012,7880,32600,40480
2/25/2025,Nayanathara Perera,Galle,Unawatuna,Southern,1602,8411,10013,64080,336440,400520
2/26/2025,Nayanathara Perera,Galle,Unawatuna,Southern,6092,5971,12063,243680,238840,482520
2/27/2025,Nayanathara Perera,Galle,Unawatuna,Southern,8599,157,8756,343960,6280,350240
2/28/2025,Nayanathara Perera,Galle,Unawatuna,Southern,9972,5230,15202,398880,209200,608080
3/1/2025,Nayanathara Perera,Galle,Unawatuna,Southern,9498,8045,17543,379920,321800,701720
3/2/2025,Nayanathara Perera,Galle,Unawatuna,Southern,9601,2902,12503,384040,116080,500120
3/3/2025,Nayanathara Perera,Galle,Unawatuna,Southern,5634,9428,15062,225360,377120,602480
3/4/2025,Nayanathara Perera,Galle,Unawatuna,Southern,5744,2559,8303,229760,102360,332120
3/5/2025,Nayanathara Perera,Galle,Unawatuna,Southern,8029,6534,14563,321160,261360,582520
3/6/2025,Nayanathara Perera,Galle,Unawatuna,Southern,3146,3423,6569,125840,136920,262760
3/7/2025,Nayanathara Perera,Galle,Unawatuna,Southern,2210,4492,6702,88400,179680,268080
3/8/2025,Nayanathara Perera,Galle,Unawatuna,Southern,1682,2392,4074,67280,95680,162960
3/9/2025,Nayanathara Perera,Galle,Unawatuna,Southern,458,3947,4405,18320,157880,176200
3/10/2025,Nayanathara Perera,Galle,Unawatuna,Southern,5085,6844,11929,203400,273760,477160
3/11/2025,Nayanathara Perera,Galle,Unawatuna,Southern,5440,4090,9530,217600,163600,381200
3/12/2025,Nayanathara Perera,Galle,Unawatuna,Southern,5061,9744,14805,202440,389760,592200
3/13/2025,Nayanathara Perera,Galle,Unawatuna,Southern,800,9162,9962,32000,366480,398480
3/14/2025,Nayanathara Perera,Galle,Unawatuna,Southern,6702,5093,11795,268080,203720,471800
3/15/2025,Nayanathara Perera,Galle,Unawatuna,Southern,9036,5030,14066,361440,201200,562640
3/16/2025,Nayanathara Perera,Galle,Unawatuna,Southern,112,7210,7322,4480,288400,292880
3/17/2025,Nayanathara Perera,Galle,Unawatuna,Southern,2169,2129,4298,86760,85160,171920
3/18/2025,Nayanathara Perera,Galle,Unawatuna,Southern,2792,1454,4246,111680,58160,169840
3/19/2025,Nayanathara Perera,Galle,Unawatuna,Southern,7365,3216,10581,294600,128640,423240
3/20/2025,Nayanathara Perera,Galle,Unawatuna,Southern,807,3785,4592,32280,151400,183680
3/21/2025,Nayanathara Perera,Galle,Unawatuna,Southern,5,5005,5010,200,200200,200400
3/22/2025,Nayanathara Perera,Galle,Unawatuna,Southern,73,8481,8554,2920,339240,342160
3/23/2025,Nayanathara Perera,Galle,Unawatuna,Southern,6188,6720,12908,247520,268800,516320
3/25/2024,Tina Kumari,Kandy,Hunnasgiriya,Central,5028,3076,8104,201120,123040,324160
3/26/2024,Tina Kumari,Kandy,Hunnasgiriya,Central,3911,4749,8660,156440,189960,346400
3/27/2024,Tina Kumari,Kandy,Hunnasgiriya,Central,8890,2242,11132,355600,89680,445280
3/28/2024,Tina Kumari,Kandy,Hunnasgiriya,Central,9563,4628,14191,382520,185120,567640
3/29/2024,Tina Kumari,Kandy,Hunnasgiriya,Central,484,9136,9620,19360,365440,384800
3/30/2024,Tina Kumari,Kandy,Hunnasgiriya,Central,2198,8648,10846,87920,345920,433840
3/31/2024,Tina Kumari,Kandy,Hunnasgiriya,Central,96,1652,1748,3840,66080,69920
4/1/2024,Tina Kumari,Kandy,Hunnasgiriya,Central,3844,2857,6701,153760,114280,268040
4/2/2024,Tina Kumari,Kandy,Hunnasgiriya,Central,3626,5449,9075,145040,217960,363000
4/3/2024,Tina Kumari,Kandy,Hunnasgiriya,Central,3645,7761,11406,145800,310440,456240
4/4/2024,Tina Kumari,Kandy,Hunnasgiriya,Central,2934,3597,6531,117360,143880,261240
4/5/2024,Tina Kumari,Kandy,Hunnasgiriya,Central,6947,7432,14379,277880,297280,575160
4/6/2024,Tina Kumari,Kandy,Hunnasgiriya,Central,7235,5151,12386,289400,206040,495440
4/7/2024,Tina Kumari,Kandy,Hunnasgiriya,Central,9372,2060,11432,374880,82400,457280
4/8/2024,Tina Kumari,Kandy,Hunnasgiriya,Central,4032,8162,12194,161280,326480,487760
4/9/2024,Tina Kumari,Kandy,Hunnasgiriya,Central,4069,6054,10123,162760,242160,404920
4/10/2024,Tina Kumari,Kandy,Hunnasgiriya,Central,6987,3106,10093,279480,124240,403720
4/11/2024,Tina Kumari,Kandy,Hunnasgiriya,Central,8239,3677,11916,329560,147080,476640
4/19/2024,Tina Kumari,Kandy,Hunnasgiriya,Central,3358,9076,12434,134320,363040,497360
4/20/2024,Tina Kumari,Kandy,Hunnasgiriya,Central,7108,548,7656,284320,21920,306240
4/21/2024,Tina Kumari,Kandy,Hunnasgiriya,Central,3293,6954,10247,131720,278160,409880
4/22/2024,Tina Kumari,Kandy,Hunnasgiriya,Central,2549,474,3023,101960,18960,120920
4/23/2024,Tina Kumari,Kandy,Hunnasgiriya,Central,8523,8296,16819,340920,331840,672760
4/24/2024,Tina Kumari,Kandy,Hunnasgiriya,Central,9603,1964,11567,384120,78560,462680
4/25/2024,Tina Kumari,Kandy,Hunnasgiriya,Central,6572,1080,7652,262880,43200,306080
4/26/2024,Tina Kumari,Kandy,Hunnasgiriya,Central,2009,2275,4284,80360,91000,171360
4/27/2024,Tina Kumari,Kandy,Hunnasgiriya,Central,6528,3409,9937,261120,136360,397480
4/28/2024,Tina Kumari,Kandy,Hunnasgiriya,Central,4223,190,4413,168920,7600,176520
4/29/2024,Tina Kumari,Kandy,Hunnasgiriya,Central,8494,8303,16797,339760,332120,671880
4/30/2024,Tina Kumari,Kandy,Hunnasgiriya,Central,991,7430,8421,39640,297200,336840
5/1/2024,Tina Kumari,Kandy,Hunnasgiriya,Central,2310,7888,10198,92400,315520,407920
5/2/2024,Tina Kumari,Kandy,Hunnasgiriya,Central,7472,7227,14699,298880,289080,587960
5/3/2024,Tina Kumari,Kandy,Hunnasgiriya,Central,922,7131,8053,36880,285240,322120
5/4/2024,Tina Kumari,Kandy,Hunnasgiriya,Central,6871,8528,15399,274840,341120,615960
5/5/2024,Tina Kumari,Kandy,Hunnasgiriya,Central,6839,3119,9958,273560,124760,398320
5/6/2024,Tina Kumari,Kandy,Hunnasgiriya,Central,4149,7989,12138,165960,319560,485520
5/7/2024,Tina Kumari,Kandy,Hunnasgiriya,Central,764,4813,5577,30560,192520,223080
5/8/2024,Tina Kumari,Kandy,Hunnasgiriya,Central,2447,8326,10773,97880,333040,430920
5/9/2024,Tina Kumari,Kandy,Hunnasgiriya,Central,890,7265,8155,35600,290600,326200
5/10/2024,Tina Kumari,Kandy,Hunnasgiriya,Central,8684,1301,9985,347360,52040,399400
5/11/2024,Tina Kumari,Kandy,Hunnasgiriya,Central,4220,6788,11008,168800,271520,440320
5/12/2024,Tina Kumari,Kandy,Hunnasgiriya,Central,5637,1657,7294,225480,66280,291760
5/13/2024,Tina Kumari,Kandy,Hunnasgiriya,Central,1060,3852,4912,42400,154080,196480
5/14/2024,Tina Kumari,Kandy,Hunnasgiriya,Central,421,7572,7993,16840,302880,319720
5/15/2024,Tina Kumari,Kandy,Hunnasgiriya,Central,4058,1362,5420,162320,54480,216800
5/16/2024,Tina Kumari,Kandy,Hunnasgiriya,Central,4575,5397,9972,183000,215880,398880
5/17/2024,Tina Kumari,Kandy,Hunnasgiriya,Central,7814,2637,10451,312560,105480,418040
5/18/2024,Tina Kumari,Kandy,Hunnasgiriya,Central,798,7613,8411,31920,304520,336440
5/19/2024,Tina Kumari,Kandy,Hunnasgiriya,Central,988,3899,4887,39520,155960,195480
5/20/2024,Tina Kumari,Kandy,Hunnasgiriya,Central,1568,5306,6874,62720,212240,274960
5/21/2024,Tina Kumari,Kandy,Hunnasgiriya,Central,5157,8416,13573,206280,336640,542920
5/22/2024,Tina Kumari,Kandy,Hunnasgiriya,Central,5240,1375,6615,209600,55000,264600
5/24/2024,Tina Kumari,Kandy,Hunnasgiriya,Central,5416,597,6013,216640,23880,240520
5/25/2024,Tina Kumari,Kandy,Hunnasgiriya,Central,4479,5189,9668,179160,207560,386720
5/26/2024,Tina Kumari,Kandy,Hunnasgiriya,Central,2670,5432,8102,106800,217280,324080
5/27/2024,Tina Kumari,Kandy,Hunnasgiriya,Central,5521,7054,12575,220840,282160,503000
5/28/2024,Tina Kumari,Kandy,Hunnasgiriya,Central,6306,4656,10962,252240,186240,438480
5/29/2024,Tina Kumari,Kandy,Hunnasgiriya,Central,8811,5525,14336,352440,221000,573440
5/30/2024,Tina Kumari,Kandy,Hunnasgiriya,Central,7030,5620,12650,281200,224800,506000
5/31/2024,Tina Kumari,Kandy,Hunnasgiriya,Central,3988,30,4018,159520,1200,160720
6/1/2024,Tina Kumari,Kandy,Hunnasgiriya,Central,8949,5256,14205,357960,210240,568200
6/2/2024,Tina Kumari,Kandy,Hunnasgiriya,Central,9576,7737,17313,383040,309480,692520
6/3/2024,Tina Kumari,Kandy,Hunnasgiriya,Central,2317,6861,9178,92680,274440,367120
6/4/2024,Tina Kumari,Kandy,Hunnasgiriya,Central,1669,1116,2785,66760,44640,111400
6/5/2024,Tina Kumari,Kandy,Hunnasgiriya,Central,6288,3589,9877,251520,143560,395080
6/6/2024,Tina Kumari,Kandy,Hunnasgiriya,Central,3651,1203,4854,146040,48120,194160
6/7/2024,Tina Kumari,Kandy,Hunnasgiriya,Central,8509,2681,11190,340360,107240,447600
6/8/2024,Tina Kumari,Kandy,Hunnasgiriya,Central,6619,5215,11834,264760,208600,473360
6/9/2024,Tina Kumari,Kandy,Hunnasgiriya,Central,3587,5232,8819,143480,209280,352760
6/10/2024,Tina Kumari,Kandy,Hunnasgiriya,Central,7414,1077,8491,296560,43080,339640
6/11/2024,Tina Kumari,Kandy,Hunnasgiriya,Central,3011,8875,11886,120440,355000,475440
6/12/2024,Tina Kumari,Kandy,Hunnasgiriya,Central,7877,1590,9467,315080,63600,378680
6/13/2024,Tina Kumari,Kandy,Hunnasgiriya,Central,1240,2170,3410,49600,86800,136400
6/14/2024,Tina Kumari,Kandy,Hunnasgiriya,Central,472,2211,2683,18880,88440,107320
6/15/2024,Tina Kumari,Kandy,Hunnasgiriya,Central,110,1382,1492,4400,55280,59680
6/16/2024,Tina Kumari,Kandy,Hunnasgiriya,Central,4735,7601,12336,189400,304040,493440
6/17/2024,Tina Kumari,Kandy,Hunnasgiriya,Central,3365,2998,6363,134600,119920,254520
6/18/2024,Tina Kumari,Kandy,Hunnasgiriya,Central,425,681,1106,17000,27240,44240
6/19/2024,Tina Kumari,Kandy,Hunnasgiriya,Central,8149,893,9042,325960,35720,361680
6/20/2024,Tina Kumari,Kandy,Hunnasgiriya,Central,394,1091,1485,15760,43640,59400
6/21/2024,Tina Kumari,Kandy,Hunnasgiriya,Central,1449,3337,4786,57960,133480,191440
6/22/2024,Tina Kumari,Kandy,Hunnasgiriya,Central,7003,7427,14430,280120,297080,577200
6/23/2024,Tina Kumari,Kandy,Hunnasgiriya,Central,600,2607,3207,24000,104280,128280
6/24/2024,Tina Kumari,Kandy,Hunnasgiriya,Central,5780,9857,15637,231200,394280,625480
6/25/2024,Tina Kumari,Kandy,Hunnasgiriya,Central,8736,7626,16362,349440,305040,654480
6/26/2024,Tina Kumari,Kandy,Hunnasgiriya,Central,3583,7799,11382,143320,311960,455280
6/27/2024,Tina Kumari,Kandy,Hunnasgiriya,Central,9409,6288,15697,376360,251520,627880
6/28/2024,Tina Kumari,Kandy,Hunnasgiriya,Central,9911,7230,17141,396440,289200,685640
6/29/2024,Tina Kumari,Kandy,Hunnasgiriya,Central,2958,9404,12362,118320,376160,494480
6/30/2024,Tina Kumari,Kandy,Hunnasgiriya,Central,7176,7512,14688,287040,300480,587520
7/1/2024,Tina Kumari,Kandy,Hunnasgiriya,Central,3472,2150,5622,138880,86000,224880
7/2/2024,Tina Kumari,Kandy,Hunnasgiriya,Central,2256,4379,6635,90240,175160,265400
7/3/2024,Tina Kumari,Kandy,Hunnasgiriya,Central,4865,8134,12999,194600,325360,519960
7/4/2024,Tina Kumari,Kandy,Hunnasgiriya,Central,5560,1525,7085,222400,61000,283400
7/5/2024,Tina Kumari,Kandy,Hunnasgiriya,Central,6747,1906,8653,269880,76240,346120
7/6/2024,Tina Kumari,Kandy,Hunnasgiriya,Central,1636,8865,10501,65440,354600,420040
7/7/2024,Tina Kumari,Kandy,Hunnasgiriya,Central,3453,1418,4871,138120,56720,194840
7/8/2024,Tina Kumari,Kandy,Hunnasgiriya,Central,5853,8113,13966,234120,324520,558640
7/9/2024,Tina Kumari,Kandy,Hunnasgiriya,Central,214,7401,7615,8560,296040,304600
7/10/2024,Tina Kumari,Kandy,Hunnasgiriya,Central,3324,6936,10260,132960,277440,410400
7/11/2024,Tina Kumari,Kandy,Hunnasgiriya,Central,3292,6585,9877,131680,263400,395080
7/12/2024,Tina Kumari,Kandy,Hunnasgiriya,Central,7408,5720,13128,296320,228800,525120
7/13/2024,Tina Kumari,Kandy,Hunnasgiriya,Central,3055,5073,8128,122200,202920,325120
7/14/2024,Tina Kumari,Kandy,Hunnasgiriya,Central,5592,7688,13280,223680,307520,531200
7/15/2024,Tina Kumari,Kandy,Hunnasgiriya,Central,4202,1786,5988,168080,71440,239520
7/16/2024,Tina Kumari,Kandy,Hunnasgiriya,Central,9449,4335,13784,377960,173400,551360
7/17/2024,Tina Kumari,Kandy,Hunnasgiriya,Central,8000,6815,14815,320000,272600,592600
7/18/2024,Tina Kumari,Kandy,Hunnasgiriya,Central,585,1744,2329,23400,69760,93160
7/19/2024,Tina Kumari,Kandy,Hunnasgiriya,Central,4073,1902,5975,162920,76080,239000
7/20/2024,Tina Kumari,Kandy,Hunnasgiriya,Central,7445,568,8013,297800,22720,320520
7/21/2024,Tina Kumari,Kandy,Hunnasgiriya,Central,472,5286,5758,18880,211440,230320
7/22/2024,Tina Kumari,Kandy,Hunnasgiriya,Central,1109,2187,3296,44360,87480,131840
7/23/2024,Tina Kumari,Kandy,Hunnasgiriya,Central,7647,4634,12281,305880,185360,491240
7/24/2024,Tina Kumari,Kandy,Hunnasgiriya,Central,7368,5642,13010,294720,225680,520400
7/25/2024,Tina Kumari,Kandy,Hunnasgiriya,Central,4794,1250,6044,191760,50000,241760
7/26/2024,Tina Kumari,Kandy,Hunnasgiriya,Central,42,2468,2510,1680,98720,100400
7/27/2024,Tina Kumari,Kandy,Hunnasgiriya,Central,8402,1229,9631,336080,49160,385240
7/28/2024,Tina Kumari,Kandy,Hunnasgiriya,Central,4781,7479,12260,191240,299160,490400
7/29/2024,Tina Kumari,Kandy,Hunnasgiriya,Central,9762,4901,14663,390480,196040,586520
7/30/2024,Tina Kumari,Kandy,Hunnasgiriya,Central,209,1858,2067,8360,74320,82680
7/31/2024,Tina Kumari,Kandy,Hunnasgiriya,Central,8405,4329,12734,336200,173160,509360
8/1/2024,Tina Kumari,Kandy,Hunnasgiriya,Central,1751,2615,4366,70040,104600,174640
8/2/2024,Tina Kumari,Kandy,Hunnasgiriya,Central,4310,1194,5504,172400,47760,220160
8/3/2024,Tina Kumari,Kandy,Hunnasgiriya,Central,805,6602,7407,32200,264080,296280
8/4/2024,Tina Kumari,Kandy,Hunnasgiriya,Central,4334,8645,12979,173360,345800,519160
8/5/2024,Tina Kumari,Kandy,Hunnasgiriya,Central,8190,5090,13280,327600,203600,531200
8/6/2024,Tina Kumari,Kandy,Hunnasgiriya,Central,1688,2573,4261,67520,102920,170440
8/7/2024,Tina Kumari,Kandy,Hunnasgiriya,Central,121,4481,4602,4840,179240,184080
8/8/2024,Tina Kumari,Kandy,Hunnasgiriya,Central,2991,5881,8872,119640,235240,354880
8/9/2024,Tina Kumari,Kandy,Hunnasgiriya,Central,4525,2153,6678,181000,86120,267120
8/10/2024,Tina Kumari,Kandy,Hunnasgiriya,Central,1525,8117,9642,61000,324680,385680
8/11/2024,Tina Kumari,Kandy,Hunnasgiriya,Central,7951,1855,9806,318040,74200,392240
8/12/2024,Tina Kumari,Kandy,Hunnasgiriya,Central,1070,4314,5384,42800,172560,215360
8/13/2024,Tina Kumari,Kandy,Hunnasgiriya,Central,1522,5463,6985,60880,218520,279400
8/14/2024,Tina Kumari,Kandy,Hunnasgiriya,Central,1215,9651,10866,48600,386040,434640
8/15/2024,Tina Kumari,Kandy,Hunnasgiriya,Central,229,9018,9247,9160,360720,369880
8/16/2024,Tina Kumari,Kandy,Hunnasgiriya,Central,9804,8288,18092,392160,331520,723680
8/17/2024,Tina Kumari,Kandy,Hunnasgiriya,Central,6851,5157,12008,274040,206280,480320
8/18/2024,Tina Kumari,Kandy,Hunnasgiriya,Central,3419,584,4003,136760,23360,160120
8/19/2024,Tina Kumari,Kandy,Hunnasgiriya,Central,7664,878,8542,306560,35120,341680
8/20/2024,Tina Kumari,Kandy,Hunnasgiriya,Central,911,5083,5994,36440,203320,239760
8/21/2024,Tina Kumari,Kandy,Hunnasgiriya,Central,6008,5690,11698,240320,227600,467920
8/22/2024,Tina Kumari,Kandy,Hunnasgiriya,Central,9860,8573,18433,394400,342920,737320
8/23/2024,Tina Kumari,Kandy,Hunnasgiriya,Central,7178,3960,11138,287120,158400,445520
8/24/2024,Tina Kumari,Kandy,Hunnasgiriya,Central,6197,3214,9411,247880,128560,376440
8/25/2024,Tina Kumari,Kandy,Hunnasgiriya,Central,5427,6766,12193,217080,270640,487720
8/26/2024,Tina Kumari,Kandy,Hunnasgiriya,Central,7250,9465,16715,290000,378600,668600
8/27/2024,Tina Kumari,Kandy,Hunnasgiriya,Central,2218,275,2493,88720,11000,99720
8/28/2024,Tina Kumari,Kandy,Hunnasgiriya,Central,8578,6487,15065,343120,259480,602600
8/29/2024,Tina Kumari,Kandy,Hunnasgiriya,Central,4924,8010,12934,196960,320400,517360
8/30/2024,Tina Kumari,Kandy,Hunnasgiriya,Central,9514,1296,10810,380560,51840,432400
8/31/2024,Tina Kumari,Kandy,Hunnasgiriya,Central,8819,7468,16287,352760,298720,651480
9/1/2024,Tina Kumari,Kandy,Hunnasgiriya,Central,4445,9732,14177,177800,389280,567080
9/2/2024,Tina Kumari,Kandy,Hunnasgiriya,Central,1854,2446,4300,74160,97840,172000
9/3/2024,Tina Kumari,Kandy,Hunnasgiriya,Central,9993,4569,14562,399720,182760,582480
9/4/2024,Tina Kumari,Kandy,Hunnasgiriya,Central,1109,1570,2679,44360,62800,107160
9/5/2024,Tina Kumari,Kandy,Hunnasgiriya,Central,8518,5960,14478,340720,238400,579120
9/6/2024,Tina Kumari,Kandy,Hunnasgiriya,Central,8840,5429,14269,353600,217160,570760
9/7/2024,Tina Kumari,Kandy,Hunnasgiriya,Central,3200,5197,8397,128000,207880,335880
9/8/2024,Tina Kumari,Kandy,Hunnasgiriya,Central,9436,8656,18092,377440,346240,723680
9/9/2024,Tina Kumari,Kandy,Hunnasgiriya,Central,4027,7903,11930,161080,316120,477200
9/10/2024,Tina Kumari,Kandy,Hunnasgiriya,Central,1140,1755,2895,45600,70200,115800
9/11/2024,Tina Kumari,Kandy,Hunnasgiriya,Central,9309,7139,16448,372360,285560,657920
9/12/2024,Tina Kumari,Kandy,Hunnasgiriya,Central,3752,4573,8325,150080,182920,333000
9/13/2024,Tina Kumari,Kandy,Hunnasgiriya,Central,3174,2640,5814,126960,105600,232560
9/14/2024,Tina Kumari,Kandy,Hunnasgiriya,Central,6926,714,7640,277040,28560,305600
9/15/2024,Tina Kumari,Kandy,Hunnasgiriya,Central,1334,5848,7182,53360,233920,287280
9/16/2024,Tina Kumari,Kandy,Hunnasgiriya,Central,7557,2222,9779,302280,88880,391160
9/17/2024,Tina Kumari,Kandy,Hunnasgiriya,Central,1788,5096,6884,71520,203840,275360
9/18/2024,Tina Kumari,Kandy,Hunnasgiriya,Central,571,1312,1883,22840,52480,75320
9/19/2024,Tina Kumari,Kandy,Hunnasgiriya,Central,5057,5330,10387,202280,213200,415480
9/20/2024,Tina Kumari,Kandy,Hunnasgiriya,Central,3165,449,3614,126600,17960,144560
9/21/2024,Tina Kumari,Kandy,Hunnasgiriya,Central,5186,4776,9962,207440,191040,398480
9/22/2024,Tina Kumari,Kandy,Hunnasgiriya,Central,1963,4871,6834,78520,194840,273360
9/23/2024,Tina Kumari,Kandy,Hunnasgiriya,Central,6559,6862,13421,262360,274480,536840
9/24/2024,Tina Kumari,Kandy,Hunnasgiriya,Central,8877,8614,17491,355080,344560,699640
9/25/2024,Tina Kumari,Kandy,Hunnasgiriya,Central,5229,6791,12020,209160,271640,480800
9/26/2024,Tina Kumari,Kandy,Hunnasgiriya,Central,4685,1330,6015,187400,53200,240600
9/27/2024,Tina Kumari,Kandy,Hunnasgiriya,Central,3068,8452,11520,122720,338080,460800
9/28/2024,Tina Kumari,Kandy,Hunnasgiriya,Central,3488,2768,6256,139520,110720,250240
9/29/2024,Tina Kumari,Kandy,Hunnasgiriya,Central,234,7401,7635,9360,296040,305400
9/30/2024,Tina Kumari,Kandy,Hunnasgiriya,Central,6253,9799,16052,250120,391960,642080
10/1/2024,Tina Kumari,Kandy,Hunnasgiriya,Central,6317,1909,8226,252680,76360,329040
10/2/2024,Tina Kumari,Kandy,Hunnasgiriya,Central,743,1418,2161,29720,56720,86440
10/3/2024,Tina Kumari,Kandy,Hunnasgiriya,Central,9135,2418,11553,365400,96720,462120
10/4/2024,Tina Kumari,Kandy,Hunnasgiriya,Central,5171,4395,9566,206840,175800,382640
10/5/2024,Tina Kumari,Kandy,Hunnasgiriya,Central,5176,7142,12318,207040,285680,492720
10/6/2024,Tina Kumari,Kandy,Hunnasgiriya,Central,7892,408,8300,315680,16320,332000
10/7/2024,Tina Kumari,Kandy,Hunnasgiriya,Central,8329,8022,16351,333160,320880,654040
10/8/2024,Tina Kumari,Kandy,Hunnasgiriya,Central,6574,5086,11660,262960,203440,466400
10/9/2024,Tina Kumari,Kandy,Hunnasgiriya,Central,6720,1308,8028,268800,52320,321120
10/10/2024,Tina Kumari,Kandy,Hunnasgiriya,Central,6094,8928,15022,243760,357120,600880
10/11/2024,Tina Kumari,Kandy,Hunnasgiriya,Central,8047,5269,13316,321880,210760,532640
10/12/2024,Tina Kumari,Kandy,Hunnasgiriya,Central,6611,4973,11584,264440,198920,463360
10/13/2024,Tina Kumari,Kandy,Hunnasgiriya,Central,6278,873,7151,251120,34920,286040
10/14/2024,Tina Kumari,Kandy,Hunnasgiriya,Central,5177,5120,10297,207080,204800,411880
10/15/2024,Tina Kumari,Kandy,Hunnasgiriya,Central,8695,8725,17420,347800,349000,696800
10/16/2024,Tina Kumari,Kandy,Hunnasgiriya,Central,8286,2679,10965,331440,107160,438600
10/17/2024,Tina Kumari,Kandy,Hunnasgiriya,Central,5129,1988,7117,205160,79520,284680
10/18/2024,Tina Kumari,Kandy,Hunnasgiriya,Central,1602,8529,10131,64080,341160,405240
10/19/2024,Tina Kumari,Kandy,Hunnasgiriya,Central,2376,5801,8177,95040,232040,327080
10/20/2024,Tina Kumari,Kandy,Hunnasgiriya,Central,2189,1686,3875,87560,67440,155000
10/21/2024,Tina Kumari,Kandy,Hunnasgiriya,Central,4695,344,5039,187800,13760,201560
10/22/2024,Tina Kumari,Kandy,Hunnasgiriya,Central,7909,3803,11712,316360,152120,468480
10/23/2024,Tina Kumari,Kandy,Hunnasgiriya,Central,7807,7351,15158,312280,294040,606320
10/24/2024,Tina Kumari,Kandy,Hunnasgiriya,Central,428,213,641,17120,8520,25640
10/25/2024,Tina Kumari,Kandy,Hunnasgiriya,Central,6201,663,6864,248040,26520,274560
10/26/2024,Tina Kumari,Kandy,Hunnasgiriya,Central,4854,8943,13797,194160,357720,551880
10/27/2024,Tina Kumari,Kandy,Hunnasgiriya,Central,7001,8917,15918,280040,356680,636720
10/28/2024,Tina Kumari,Kandy,Hunnasgiriya,Central,1149,5382,6531,45960,215280,261240
10/29/2024,Tina Kumari,Kandy,Hunnasgiriya,Central,9910,1305,11215,396400,52200,448600
10/30/2024,Tina Kumari,Kandy,Hunnasgiriya,Central,7737,9159,16896,309480,366360,675840
10/31/2024,Tina Kumari,Kandy,Hunnasgiriya,Central,3410,5881,9291,136400,235240,371640
11/1/2024,Tina Kumari,Kandy,Hunnasgiriya,Central,2560,1193,3753,102400,47720,150120
11/2/2024,Tina Kumari,Kandy,Hunnasgiriya,Central,190,4289,4479,7600,171560,179160
11/3/2024,Tina Kumari,Kandy,Hunnasgiriya,Central,5605,8036,13641,224200,321440,545640
11/4/2024,Tina Kumari,Kandy,Hunnasgiriya,Central,1783,6701,8484,71320,268040,339360
11/5/2024,Tina Kumari,Kandy,Hunnasgiriya,Central,9023,1953,10976,360920,78120,439040
11/6/2024,Tina Kumari,Kandy,Hunnasgiriya,Central,1143,3218,4361,45720,128720,174440
11/7/2024,Tina Kumari,Kandy,Hunnasgiriya,Central,1008,245,1253,40320,9800,50120
11/8/2024,Tina Kumari,Kandy,Hunnasgiriya,Central,8996,3688,12684,359840,147520,507360
11/9/2024,Tina Kumari,Kandy,Hunnasgiriya,Central,6916,4700,11616,276640,188000,464640
11/10/2024,Tina Kumari,Kandy,Hunnasgiriya,Central,4683,2200,6883,187320,88000,275320
11/11/2024,Tina Kumari,Kandy,Hunnasgiriya,Central,8953,4773,13726,358120,190920,549040
11/12/2024,Tina Kumari,Kandy,Hunnasgiriya,Central,4120,299,4419,164800,11960,176760
11/13/2024,Tina Kumari,Kandy,Hunnasgiriya,Central,2262,684,2946,90480,27360,117840
11/14/2024,Tina Kumari,Kandy,Hunnasgiriya,Central,4260,3123,7383,170400,124920,295320
11/15/2024,Tina Kumari,Kandy,Hunnasgiriya,Central,9002,8218,17220,360080,328720,688800
11/16/2024,Tina Kumari,Kandy,Hunnasgiriya,Central,8323,1492,9815,332920,59680,392600
11/17/2024,Tina Kumari,Kandy,Hunnasgiriya,Central,737,7130,7867,29480,285200,314680
11/18/2024,Tina Kumari,Kandy,Hunnasgiriya,Central,2926,9527,12453,117040,381080,498120
11/19/2024,Tina Kumari,Kandy,Hunnasgiriya,Central,4922,9327,14249,196880,373080,569960
11/20/2024,Tina Kumari,Kandy,Hunnasgiriya,Central,4108,8056,12164,164320,322240,486560
11/21/2024,Tina Kumari,Kandy,Hunnasgiriya,Central,5255,6077,11332,210200,243080,453280
11/22/2024,Tina Kumari,Kandy,Hunnasgiriya,Central,9032,9616,18648,361280,384640,745920
11/23/2024,Tina Kumari,Kandy,Hunnasgiriya,Central,5808,6277,12085,232320,251080,483400
11/24/2024,Tina Kumari,Kandy,Hunnasgiriya,Central,2655,3174,5829,106200,126960,233160
11/25/2024,Tina Kumari,Kandy,Hunnasgiriya,Central,970,5491,6461,38800,219640,258440
11/26/2024,Tina Kumari,Kandy,Hunnasgiriya,Central,5082,2871,7953,203280,114840,318120
11/27/2024,Tina Kumari,Kandy,Hunnasgiriya,Central,1929,6705,8634,77160,268200,345360
11/28/2024,Tina Kumari,Kandy,Hunnasgiriya,Central,8899,4225,13124,355960,169000,524960
11/29/2024,Tina Kumari,Kandy,Hunnasgiriya,Central,9512,3932,13444,380480,157280,537760
11/30/2024,Tina Kumari,Kandy,Hunnasgiriya,Central,8857,5119,13976,354280,204760,559040
12/1/2024,Tina Kumari,Kandy,Hunnasgiriya,Central,5579,442,6021,223160,17680,240840
12/2/2024,Tina Kumari,Kandy,Hunnasgiriya,Central,8535,7911,16446,341400,316440,657840
12/3/2024,Tina Kumari,Kandy,Hunnasgiriya,Central,11,6506,6517,440,260240,260680
12/4/2024,Tina Kumari,Kandy,Hunnasgiriya,Central,1313,3199,4512,52520,127960,180480
12/5/2024,Tina Kumari,Kandy,Hunnasgiriya,Central,9488,652,10140,379520,26080,405600
12/6/2024,Tina Kumari,Kandy,Hunnasgiriya,Central,9124,9220,18344,364960,368800,733760
12/7/2024,Tina Kumari,Kandy,Hunnasgiriya,Central,3483,5967,9450,139320,238680,378000
12/8/2024,Tina Kumari,Kandy,Hunnasgiriya,Central,3802,9830,13632,152080,393200,545280
12/9/2024,Tina Kumari,Kandy,Hunnasgiriya,Central,8908,8817,17725,356320,352680,709000
12/10/2024,Tina Kumari,Kandy,Hunnasgiriya,Central,6703,9354,16057,268120,374160,642280
12/11/2024,Tina Kumari,Kandy,Hunnasgiriya,Central,5701,1623,7324,228040,64920,292960
12/12/2024,Tina Kumari,Kandy,Hunnasgiriya,Central,919,8655,9574,36760,346200,382960
12/13/2024,Tina Kumari,Kandy,Hunnasgiriya,Central,4083,5103,9186,163320,204120,367440
12/14/2024,Tina Kumari,Kandy,Hunnasgiriya,Central,9918,4755,14673,396720,190200,586920
12/15/2024,Tina Kumari,Kandy,Hunnasgiriya,Central,4766,6809,11575,190640,272360,463000
12/16/2024,Tina Kumari,Kandy,Hunnasgiriya,Central,2887,328,3215,115480,13120,128600
12/17/2024,Tina Kumari,Kandy,Hunnasgiriya,Central,8468,9699,18167,338720,387960,726680
12/18/2024,Tina Kumari,Kandy,Hunnasgiriya,Central,5373,1597,6970,214920,63880,278800
12/19/2024,Tina Kumari,Kandy,Hunnasgiriya,Central,829,9128,9957,33160,365120,398280
12/20/2024,Tina Kumari,Kandy,Hunnasgiriya,Central,5322,3548,8870,212880,141920,354800
12/21/2024,Tina Kumari,Kandy,Hunnasgiriya,Central,9140,4502,13642,365600,180080,545680
12/22/2024,Tina Kumari,Kandy,Hunnasgiriya,Central,228,1717,1945,9120,68680,77800
12/23/2024,Tina Kumari,Kandy,Hunnasgiriya,Central,3002,2173,5175,120080,86920,207000
12/24/2024,Tina Kumari,Kandy,Hunnasgiriya,Central,8569,2116,10685,342760,84640,427400
12/25/2024,Tina Kumari,Kandy,Hunnasgiriya,Central,4174,5278,9452,166960,211120,378080
12/26/2024,Tina Kumari,Kandy,Hunnasgiriya,Central,1477,3734,5211,59080,149360,208440
12/27/2024,Tina Kumari,Kandy,Hunnasgiriya,Central,2341,7206,9547,93640,288240,381880
12/28/2024,Tina Kumari,Kandy,Hunnasgiriya,Central,9835,7386,17221,393400,295440,688840
12/29/2024,Tina Kumari,Kandy,Hunnasgiriya,Central,5254,7292,12546,210160,291680,501840
12/30/2024,Tina Kumari,Kandy,Hunnasgiriya,Central,8320,6821,15141,332800,272840,605640
12/31/2024,Tina Kumari,Kandy,Hunnasgiriya,Central,8603,7694,16297,344120,307760,651880
1/1/2025,Tina Kumari,Kandy,Hunnasgiriya,Central,765,7589,8354,30600,303560,334160
1/2/2025,Tina Kumari,Kandy,Hunnasgiriya,Central,8417,4734,13151,336680,189360,526040
1/3/2025,Tina Kumari,Kandy,Hunnasgiriya,Central,2830,8634,11464,113200,345360,458560
1/4/2025,Tina Kumari,Kandy,Hunnasgiriya,Central,7394,8103,15497,295760,324120,619880
1/5/2025,Tina Kumari,Kandy,Hunnasgiriya,Central,6898,2509,9407,275920,100360,376280
1/6/2025,Tina Kumari,Kandy,Hunnasgiriya,Central,4899,2031,6930,195960,81240,277200
1/7/2025,Tina Kumari,Kandy,Hunnasgiriya,Central,8453,7247,15700,338120,289880,628000
1/8/2025,Tina Kumari,Kandy,Hunnasgiriya,Central,4220,317,4537,168800,12680,181480
1/9/2025,Tina Kumari,Kandy,Hunnasgiriya,Central,825,3310,4135,33000,132400,165400
1/10/2025,Tina Kumari,Kandy,Hunnasgiriya,Central,6471,79,6550,258840,3160,262000
1/11/2025,Tina Kumari,Kandy,Hunnasgiriya,Central,1654,5640,7294,66160,225600,291760
1/12/2025,Tina Kumari,Kandy,Hunnasgiriya,Central,2693,3153,5846,107720,126120,233840
1/13/2025,Tina Kumari,Kandy,Hunnasgiriya,Central,5424,8647,14071,216960,345880,562840
1/14/2025,Tina Kumari,Kandy,Hunnasgiriya,Central,7203,8690,15893,288120,347600,635720
1/15/2025,Tina Kumari,Kandy,Hunnasgiriya,Central,3210,8376,11586,128400,335040,463440
1/16/2025,Tina Kumari,Kandy,Hunnasgiriya,Central,5186,2174,7360,207440,86960,294400
1/17/2025,Tina Kumari,Kandy,Hunnasgiriya,Central,3914,1204,5118,156560,48160,204720
1/18/2025,Tina Kumari,Kandy,Hunnasgiriya,Central,1195,3024,4219,47800,120960,168760
1/19/2025,Tina Kumari,Kandy,Hunnasgiriya,Central,7008,8772,15780,280320,350880,631200
1/20/2025,Tina Kumari,Kandy,Hunnasgiriya,Central,3005,2629,5634,120200,105160,225360
1/21/2025,Tina Kumari,Kandy,Hunnasgiriya,Central,8330,5346,13676,333200,213840,547040
1/22/2025,Tina Kumari,Kandy,Hunnasgiriya,Central,9332,8981,18313,373280,359240,732520
1/23/2025,Tina Kumari,Kandy,Hunnasgiriya,Central,6772,6956,13728,270880,278240,549120
1/24/2025,Tina Kumari,Kandy,Hunnasgiriya,Central,507,4650,5157,20280,186000,206280
1/25/2025,Tina Kumari,Kandy,Hunnasgiriya,Central,6195,8810,15005,247800,352400,600200
1/26/2025,Tina Kumari,Kandy,Hunnasgiriya,Central,9212,382,9594,368480,15280,383760
1/27/2025,Tina Kumari,Kandy,Hunnasgiriya,Central,3902,6915,10817,156080,276600,432680
1/28/2025,Tina Kumari,Kandy,Hunnasgiriya,Central,7318,2378,9696,292720,95120,387840
1/29/2025,Tina Kumari,Kandy,Hunnasgiriya,Central,8996,4028,13024,359840,161120,520960
1/30/2025,Tina Kumari,Kandy,Hunnasgiriya,Central,3799,3082,6881,151960,123280,275240
1/31/2025,Tina Kumari,Kandy,Hunnasgiriya,Central,3847,5660,9507,153880,226400,380280
2/1/2025,Tina Kumari,Kandy,Hunnasgiriya,Central,8756,3150,11906,350240,126000,476240
2/2/2025,Tina Kumari,Kandy,Hunnasgiriya,Central,3255,6630,9885,130200,265200,395400
2/3/2025,Tina Kumari,Kandy,Hunnasgiriya,Central,9427,8312,17739,377080,332480,709560
2/4/2025,Tina Kumari,Kandy,Hunnasgiriya,Central,6686,7507,14193,267440,300280,567720
2/5/2025,Tina Kumari,Kandy,Hunnasgiriya,Central,3404,9983,13387,136160,399320,535480
2/6/2025,Tina Kumari,Kandy,Hunnasgiriya,Central,2664,8249,10913,106560,329960,436520
2/7/2025,Tina Kumari,Kandy,Hunnasgiriya,Central,7523,8575,16098,300920,343000,643920
2/8/2025,Tina Kumari,Kandy,Hunnasgiriya,Central,5498,8310,13808,219920,332400,552320
2/9/2025,Tina Kumari,Kandy,Hunnasgiriya,Central,5866,2750,8616,234640,110000,344640
2/10/2025,Tina Kumari,Kandy,Hunnasgiriya,Central,6325,8394,14719,253000,335760,588760
2/11/2025,Tina Kumari,Kandy,Hunnasgiriya,Central,1193,7750,8943,47720,310000,357720
2/12/2025,Tina Kumari,Kandy,Hunnasgiriya,Central,1522,6000,7522,60880,240000,300880
2/13/2025,Tina Kumari,Kandy,Hunnasgiriya,Central,5099,2502,7601,203960,100080,304040
2/14/2025,Tina Kumari,Kandy,Hunnasgiriya,Central,907,3356,4263,36280,134240,170520
2/15/2025,Tina Kumari,Kandy,Hunnasgiriya,Central,6374,9296,15670,254960,371840,626800
2/16/2025,Tina Kumari,Kandy,Hunnasgiriya,Central,4522,2868,7390,180880,114720,295600
2/17/2025,Tina Kumari,Kandy,Hunnasgiriya,Central,1612,1317,2929,64480,52680,117160
2/18/2025,Tina Kumari,Kandy,Hunnasgiriya,Central,1365,4012,5377,54600,160480,215080
2/19/2025,Tina Kumari,Kandy,Hunnasgiriya,Central,5214,9596,14810,208560,383840,592400
2/20/2025,Tina Kumari,Kandy,Hunnasgiriya,Central,8717,5620,14337,348680,224800,573480
2/21/2025,Tina Kumari,Kandy,Hunnasgiriya,Central,5734,8815,14549,229360,352600,581960
2/22/2025,Tina Kumari,Kandy,Hunnasgiriya,Central,524,9917,10441,20960,396680,417640
2/23/2025,Tina Kumari,Kandy,Hunnasgiriya,Central,7239,9089,16328,289560,363560,653120
2/24/2025,Tina Kumari,Kandy,Hunnasgiriya,Central,3493,7329,10822,139720,293160,432880
2/25/2025,Tina Kumari,Kandy,Hunnasgiriya,Central,2191,3969,6160,87640,158760,246400
2/26/2025,Tina Kumari,Kandy,Hunnasgiriya,Central,2600,2888,5488,104000,115520,219520
2/27/2025,Tina Kumari,Kandy,Hunnasgiriya,Central,8189,3283,11472,327560,131320,458880
2/28/2025,Tina Kumari,Kandy,Hunnasgiriya,Central,8720,8561,17281,348800,342440,691240
3/1/2025,Tina Kumari,Kandy,Hunnasgiriya,Central,7861,8414,16275,314440,336560,651000
3/2/2025,Tina Kumari,Kandy,Hunnasgiriya,Central,1903,6297,8200,76120,251880,328000
3/3/2025,Tina Kumari,Kandy,Hunnasgiriya,Central,9407,2013,11420,376280,80520,456800
3/4/2025,Tina Kumari,Kandy,Hunnasgiriya,Central,9464,1603,11067,378560,64120,442680
3/5/2025,Tina Kumari,Kandy,Hunnasgiriya,Central,5836,9861,15697,233440,394440,627880
3/6/2025,Tina Kumari,Kandy,Hunnasgiriya,Central,289,115,404,11560,4600,16160
3/7/2025,Tina Kumari,Kandy,Hunnasgiriya,Central,5282,9387,14669,211280,375480,586760
3/8/2025,Tina Kumari,Kandy,Hunnasgiriya,Central,4772,7796,12568,190880,311840,502720
3/9/2025,Tina Kumari,Kandy,Hunnasgiriya,Central,493,9086,9579,19720,363440,383160
3/10/2025,Tina Kumari,Kandy,Hunnasgiriya,Central,1775,8246,10021,71000,329840,400840
3/11/2025,Tina Kumari,Kandy,Hunnasgiriya,Central,3347,1889,5236,133880,75560,209440
3/12/2025,Tina Kumari,Kandy,Hunnasgiriya,Central,389,7199,7588,15560,287960,303520
3/13/2025,Tina Kumari,Kandy,Hunnasgiriya,Central,9932,5350,15282,397280,214000,611280
3/14/2025,Tina Kumari,Kandy,Hunnasgiriya,Central,2330,8202,10532,93200,328080,421280
3/15/2025,Tina Kumari,Kandy,Hunnasgiriya,Central,8771,6808,15579,350840,272320,623160
3/16/2025,Tina Kumari,Kandy,Hunnasgiriya,Central,8910,4630,13540,356400,185200,541600
3/17/2025,Tina Kumari,Kandy,Hunnasgiriya,Central,4429,4998,9427,177160,199920,377080
3/18/2025,Tina Kumari,Kandy,Hunnasgiriya,Central,9339,6256,15595,373560,250240,623800
3/19/2025,Tina Kumari,Kandy,Hunnasgiriya,Central,928,3249,4177,37120,129960,167080
3/20/2025,Tina Kumari,Kandy,Hunnasgiriya,Central,3473,5473,8946,138920,218920,357840
3/21/2025,Tina Kumari,Kandy,Hunnasgiriya,Central,316,4021,4337,12640,160840,173480
3/22/2025,Tina Kumari,Kandy,Hunnasgiriya,Central,2039,3883,5922,81560,155320,236880
3/23/2025,Tina Kumari,Kandy,Hunnasgiriya,Central,8199,4576,12775,327960,183040,511000
3/25/2024,Chanaka Mahendra,Kandy,Kandy,Central,2208,3519,5727,88320,140760,229080
3/26/2024,Chanaka Mahendra,Kandy,Kandy,Central,1300,1133,2433,52000,45320,97320
3/27/2024,Chanaka Mahendra,Kandy,Kandy,Central,9786,4541,14327,391440,181640,573080
3/28/2024,Chanaka Mahendra,Kandy,Kandy,Central,513,2762,3275,20520,110480,131000
3/29/2024,Chanaka Mahendra,Kandy,Kandy,Central,7290,910,8200,291600,36400,328000
3/30/2024,Chanaka Mahendra,Kandy,Kandy,Central,1333,436,1769,53320,17440,70760
3/31/2024,Chanaka Mahendra,Kandy,Kandy,Central,331,8013,8344,13240,320520,333760
4/1/2024,Chanaka Mahendra,Kandy,Kandy,Central,3870,8227,12097,154800,329080,483880
4/2/2024,Chanaka Mahendra,Kandy,Kandy,Central,532,8468,9000,21280,338720,360000
4/3/2024,Chanaka Mahendra,Kandy,Kandy,Central,4332,3205,7537,173280,128200,301480
4/4/2024,Chanaka Mahendra,Kandy,Kandy,Central,4798,5261,10059,191920,210440,402360
4/5/2024,Chanaka Mahendra,Kandy,Kandy,Central,2061,7572,9633,82440,302880,385320
4/6/2024,Chanaka Mahendra,Kandy,Kandy,Central,9440,9175,18615,377600,367000,744600
4/7/2024,Chanaka Mahendra,Kandy,Kandy,Central,2702,5821,8523,108080,232840,340920
4/8/2024,Chanaka Mahendra,Kandy,Kandy,Central,2662,7526,10188,106480,301040,407520
4/9/2024,Chanaka Mahendra,Kandy,Kandy,Central,2460,9249,11709,98400,369960,468360
4/10/2024,Chanaka Mahendra,Kandy,Kandy,Central,1595,1361,2956,63800,54440,118240
4/11/2024,Chanaka Mahendra,Kandy,Kandy,Central,2574,5854,8428,102960,234160,337120
4/19/2024,Chanaka Mahendra,Kandy,Kandy,Central,9716,6923,16639,388640,276920,665560
4/20/2024,Chanaka Mahendra,Kandy,Kandy,Central,4526,3458,7984,181040,138320,319360
4/21/2024,Chanaka Mahendra,Kandy,Kandy,Central,6106,322,6428,244240,12880,257120
4/22/2024,Chanaka Mahendra,Kandy,Kandy,Central,1046,2083,3129,41840,83320,125160
4/23/2024,Chanaka Mahendra,Kandy,Kandy,Central,5973,3799,9772,238920,151960,390880
4/24/2024,Chanaka Mahendra,Kandy,Kandy,Central,7510,1103,8613,300400,44120,344520
4/25/2024,Chanaka Mahendra,Kandy,Kandy,Central,8102,5767,13869,324080,230680,554760
4/26/2024,Chanaka Mahendra,Kandy,Kandy,Central,4703,540,5243,188120,21600,209720
4/27/2024,Chanaka Mahendra,Kandy,Kandy,Central,8142,6500,14642,325680,260000,585680
4/28/2024,Chanaka Mahendra,Kandy,Kandy,Central,4321,1977,6298,172840,79080,251920
4/29/2024,Chanaka Mahendra,Kandy,Kandy,Central,4021,2626,6647,160840,105040,265880
4/30/2024,Chanaka Mahendra,Kandy,Kandy,Central,8338,2750,11088,333520,110000,443520
5/1/2024,Chanaka Mahendra,Kandy,Kandy,Central,1123,2972,4095,44920,118880,163800
5/2/2024,Chanaka Mahendra,Kandy,Kandy,Central,5439,9967,15406,217560,398680,616240
5/3/2024,Chanaka Mahendra,Kandy,Kandy,Central,2274,6945,9219,90960,277800,368760
5/4/2024,Chanaka Mahendra,Kandy,Kandy,Central,8397,3100,11497,335880,124000,459880
5/5/2024,Chanaka Mahendra,Kandy,Kandy,Central,1929,1785,3714,77160,71400,148560
5/6/2024,Chanaka Mahendra,Kandy,Kandy,Central,1387,3239,4626,55480,129560,185040
5/7/2024,Chanaka Mahendra,Kandy,Kandy,Central,835,6860,7695,33400,274400,307800
5/8/2024,Chanaka Mahendra,Kandy,Kandy,Central,2681,7572,10253,107240,302880,410120
5/9/2024,Chanaka Mahendra,Kandy,Kandy,Central,526,6404,6930,21040,256160,277200
5/10/2024,Chanaka Mahendra,Kandy,Kandy,Central,7019,243,7262,280760,9720,290480
5/11/2024,Chanaka Mahendra,Kandy,Kandy,Central,6548,8697,15245,261920,347880,609800
5/12/2024,Chanaka Mahendra,Kandy,Kandy,Central,7591,8950,16541,303640,358000,661640
5/13/2024,Chanaka Mahendra,Kandy,Kandy,Central,8147,1606,9753,325880,64240,390120
5/14/2024,Chanaka Mahendra,Kandy,Kandy,Central,8068,9434,17502,322720,377360,700080
5/15/2024,Chanaka Mahendra,Kandy,Kandy,Central,1971,8536,10507,78840,341440,420280
5/16/2024,Chanaka Mahendra,Kandy,Kandy,Central,1364,5700,7064,54560,228000,282560
5/17/2024,Chanaka Mahendra,Kandy,Kandy,Central,7683,9563,17246,307320,382520,689840
5/18/2024,Chanaka Mahendra,Kandy,Kandy,Central,3584,6644,10228,143360,265760,409120
5/19/2024,Chanaka Mahendra,Kandy,Kandy,Central,7281,3421,10702,291240,136840,428080
5/20/2024,Chanaka Mahendra,Kandy,Kandy,Central,4699,9131,13830,187960,365240,553200
5/21/2024,Chanaka Mahendra,Kandy,Kandy,Central,3649,1542,5191,145960,61680,207640
5/22/2024,Chanaka Mahendra,Kandy,Kandy,Central,4641,8459,13100,185640,338360,524000
5/24/2024,Chanaka Mahendra,Kandy,Kandy,Central,4152,4085,8237,166080,163400,329480
5/25/2024,Chanaka Mahendra,Kandy,Kandy,Central,3148,9878,13026,125920,395120,521040
5/26/2024,Chanaka Mahendra,Kandy,Kandy,Central,1554,5143,6697,62160,205720,267880
5/27/2024,Chanaka Mahendra,Kandy,Kandy,Central,3917,8475,12392,156680,339000,495680
5/28/2024,Chanaka Mahendra,Kandy,Kandy,Central,1417,5951,7368,56680,238040,294720
5/29/2024,Chanaka Mahendra,Kandy,Kandy,Central,170,8537,8707,6800,341480,348280
5/30/2024,Chanaka Mahendra,Kandy,Kandy,Central,875,1598,2473,35000,63920,98920
5/31/2024,Chanaka Mahendra,Kandy,Kandy,Central,9240,5786,15026,369600,231440,601040
6/1/2024,Chanaka Mahendra,Kandy,Kandy,Central,9281,78,9359,371240,3120,374360
6/2/2024,Chanaka Mahendra,Kandy,Kandy,Central,1066,4273,5339,42640,170920,213560
6/3/2024,Chanaka Mahendra,Kandy,Kandy,Central,4328,6568,10896,173120,262720,435840
6/4/2024,Chanaka Mahendra,Kandy,Kandy,Central,2931,7264,10195,117240,290560,407800
6/5/2024,Chanaka Mahendra,Kandy,Kandy,Central,9788,6267,16055,391520,250680,642200
6/6/2024,Chanaka Mahendra,Kandy,Kandy,Central,7013,6366,13379,280520,254640,535160
6/7/2024,Chanaka Mahendra,Kandy,Kandy,Central,982,7566,8548,39280,302640,341920
6/8/2024,Chanaka Mahendra,Kandy,Kandy,Central,1438,5770,7208,57520,230800,288320
6/9/2024,Chanaka Mahendra,Kandy,Kandy,Central,9715,3569,13284,388600,142760,531360
6/10/2024,Chanaka Mahendra,Kandy,Kandy,Central,550,1905,2455,22000,76200,98200
6/11/2024,Chanaka Mahendra,Kandy,Kandy,Central,5280,6185,11465,211200,247400,458600
6/12/2024,Chanaka Mahendra,Kandy,Kandy,Central,7442,1856,9298,297680,74240,371920
6/13/2024,Chanaka Mahendra,Kandy,Kandy,Central,7105,2406,9511,284200,96240,380440
6/14/2024,Chanaka Mahendra,Kandy,Kandy,Central,6599,31,6630,263960,1240,265200
6/15/2024,Chanaka Mahendra,Kandy,Kandy,Central,3170,5626,8796,126800,225040,351840
6/16/2024,Chanaka Mahendra,Kandy,Kandy,Central,8874,1328,10202,354960,53120,408080
6/17/2024,Chanaka Mahendra,Kandy,Kandy,Central,7604,3732,11336,304160,149280,453440
6/18/2024,Chanaka Mahendra,Kandy,Kandy,Central,5981,3613,9594,239240,144520,383760
6/19/2024,Chanaka Mahendra,Kandy,Kandy,Central,1348,2996,4344,53920,119840,173760
6/20/2024,Chanaka Mahendra,Kandy,Kandy,Central,973,3001,3974,38920,120040,158960
6/21/2024,Chanaka Mahendra,Kandy,Kandy,Central,2075,609,2684,83000,24360,107360
6/22/2024,Chanaka Mahendra,Kandy,Kandy,Central,6838,1257,8095,273520,50280,323800
6/23/2024,Chanaka Mahendra,Kandy,Kandy,Central,7893,274,8167,315720,10960,326680
6/24/2024,Chanaka Mahendra,Kandy,Kandy,Central,1063,8737,9800,42520,349480,392000
6/25/2024,Chanaka Mahendra,Kandy,Kandy,Central,274,8018,8292,10960,320720,331680
6/26/2024,Chanaka Mahendra,Kandy,Kandy,Central,8011,5499,13510,320440,219960,540400
6/27/2024,Chanaka Mahendra,Kandy,Kandy,Central,9379,3045,12424,375160,121800,496960
6/28/2024,Chanaka Mahendra,Kandy,Kandy,Central,4272,516,4788,170880,20640,191520
6/29/2024,Chanaka Mahendra,Kandy,Kandy,Central,8246,4570,12816,329840,182800,512640
6/30/2024,Chanaka Mahendra,Kandy,Kandy,Central,446,1184,1630,17840,47360,65200
7/1/2024,Chanaka Mahendra,Kandy,Kandy,Central,1627,1944,3571,65080,77760,142840
7/2/2024,Chanaka Mahendra,Kandy,Kandy,Central,6366,2439,8805,254640,97560,352200
7/3/2024,Chanaka Mahendra,Kandy,Kandy,Central,6469,9775,16244,258760,391000,649760
7/4/2024,Chanaka Mahendra,Kandy,Kandy,Central,3240,465,3705,129600,18600,148200
7/5/2024,Chanaka Mahendra,Kandy,Kandy,Central,6834,7673,14507,273360,306920,580280
7/6/2024,Chanaka Mahendra,Kandy,Kandy,Central,8514,9710,18224,340560,388400,728960
7/7/2024,Chanaka Mahendra,Kandy,Kandy,Central,9998,1382,11380,399920,55280,455200
7/8/2024,Chanaka Mahendra,Kandy,Kandy,Central,1231,5980,7211,49240,239200,288440
7/9/2024,Chanaka Mahendra,Kandy,Kandy,Central,2139,1845,3984,85560,73800,159360
7/10/2024,Chanaka Mahendra,Kandy,Kandy,Central,377,8959,9336,15080,358360,373440
7/11/2024,Chanaka Mahendra,Kandy,Kandy,Central,7840,7540,15380,313600,301600,615200
7/12/2024,Chanaka Mahendra,Kandy,Kandy,Central,415,8281,8696,16600,331240,347840
7/13/2024,Chanaka Mahendra,Kandy,Kandy,Central,3995,8170,12165,159800,326800,486600
7/14/2024,Chanaka Mahendra,Kandy,Kandy,Central,342,2855,3197,13680,114200,127880
7/15/2024,Chanaka Mahendra,Kandy,Kandy,Central,5655,8569,14224,226200,342760,568960
7/16/2024,Chanaka Mahendra,Kandy,Kandy,Central,2951,6688,9639,118040,267520,385560
7/17/2024,Chanaka Mahendra,Kandy,Kandy,Central,7681,5011,12692,307240,200440,507680
7/18/2024,Chanaka Mahendra,Kandy,Kandy,Central,688,1380,2068,27520,55200,82720
7/19/2024,Chanaka Mahendra,Kandy,Kandy,Central,9018,4489,13507,360720,179560,540280
7/20/2024,Chanaka Mahendra,Kandy,Kandy,Central,369,5130,5499,14760,205200,219960
7/21/2024,Chanaka Mahendra,Kandy,Kandy,Central,6535,8733,15268,261400,349320,610720
7/22/2024,Chanaka Mahendra,Kandy,Kandy,Central,7927,4074,12001,317080,162960,480040
7/23/2024,Chanaka Mahendra,Kandy,Kandy,Central,6081,8553,14634,243240,342120,585360
7/24/2024,Chanaka Mahendra,Kandy,Kandy,Central,62,7197,7259,2480,287880,290360
7/25/2024,Chanaka Mahendra,Kandy,Kandy,Central,1821,782,2603,72840,31280,104120
7/26/2024,Chanaka Mahendra,Kandy,Kandy,Central,2711,4699,7410,108440,187960,296400
7/27/2024,Chanaka Mahendra,Kandy,Kandy,Central,3756,4641,8397,150240,185640,335880
7/28/2024,Chanaka Mahendra,Kandy,Kandy,Central,8580,7097,15677,343200,283880,627080
7/29/2024,Chanaka Mahendra,Kandy,Kandy,Central,5932,7099,13031,237280,283960,521240
7/30/2024,Chanaka Mahendra,Kandy,Kandy,Central,8743,6232,14975,349720,249280,599000
7/31/2024,Chanaka Mahendra,Kandy,Kandy,Central,349,9613,9962,13960,384520,398480
8/1/2024,Chanaka Mahendra,Kandy,Kandy,Central,4915,3640,8555,196600,145600,342200
8/2/2024,Chanaka Mahendra,Kandy,Kandy,Central,8817,4035,12852,352680,161400,514080
8/3/2024,Chanaka Mahendra,Kandy,Kandy,Central,4532,5227,9759,181280,209080,390360
8/4/2024,Chanaka Mahendra,Kandy,Kandy,Central,8649,3852,12501,345960,154080,500040
8/5/2024,Chanaka Mahendra,Kandy,Kandy,Central,6314,7522,13836,252560,300880,553440
8/6/2024,Chanaka Mahendra,Kandy,Kandy,Central,7771,335,8106,310840,13400,324240
8/7/2024,Chanaka Mahendra,Kandy,Kandy,Central,7238,2903,10141,289520,116120,405640
8/8/2024,Chanaka Mahendra,Kandy,Kandy,Central,1512,327,1839,60480,13080,73560
8/9/2024,Chanaka Mahendra,Kandy,Kandy,Central,5928,1823,7751,237120,72920,310040
8/10/2024,Chanaka Mahendra,Kandy,Kandy,Central,6906,2887,9793,276240,115480,391720
8/11/2024,Chanaka Mahendra,Kandy,Kandy,Central,4165,8434,12599,166600,337360,503960
8/12/2024,Chanaka Mahendra,Kandy,Kandy,Central,9587,4725,14312,383480,189000,572480
8/13/2024,Chanaka Mahendra,Kandy,Kandy,Central,9551,1248,10799,382040,49920,431960
8/14/2024,Chanaka Mahendra,Kandy,Kandy,Central,2631,9050,11681,105240,362000,467240
8/15/2024,Chanaka Mahendra,Kandy,Kandy,Central,3561,5591,9152,142440,223640,366080
8/16/2024,Chanaka Mahendra,Kandy,Kandy,Central,2139,3776,5915,85560,151040,236600
8/17/2024,Chanaka Mahendra,Kandy,Kandy,Central,781,2693,3474,31240,107720,138960
8/18/2024,Chanaka Mahendra,Kandy,Kandy,Central,6368,2350,8718,254720,94000,348720
8/19/2024,Chanaka Mahendra,Kandy,Kandy,Central,666,863,1529,26640,34520,61160
8/20/2024,Chanaka Mahendra,Kandy,Kandy,Central,329,9090,9419,13160,363600,376760
8/21/2024,Chanaka Mahendra,Kandy,Kandy,Central,2326,5993,8319,93040,239720,332760
8/22/2024,Chanaka Mahendra,Kandy,Kandy,Central,4174,2937,7111,166960,117480,284440
8/23/2024,Chanaka Mahendra,Kandy,Kandy,Central,9809,5706,15515,392360,228240,620600
8/24/2024,Chanaka Mahendra,Kandy,Kandy,Central,5365,3920,9285,214600,156800,371400
8/25/2024,Chanaka Mahendra,Kandy,Kandy,Central,9038,5488,14526,361520,219520,581040
8/26/2024,Chanaka Mahendra,Kandy,Kandy,Central,2972,6118,9090,118880,244720,363600
8/27/2024,Chanaka Mahendra,Kandy,Kandy,Central,5061,2961,8022,202440,118440,320880
8/28/2024,Chanaka Mahendra,Kandy,Kandy,Central,4636,4685,9321,185440,187400,372840
8/29/2024,Chanaka Mahendra,Kandy,Kandy,Central,9920,2814,12734,396800,112560,509360
8/30/2024,Chanaka Mahendra,Kandy,Kandy,Central,540,2594,3134,21600,103760,125360
8/31/2024,Chanaka Mahendra,Kandy,Kandy,Central,2758,1022,3780,110320,40880,151200
9/1/2024,Chanaka Mahendra,Kandy,Kandy,Central,1553,4205,5758,62120,168200,230320
9/2/2024,Chanaka Mahendra,Kandy,Kandy,Central,7986,6253,14239,319440,250120,569560
9/3/2024,Chanaka Mahendra,Kandy,Kandy,Central,3694,4797,8491,147760,191880,339640
9/4/2024,Chanaka Mahendra,Kandy,Kandy,Central,1612,5425,7037,64480,217000,281480
9/5/2024,Chanaka Mahendra,Kandy,Kandy,Central,2167,6973,9140,86680,278920,365600
9/6/2024,Chanaka Mahendra,Kandy,Kandy,Central,7755,5626,13381,310200,225040,535240
9/7/2024,Chanaka Mahendra,Kandy,Kandy,Central,3500,8153,11653,140000,326120,466120
9/8/2024,Chanaka Mahendra,Kandy,Kandy,Central,1557,4703,6260,62280,188120,250400
9/9/2024,Chanaka Mahendra,Kandy,Kandy,Central,8898,22,8920,355920,880,356800
9/10/2024,Chanaka Mahendra,Kandy,Kandy,Central,6966,3944,10910,278640,157760,436400
9/11/2024,Chanaka Mahendra,Kandy,Kandy,Central,6848,9270,16118,273920,370800,644720
9/12/2024,Chanaka Mahendra,Kandy,Kandy,Central,8227,8441,16668,329080,337640,666720
9/13/2024,Chanaka Mahendra,Kandy,Kandy,Central,4545,1556,6101,181800,62240,244040
9/14/2024,Chanaka Mahendra,Kandy,Kandy,Central,5642,2958,8600,225680,118320,344000
9/15/2024,Chanaka Mahendra,Kandy,Kandy,Central,1905,9690,11595,76200,387600,463800
9/16/2024,Chanaka Mahendra,Kandy,Kandy,Central,3334,1639,4973,133360,65560,198920
9/17/2024,Chanaka Mahendra,Kandy,Kandy,Central,4277,3128,7405,171080,125120,296200
9/18/2024,Chanaka Mahendra,Kandy,Kandy,Central,601,5759,6360,24040,230360,254400
9/19/2024,Chanaka Mahendra,Kandy,Kandy,Central,8024,1193,9217,320960,47720,368680
9/20/2024,Chanaka Mahendra,Kandy,Kandy,Central,8157,9926,18083,326280,397040,723320
9/21/2024,Chanaka Mahendra,Kandy,Kandy,Central,335,1101,1436,13400,44040,57440
9/22/2024,Chanaka Mahendra,Kandy,Kandy,Central,2400,2013,4413,96000,80520,176520
9/23/2024,Chanaka Mahendra,Kandy,Kandy,Central,2957,8282,11239,118280,331280,449560
9/24/2024,Chanaka Mahendra,Kandy,Kandy,Central,2035,6946,8981,81400,277840,359240
9/25/2024,Chanaka Mahendra,Kandy,Kandy,Central,248,3841,4089,9920,153640,163560
9/26/2024,Chanaka Mahendra,Kandy,Kandy,Central,1515,7757,9272,60600,310280,370880
9/27/2024,Chanaka Mahendra,Kandy,Kandy,Central,2013,9879,11892,80520,395160,475680
9/28/2024,Chanaka Mahendra,Kandy,Kandy,Central,690,1013,1703,27600,40520,68120
9/29/2024,Chanaka Mahendra,Kandy,Kandy,Central,6556,2481,9037,262240,99240,361480
9/30/2024,Chanaka Mahendra,Kandy,Kandy,Central,5211,5309,10520,208440,212360,420800
10/1/2024,Chanaka Mahendra,Kandy,Kandy,Central,649,2032,2681,25960,81280,107240
10/2/2024,Chanaka Mahendra,Kandy,Kandy,Central,3930,6165,10095,157200,246600,403800
10/3/2024,Chanaka Mahendra,Kandy,Kandy,Central,3127,6356,9483,125080,254240,379320
10/4/2024,Chanaka Mahendra,Kandy,Kandy,Central,5548,7745,13293,221920,309800,531720
10/5/2024,Chanaka Mahendra,Kandy,Kandy,Central,4774,37,4811,190960,1480,192440
10/6/2024,Chanaka Mahendra,Kandy,Kandy,Central,7375,446,7821,295000,17840,312840
10/7/2024,Chanaka Mahendra,Kandy,Kandy,Central,1613,2974,4587,64520,118960,183480
10/8/2024,Chanaka Mahendra,Kandy,Kandy,Central,1277,2182,3459,51080,87280,138360
10/9/2024,Chanaka Mahendra,Kandy,Kandy,Central,2626,4820,7446,105040,192800,297840
10/10/2024,Chanaka Mahendra,Kandy,Kandy,Central,5990,182,6172,239600,7280,246880
10/11/2024,Chanaka Mahendra,Kandy,Kandy,Central,5031,1076,6107,201240,43040,244280
10/12/2024,Chanaka Mahendra,Kandy,Kandy,Central,7178,7133,14311,287120,285320,572440
10/13/2024,Chanaka Mahendra,Kandy,Kandy,Central,2138,8829,10967,85520,353160,438680
10/14/2024,Chanaka Mahendra,Kandy,Kandy,Central,3330,3982,7312,133200,159280,292480
10/15/2024,Chanaka Mahendra,Kandy,Kandy,Central,4932,7472,12404,197280,298880,496160
10/16/2024,Chanaka Mahendra,Kandy,Kandy,Central,6805,1846,8651,272200,73840,346040
10/17/2024,Chanaka Mahendra,Kandy,Kandy,Central,1193,2169,3362,47720,86760,134480
10/18/2024,Chanaka Mahendra,Kandy,Kandy,Central,6286,2970,9256,251440,118800,370240
10/19/2024,Chanaka Mahendra,Kandy,Kandy,Central,3602,4791,8393,144080,191640,335720
10/20/2024,Chanaka Mahendra,Kandy,Kandy,Central,7756,5653,13409,310240,226120,536360
10/21/2024,Chanaka Mahendra,Kandy,Kandy,Central,1823,8593,10416,72920,343720,416640
10/22/2024,Chanaka Mahendra,Kandy,Kandy,Central,2632,3396,6028,105280,135840,241120
10/23/2024,Chanaka Mahendra,Kandy,Kandy,Central,3621,4931,8552,144840,197240,342080
10/24/2024,Chanaka Mahendra,Kandy,Kandy,Central,3957,1559,5516,158280,62360,220640
10/25/2024,Chanaka Mahendra,Kandy,Kandy,Central,2713,5431,8144,108520,217240,325760
10/26/2024,Chanaka Mahendra,Kandy,Kandy,Central,3466,9444,12910,138640,377760,516400
10/27/2024,Chanaka Mahendra,Kandy,Kandy,Central,2119,2751,4870,84760,110040,194800
10/28/2024,Chanaka Mahendra,Kandy,Kandy,Central,7278,9737,17015,291120,389480,680600
10/29/2024,Chanaka Mahendra,Kandy,Kandy,Central,8748,1194,9942,349920,47760,397680
10/30/2024,Chanaka Mahendra,Kandy,Kandy,Central,3417,7401,10818,136680,296040,432720
10/31/2024,Chanaka Mahendra,Kandy,Kandy,Central,7033,7814,14847,281320,312560,593880
11/1/2024,Chanaka Mahendra,Kandy,Kandy,Central,1995,308,2303,79800,12320,92120
11/2/2024,Chanaka Mahendra,Kandy,Kandy,Central,7440,1535,8975,297600,61400,359000
11/3/2024,Chanaka Mahendra,Kandy,Kandy,Central,4957,8768,13725,198280,350720,549000
11/4/2024,Chanaka Mahendra,Kandy,Kandy,Central,4142,4101,8243,165680,164040,329720
11/5/2024,Chanaka Mahendra,Kandy,Kandy,Central,3886,4494,8380,155440,179760,335200
11/6/2024,Chanaka Mahendra,Kandy,Kandy,Central,9462,2304,11766,378480,92160,470640
11/7/2024,Chanaka Mahendra,Kandy,Kandy,Central,130,6039,6169,5200,241560,246760
11/8/2024,Chanaka Mahendra,Kandy,Kandy,Central,396,4627,5023,15840,185080,200920
11/9/2024,Chanaka Mahendra,Kandy,Kandy,Central,4907,285,5192,196280,11400,207680
11/10/2024,Chanaka Mahendra,Kandy,Kandy,Central,7871,9929,17800,314840,397160,712000
11/11/2024,Chanaka Mahendra,Kandy,Kandy,Central,9380,6735,16115,375200,269400,644600
11/12/2024,Chanaka Mahendra,Kandy,Kandy,Central,8598,8758,17356,343920,350320,694240
11/13/2024,Chanaka Mahendra,Kandy,Kandy,Central,9422,3805,13227,376880,152200,529080
11/14/2024,Chanaka Mahendra,Kandy,Kandy,Central,7290,6568,13858,291600,262720,554320
11/15/2024,Chanaka Mahendra,Kandy,Kandy,Central,9340,6167,15507,373600,246680,620280
11/16/2024,Chanaka Mahendra,Kandy,Kandy,Central,3718,3781,7499,148720,151240,299960
11/17/2024,Chanaka Mahendra,Kandy,Kandy,Central,6896,4399,11295,275840,175960,451800
11/18/2024,Chanaka Mahendra,Kandy,Kandy,Central,8982,3268,12250,359280,130720,490000
11/19/2024,Chanaka Mahendra,Kandy,Kandy,Central,494,3586,4080,19760,143440,163200
11/20/2024,Chanaka Mahendra,Kandy,Kandy,Central,4502,2624,7126,180080,104960,285040
11/21/2024,Chanaka Mahendra,Kandy,Kandy,Central,1200,8547,9747,48000,341880,389880
11/22/2024,Chanaka Mahendra,Kandy,Kandy,Central,7821,1287,9108,312840,51480,364320
11/23/2024,Chanaka Mahendra,Kandy,Kandy,Central,6638,4375,11013,265520,175000,440520
11/24/2024,Chanaka Mahendra,Kandy,Kandy,Central,6903,6250,13153,276120,250000,526120
11/25/2024,Chanaka Mahendra,Kandy,Kandy,Central,7991,4435,12426,319640,177400,497040
11/26/2024,Chanaka Mahendra,Kandy,Kandy,Central,849,2596,3445,33960,103840,137800
11/27/2024,Chanaka Mahendra,Kandy,Kandy,Central,4371,7569,11940,174840,302760,477600
11/28/2024,Chanaka Mahendra,Kandy,Kandy,Central,779,7354,8133,31160,294160,325320
11/29/2024,Chanaka Mahendra,Kandy,Kandy,Central,8589,4447,13036,343560,177880,521440
11/30/2024,Chanaka Mahendra,Kandy,Kandy,Central,4875,2757,7632,195000,110280,305280
12/1/2024,Chanaka Mahendra,Kandy,Kandy,Central,5404,1498,6902,216160,59920,276080
12/2/2024,Chanaka Mahendra,Kandy,Kandy,Central,9874,9151,19025,394960,366040,761000
12/3/2024,Chanaka Mahendra,Kandy,Kandy,Central,6093,9040,15133,243720,361600,605320
12/4/2024,Chanaka Mahendra,Kandy,Kandy,Central,4404,5823,10227,176160,232920,409080
12/5/2024,Chanaka Mahendra,Kandy,Kandy,Central,6057,2788,8845,242280,111520,353800
12/6/2024,Chanaka Mahendra,Kandy,Kandy,Central,5048,8940,13988,201920,357600,559520
12/7/2024,Chanaka Mahendra,Kandy,Kandy,Central,987,2038,3025,39480,81520,121000
12/8/2024,Chanaka Mahendra,Kandy,Kandy,Central,1484,8378,9862,59360,335120,394480
12/9/2024,Chanaka Mahendra,Kandy,Kandy,Central,8619,7901,16520,344760,316040,660800
12/10/2024,Chanaka Mahendra,Kandy,Kandy,Central,916,6882,7798,36640,275280,311920
12/11/2024,Chanaka Mahendra,Kandy,Kandy,Central,5332,6534,11866,213280,261360,474640
12/12/2024,Chanaka Mahendra,Kandy,Kandy,Central,9596,2197,11793,383840,87880,471720
12/13/2024,Chanaka Mahendra,Kandy,Kandy,Central,7782,4761,12543,311280,190440,501720
12/14/2024,Chanaka Mahendra,Kandy,Kandy,Central,247,8772,9019,9880,350880,360760
12/15/2024,Chanaka Mahendra,Kandy,Kandy,Central,6315,4027,10342,252600,161080,413680
12/16/2024,Chanaka Mahendra,Kandy,Kandy,Central,6411,7698,14109,256440,307920,564360
12/17/2024,Chanaka Mahendra,Kandy,Kandy,Central,9751,3890,13641,390040,155600,545640
12/18/2024,Chanaka Mahendra,Kandy,Kandy,Central,6518,6429,12947,260720,257160,517880
12/19/2024,Chanaka Mahendra,Kandy,Kandy,Central,7847,8889,16736,313880,355560,669440
12/20/2024,Chanaka Mahendra,Kandy,Kandy,Central,9184,5892,15076,367360,235680,603040
12/21/2024,Chanaka Mahendra,Kandy,Kandy,Central,1905,5436,7341,76200,217440,293640
12/22/2024,Chanaka Mahendra,Kandy,Kandy,Central,8769,5455,14224,350760,218200,568960
12/23/2024,Chanaka Mahendra,Kandy,Kandy,Central,4690,5379,10069,187600,215160,402760
12/24/2024,Chanaka Mahendra,Kandy,Kandy,Central,6200,4407,10607,248000,176280,424280
12/25/2024,Chanaka Mahendra,Kandy,Kandy,Central,8495,697,9192,339800,27880,367680
12/26/2024,Chanaka Mahendra,Kandy,Kandy,Central,6368,726,7094,254720,29040,283760
12/27/2024,Chanaka Mahendra,Kandy,Kandy,Central,7636,3469,11105,305440,138760,444200
12/28/2024,Chanaka Mahendra,Kandy,Kandy,Central,1889,8811,10700,75560,352440,428000
12/29/2024,Chanaka Mahendra,Kandy,Kandy,Central,1392,4491,5883,55680,179640,235320
12/30/2024,Chanaka Mahendra,Kandy,Kandy,Central,6348,8367,14715,253920,334680,588600
12/31/2024,Chanaka Mahendra,Kandy,Kandy,Central,2411,4455,6866,96440,178200,274640
1/1/2025,Chanaka Mahendra,Kandy,Kandy,Central,8799,3415,12214,351960,136600,488560
1/2/2025,Chanaka Mahendra,Kandy,Kandy,Central,1646,4853,6499,65840,194120,259960
1/3/2025,Chanaka Mahendra,Kandy,Kandy,Central,3446,4407,7853,137840,176280,314120
1/4/2025,Chanaka Mahendra,Kandy,Kandy,Central,8744,6630,15374,349760,265200,614960
1/5/2025,Chanaka Mahendra,Kandy,Kandy,Central,5172,6768,11940,206880,270720,477600
1/6/2025,Chanaka Mahendra,Kandy,Kandy,Central,4628,7767,12395,185120,310680,495800
1/7/2025,Chanaka Mahendra,Kandy,Kandy,Central,1672,9593,11265,66880,383720,450600
1/8/2025,Chanaka Mahendra,Kandy,Kandy,Central,2299,6442,8741,91960,257680,349640
1/9/2025,Chanaka Mahendra,Kandy,Kandy,Central,269,100,369,10760,4000,14760
1/10/2025,Chanaka Mahendra,Kandy,Kandy,Central,7455,9575,17030,298200,383000,681200
1/11/2025,Chanaka Mahendra,Kandy,Kandy,Central,6449,7426,13875,257960,297040,555000
1/12/2025,Chanaka Mahendra,Kandy,Kandy,Central,8661,5846,14507,346440,233840,580280
1/13/2025,Chanaka Mahendra,Kandy,Kandy,Central,4229,6841,11070,169160,273640,442800
1/14/2025,Chanaka Mahendra,Kandy,Kandy,Central,2074,5309,7383,82960,212360,295320
1/15/2025,Chanaka Mahendra,Kandy,Kandy,Central,1834,1415,3249,73360,56600,129960
1/16/2025,Chanaka Mahendra,Kandy,Kandy,Central,1419,6700,8119,56760,268000,324760
1/17/2025,Chanaka Mahendra,Kandy,Kandy,Central,4804,657,5461,192160,26280,218440
1/18/2025,Chanaka Mahendra,Kandy,Kandy,Central,3794,3858,7652,151760,154320,306080
1/19/2025,Chanaka Mahendra,Kandy,Kandy,Central,2308,5527,7835,92320,221080,313400
1/20/2025,Chanaka Mahendra,Kandy,Kandy,Central,937,5158,6095,37480,206320,243800
1/21/2025,Chanaka Mahendra,Kandy,Kandy,Central,9282,2089,11371,371280,83560,454840
1/22/2025,Chanaka Mahendra,Kandy,Kandy,Central,1596,3500,5096,63840,140000,203840
1/23/2025,Chanaka Mahendra,Kandy,Kandy,Central,6429,3853,10282,257160,154120,411280
1/24/2025,Chanaka Mahendra,Kandy,Kandy,Central,7189,1263,8452,287560,50520,338080
1/25/2025,Chanaka Mahendra,Kandy,Kandy,Central,5689,9546,15235,227560,381840,609400
1/26/2025,Chanaka Mahendra,Kandy,Kandy,Central,4908,6812,11720,196320,272480,468800
1/27/2025,Chanaka Mahendra,Kandy,Kandy,Central,4808,1143,5951,192320,45720,238040
1/28/2025,Chanaka Mahendra,Kandy,Kandy,Central,6129,6109,12238,245160,244360,489520
1/29/2025,Chanaka Mahendra,Kandy,Kandy,Central,5109,4173,9282,204360,166920,371280
1/30/2025,Chanaka Mahendra,Kandy,Kandy,Central,1909,7042,8951,76360,281680,358040
1/31/2025,Chanaka Mahendra,Kandy,Kandy,Central,5163,5736,10899,206520,229440,435960
2/1/2025,Chanaka Mahendra,Kandy,Kandy,Central,4367,7954,12321,174680,318160,492840
2/2/2025,Chanaka Mahendra,Kandy,Kandy,Central,4828,885,5713,193120,35400,228520
2/3/2025,Chanaka Mahendra,Kandy,Kandy,Central,3259,706,3965,130360,28240,158600
2/4/2025,Chanaka Mahendra,Kandy,Kandy,Central,9265,6243,15508,370600,249720,620320
2/5/2025,Chanaka Mahendra,Kandy,Kandy,Central,3051,9840,12891,122040,393600,515640
2/6/2025,Chanaka Mahendra,Kandy,Kandy,Central,6403,3359,9762,256120,134360,390480
2/7/2025,Chanaka Mahendra,Kandy,Kandy,Central,6020,2266,8286,240800,90640,331440
2/8/2025,Chanaka Mahendra,Kandy,Kandy,Central,2626,4807,7433,105040,192280,297320
2/9/2025,Chanaka Mahendra,Kandy,Kandy,Central,9423,2383,11806,376920,95320,472240
2/10/2025,Chanaka Mahendra,Kandy,Kandy,Central,8343,310,8653,333720,12400,346120
2/11/2025,Chanaka Mahendra,Kandy,Kandy,Central,4578,2170,6748,183120,86800,269920
2/12/2025,Chanaka Mahendra,Kandy,Kandy,Central,9009,996,10005,360360,39840,400200
2/13/2025,Chanaka Mahendra,Kandy,Kandy,Central,8832,6046,14878,353280,241840,595120
2/14/2025,Chanaka Mahendra,Kandy,Kandy,Central,5372,2401,7773,214880,96040,310920
2/15/2025,Chanaka Mahendra,Kandy,Kandy,Central,5078,8257,13335,203120,330280,533400
2/16/2025,Chanaka Mahendra,Kandy,Kandy,Central,1517,2575,4092,60680,103000,163680
2/17/2025,Chanaka Mahendra,Kandy,Kandy,Central,7050,5915,12965,282000,236600,518600
2/18/2025,Chanaka Mahendra,Kandy,Kandy,Central,500,1274,1774,20000,50960,70960
2/19/2025,Chanaka Mahendra,Kandy,Kandy,Central,3986,1422,5408,159440,56880,216320
2/20/2025,Chanaka Mahendra,Kandy,Kandy,Central,8766,1167,9933,350640,46680,397320
2/21/2025,Chanaka Mahendra,Kandy,Kandy,Central,260,7241,7501,10400,289640,300040
2/22/2025,Chanaka Mahendra,Kandy,Kandy,Central,469,4177,4646,18760,167080,185840
2/23/2025,Chanaka Mahendra,Kandy,Kandy,Central,3928,8262,12190,157120,330480,487600
2/24/2025,Chanaka Mahendra,Kandy,Kandy,Central,5770,9352,15122,230800,374080,604880
2/25/2025,Chanaka Mahendra,Kandy,Kandy,Central,9057,4183,13240,362280,167320,529600
2/26/2025,Chanaka Mahendra,Kandy,Kandy,Central,1686,2650,4336,67440,106000,173440
2/27/2025,Chanaka Mahendra,Kandy,Kandy,Central,6360,1021,7381,254400,40840,295240
2/28/2025,Chanaka Mahendra,Kandy,Kandy,Central,3409,6745,10154,136360,269800,406160
3/1/2025,Chanaka Mahendra,Kandy,Kandy,Central,2156,1560,3716,86240,62400,148640
3/2/2025,Chanaka Mahendra,Kandy,Kandy,Central,2087,4813,6900,83480,192520,276000
3/3/2025,Chanaka Mahendra,Kandy,Kandy,Central,2081,5900,7981,83240,236000,319240
3/4/2025,Chanaka Mahendra,Kandy,Kandy,Central,4088,3665,7753,163520,146600,310120
3/5/2025,Chanaka Mahendra,Kandy,Kandy,Central,2754,6481,9235,110160,259240,369400
3/6/2025,Chanaka Mahendra,Kandy,Kandy,Central,7763,8025,15788,310520,321000,631520
3/7/2025,Chanaka Mahendra,Kandy,Kandy,Central,5638,239,5877,225520,9560,235080
3/8/2025,Chanaka Mahendra,Kandy,Kandy,Central,696,7216,7912,27840,288640,316480
3/9/2025,Chanaka Mahendra,Kandy,Kandy,Central,1596,3304,4900,63840,132160,196000
3/10/2025,Chanaka Mahendra,Kandy,Kandy,Central,7045,2330,9375,281800,93200,375000
3/11/2025,Chanaka Mahendra,Kandy,Kandy,Central,6534,6081,12615,261360,243240,504600
3/12/2025,Chanaka Mahendra,Kandy,Kandy,Central,5968,3989,9957,238720,159560,398280
3/13/2025,Chanaka Mahendra,Kandy,Kandy,Central,7145,3132,10277,285800,125280,411080
3/14/2025,Chanaka Mahendra,Kandy,Kandy,Central,8968,4808,13776,358720,192320,551040
3/15/2025,Chanaka Mahendra,Kandy,Kandy,Central,8851,7489,16340,354040,299560,653600
3/16/2025,Chanaka Mahendra,Kandy,Kandy,Central,5592,776,6368,223680,31040,254720
3/17/2025,Chanaka Mahendra,Kandy,Kandy,Central,1750,2371,4121,70000,94840,164840
3/18/2025,Chanaka Mahendra,Kandy,Kandy,Central,6136,9857,15993,245440,394280,639720
3/19/2025,Chanaka Mahendra,Kandy,Kandy,Central,7354,3578,10932,294160,143120,437280
3/20/2025,Chanaka Mahendra,Kandy,Kandy,Central,7656,8232,15888,306240,329280,635520
3/21/2025,Chanaka Mahendra,Kandy,Kandy,Central,6449,3513,9962,257960,140520,398480
3/22/2025,Chanaka Mahendra,Kandy,Kandy,Central,6933,6865,13798,277320,274600,551920
3/23/2025,Chanaka Mahendra,Kandy,Kandy,Central,9314,5915,15229,372560,236600,609160
3/25/2024,Ravindu Abeyratne,Kurunegala,Melsiripura,North Western,1395,9982,11377,55800,399280,455080
3/26/2024,Ravindu Abeyratne,Kurunegala,Melsiripura,North Western,6770,6704,13474,270800,268160,538960
3/27/2024,Ravindu Abeyratne,Kurunegala,Melsiripura,North Western,4342,9169,13511,173680,366760,540440
3/28/2024,Ravindu Abeyratne,Kurunegala,Melsiripura,North Western,5770,8668,14438,230800,346720,577520
3/29/2024,Ravindu Abeyratne,Kurunegala,Melsiripura,North Western,1573,3124,4697,62920,124960,187880
3/30/2024,Ravindu Abeyratne,Kurunegala,Melsiripura,North Western,209,7759,7968,8360,310360,318720
3/31/2024,Ravindu Abeyratne,Kurunegala,Melsiripura,North Western,7961,7355,15316,318440,294200,612640
4/1/2024,Ravindu Abeyratne,Kurunegala,Melsiripura,North Western,9685,3146,12831,387400,125840,513240
4/2/2024,Ravindu Abeyratne,Kurunegala,Melsiripura,North Western,9595,4534,14129,383800,181360,565160
4/3/2024,Ravindu Abeyratne,Kurunegala,Melsiripura,North Western,341,8306,8647,13640,332240,345880
4/4/2024,Ravindu Abeyratne,Kurunegala,Melsiripura,North Western,2943,9930,12873,117720,397200,514920
4/5/2024,Ravindu Abeyratne,Kurunegala,Melsiripura,North Western,6837,6781,13618,273480,271240,544720
4/6/2024,Ravindu Abeyratne,Kurunegala,Melsiripura,North Western,4290,6009,10299,171600,240360,411960
4/7/2024,Ravindu Abeyratne,Kurunegala,Melsiripura,North Western,3277,7220,10497,131080,288800,419880
4/8/2024,Ravindu Abeyratne,Kurunegala,Melsiripura,North Western,1707,459,2166,68280,18360,86640
4/9/2024,Ravindu Abeyratne,Kurunegala,Melsiripura,North Western,2089,6407,8496,83560,256280,339840
4/10/2024,Ravindu Abeyratne,Kurunegala,Melsiripura,North Western,8,1398,1406,320,55920,56240
4/11/2024,Ravindu Abeyratne,Kurunegala,Melsiripura,North Western,226,5663,5889,9040,226520,235560
4/19/2024,Ravindu Abeyratne,Kurunegala,Melsiripura,North Western,2229,6090,8319,89160,243600,332760
4/20/2024,Ravindu Abeyratne,Kurunegala,Melsiripura,North Western,1879,9724,11603,75160,388960,464120
4/21/2024,Ravindu Abeyratne,Kurunegala,Melsiripura,North Western,2218,1510,3728,88720,60400,149120
4/22/2024,Ravindu Abeyratne,Kurunegala,Melsiripura,North Western,7501,5927,13428,300040,237080,537120
4/23/2024,Ravindu Abeyratne,Kurunegala,Melsiripura,North Western,4859,9827,14686,194360,393080,587440
4/24/2024,Ravindu Abeyratne,Kurunegala,Melsiripura,North Western,8313,7618,15931,332520,304720,637240
4/25/2024,Ravindu Abeyratne,Kurunegala,Melsiripura,North Western,5166,6306,11472,206640,252240,458880
4/26/2024,Ravindu Abeyratne,Kurunegala,Melsiripura,North Western,5490,6043,11533,219600,241720,461320
4/27/2024,Ravindu Abeyratne,Kurunegala,Melsiripura,North Western,4022,3854,7876,160880,154160,315040
4/28/2024,Ravindu Abeyratne,Kurunegala,Melsiripura,North Western,8087,7770,15857,323480,310800,634280
4/29/2024,Ravindu Abeyratne,Kurunegala,Melsiripura,North Western,9671,3333,13004,386840,133320,520160
4/30/2024,Ravindu Abeyratne,Kurunegala,Melsiripura,North Western,1670,5822,7492,66800,232880,299680
5/1/2024,Ravindu Abeyratne,Kurunegala,Melsiripura,North Western,2992,8859,11851,119680,354360,474040
5/2/2024,Ravindu Abeyratne,Kurunegala,Melsiripura,North Western,4106,416,4522,164240,16640,180880
5/3/2024,Ravindu Abeyratne,Kurunegala,Melsiripura,North Western,9040,3769,12809,361600,150760,512360
5/4/2024,Ravindu Abeyratne,Kurunegala,Melsiripura,North Western,3865,7886,11751,154600,315440,470040
5/5/2024,Ravindu Abeyratne,Kurunegala,Melsiripura,North Western,4969,8922,13891,198760,356880,555640
5/6/2024,Ravindu Abeyratne,Kurunegala,Melsiripura,North Western,8760,6983,15743,350400,279320,629720
5/7/2024,Ravindu Abeyratne,Kurunegala,Melsiripura,North Western,3518,1836,5354,140720,73440,214160
5/8/2024,Ravindu Abeyratne,Kurunegala,Melsiripura,North Western,6063,7524,13587,242520,300960,543480
5/9/2024,Ravindu Abeyratne,Kurunegala,Melsiripura,North Western,720,2673,3393,28800,106920,135720
5/10/2024,Ravindu Abeyratne,Kurunegala,Melsiripura,North Western,9341,8621,17962,373640,344840,718480
5/11/2024,Ravindu Abeyratne,Kurunegala,Melsiripura,North Western,7332,938,8270,293280,37520,330800
5/12/2024,Ravindu Abeyratne,Kurunegala,Melsiripura,North Western,5176,8642,13818,207040,345680,552720
5/13/2024,Ravindu Abeyratne,Kurunegala,Melsiripura,North Western,7620,4560,12180,304800,182400,487200
5/14/2024,Ravindu Abeyratne,Kurunegala,Melsiripura,North Western,7883,7153,15036,315320,286120,601440
5/15/2024,Ravindu Abeyratne,Kurunegala,Melsiripura,North Western,1591,8336,9927,63640,333440,397080
5/16/2024,Ravindu Abeyratne,Kurunegala,Melsiripura,North Western,9567,6796,16363,382680,271840,654520
5/17/2024,Ravindu Abeyratne,Kurunegala,Melsiripura,North Western,6647,1005,7652,265880,40200,306080
5/18/2024,Ravindu Abeyratne,Kurunegala,Melsiripura,North Western,489,2658,3147,19560,106320,125880
5/19/2024,Ravindu Abeyratne,Kurunegala,Melsiripura,North Western,1651,1351,3002,66040,54040,120080
5/20/2024,Ravindu Abeyratne,Kurunegala,Melsiripura,North Western,9258,7713,16971,370320,308520,678840
5/21/2024,Ravindu Abeyratne,Kurunegala,Melsiripura,North Western,2566,8462,11028,102640,338480,441120
5/22/2024,Ravindu Abeyratne,Kurunegala,Melsiripura,North Western,7385,7305,14690,295400,292200,587600
5/24/2024,Ravindu Abeyratne,Kurunegala,Melsiripura,North Western,6243,6601,12844,249720,264040,513760
5/25/2024,Ravindu Abeyratne,Kurunegala,Melsiripura,North Western,55,3194,3249,2200,127760,129960
5/26/2024,Ravindu Abeyratne,Kurunegala,Melsiripura,North Western,3150,2439,5589,126000,97560,223560
5/27/2024,Ravindu Abeyratne,Kurunegala,Melsiripura,North Western,5291,2740,8031,211640,109600,321240
5/28/2024,Ravindu Abeyratne,Kurunegala,Melsiripura,North Western,7225,8513,15738,289000,340520,629520
5/29/2024,Ravindu Abeyratne,Kurunegala,Melsiripura,North Western,6867,679,7546,274680,27160,301840
5/30/2024,Ravindu Abeyratne,Kurunegala,Melsiripura,North Western,7025,331,7356,281000,13240,294240
5/31/2024,Ravindu Abeyratne,Kurunegala,Melsiripura,North Western,4848,8230,13078,193920,329200,523120
6/1/2024,Ravindu Abeyratne,Kurunegala,Melsiripura,North Western,5623,5992,11615,224920,239680,464600
6/2/2024,Ravindu Abeyratne,Kurunegala,Melsiripura,North Western,4321,1125,5446,172840,45000,217840
6/3/2024,Ravindu Abeyratne,Kurunegala,Melsiripura,North Western,2619,3644,6263,104760,145760,250520
6/4/2024,Ravindu Abeyratne,Kurunegala,Melsiripura,North Western,4669,2992,7661,186760,119680,306440
6/5/2024,Ravindu Abeyratne,Kurunegala,Melsiripura,North Western,2612,3560,6172,104480,142400,246880
6/6/2024,Ravindu Abeyratne,Kurunegala,Melsiripura,North Western,8198,9844,18042,327920,393760,721680
6/7/2024,Ravindu Abeyratne,Kurunegala,Melsiripura,North Western,8200,7493,15693,328000,299720,627720
6/8/2024,Ravindu Abeyratne,Kurunegala,Melsiripura,North Western,9149,8034,17183,365960,321360,687320
6/9/2024,Ravindu Abeyratne,Kurunegala,Melsiripura,North Western,5558,274,5832,222320,10960,233280
6/10/2024,Ravindu Abeyratne,Kurunegala,Melsiripura,North Western,7390,2656,10046,295600,106240,401840
6/11/2024,Ravindu Abeyratne,Kurunegala,Melsiripura,North Western,6839,2550,9389,273560,102000,375560
6/12/2024,Ravindu Abeyratne,Kurunegala,Melsiripura,North Western,5971,518,6489,238840,20720,259560
6/13/2024,Ravindu Abeyratne,Kurunegala,Melsiripura,North Western,2142,8606,10748,85680,344240,429920
6/14/2024,Ravindu Abeyratne,Kurunegala,Melsiripura,North Western,3326,3782,7108,133040,151280,284320
6/15/2024,Ravindu Abeyratne,Kurunegala,Melsiripura,North Western,6961,3802,10763,278440,152080,430520
6/16/2024,Ravindu Abeyratne,Kurunegala,Melsiripura,North Western,2610,9831,12441,104400,393240,497640
6/17/2024,Ravindu Abeyratne,Kurunegala,Melsiripura,North Western,3131,3606,6737,125240,144240,269480
6/18/2024,Ravindu Abeyratne,Kurunegala,Melsiripura,North Western,2622,7179,9801,104880,287160,392040
6/19/2024,Ravindu Abeyratne,Kurunegala,Melsiripura,North Western,9116,7618,16734,364640,304720,669360
6/20/2024,Ravindu Abeyratne,Kurunegala,Melsiripura,North Western,3561,7464,11025,142440,298560,441000
6/21/2024,Ravindu Abeyratne,Kurunegala,Melsiripura,North Western,8046,8193,16239,321840,327720,649560
6/22/2024,Ravindu Abeyratne,Kurunegala,Melsiripura,North Western,8125,7203,15328,325000,288120,613120
6/23/2024,Ravindu Abeyratne,Kurunegala,Melsiripura,North Western,2239,5279,7518,89560,211160,300720
6/24/2024,Ravindu Abeyratne,Kurunegala,Melsiripura,North Western,9386,9960,19346,375440,398400,773840
6/25/2024,Ravindu Abeyratne,Kurunegala,Melsiripura,North Western,4938,4008,8946,197520,160320,357840
6/26/2024,Ravindu Abeyratne,Kurunegala,Melsiripura,North Western,3438,3964,7402,137520,158560,296080
6/27/2024,Ravindu Abeyratne,Kurunegala,Melsiripura,North Western,5830,9661,15491,233200,386440,619640
6/28/2024,Ravindu Abeyratne,Kurunegala,Melsiripura,North Western,8721,5416,14137,348840,216640,565480
6/29/2024,Ravindu Abeyratne,Kurunegala,Melsiripura,North Western,4814,5347,10161,192560,213880,406440
6/30/2024,Ravindu Abeyratne,Kurunegala,Melsiripura,North Western,7027,8181,15208,281080,327240,608320
7/1/2024,Ravindu Abeyratne,Kurunegala,Melsiripura,North Western,7014,1925,8939,280560,77000,357560
7/2/2024,Ravindu Abeyratne,Kurunegala,Melsiripura,North Western,8057,605,8662,322280,24200,346480
7/3/2024,Ravindu Abeyratne,Kurunegala,Melsiripura,North Western,349,9374,9723,13960,374960,388920
7/4/2024,Ravindu Abeyratne,Kurunegala,Melsiripura,North Western,2160,3516,5676,86400,140640,227040
7/5/2024,Ravindu Abeyratne,Kurunegala,Melsiripura,North Western,1611,1000,2611,64440,40000,104440
7/6/2024,Ravindu Abeyratne,Kurunegala,Melsiripura,North Western,7659,3402,11061,306360,136080,442440
7/7/2024,Ravindu Abeyratne,Kurunegala,Melsiripura,North Western,5158,6715,11873,206320,268600,474920
7/8/2024,Ravindu Abeyratne,Kurunegala,Melsiripura,North Western,4985,8172,13157,199400,326880,526280
7/9/2024,Ravindu Abeyratne,Kurunegala,Melsiripura,North Western,3619,6862,10481,144760,274480,419240
7/10/2024,Ravindu Abeyratne,Kurunegala,Melsiripura,North Western,4963,6230,11193,198520,249200,447720
7/11/2024,Ravindu Abeyratne,Kurunegala,Melsiripura,North Western,3295,9611,12906,131800,384440,516240
7/12/2024,Ravindu Abeyratne,Kurunegala,Melsiripura,North Western,9025,9698,18723,361000,387920,748920
7/13/2024,Ravindu Abeyratne,Kurunegala,Melsiripura,North Western,3963,2968,6931,158520,118720,277240
7/14/2024,Ravindu Abeyratne,Kurunegala,Melsiripura,North Western,2686,265,2951,107440,10600,118040
7/15/2024,Ravindu Abeyratne,Kurunegala,Melsiripura,North Western,4247,142,4389,169880,5680,175560
7/16/2024,Ravindu Abeyratne,Kurunegala,Melsiripura,North Western,3549,4889,8438,141960,195560,337520
7/17/2024,Ravindu Abeyratne,Kurunegala,Melsiripura,North Western,7624,6445,14069,304960,257800,562760
7/18/2024,Ravindu Abeyratne,Kurunegala,Melsiripura,North Western,3248,5569,8817,129920,222760,352680
7/19/2024,Ravindu Abeyratne,Kurunegala,Melsiripura,North Western,1917,5479,7396,76680,219160,295840
7/20/2024,Ravindu Abeyratne,Kurunegala,Melsiripura,North Western,1541,6029,7570,61640,241160,302800
7/21/2024,Ravindu Abeyratne,Kurunegala,Melsiripura,North Western,9542,1766,11308,381680,70640,452320
7/22/2024,Ravindu Abeyratne,Kurunegala,Melsiripura,North Western,4723,3671,8394,188920,146840,335760
7/23/2024,Ravindu Abeyratne,Kurunegala,Melsiripura,North Western,5009,7068,12077,200360,282720,483080
7/24/2024,Ravindu Abeyratne,Kurunegala,Melsiripura,North Western,7611,6874,14485,304440,274960,579400
7/25/2024,Ravindu Abeyratne,Kurunegala,Melsiripura,North Western,5768,6059,11827,230720,242360,473080
7/26/2024,Ravindu Abeyratne,Kurunegala,Melsiripura,North Western,4169,3397,7566,166760,135880,302640
7/27/2024,Ravindu Abeyratne,Kurunegala,Melsiripura,North Western,1401,1700,3101,56040,68000,124040
7/28/2024,Ravindu Abeyratne,Kurunegala,Melsiripura,North Western,5741,9518,15259,229640,380720,610360
7/29/2024,Ravindu Abeyratne,Kurunegala,Melsiripura,North Western,2204,492,2696,88160,19680,107840
7/30/2024,Ravindu Abeyratne,Kurunegala,Melsiripura,North Western,9967,5527,15494,398680,221080,619760
7/31/2024,Ravindu Abeyratne,Kurunegala,Melsiripura,North Western,814,6131,6945,32560,245240,277800
8/1/2024,Ravindu Abeyratne,Kurunegala,Melsiripura,North Western,7136,8411,15547,285440,336440,621880
8/2/2024,Ravindu Abeyratne,Kurunegala,Melsiripura,North Western,2111,6730,8841,84440,269200,353640
8/3/2024,Ravindu Abeyratne,Kurunegala,Melsiripura,North Western,165,563,728,6600,22520,29120
8/4/2024,Ravindu Abeyratne,Kurunegala,Melsiripura,North Western,6349,7886,14235,253960,315440,569400
8/5/2024,Ravindu Abeyratne,Kurunegala,Melsiripura,North Western,718,7312,8030,28720,292480,321200
8/6/2024,Ravindu Abeyratne,Kurunegala,Melsiripura,North Western,9409,4476,13885,376360,179040,555400
8/7/2024,Ravindu Abeyratne,Kurunegala,Melsiripura,North Western,8644,365,9009,345760,14600,360360
8/8/2024,Ravindu Abeyratne,Kurunegala,Melsiripura,North Western,3267,5192,8459,130680,207680,338360
8/9/2024,Ravindu Abeyratne,Kurunegala,Melsiripura,North Western,4980,9963,14943,199200,398520,597720
8/10/2024,Ravindu Abeyratne,Kurunegala,Melsiripura,North Western,5083,5067,10150,203320,202680,406000
8/11/2024,Ravindu Abeyratne,Kurunegala,Melsiripura,North Western,8428,460,8888,337120,18400,355520
8/12/2024,Ravindu Abeyratne,Kurunegala,Melsiripura,North Western,6399,4755,11154,255960,190200,446160
8/13/2024,Ravindu Abeyratne,Kurunegala,Melsiripura,North Western,6685,5159,11844,267400,206360,473760
8/14/2024,Ravindu Abeyratne,Kurunegala,Melsiripura,North Western,6527,8823,15350,261080,352920,614000
8/15/2024,Ravindu Abeyratne,Kurunegala,Melsiripura,North Western,8001,2703,10704,320040,108120,428160
8/16/2024,Ravindu Abeyratne,Kurunegala,Melsiripura,North Western,136,5441,5577,5440,217640,223080
8/17/2024,Ravindu Abeyratne,Kurunegala,Melsiripura,North Western,9219,8048,17267,368760,321920,690680
8/18/2024,Ravindu Abeyratne,Kurunegala,Melsiripura,North Western,8279,169,8448,331160,6760,337920
8/19/2024,Ravindu Abeyratne,Kurunegala,Melsiripura,North Western,604,2419,3023,24160,96760,120920
8/20/2024,Ravindu Abeyratne,Kurunegala,Melsiripura,North Western,6225,4747,10972,249000,189880,438880
8/21/2024,Ravindu Abeyratne,Kurunegala,Melsiripura,North Western,1515,7149,8664,60600,285960,346560
8/22/2024,Ravindu Abeyratne,Kurunegala,Melsiripura,North Western,9340,5229,14569,373600,209160,582760
8/23/2024,Ravindu Abeyratne,Kurunegala,Melsiripura,North Western,1353,3123,4476,54120,124920,179040
8/24/2024,Ravindu Abeyratne,Kurunegala,Melsiripura,North Western,5496,8449,13945,219840,337960,557800
8/25/2024,Ravindu Abeyratne,Kurunegala,Melsiripura,North Western,3693,9955,13648,147720,398200,545920
8/26/2024,Ravindu Abeyratne,Kurunegala,Melsiripura,North Western,4471,4578,9049,178840,183120,361960
8/27/2024,Ravindu Abeyratne,Kurunegala,Melsiripura,North Western,1011,6444,7455,40440,257760,298200
8/28/2024,Ravindu Abeyratne,Kurunegala,Melsiripura,North Western,9693,2672,12365,387720,106880,494600
8/29/2024,Ravindu Abeyratne,Kurunegala,Melsiripura,North Western,9434,7332,16766,377360,293280,670640
8/30/2024,Ravindu Abeyratne,Kurunegala,Melsiripura,North Western,3194,1815,5009,127760,72600,200360
8/31/2024,Ravindu Abeyratne,Kurunegala,Melsiripura,North Western,380,5125,5505,15200,205000,220200
9/1/2024,Ravindu Abeyratne,Kurunegala,Melsiripura,North Western,278,5110,5388,11120,204400,215520
9/2/2024,Ravindu Abeyratne,Kurunegala,Melsiripura,North Western,8707,1400,10107,348280,56000,404280
9/3/2024,Ravindu Abeyratne,Kurunegala,Melsiripura,North Western,2918,482,3400,116720,19280,136000
9/4/2024,Ravindu Abeyratne,Kurunegala,Melsiripura,North Western,8156,2192,10348,326240,87680,413920
9/5/2024,Ravindu Abeyratne,Kurunegala,Melsiripura,North Western,9180,1904,11084,367200,76160,443360
9/6/2024,Ravindu Abeyratne,Kurunegala,Melsiripura,North Western,4145,2725,6870,165800,109000,274800
9/7/2024,Ravindu Abeyratne,Kurunegala,Melsiripura,North Western,9879,6946,16825,395160,277840,673000
9/8/2024,Ravindu Abeyratne,Kurunegala,Melsiripura,North Western,8526,8056,16582,341040,322240,663280
9/9/2024,Ravindu Abeyratne,Kurunegala,Melsiripura,North Western,4528,3243,7771,181120,129720,310840
9/10/2024,Ravindu Abeyratne,Kurunegala,Melsiripura,North Western,975,9173,10148,39000,366920,405920
9/11/2024,Ravindu Abeyratne,Kurunegala,Melsiripura,North Western,1763,1255,3018,70520,50200,120720
9/12/2024,Ravindu Abeyratne,Kurunegala,Melsiripura,North Western,866,5479,6345,34640,219160,253800
9/13/2024,Ravindu Abeyratne,Kurunegala,Melsiripura,North Western,5489,6078,11567,219560,243120,462680
9/14/2024,Ravindu Abeyratne,Kurunegala,Melsiripura,North Western,4029,8849,12878,161160,353960,515120
9/15/2024,Ravindu Abeyratne,Kurunegala,Melsiripura,North Western,590,1381,1971,23600,55240,78840
9/16/2024,Ravindu Abeyratne,Kurunegala,Melsiripura,North Western,2293,1755,4048,91720,70200,161920
9/17/2024,Ravindu Abeyratne,Kurunegala,Melsiripura,North Western,3204,6799,10003,128160,271960,400120
9/18/2024,Ravindu Abeyratne,Kurunegala,Melsiripura,North Western,4642,1076,5718,185680,43040,228720
9/19/2024,Ravindu Abeyratne,Kurunegala,Melsiripura,North Western,6710,2616,9326,268400,104640,373040
9/20/2024,Ravindu Abeyratne,Kurunegala,Melsiripura,North Western,3749,8561,12310,149960,342440,492400
9/21/2024,Ravindu Abeyratne,Kurunegala,Melsiripura,North Western,8507,3998,12505,340280,159920,500200
9/22/2024,Ravindu Abeyratne,Kurunegala,Melsiripura,North Western,8923,9244,18167,356920,369760,726680
9/23/2024,Ravindu Abeyratne,Kurunegala,Melsiripura,North Western,5584,1786,7370,223360,71440,294800
9/24/2024,Ravindu Abeyratne,Kurunegala,Melsiripura,North Western,6084,2746,8830,243360,109840,353200
9/25/2024,Ravindu Abeyratne,Kurunegala,Melsiripura,North Western,1482,1440,2922,59280,57600,116880
9/26/2024,Ravindu Abeyratne,Kurunegala,Melsiripura,North Western,5150,2373,7523,206000,94920,300920
9/27/2024,Ravindu Abeyratne,Kurunegala,Melsiripura,North Western,7441,2016,9457,297640,80640,378280
9/28/2024,Ravindu Abeyratne,Kurunegala,Melsiripura,North Western,7818,7969,15787,312720,318760,631480
9/29/2024,Ravindu Abeyratne,Kurunegala,Melsiripura,North Western,6359,1883,8242,254360,75320,329680
9/30/2024,Ravindu Abeyratne,Kurunegala,Melsiripura,North Western,8957,929,9886,358280,37160,395440
10/1/2024,Ravindu Abeyratne,Kurunegala,Melsiripura,North Western,5673,3008,8681,226920,120320,347240
10/2/2024,Ravindu Abeyratne,Kurunegala,Melsiripura,North Western,1117,6188,7305,44680,247520,292200
10/3/2024,Ravindu Abeyratne,Kurunegala,Melsiripura,North Western,8906,1787,10693,356240,71480,427720
10/4/2024,Ravindu Abeyratne,Kurunegala,Melsiripura,North Western,5902,9725,15627,236080,389000,625080
10/5/2024,Ravindu Abeyratne,Kurunegala,Melsiripura,North Western,3648,7912,11560,145920,316480,462400
10/6/2024,Ravindu Abeyratne,Kurunegala,Melsiripura,North Western,5851,5543,11394,234040,221720,455760
10/7/2024,Ravindu Abeyratne,Kurunegala,Melsiripura,North Western,685,7782,8467,27400,311280,338680
10/8/2024,Ravindu Abeyratne,Kurunegala,Melsiripura,North Western,2507,7339,9846,100280,293560,393840
10/9/2024,Ravindu Abeyratne,Kurunegala,Melsiripura,North Western,2420,7499,9919,96800,299960,396760
10/10/2024,Ravindu Abeyratne,Kurunegala,Melsiripura,North Western,7810,4010,11820,312400,160400,472800
10/11/2024,Ravindu Abeyratne,Kurunegala,Melsiripura,North Western,1757,7372,9129,70280,294880,365160
10/12/2024,Ravindu Abeyratne,Kurunegala,Melsiripura,North Western,892,4235,5127,35680,169400,205080
10/13/2024,Ravindu Abeyratne,Kurunegala,Melsiripura,North Western,1899,6460,8359,75960,258400,334360
10/14/2024,Ravindu Abeyratne,Kurunegala,Melsiripura,North Western,585,3601,4186,23400,144040,167440
10/15/2024,Ravindu Abeyratne,Kurunegala,Melsiripura,North Western,1133,1826,2959,45320,73040,118360
10/16/2024,Ravindu Abeyratne,Kurunegala,Melsiripura,North Western,3669,9849,13518,146760,393960,540720
10/17/2024,Ravindu Abeyratne,Kurunegala,Melsiripura,North Western,2554,2663,5217,102160,106520,208680
10/18/2024,Ravindu Abeyratne,Kurunegala,Melsiripura,North Western,3997,7008,11005,159880,280320,440200
10/19/2024,Ravindu Abeyratne,Kurunegala,Melsiripura,North Western,1196,7220,8416,47840,288800,336640
10/20/2024,Ravindu Abeyratne,Kurunegala,Melsiripura,North Western,5885,786,6671,235400,31440,266840
10/21/2024,Ravindu Abeyratne,Kurunegala,Melsiripura,North Western,9564,9867,19431,382560,394680,777240
10/22/2024,Ravindu Abeyratne,Kurunegala,Melsiripura,North Western,8010,1293,9303,320400,51720,372120
10/23/2024,Ravindu Abeyratne,Kurunegala,Melsiripura,North Western,9827,3637,13464,393080,145480,538560
10/24/2024,Ravindu Abeyratne,Kurunegala,Melsiripura,North Western,5054,2020,7074,202160,80800,282960
10/25/2024,Ravindu Abeyratne,Kurunegala,Melsiripura,North Western,7859,6251,14110,314360,250040,564400
10/26/2024,Ravindu Abeyratne,Kurunegala,Melsiripura,North Western,7032,6099,13131,281280,243960,525240
10/27/2024,Ravindu Abeyratne,Kurunegala,Melsiripura,North Western,5378,7590,12968,215120,303600,518720
10/28/2024,Ravindu Abeyratne,Kurunegala,Melsiripura,North Western,4988,4601,9589,199520,184040,383560
10/29/2024,Ravindu Abeyratne,Kurunegala,Melsiripura,North Western,6193,4193,10386,247720,167720,415440
10/30/2024,Ravindu Abeyratne,Kurunegala,Melsiripura,North Western,2871,128,2999,114840,5120,119960
10/31/2024,Ravindu Abeyratne,Kurunegala,Melsiripura,North Western,9278,3692,12970,371120,147680,518800
11/1/2024,Ravindu Abeyratne,Kurunegala,Melsiripura,North Western,3375,9441,12816,135000,377640,512640
11/2/2024,Ravindu Abeyratne,Kurunegala,Melsiripura,North Western,7210,5884,13094,288400,235360,523760
11/3/2024,Ravindu Abeyratne,Kurunegala,Melsiripura,North Western,9655,367,10022,386200,14680,400880
11/4/2024,Ravindu Abeyratne,Kurunegala,Melsiripura,North Western,2585,8651,11236,103400,346040,449440
11/5/2024,Ravindu Abeyratne,Kurunegala,Melsiripura,North Western,4560,7866,12426,182400,314640,497040
11/6/2024,Ravindu Abeyratne,Kurunegala,Melsiripura,North Western,2025,8196,10221,81000,327840,408840
11/7/2024,Ravindu Abeyratne,Kurunegala,Melsiripura,North Western,9229,3812,13041,369160,152480,521640
11/8/2024,Ravindu Abeyratne,Kurunegala,Melsiripura,North Western,6236,4997,11233,249440,199880,449320
11/9/2024,Ravindu Abeyratne,Kurunegala,Melsiripura,North Western,7627,8611,16238,305080,344440,649520
11/10/2024,Ravindu Abeyratne,Kurunegala,Melsiripura,North Western,1185,3149,4334,47400,125960,173360
11/11/2024,Ravindu Abeyratne,Kurunegala,Melsiripura,North Western,1789,6875,8664,71560,275000,346560
11/12/2024,Ravindu Abeyratne,Kurunegala,Melsiripura,North Western,8094,4611,12705,323760,184440,508200
11/13/2024,Ravindu Abeyratne,Kurunegala,Melsiripura,North Western,8661,9296,17957,346440,371840,718280
11/14/2024,Ravindu Abeyratne,Kurunegala,Melsiripura,North Western,4172,1217,5389,166880,48680,215560
11/15/2024,Ravindu Abeyratne,Kurunegala,Melsiripura,North Western,225,6703,6928,9000,268120,277120
11/16/2024,Ravindu Abeyratne,Kurunegala,Melsiripura,North Western,6266,9868,16134,250640,394720,645360
11/17/2024,Ravindu Abeyratne,Kurunegala,Melsiripura,North Western,3773,8676,12449,150920,347040,497960
11/18/2024,Ravindu Abeyratne,Kurunegala,Melsiripura,North Western,6015,6666,12681,240600,266640,507240
11/19/2024,Ravindu Abeyratne,Kurunegala,Melsiripura,North Western,7939,8299,16238,317560,331960,649520
11/20/2024,Ravindu Abeyratne,Kurunegala,Melsiripura,North Western,8242,3591,11833,329680,143640,473320
11/21/2024,Ravindu Abeyratne,Kurunegala,Melsiripura,North Western,5883,1360,7243,235320,54400,289720
11/22/2024,Ravindu Abeyratne,Kurunegala,Melsiripura,North Western,8853,6063,14916,354120,242520,596640
11/23/2024,Ravindu Abeyratne,Kurunegala,Melsiripura,North Western,770,506,1276,30800,20240,51040
11/24/2024,Ravindu Abeyratne,Kurunegala,Melsiripura,North Western,3514,470,3984,140560,18800,159360
11/25/2024,Ravindu Abeyratne,Kurunegala,Melsiripura,North Western,8831,6515,15346,353240,260600,613840
11/26/2024,Ravindu Abeyratne,Kurunegala,Melsiripura,North Western,8419,763,9182,336760,30520,367280
11/27/2024,Ravindu Abeyratne,Kurunegala,Melsiripura,North Western,8820,5637,14457,352800,225480,578280
11/28/2024,Ravindu Abeyratne,Kurunegala,Melsiripura,North Western,6904,5247,12151,276160,209880,486040
11/29/2024,Ravindu Abeyratne,Kurunegala,Melsiripura,North Western,9618,5081,14699,384720,203240,587960
11/30/2024,Ravindu Abeyratne,Kurunegala,Melsiripura,North Western,3977,13,3990,159080,520,159600
12/1/2024,Ravindu Abeyratne,Kurunegala,Melsiripura,North Western,5761,7744,13505,230440,309760,540200
12/2/2024,Ravindu Abeyratne,Kurunegala,Melsiripura,North Western,23,182,205,920,7280,8200
12/3/2024,Ravindu Abeyratne,Kurunegala,Melsiripura,North Western,9584,2304,11888,383360,92160,475520
12/4/2024,Ravindu Abeyratne,Kurunegala,Melsiripura,North Western,1259,395,1654,50360,15800,66160
12/5/2024,Ravindu Abeyratne,Kurunegala,Melsiripura,North Western,8374,5111,13485,334960,204440,539400
12/6/2024,Ravindu Abeyratne,Kurunegala,Melsiripura,North Western,8066,2893,10959,322640,115720,438360
12/7/2024,Ravindu Abeyratne,Kurunegala,Melsiripura,North Western,6715,8752,15467,268600,350080,618680
12/8/2024,Ravindu Abeyratne,Kurunegala,Melsiripura,North Western,8644,7658,16302,345760,306320,652080
12/9/2024,Ravindu Abeyratne,Kurunegala,Melsiripura,North Western,853,2158,3011,34120,86320,120440
12/10/2024,Ravindu Abeyratne,Kurunegala,Melsiripura,North Western,7541,6460,14001,301640,258400,560040
12/11/2024,Ravindu Abeyratne,Kurunegala,Melsiripura,North Western,9432,4405,13837,377280,176200,553480
12/12/2024,Ravindu Abeyratne,Kurunegala,Melsiripura,North Western,1290,5232,6522,51600,209280,260880
12/13/2024,Ravindu Abeyratne,Kurunegala,Melsiripura,North Western,5908,605,6513,236320,24200,260520
12/14/2024,Ravindu Abeyratne,Kurunegala,Melsiripura,North Western,4998,6888,11886,199920,275520,475440
12/15/2024,Ravindu Abeyratne,Kurunegala,Melsiripura,North Western,4825,212,5037,193000,8480,201480
12/16/2024,Ravindu Abeyratne,Kurunegala,Melsiripura,North Western,4182,7625,11807,167280,305000,472280
12/17/2024,Ravindu Abeyratne,Kurunegala,Melsiripura,North Western,8428,445,8873,337120,17800,354920
12/18/2024,Ravindu Abeyratne,Kurunegala,Melsiripura,North Western,6176,6840,13016,247040,273600,520640
12/19/2024,Ravindu Abeyratne,Kurunegala,Melsiripura,North Western,4890,1967,6857,195600,78680,274280
12/20/2024,Ravindu Abeyratne,Kurunegala,Melsiripura,North Western,5259,2208,7467,210360,88320,298680
12/21/2024,Ravindu Abeyratne,Kurunegala,Melsiripura,North Western,4397,31,4428,175880,1240,177120
12/22/2024,Ravindu Abeyratne,Kurunegala,Melsiripura,North Western,425,6719,7144,17000,268760,285760
12/23/2024,Ravindu Abeyratne,Kurunegala,Melsiripura,North Western,6824,469,7293,272960,18760,291720
12/24/2024,Ravindu Abeyratne,Kurunegala,Melsiripura,North Western,461,5977,6438,18440,239080,257520
12/25/2024,Ravindu Abeyratne,Kurunegala,Melsiripura,North Western,2425,1249,3674,97000,49960,146960
12/26/2024,Ravindu Abeyratne,Kurunegala,Melsiripura,North Western,7382,6683,14065,295280,267320,562600
12/27/2024,Ravindu Abeyratne,Kurunegala,Melsiripura,North Western,3358,8433,11791,134320,337320,471640
12/28/2024,Ravindu Abeyratne,Kurunegala,Melsiripura,North Western,8080,5414,13494,323200,216560,539760
12/29/2024,Ravindu Abeyratne,Kurunegala,Melsiripura,North Western,129,3255,3384,5160,130200,135360
12/30/2024,Ravindu Abeyratne,Kurunegala,Melsiripura,North Western,2724,5089,7813,108960,203560,312520
12/31/2024,Ravindu Abeyratne,Kurunegala,Melsiripura,North Western,8782,6120,14902,351280,244800,596080
1/1/2025,Ravindu Abeyratne,Kurunegala,Melsiripura,North Western,4438,2178,6616,177520,87120,264640
1/2/2025,Ravindu Abeyratne,Kurunegala,Melsiripura,North Western,4109,2326,6435,164360,93040,257400
1/3/2025,Ravindu Abeyratne,Kurunegala,Melsiripura,North Western,1550,9080,10630,62000,363200,425200
1/4/2025,Ravindu Abeyratne,Kurunegala,Melsiripura,North Western,3174,6028,9202,126960,241120,368080
1/5/2025,Ravindu Abeyratne,Kurunegala,Melsiripura,North Western,356,7403,7759,14240,296120,310360
1/6/2025,Ravindu Abeyratne,Kurunegala,Melsiripura,North Western,9398,2448,11846,375920,97920,473840
1/7/2025,Ravindu Abeyratne,Kurunegala,Melsiripura,North Western,5308,464,5772,212320,18560,230880
1/8/2025,Ravindu Abeyratne,Kurunegala,Melsiripura,North Western,7888,5256,13144,315520,210240,525760
1/9/2025,Ravindu Abeyratne,Kurunegala,Melsiripura,North Western,853,3398,4251,34120,135920,170040
1/10/2025,Ravindu Abeyratne,Kurunegala,Melsiripura,North Western,4027,8914,12941,161080,356560,517640
1/11/2025,Ravindu Abeyratne,Kurunegala,Melsiripura,North Western,9768,2745,12513,390720,109800,500520
1/12/2025,Ravindu Abeyratne,Kurunegala,Melsiripura,North Western,5339,6327,11666,213560,253080,466640
1/13/2025,Ravindu Abeyratne,Kurunegala,Melsiripura,North Western,9597,5861,15458,383880,234440,618320
1/14/2025,Ravindu Abeyratne,Kurunegala,Melsiripura,North Western,8398,926,9324,335920,37040,372960
1/15/2025,Ravindu Abeyratne,Kurunegala,Melsiripura,North Western,9039,8000,17039,361560,320000,681560
1/16/2025,Ravindu Abeyratne,Kurunegala,Melsiripura,North Western,4023,4826,8849,160920,193040,353960
1/17/2025,Ravindu Abeyratne,Kurunegala,Melsiripura,North Western,2407,3295,5702,96280,131800,228080
1/18/2025,Ravindu Abeyratne,Kurunegala,Melsiripura,North Western,3834,3690,7524,153360,147600,300960
1/19/2025,Ravindu Abeyratne,Kurunegala,Melsiripura,North Western,656,1366,2022,26240,54640,80880
1/20/2025,Ravindu Abeyratne,Kurunegala,Melsiripura,North Western,2089,5969,8058,83560,238760,322320
1/21/2025,Ravindu Abeyratne,Kurunegala,Melsiripura,North Western,9360,4975,14335,374400,199000,573400
1/22/2025,Ravindu Abeyratne,Kurunegala,Melsiripura,North Western,9659,4986,14645,386360,199440,585800
1/23/2025,Ravindu Abeyratne,Kurunegala,Melsiripura,North Western,2842,7543,10385,113680,301720,415400
1/24/2025,Ravindu Abeyratne,Kurunegala,Melsiripura,North Western,7511,6857,14368,300440,274280,574720
1/25/2025,Ravindu Abeyratne,Kurunegala,Melsiripura,North Western,5877,3922,9799,235080,156880,391960
1/26/2025,Ravindu Abeyratne,Kurunegala,Melsiripura,North Western,494,3777,4271,19760,151080,170840
1/27/2025,Ravindu Abeyratne,Kurunegala,Melsiripura,North Western,3562,2166,5728,142480,86640,229120
1/28/2025,Ravindu Abeyratne,Kurunegala,Melsiripura,North Western,8497,9364,17861,339880,374560,714440
1/29/2025,Ravindu Abeyratne,Kurunegala,Melsiripura,North Western,81,9169,9250,3240,366760,370000
1/30/2025,Ravindu Abeyratne,Kurunegala,Melsiripura,North Western,7910,2703,10613,316400,108120,424520
1/31/2025,Ravindu Abeyratne,Kurunegala,Melsiripura,North Western,8698,198,8896,347920,7920,355840
2/1/2025,Ravindu Abeyratne,Kurunegala,Melsiripura,North Western,125,9257,9382,5000,370280,375280
2/2/2025,Ravindu Abeyratne,Kurunegala,Melsiripura,North Western,8184,5371,13555,327360,214840,542200
2/3/2025,Ravindu Abeyratne,Kurunegala,Melsiripura,North Western,6411,3353,9764,256440,134120,390560
2/4/2025,Ravindu Abeyratne,Kurunegala,Melsiripura,North Western,4175,9927,14102,167000,397080,564080
2/5/2025,Ravindu Abeyratne,Kurunegala,Melsiripura,North Western,9070,5640,14710,362800,225600,588400
2/6/2025,Ravindu Abeyratne,Kurunegala,Melsiripura,North Western,842,35,877,33680,1400,35080
2/7/2025,Ravindu Abeyratne,Kurunegala,Melsiripura,North Western,6172,5213,11385,246880,208520,455400
2/8/2025,Ravindu Abeyratne,Kurunegala,Melsiripura,North Western,8457,469,8926,338280,18760,357040
2/9/2025,Ravindu Abeyratne,Kurunegala,Melsiripura,North Western,5516,8075,13591,220640,323000,543640
2/10/2025,Ravindu Abeyratne,Kurunegala,Melsiripura,North Western,75,121,196,3000,4840,7840
2/11/2025,Ravindu Abeyratne,Kurunegala,Melsiripura,North Western,5371,1244,6615,214840,49760,264600
2/12/2025,Ravindu Abeyratne,Kurunegala,Melsiripura,North Western,6143,9550,15693,245720,382000,627720
2/13/2025,Ravindu Abeyratne,Kurunegala,Melsiripura,North Western,6402,9919,16321,256080,396760,652840
2/14/2025,Ravindu Abeyratne,Kurunegala,Melsiripura,North Western,8673,4660,13333,346920,186400,533320
2/15/2025,Ravindu Abeyratne,Kurunegala,Melsiripura,North Western,6128,9486,15614,245120,379440,624560
2/16/2025,Ravindu Abeyratne,Kurunegala,Melsiripura,North Western,1389,4089,5478,55560,163560,219120
2/17/2025,Ravindu Abeyratne,Kurunegala,Melsiripura,North Western,8089,6775,14864,323560,271000,594560
2/18/2025,Ravindu Abeyratne,Kurunegala,Melsiripura,North Western,2706,7790,10496,108240,311600,419840
2/19/2025,Ravindu Abeyratne,Kurunegala,Melsiripura,North Western,6985,5569,12554,279400,222760,502160
2/20/2025,Ravindu Abeyratne,Kurunegala,Melsiripura,North Western,6275,205,6480,251000,8200,259200
2/21/2025,Ravindu Abeyratne,Kurunegala,Melsiripura,North Western,7948,8768,16716,317920,350720,668640
2/22/2025,Ravindu Abeyratne,Kurunegala,Melsiripura,North Western,8623,7117,15740,344920,284680,629600
2/23/2025,Ravindu Abeyratne,Kurunegala,Melsiripura,North Western,2561,7753,10314,102440,310120,412560
2/24/2025,Ravindu Abeyratne,Kurunegala,Melsiripura,North Western,727,239,966,29080,9560,38640
2/25/2025,Ravindu Abeyratne,Kurunegala,Melsiripura,North Western,1359,257,1616,54360,10280,64640
2/26/2025,Ravindu Abeyratne,Kurunegala,Melsiripura,North Western,8516,2229,10745,340640,89160,429800
2/27/2025,Ravindu Abeyratne,Kurunegala,Melsiripura,North Western,585,3480,4065,23400,139200,162600
2/28/2025,Ravindu Abeyratne,Kurunegala,Melsiripura,North Western,2461,2103,4564,98440,84120,182560
3/1/2025,Ravindu Abeyratne,Kurunegala,Melsiripura,North Western,7421,2031,9452,296840,81240,378080
3/2/2025,Ravindu Abeyratne,Kurunegala,Melsiripura,North Western,8298,7528,15826,331920,301120,633040
3/3/2025,Ravindu Abeyratne,Kurunegala,Melsiripura,North Western,1375,2561,3936,55000,102440,157440
3/4/2025,Ravindu Abeyratne,Kurunegala,Melsiripura,North Western,8099,14,8113,323960,560,324520
3/5/2025,Ravindu Abeyratne,Kurunegala,Melsiripura,North Western,5597,2321,7918,223880,92840,316720
3/6/2025,Ravindu Abeyratne,Kurunegala,Melsiripura,North Western,5041,4337,9378,201640,173480,375120
3/7/2025,Ravindu Abeyratne,Kurunegala,Melsiripura,North Western,3022,8010,11032,120880,320400,441280
3/8/2025,Ravindu Abeyratne,Kurunegala,Melsiripura,North Western,1798,9456,11254,71920,378240,450160
3/9/2025,Ravindu Abeyratne,Kurunegala,Melsiripura,North Western,1466,7412,8878,58640,296480,355120
3/10/2025,Ravindu Abeyratne,Kurunegala,Melsiripura,North Western,3861,7842,11703,154440,313680,468120
3/11/2025,Ravindu Abeyratne,Kurunegala,Melsiripura,North Western,3006,8198,11204,120240,327920,448160
3/12/2025,Ravindu Abeyratne,Kurunegala,Melsiripura,North Western,1312,5075,6387,52480,203000,255480
3/13/2025,Ravindu Abeyratne,Kurunegala,Melsiripura,North Western,7842,8775,16617,313680,351000,664680
3/14/2025,Ravindu Abeyratne,Kurunegala,Melsiripura,North Western,3956,3259,7215,158240,130360,288600
3/15/2025,Ravindu Abeyratne,Kurunegala,Melsiripura,North Western,2414,3156,5570,96560,126240,222800
3/16/2025,Ravindu Abeyratne,Kurunegala,Melsiripura,North Western,5492,8052,13544,219680,322080,541760
3/17/2025,Ravindu Abeyratne,Kurunegala,Melsiripura,North Western,1621,1888,3509,64840,75520,140360
3/18/2025,Ravindu Abeyratne,Kurunegala,Melsiripura,North Western,5273,9622,14895,210920,384880,595800
3/19/2025,Ravindu Abeyratne,Kurunegala,Melsiripura,North Western,9377,5066,14443,375080,202640,577720
3/20/2025,Ravindu Abeyratne,Kurunegala,Melsiripura,North Western,512,5256,5768,20480,210240,230720
3/21/2025,Ravindu Abeyratne,Kurunegala,Melsiripura,North Western,4527,5827,10354,181080,233080,414160
3/22/2025,Ravindu Abeyratne,Kurunegala,Melsiripura,North Western,9721,1839,11560,388840,73560,462400
3/23/2025,Ravindu Abeyratne,Kurunegala,Melsiripura,North Western,293,5100,5393,11720,204000,215720
3/25/2024,Hiruni Chandrasiri,Badulla,Ella,Uva,8287,7731,16018,331480,309240,640720
3/26/2024,Hiruni Chandrasiri,Badulla,Ella,Uva,1454,5605,7059,58160,224200,282360
3/27/2024,Hiruni Chandrasiri,Badulla,Ella,Uva,9007,202,9209,360280,8080,368360
3/28/2024,Hiruni Chandrasiri,Badulla,Ella,Uva,6989,2375,9364,279560,95000,374560
3/29/2024,Hiruni Chandrasiri,Badulla,Ella,Uva,942,5789,6731,37680,231560,269240
3/30/2024,Hiruni Chandrasiri,Badulla,Ella,Uva,1479,2189,3668,59160,87560,146720
3/31/2024,Hiruni Chandrasiri,Badulla,Ella,Uva,8538,8012,16550,341520,320480,662000
4/1/2024,Hiruni Chandrasiri,Badulla,Ella,Uva,6342,8613,14955,253680,344520,598200
4/2/2024,Hiruni Chandrasiri,Badulla,Ella,Uva,2030,7099,9129,81200,283960,365160
4/3/2024,Hiruni Chandrasiri,Badulla,Ella,Uva,9547,3958,13505,381880,158320,540200
4/4/2024,Hiruni Chandrasiri,Badulla,Ella,Uva,8274,1252,9526,330960,50080,381040
4/5/2024,Hiruni Chandrasiri,Badulla,Ella,Uva,8651,331,8982,346040,13240,359280
4/6/2024,Hiruni Chandrasiri,Badulla,Ella,Uva,4350,5212,9562,174000,208480,382480
4/7/2024,Hiruni Chandrasiri,Badulla,Ella,Uva,1030,1825,2855,41200,73000,114200
4/8/2024,Hiruni Chandrasiri,Badulla,Ella,Uva,5625,9654,15279,225000,386160,611160
4/9/2024,Hiruni Chandrasiri,Badulla,Ella,Uva,1486,6936,8422,59440,277440,336880
4/10/2024,Hiruni Chandrasiri,Badulla,Ella,Uva,6550,427,6977,262000,17080,279080
4/11/2024,Hiruni Chandrasiri,Badulla,Ella,Uva,7931,540,8471,317240,21600,338840
4/19/2024,Hiruni Chandrasiri,Badulla,Ella,Uva,878,7434,8312,35120,297360,332480
4/20/2024,Hiruni Chandrasiri,Badulla,Ella,Uva,5747,7880,13627,229880,315200,545080
4/21/2024,Hiruni Chandrasiri,Badulla,Ella,Uva,162,3256,3418,6480,130240,136720
4/22/2024,Hiruni Chandrasiri,Badulla,Ella,Uva,6469,6718,13187,258760,268720,527480
4/23/2024,Hiruni Chandrasiri,Badulla,Ella,Uva,1030,6948,7978,41200,277920,319120
4/24/2024,Hiruni Chandrasiri,Badulla,Ella,Uva,9692,7074,16766,387680,282960,670640
4/25/2024,Hiruni Chandrasiri,Badulla,Ella,Uva,1975,6577,8552,79000,263080,342080
4/26/2024,Hiruni Chandrasiri,Badulla,Ella,Uva,2372,150,2522,94880,6000,100880
4/27/2024,Hiruni Chandrasiri,Badulla,Ella,Uva,5487,4340,9827,219480,173600,393080
4/28/2024,Hiruni Chandrasiri,Badulla,Ella,Uva,57,591,648,2280,23640,25920
4/29/2024,Hiruni Chandrasiri,Badulla,Ella,Uva,2115,2035,4150,84600,81400,166000
4/30/2024,Hiruni Chandrasiri,Badulla,Ella,Uva,96,3994,4090,3840,159760,163600
5/1/2024,Hiruni Chandrasiri,Badulla,Ella,Uva,5747,2958,8705,229880,118320,348200
5/2/2024,Hiruni Chandrasiri,Badulla,Ella,Uva,2961,4690,7651,118440,187600,306040
5/3/2024,Hiruni Chandrasiri,Badulla,Ella,Uva,477,8311,8788,19080,332440,351520
5/4/2024,Hiruni Chandrasiri,Badulla,Ella,Uva,6447,6939,13386,257880,277560,535440
5/5/2024,Hiruni Chandrasiri,Badulla,Ella,Uva,8660,2504,11164,346400,100160,446560
5/6/2024,Hiruni Chandrasiri,Badulla,Ella,Uva,8275,2504,10779,331000,100160,431160
5/7/2024,Hiruni Chandrasiri,Badulla,Ella,Uva,2639,4771,7410,105560,190840,296400
5/8/2024,Hiruni Chandrasiri,Badulla,Ella,Uva,600,1900,2500,24000,76000,100000
5/9/2024,Hiruni Chandrasiri,Badulla,Ella,Uva,2349,29,2378,93960,1160,95120
5/10/2024,Hiruni Chandrasiri,Badulla,Ella,Uva,1215,8506,9721,48600,340240,388840
5/11/2024,Hiruni Chandrasiri,Badulla,Ella,Uva,2980,5649,8629,119200,225960,345160
5/12/2024,Hiruni Chandrasiri,Badulla,Ella,Uva,1932,9602,11534,77280,384080,461360
5/13/2024,Hiruni Chandrasiri,Badulla,Ella,Uva,4510,6331,10841,180400,253240,433640
5/14/2024,Hiruni Chandrasiri,Badulla,Ella,Uva,3019,2610,5629,120760,104400,225160
5/15/2024,Hiruni Chandrasiri,Badulla,Ella,Uva,7350,8297,15647,294000,331880,625880
5/16/2024,Hiruni Chandrasiri,Badulla,Ella,Uva,1969,4836,6805,78760,193440,272200
5/17/2024,Hiruni Chandrasiri,Badulla,Ella,Uva,9418,5239,14657,376720,209560,586280
5/18/2024,Hiruni Chandrasiri,Badulla,Ella,Uva,3529,1539,5068,141160,61560,202720
5/19/2024,Hiruni Chandrasiri,Badulla,Ella,Uva,5224,3457,8681,208960,138280,347240
5/20/2024,Hiruni Chandrasiri,Badulla,Ella,Uva,9823,4566,14389,392920,182640,575560
5/21/2024,Hiruni Chandrasiri,Badulla,Ella,Uva,8732,6228,14960,349280,249120,598400
5/22/2024,Hiruni Chandrasiri,Badulla,Ella,Uva,252,4958,5210,10080,198320,208400
5/24/2024,Hiruni Chandrasiri,Badulla,Ella,Uva,3280,5507,8787,131200,220280,351480
5/25/2024,Hiruni Chandrasiri,Badulla,Ella,Uva,3723,3164,6887,148920,126560,275480
5/26/2024,Hiruni Chandrasiri,Badulla,Ella,Uva,2277,6775,9052,91080,271000,362080
5/27/2024,Hiruni Chandrasiri,Badulla,Ella,Uva,3378,335,3713,135120,13400,148520
5/28/2024,Hiruni Chandrasiri,Badulla,Ella,Uva,3396,7254,10650,135840,290160,426000
5/29/2024,Hiruni Chandrasiri,Badulla,Ella,Uva,1101,3271,4372,44040,130840,174880
5/30/2024,Hiruni Chandrasiri,Badulla,Ella,Uva,1823,283,2106,72920,11320,84240
5/31/2024,Hiruni Chandrasiri,Badulla,Ella,Uva,1701,3166,4867,68040,126640,194680
6/1/2024,Hiruni Chandrasiri,Badulla,Ella,Uva,8104,8536,16640,324160,341440,665600
6/2/2024,Hiruni Chandrasiri,Badulla,Ella,Uva,6258,9481,15739,250320,379240,629560
6/3/2024,Hiruni Chandrasiri,Badulla,Ella,Uva,6151,5171,11322,246040,206840,452880
6/4/2024,Hiruni Chandrasiri,Badulla,Ella,Uva,9695,5088,14783,387800,203520,591320
6/5/2024,Hiruni Chandrasiri,Badulla,Ella,Uva,6942,4930,11872,277680,197200,474880
6/6/2024,Hiruni Chandrasiri,Badulla,Ella,Uva,1820,9007,10827,72800,360280,433080
6/7/2024,Hiruni Chandrasiri,Badulla,Ella,Uva,4575,387,4962,183000,15480,198480
6/8/2024,Hiruni Chandrasiri,Badulla,Ella,Uva,6241,6948,13189,249640,277920,527560
6/9/2024,Hiruni Chandrasiri,Badulla,Ella,Uva,2432,5076,7508,97280,203040,300320
6/10/2024,Hiruni Chandrasiri,Badulla,Ella,Uva,6297,8085,14382,251880,323400,575280
6/11/2024,Hiruni Chandrasiri,Badulla,Ella,Uva,4875,5707,10582,195000,228280,423280
6/12/2024,Hiruni Chandrasiri,Badulla,Ella,Uva,790,9468,10258,31600,378720,410320
6/13/2024,Hiruni Chandrasiri,Badulla,Ella,Uva,3339,8776,12115,133560,351040,484600
6/14/2024,Hiruni Chandrasiri,Badulla,Ella,Uva,2080,1701,3781,83200,68040,151240
6/15/2024,Hiruni Chandrasiri,Badulla,Ella,Uva,6788,3919,10707,271520,156760,428280
6/16/2024,Hiruni Chandrasiri,Badulla,Ella,Uva,805,5756,6561,32200,230240,262440
6/17/2024,Hiruni Chandrasiri,Badulla,Ella,Uva,2067,315,2382,82680,12600,95280
6/18/2024,Hiruni Chandrasiri,Badulla,Ella,Uva,4999,5025,10024,199960,201000,400960
6/19/2024,Hiruni Chandrasiri,Badulla,Ella,Uva,870,2529,3399,34800,101160,135960
6/20/2024,Hiruni Chandrasiri,Badulla,Ella,Uva,8440,9570,18010,337600,382800,720400
6/21/2024,Hiruni Chandrasiri,Badulla,Ella,Uva,4579,7080,11659,183160,283200,466360
6/22/2024,Hiruni Chandrasiri,Badulla,Ella,Uva,3997,370,4367,159880,14800,174680
6/23/2024,Hiruni Chandrasiri,Badulla,Ella,Uva,4069,4848,8917,162760,193920,356680
6/24/2024,Hiruni Chandrasiri,Badulla,Ella,Uva,6576,402,6978,263040,16080,279120
6/25/2024,Hiruni Chandrasiri,Badulla,Ella,Uva,2807,6139,8946,112280,245560,357840
6/26/2024,Hiruni Chandrasiri,Badulla,Ella,Uva,7432,3859,11291,297280,154360,451640
6/27/2024,Hiruni Chandrasiri,Badulla,Ella,Uva,5902,2978,8880,236080,119120,355200
6/28/2024,Hiruni Chandrasiri,Badulla,Ella,Uva,5310,6210,11520,212400,248400,460800
6/29/2024,Hiruni Chandrasiri,Badulla,Ella,Uva,3535,5955,9490,141400,238200,379600
6/30/2024,Hiruni Chandrasiri,Badulla,Ella,Uva,9949,1691,11640,397960,67640,465600
7/1/2024,Hiruni Chandrasiri,Badulla,Ella,Uva,6070,912,6982,242800,36480,279280
7/2/2024,Hiruni Chandrasiri,Badulla,Ella,Uva,2836,3540,6376,113440,141600,255040
7/3/2024,Hiruni Chandrasiri,Badulla,Ella,Uva,2147,1723,3870,85880,68920,154800
7/4/2024,Hiruni Chandrasiri,Badulla,Ella,Uva,6521,9484,16005,260840,379360,640200
7/5/2024,Hiruni Chandrasiri,Badulla,Ella,Uva,1984,3689,5673,79360,147560,226920
7/6/2024,Hiruni Chandrasiri,Badulla,Ella,Uva,3423,1474,4897,136920,58960,195880
7/7/2024,Hiruni Chandrasiri,Badulla,Ella,Uva,3753,7071,10824,150120,282840,432960
7/8/2024,Hiruni Chandrasiri,Badulla,Ella,Uva,597,972,1569,23880,38880,62760
7/9/2024,Hiruni Chandrasiri,Badulla,Ella,Uva,7779,735,8514,311160,29400,340560
7/10/2024,Hiruni Chandrasiri,Badulla,Ella,Uva,6141,7766,13907,245640,310640,556280
7/11/2024,Hiruni Chandrasiri,Badulla,Ella,Uva,7317,6742,14059,292680,269680,562360
7/12/2024,Hiruni Chandrasiri,Badulla,Ella,Uva,5792,3694,9486,231680,147760,379440
7/13/2024,Hiruni Chandrasiri,Badulla,Ella,Uva,1007,3361,4368,40280,134440,174720
7/14/2024,Hiruni Chandrasiri,Badulla,Ella,Uva,9352,8354,17706,374080,334160,708240
7/15/2024,Hiruni Chandrasiri,Badulla,Ella,Uva,7173,9635,16808,286920,385400,672320
7/16/2024,Hiruni Chandrasiri,Badulla,Ella,Uva,7614,5126,12740,304560,205040,509600
7/17/2024,Hiruni Chandrasiri,Badulla,Ella,Uva,5116,7451,12567,204640,298040,502680
7/18/2024,Hiruni Chandrasiri,Badulla,Ella,Uva,7520,3139,10659,300800,125560,426360
7/19/2024,Hiruni Chandrasiri,Badulla,Ella,Uva,3029,6786,9815,121160,271440,392600
7/20/2024,Hiruni Chandrasiri,Badulla,Ella,Uva,4908,3217,8125,196320,128680,325000
7/21/2024,Hiruni Chandrasiri,Badulla,Ella,Uva,7966,3601,11567,318640,144040,462680
7/22/2024,Hiruni Chandrasiri,Badulla,Ella,Uva,2188,4649,6837,87520,185960,273480
7/23/2024,Hiruni Chandrasiri,Badulla,Ella,Uva,2162,8051,10213,86480,322040,408520
7/24/2024,Hiruni Chandrasiri,Badulla,Ella,Uva,8991,4943,13934,359640,197720,557360
7/25/2024,Hiruni Chandrasiri,Badulla,Ella,Uva,7458,6660,14118,298320,266400,564720
7/26/2024,Hiruni Chandrasiri,Badulla,Ella,Uva,9558,7681,17239,382320,307240,689560
7/27/2024,Hiruni Chandrasiri,Badulla,Ella,Uva,7705,1233,8938,308200,49320,357520
7/28/2024,Hiruni Chandrasiri,Badulla,Ella,Uva,9449,5787,15236,377960,231480,609440
7/29/2024,Hiruni Chandrasiri,Badulla,Ella,Uva,7923,2555,10478,316920,102200,419120
7/30/2024,Hiruni Chandrasiri,Badulla,Ella,Uva,5350,4683,10033,214000,187320,401320
7/31/2024,Hiruni Chandrasiri,Badulla,Ella,Uva,7026,6006,13032,281040,240240,521280
8/1/2024,Hiruni Chandrasiri,Badulla,Ella,Uva,7272,5773,13045,290880,230920,521800
8/2/2024,Hiruni Chandrasiri,Badulla,Ella,Uva,8779,7469,16248,351160,298760,649920
8/3/2024,Hiruni Chandrasiri,Badulla,Ella,Uva,710,7640,8350,28400,305600,334000
8/4/2024,Hiruni Chandrasiri,Badulla,Ella,Uva,4113,3571,7684,164520,142840,307360
8/5/2024,Hiruni Chandrasiri,Badulla,Ella,Uva,5998,8063,14061,239920,322520,562440
8/6/2024,Hiruni Chandrasiri,Badulla,Ella,Uva,5754,4087,9841,230160,163480,393640
8/7/2024,Hiruni Chandrasiri,Badulla,Ella,Uva,6141,7085,13226,245640,283400,529040
8/8/2024,Hiruni Chandrasiri,Badulla,Ella,Uva,4053,1098,5151,162120,43920,206040
8/9/2024,Hiruni Chandrasiri,Badulla,Ella,Uva,2351,2045,4396,94040,81800,175840
8/10/2024,Hiruni Chandrasiri,Badulla,Ella,Uva,4850,7348,12198,194000,293920,487920
8/11/2024,Hiruni Chandrasiri,Badulla,Ella,Uva,1049,6832,7881,41960,273280,315240
8/12/2024,Hiruni Chandrasiri,Badulla,Ella,Uva,7672,6774,14446,306880,270960,577840
8/13/2024,Hiruni Chandrasiri,Badulla,Ella,Uva,3066,223,3289,122640,8920,131560
8/14/2024,Hiruni Chandrasiri,Badulla,Ella,Uva,3507,956,4463,140280,38240,178520
8/15/2024,Hiruni Chandrasiri,Badulla,Ella,Uva,2093,4753,6846,83720,190120,273840
8/16/2024,Hiruni Chandrasiri,Badulla,Ella,Uva,7876,6030,13906,315040,241200,556240
8/17/2024,Hiruni Chandrasiri,Badulla,Ella,Uva,903,3773,4676,36120,150920,187040
8/18/2024,Hiruni Chandrasiri,Badulla,Ella,Uva,3527,1220,4747,141080,48800,189880
8/19/2024,Hiruni Chandrasiri,Badulla,Ella,Uva,1422,3623,5045,56880,144920,201800
8/20/2024,Hiruni Chandrasiri,Badulla,Ella,Uva,2150,984,3134,86000,39360,125360
8/21/2024,Hiruni Chandrasiri,Badulla,Ella,Uva,6882,7598,14480,275280,303920,579200
8/22/2024,Hiruni Chandrasiri,Badulla,Ella,Uva,2089,5449,7538,83560,217960,301520
8/23/2024,Hiruni Chandrasiri,Badulla,Ella,Uva,5727,1917,7644,229080,76680,305760
8/24/2024,Hiruni Chandrasiri,Badulla,Ella,Uva,550,393,943,22000,15720,37720
8/25/2024,Hiruni Chandrasiri,Badulla,Ella,Uva,1702,2446,4148,68080,97840,165920
8/26/2024,Hiruni Chandrasiri,Badulla,Ella,Uva,8959,8540,17499,358360,341600,699960
8/27/2024,Hiruni Chandrasiri,Badulla,Ella,Uva,4626,786,5412,185040,31440,216480
8/28/2024,Hiruni Chandrasiri,Badulla,Ella,Uva,285,1318,1603,11400,52720,64120
8/29/2024,Hiruni Chandrasiri,Badulla,Ella,Uva,959,3680,4639,38360,147200,185560
8/30/2024,Hiruni Chandrasiri,Badulla,Ella,Uva,5237,7406,12643,209480,296240,505720
8/31/2024,Hiruni Chandrasiri,Badulla,Ella,Uva,6912,5499,12411,276480,219960,496440
9/1/2024,Hiruni Chandrasiri,Badulla,Ella,Uva,8040,4518,12558,321600,180720,502320
9/2/2024,Hiruni Chandrasiri,Badulla,Ella,Uva,8983,8771,17754,359320,350840,710160
9/3/2024,Hiruni Chandrasiri,Badulla,Ella,Uva,5757,7494,13251,230280,299760,530040
9/4/2024,Hiruni Chandrasiri,Badulla,Ella,Uva,9391,5890,15281,375640,235600,611240
9/5/2024,Hiruni Chandrasiri,Badulla,Ella,Uva,5379,7274,12653,215160,290960,506120
9/6/2024,Hiruni Chandrasiri,Badulla,Ella,Uva,1350,304,1654,54000,12160,66160
9/7/2024,Hiruni Chandrasiri,Badulla,Ella,Uva,6527,3975,10502,261080,159000,420080
9/8/2024,Hiruni Chandrasiri,Badulla,Ella,Uva,8851,5710,14561,354040,228400,582440
9/9/2024,Hiruni Chandrasiri,Badulla,Ella,Uva,2253,3595,5848,90120,143800,233920
9/10/2024,Hiruni Chandrasiri,Badulla,Ella,Uva,5621,5389,11010,224840,215560,440400
9/11/2024,Hiruni Chandrasiri,Badulla,Ella,Uva,1668,3750,5418,66720,150000,216720
9/12/2024,Hiruni Chandrasiri,Badulla,Ella,Uva,2108,9323,11431,84320,372920,457240
9/13/2024,Hiruni Chandrasiri,Badulla,Ella,Uva,8039,8238,16277,321560,329520,651080
9/14/2024,Hiruni Chandrasiri,Badulla,Ella,Uva,6332,4132,10464,253280,165280,418560
9/15/2024,Hiruni Chandrasiri,Badulla,Ella,Uva,613,3512,4125,24520,140480,165000
9/16/2024,Hiruni Chandrasiri,Badulla,Ella,Uva,4261,4224,8485,170440,168960,339400
9/17/2024,Hiruni Chandrasiri,Badulla,Ella,Uva,7092,2685,9777,283680,107400,391080
9/18/2024,Hiruni Chandrasiri,Badulla,Ella,Uva,1813,6991,8804,72520,279640,352160
9/19/2024,Hiruni Chandrasiri,Badulla,Ella,Uva,9903,7969,17872,396120,318760,714880
9/20/2024,Hiruni Chandrasiri,Badulla,Ella,Uva,1268,1700,2968,50720,68000,118720
9/21/2024,Hiruni Chandrasiri,Badulla,Ella,Uva,9437,2981,12418,377480,119240,496720
9/22/2024,Hiruni Chandrasiri,Badulla,Ella,Uva,8079,4298,12377,323160,171920,495080
9/23/2024,Hiruni Chandrasiri,Badulla,Ella,Uva,6510,1156,7666,260400,46240,306640
9/24/2024,Hiruni Chandrasiri,Badulla,Ella,Uva,5367,2061,7428,214680,82440,297120
9/25/2024,Hiruni Chandrasiri,Badulla,Ella,Uva,8868,7345,16213,354720,293800,648520
9/26/2024,Hiruni Chandrasiri,Badulla,Ella,Uva,2979,5012,7991,119160,200480,319640
9/27/2024,Hiruni Chandrasiri,Badulla,Ella,Uva,7363,4494,11857,294520,179760,474280
9/28/2024,Hiruni Chandrasiri,Badulla,Ella,Uva,5251,1229,6480,210040,49160,259200
9/29/2024,Hiruni Chandrasiri,Badulla,Ella,Uva,1955,660,2615,78200,26400,104600
9/30/2024,Hiruni Chandrasiri,Badulla,Ella,Uva,6550,771,7321,262000,30840,292840
10/1/2024,Hiruni Chandrasiri,Badulla,Ella,Uva,3789,4012,7801,151560,160480,312040
10/2/2024,Hiruni Chandrasiri,Badulla,Ella,Uva,5402,2723,8125,216080,108920,325000
10/3/2024,Hiruni Chandrasiri,Badulla,Ella,Uva,7888,445,8333,315520,17800,333320
10/4/2024,Hiruni Chandrasiri,Badulla,Ella,Uva,1847,1760,3607,73880,70400,144280
10/5/2024,Hiruni Chandrasiri,Badulla,Ella,Uva,2011,8209,10220,80440,328360,408800
10/6/2024,Hiruni Chandrasiri,Badulla,Ella,Uva,478,8484,8962,19120,339360,358480
10/7/2024,Hiruni Chandrasiri,Badulla,Ella,Uva,318,3625,3943,12720,145000,157720
10/8/2024,Hiruni Chandrasiri,Badulla,Ella,Uva,329,5050,5379,13160,202000,215160
10/9/2024,Hiruni Chandrasiri,Badulla,Ella,Uva,5538,8018,13556,221520,320720,542240
10/10/2024,Hiruni Chandrasiri,Badulla,Ella,Uva,8743,7589,16332,349720,303560,653280
10/11/2024,Hiruni Chandrasiri,Badulla,Ella,Uva,1393,5221,6614,55720,208840,264560
10/12/2024,Hiruni Chandrasiri,Badulla,Ella,Uva,5255,821,6076,210200,32840,243040
10/13/2024,Hiruni Chandrasiri,Badulla,Ella,Uva,4721,3940,8661,188840,157600,346440
10/14/2024,Hiruni Chandrasiri,Badulla,Ella,Uva,7390,2227,9617,295600,89080,384680
10/15/2024,Hiruni Chandrasiri,Badulla,Ella,Uva,2366,7195,9561,94640,287800,382440
10/16/2024,Hiruni Chandrasiri,Badulla,Ella,Uva,4250,1896,6146,170000,75840,245840
10/17/2024,Hiruni Chandrasiri,Badulla,Ella,Uva,8799,6575,15374,351960,263000,614960
10/18/2024,Hiruni Chandrasiri,Badulla,Ella,Uva,1928,4062,5990,77120,162480,239600
10/19/2024,Hiruni Chandrasiri,Badulla,Ella,Uva,9449,6742,16191,377960,269680,647640
10/20/2024,Hiruni Chandrasiri,Badulla,Ella,Uva,4591,1627,6218,183640,65080,248720
10/21/2024,Hiruni Chandrasiri,Badulla,Ella,Uva,5280,7152,12432,211200,286080,497280
10/22/2024,Hiruni Chandrasiri,Badulla,Ella,Uva,3338,1920,5258,133520,76800,210320
10/23/2024,Hiruni Chandrasiri,Badulla,Ella,Uva,5372,1512,6884,214880,60480,275360
10/24/2024,Hiruni Chandrasiri,Badulla,Ella,Uva,1311,1906,3217,52440,76240,128680
10/25/2024,Hiruni Chandrasiri,Badulla,Ella,Uva,6139,1446,7585,245560,57840,303400
10/26/2024,Hiruni Chandrasiri,Badulla,Ella,Uva,1927,5860,7787,77080,234400,311480
10/27/2024,Hiruni Chandrasiri,Badulla,Ella,Uva,8211,3384,11595,328440,135360,463800
10/28/2024,Hiruni Chandrasiri,Badulla,Ella,Uva,2277,3248,5525,91080,129920,221000
10/29/2024,Hiruni Chandrasiri,Badulla,Ella,Uva,2792,2555,5347,111680,102200,213880
10/30/2024,Hiruni Chandrasiri,Badulla,Ella,Uva,3134,1803,4937,125360,72120,197480
10/31/2024,Hiruni Chandrasiri,Badulla,Ella,Uva,7679,3450,11129,307160,138000,445160
11/1/2024,Hiruni Chandrasiri,Badulla,Ella,Uva,3861,1066,4927,154440,42640,197080
11/2/2024,Hiruni Chandrasiri,Badulla,Ella,Uva,2903,2695,5598,116120,107800,223920
11/3/2024,Hiruni Chandrasiri,Badulla,Ella,Uva,1715,9923,11638,68600,396920,465520
11/4/2024,Hiruni Chandrasiri,Badulla,Ella,Uva,2862,2841,5703,114480,113640,228120
11/5/2024,Hiruni Chandrasiri,Badulla,Ella,Uva,9555,5683,15238,382200,227320,609520
11/6/2024,Hiruni Chandrasiri,Badulla,Ella,Uva,3816,20,3836,152640,800,153440
11/7/2024,Hiruni Chandrasiri,Badulla,Ella,Uva,8489,5836,14325,339560,233440,573000
11/8/2024,Hiruni Chandrasiri,Badulla,Ella,Uva,6868,3276,10144,274720,131040,405760
11/9/2024,Hiruni Chandrasiri,Badulla,Ella,Uva,1117,3317,4434,44680,132680,177360
11/10/2024,Hiruni Chandrasiri,Badulla,Ella,Uva,5699,7853,13552,227960,314120,542080
11/11/2024,Hiruni Chandrasiri,Badulla,Ella,Uva,392,6663,7055,15680,266520,282200
11/12/2024,Hiruni Chandrasiri,Badulla,Ella,Uva,2595,2937,5532,103800,117480,221280
11/13/2024,Hiruni Chandrasiri,Badulla,Ella,Uva,6903,5502,12405,276120,220080,496200
11/14/2024,Hiruni Chandrasiri,Badulla,Ella,Uva,8748,9451,18199,349920,378040,727960
11/15/2024,Hiruni Chandrasiri,Badulla,Ella,Uva,1592,2020,3612,63680,80800,144480
11/16/2024,Hiruni Chandrasiri,Badulla,Ella,Uva,8343,9406,17749,333720,376240,709960
11/17/2024,Hiruni Chandrasiri,Badulla,Ella,Uva,8979,8207,17186,359160,328280,687440
11/18/2024,Hiruni Chandrasiri,Badulla,Ella,Uva,4274,2479,6753,170960,99160,270120
11/19/2024,Hiruni Chandrasiri,Badulla,Ella,Uva,9630,5966,15596,385200,238640,623840
11/20/2024,Hiruni Chandrasiri,Badulla,Ella,Uva,131,4387,4518,5240,175480,180720
11/21/2024,Hiruni Chandrasiri,Badulla,Ella,Uva,1729,6639,8368,69160,265560,334720
11/22/2024,Hiruni Chandrasiri,Badulla,Ella,Uva,1715,6507,8222,68600,260280,328880
11/23/2024,Hiruni Chandrasiri,Badulla,Ella,Uva,4690,3989,8679,187600,159560,347160
11/24/2024,Hiruni Chandrasiri,Badulla,Ella,Uva,3443,9405,12848,137720,376200,513920
11/25/2024,Hiruni Chandrasiri,Badulla,Ella,Uva,1096,9610,10706,43840,384400,428240
11/26/2024,Hiruni Chandrasiri,Badulla,Ella,Uva,1184,5573,6757,47360,222920,270280
11/27/2024,Hiruni Chandrasiri,Badulla,Ella,Uva,3411,6890,10301,136440,275600,412040
11/28/2024,Hiruni Chandrasiri,Badulla,Ella,Uva,1847,3990,5837,73880,159600,233480
11/29/2024,Hiruni Chandrasiri,Badulla,Ella,Uva,7291,982,8273,291640,39280,330920
11/30/2024,Hiruni Chandrasiri,Badulla,Ella,Uva,1431,9253,10684,57240,370120,427360
12/1/2024,Hiruni Chandrasiri,Badulla,Ella,Uva,9412,9120,18532,376480,364800,741280
12/2/2024,Hiruni Chandrasiri,Badulla,Ella,Uva,6448,4427,10875,257920,177080,435000
12/3/2024,Hiruni Chandrasiri,Badulla,Ella,Uva,7193,5203,12396,287720,208120,495840
12/4/2024,Hiruni Chandrasiri,Badulla,Ella,Uva,2725,8086,10811,109000,323440,432440
12/5/2024,Hiruni Chandrasiri,Badulla,Ella,Uva,2729,3221,5950,109160,128840,238000
12/6/2024,Hiruni Chandrasiri,Badulla,Ella,Uva,5943,4396,10339,237720,175840,413560
12/7/2024,Hiruni Chandrasiri,Badulla,Ella,Uva,1114,8852,9966,44560,354080,398640
12/8/2024,Hiruni Chandrasiri,Badulla,Ella,Uva,6849,8018,14867,273960,320720,594680
12/9/2024,Hiruni Chandrasiri,Badulla,Ella,Uva,1966,346,2312,78640,13840,92480
12/10/2024,Hiruni Chandrasiri,Badulla,Ella,Uva,4895,1995,6890,195800,79800,275600
12/11/2024,Hiruni Chandrasiri,Badulla,Ella,Uva,1808,2773,4581,72320,110920,183240
12/12/2024,Hiruni Chandrasiri,Badulla,Ella,Uva,1413,3989,5402,56520,159560,216080
12/13/2024,Hiruni Chandrasiri,Badulla,Ella,Uva,1711,4885,6596,68440,195400,263840
12/14/2024,Hiruni Chandrasiri,Badulla,Ella,Uva,5297,6124,11421,211880,244960,456840
12/15/2024,Hiruni Chandrasiri,Badulla,Ella,Uva,7562,7839,15401,302480,313560,616040
12/16/2024,Hiruni Chandrasiri,Badulla,Ella,Uva,1844,3573,5417,73760,142920,216680
12/17/2024,Hiruni Chandrasiri,Badulla,Ella,Uva,5749,4558,10307,229960,182320,412280
12/18/2024,Hiruni Chandrasiri,Badulla,Ella,Uva,617,1896,2513,24680,75840,100520
12/19/2024,Hiruni Chandrasiri,Badulla,Ella,Uva,2177,9114,11291,87080,364560,451640
12/20/2024,Hiruni Chandrasiri,Badulla,Ella,Uva,7911,3751,11662,316440,150040,466480
12/21/2024,Hiruni Chandrasiri,Badulla,Ella,Uva,7645,4759,12404,305800,190360,496160
12/22/2024,Hiruni Chandrasiri,Badulla,Ella,Uva,5425,9855,15280,217000,394200,611200
12/23/2024,Hiruni Chandrasiri,Badulla,Ella,Uva,5921,9297,15218,236840,371880,608720
12/24/2024,Hiruni Chandrasiri,Badulla,Ella,Uva,9271,1170,10441,370840,46800,417640
12/25/2024,Hiruni Chandrasiri,Badulla,Ella,Uva,4980,3570,8550,199200,142800,342000
12/26/2024,Hiruni Chandrasiri,Badulla,Ella,Uva,4014,2623,6637,160560,104920,265480
12/27/2024,Hiruni Chandrasiri,Badulla,Ella,Uva,958,296,1254,38320,11840,50160
12/28/2024,Hiruni Chandrasiri,Badulla,Ella,Uva,221,2584,2805,8840,103360,112200
12/29/2024,Hiruni Chandrasiri,Badulla,Ella,Uva,4224,7333,11557,168960,293320,462280
12/30/2024,Hiruni Chandrasiri,Badulla,Ella,Uva,5053,4746,9799,202120,189840,391960
12/31/2024,Hiruni Chandrasiri,Badulla,Ella,Uva,4167,2510,6677,166680,100400,267080
1/1/2025,Hiruni Chandrasiri,Badulla,Ella,Uva,5151,1212,6363,206040,48480,254520
1/2/2025,Hiruni Chandrasiri,Badulla,Ella,Uva,2076,4317,6393,83040,172680,255720
1/3/2025,Hiruni Chandrasiri,Badulla,Ella,Uva,3305,4401,7706,132200,176040,308240
1/4/2025,Hiruni Chandrasiri,Badulla,Ella,Uva,1084,27,1111,43360,1080,44440
1/5/2025,Hiruni Chandrasiri,Badulla,Ella,Uva,1285,6975,8260,51400,279000,330400
1/6/2025,Hiruni Chandrasiri,Badulla,Ella,Uva,573,4663,5236,22920,186520,209440
1/7/2025,Hiruni Chandrasiri,Badulla,Ella,Uva,3627,6593,10220,145080,263720,408800
1/8/2025,Hiruni Chandrasiri,Badulla,Ella,Uva,7178,7625,14803,287120,305000,592120
1/9/2025,Hiruni Chandrasiri,Badulla,Ella,Uva,3242,6232,9474,129680,249280,378960
1/10/2025,Hiruni Chandrasiri,Badulla,Ella,Uva,7379,6794,14173,295160,271760,566920
1/11/2025,Hiruni Chandrasiri,Badulla,Ella,Uva,3346,7717,11063,133840,308680,442520
1/12/2025,Hiruni Chandrasiri,Badulla,Ella,Uva,3435,6273,9708,137400,250920,388320
1/13/2025,Hiruni Chandrasiri,Badulla,Ella,Uva,5594,1739,7333,223760,69560,293320
1/14/2025,Hiruni Chandrasiri,Badulla,Ella,Uva,8544,2996,11540,341760,119840,461600
1/15/2025,Hiruni Chandrasiri,Badulla,Ella,Uva,3780,7405,11185,151200,296200,447400
1/16/2025,Hiruni Chandrasiri,Badulla,Ella,Uva,795,2869,3664,31800,114760,146560
1/17/2025,Hiruni Chandrasiri,Badulla,Ella,Uva,4797,8834,13631,191880,353360,545240
1/18/2025,Hiruni Chandrasiri,Badulla,Ella,Uva,5826,9361,15187,233040,374440,607480
1/19/2025,Hiruni Chandrasiri,Badulla,Ella,Uva,2233,5047,7280,89320,201880,291200
1/20/2025,Hiruni Chandrasiri,Badulla,Ella,Uva,1585,4436,6021,63400,177440,240840
1/21/2025,Hiruni Chandrasiri,Badulla,Ella,Uva,7826,3476,11302,313040,139040,452080
1/22/2025,Hiruni Chandrasiri,Badulla,Ella,Uva,4631,6572,11203,185240,262880,448120
1/23/2025,Hiruni Chandrasiri,Badulla,Ella,Uva,2400,6135,8535,96000,245400,341400
1/24/2025,Hiruni Chandrasiri,Badulla,Ella,Uva,746,2162,2908,29840,86480,116320
1/25/2025,Hiruni Chandrasiri,Badulla,Ella,Uva,3514,3630,7144,140560,145200,285760
1/26/2025,Hiruni Chandrasiri,Badulla,Ella,Uva,5882,8206,14088,235280,328240,563520
1/27/2025,Hiruni Chandrasiri,Badulla,Ella,Uva,8227,3851,12078,329080,154040,483120
1/28/2025,Hiruni Chandrasiri,Badulla,Ella,Uva,683,6396,7079,27320,255840,283160
1/29/2025,Hiruni Chandrasiri,Badulla,Ella,Uva,4769,9031,13800,190760,361240,552000
1/30/2025,Hiruni Chandrasiri,Badulla,Ella,Uva,6208,7202,13410,248320,288080,536400
1/31/2025,Hiruni Chandrasiri,Badulla,Ella,Uva,4220,2958,7178,168800,118320,287120
2/1/2025,Hiruni Chandrasiri,Badulla,Ella,Uva,4156,3835,7991,166240,153400,319640
2/2/2025,Hiruni Chandrasiri,Badulla,Ella,Uva,6478,7298,13776,259120,291920,551040
2/3/2025,Hiruni Chandrasiri,Badulla,Ella,Uva,8640,104,8744,345600,4160,349760
2/4/2025,Hiruni Chandrasiri,Badulla,Ella,Uva,7250,8127,15377,290000,325080,615080
2/5/2025,Hiruni Chandrasiri,Badulla,Ella,Uva,8352,4744,13096,334080,189760,523840
2/6/2025,Hiruni Chandrasiri,Badulla,Ella,Uva,4244,9201,13445,169760,368040,537800
2/7/2025,Hiruni Chandrasiri,Badulla,Ella,Uva,1138,6714,7852,45520,268560,314080
2/8/2025,Hiruni Chandrasiri,Badulla,Ella,Uva,8951,4984,13935,358040,199360,557400
2/9/2025,Hiruni Chandrasiri,Badulla,Ella,Uva,6991,1754,8745,279640,70160,349800
2/10/2025,Hiruni Chandrasiri,Badulla,Ella,Uva,5127,1693,6820,205080,67720,272800
2/11/2025,Hiruni Chandrasiri,Badulla,Ella,Uva,9721,2806,12527,388840,112240,501080
2/12/2025,Hiruni Chandrasiri,Badulla,Ella,Uva,5529,3981,9510,221160,159240,380400
2/13/2025,Hiruni Chandrasiri,Badulla,Ella,Uva,7278,8101,15379,291120,324040,615160
2/14/2025,Hiruni Chandrasiri,Badulla,Ella,Uva,2808,648,3456,112320,25920,138240
2/15/2025,Hiruni Chandrasiri,Badulla,Ella,Uva,6969,2959,9928,278760,118360,397120
2/16/2025,Hiruni Chandrasiri,Badulla,Ella,Uva,1179,9893,11072,47160,395720,442880
2/17/2025,Hiruni Chandrasiri,Badulla,Ella,Uva,8566,208,8774,342640,8320,350960
2/18/2025,Hiruni Chandrasiri,Badulla,Ella,Uva,7858,8328,16186,314320,333120,647440
2/19/2025,Hiruni Chandrasiri,Badulla,Ella,Uva,5456,8295,13751,218240,331800,550040
2/20/2025,Hiruni Chandrasiri,Badulla,Ella,Uva,2331,2531,4862,93240,101240,194480
2/21/2025,Hiruni Chandrasiri,Badulla,Ella,Uva,3473,3729,7202,138920,149160,288080
2/22/2025,Hiruni Chandrasiri,Badulla,Ella,Uva,4226,2115,6341,169040,84600,253640
2/23/2025,Hiruni Chandrasiri,Badulla,Ella,Uva,7500,9809,17309,300000,392360,692360
2/24/2025,Hiruni Chandrasiri,Badulla,Ella,Uva,3500,6671,10171,140000,266840,406840
2/25/2025,Hiruni Chandrasiri,Badulla,Ella,Uva,986,7726,8712,39440,309040,348480
2/26/2025,Hiruni Chandrasiri,Badulla,Ella,Uva,3511,4679,8190,140440,187160,327600
2/27/2025,Hiruni Chandrasiri,Badulla,Ella,Uva,6079,3076,9155,243160,123040,366200
2/28/2025,Hiruni Chandrasiri,Badulla,Ella,Uva,8522,8330,16852,340880,333200,674080
3/1/2025,Hiruni Chandrasiri,Badulla,Ella,Uva,5520,8923,14443,220800,356920,577720
3/2/2025,Hiruni Chandrasiri,Badulla,Ella,Uva,4878,9302,14180,195120,372080,567200
3/3/2025,Hiruni Chandrasiri,Badulla,Ella,Uva,4376,667,5043,175040,26680,201720
3/4/2025,Hiruni Chandrasiri,Badulla,Ella,Uva,2777,3512,6289,111080,140480,251560
3/5/2025,Hiruni Chandrasiri,Badulla,Ella,Uva,7443,4821,12264,297720,192840,490560
3/6/2025,Hiruni Chandrasiri,Badulla,Ella,Uva,1713,1526,3239,68520,61040,129560
3/7/2025,Hiruni Chandrasiri,Badulla,Ella,Uva,9879,1587,11466,395160,63480,458640
3/8/2025,Hiruni Chandrasiri,Badulla,Ella,Uva,2986,1934,4920,119440,77360,196800
3/9/2025,Hiruni Chandrasiri,Badulla,Ella,Uva,7220,207,7427,288800,8280,297080
3/10/2025,Hiruni Chandrasiri,Badulla,Ella,Uva,4916,6197,11113,196640,247880,444520
3/11/2025,Hiruni Chandrasiri,Badulla,Ella,Uva,391,3292,3683,15640,131680,147320
3/12/2025,Hiruni Chandrasiri,Badulla,Ella,Uva,442,8297,8739,17680,331880,349560
3/13/2025,Hiruni Chandrasiri,Badulla,Ella,Uva,8836,9834,18670,353440,393360,746800
3/14/2025,Hiruni Chandrasiri,Badulla,Ella,Uva,5758,7257,13015,230320,290280,520600
3/15/2025,Hiruni Chandrasiri,Badulla,Ella,Uva,9167,1787,10954,366680,71480,438160
3/16/2025,Hiruni Chandrasiri,Badulla,Ella,Uva,2845,2308,5153,113800,92320,206120
3/17/2025,Hiruni Chandrasiri,Badulla,Ella,Uva,707,3237,3944,28280,129480,157760
3/18/2025,Hiruni Chandrasiri,Badulla,Ella,Uva,7432,3697,11129,297280,147880,445160
3/19/2025,Hiruni Chandrasiri,Badulla,Ella,Uva,3337,4134,7471,133480,165360,298840
3/20/2025,Hiruni Chandrasiri,Badulla,Ella,Uva,4504,5833,10337,180160,233320,413480
3/21/2025,Hiruni Chandrasiri,Badulla,Ella,Uva,5605,244,5849,224200,9760,233960
3/22/2025,Hiruni Chandrasiri,Badulla,Ella,Uva,6360,4736,11096,254400,189440,443840
3/23/2025,Hiruni Chandrasiri,Badulla,Ella,Uva,7662,2376,10038,306480,95040,401520
3/25/2024,Ajantha Amarasekara,Hambantota,Ambalantota,Southern,8698,3966,12664,347920,158640,506560
3/26/2024,Ajantha Amarasekara,Hambantota,Ambalantota,Southern,2967,3753,6720,118680,150120,268800
3/27/2024,Ajantha Amarasekara,Hambantota,Ambalantota,Southern,5871,7230,13101,234840,289200,524040
3/28/2024,Ajantha Amarasekara,Hambantota,Ambalantota,Southern,7300,4601,11901,292000,184040,476040
3/29/2024,Ajantha Amarasekara,Hambantota,Ambalantota,Southern,8795,4502,13297,351800,180080,531880
3/30/2024,Ajantha Amarasekara,Hambantota,Ambalantota,Southern,5958,5784,11742,238320,231360,469680
3/31/2024,Ajantha Amarasekara,Hambantota,Ambalantota,Southern,4041,5913,9954,161640,236520,398160
4/1/2024,Ajantha Amarasekara,Hambantota,Ambalantota,Southern,7823,257,8080,312920,10280,323200
4/2/2024,Ajantha Amarasekara,Hambantota,Ambalantota,Southern,1133,4974,6107,45320,198960,244280
4/3/2024,Ajantha Amarasekara,Hambantota,Ambalantota,Southern,6440,8902,15342,257600,356080,613680
4/4/2024,Ajantha Amarasekara,Hambantota,Ambalantota,Southern,7567,9386,16953,302680,375440,678120
4/5/2024,Ajantha Amarasekara,Hambantota,Ambalantota,Southern,7872,77,7949,314880,3080,317960
4/6/2024,Ajantha Amarasekara,Hambantota,Ambalantota,Southern,3670,8580,12250,146800,343200,490000
4/7/2024,Ajantha Amarasekara,Hambantota,Ambalantota,Southern,649,814,1463,25960,32560,58520
4/8/2024,Ajantha Amarasekara,Hambantota,Ambalantota,Southern,6601,9118,15719,264040,364720,628760
4/9/2024,Ajantha Amarasekara,Hambantota,Ambalantota,Southern,8151,4442,12593,326040,177680,503720
4/10/2024,Ajantha Amarasekara,Hambantota,Ambalantota,Southern,8418,721,9139,336720,28840,365560
4/11/2024,Ajantha Amarasekara,Hambantota,Ambalantota,Southern,4267,8854,13121,170680,354160,524840
4/19/2024,Ajantha Amarasekara,Hambantota,Ambalantota,Southern,6468,2672,9140,258720,106880,365600
4/20/2024,Ajantha Amarasekara,Hambantota,Ambalantota,Southern,953,1570,2523,38120,62800,100920
4/21/2024,Ajantha Amarasekara,Hambantota,Ambalantota,Southern,5147,6765,11912,205880,270600,476480
4/22/2024,Ajantha Amarasekara,Hambantota,Ambalantota,Southern,8624,11,8635,344960,440,345400
4/23/2024,Ajantha Amarasekara,Hambantota,Ambalantota,Southern,6260,3034,9294,250400,121360,371760
4/24/2024,Ajantha Amarasekara,Hambantota,Ambalantota,Southern,9576,1329,10905,383040,53160,436200
4/25/2024,Ajantha Amarasekara,Hambantota,Ambalantota,Southern,5999,8513,14512,239960,340520,580480
4/26/2024,Ajantha Amarasekara,Hambantota,Ambalantota,Southern,872,5630,6502,34880,225200,260080
4/27/2024,Ajantha Amarasekara,Hambantota,Ambalantota,Southern,3688,9335,13023,147520,373400,520920
4/28/2024,Ajantha Amarasekara,Hambantota,Ambalantota,Southern,4507,8175,12682,180280,327000,507280
4/29/2024,Ajantha Amarasekara,Hambantota,Ambalantota,Southern,1762,3646,5408,70480,145840,216320
4/30/2024,Ajantha Amarasekara,Hambantota,Ambalantota,Southern,8739,6253,14992,349560,250120,599680
5/1/2024,Ajantha Amarasekara,Hambantota,Ambalantota,Southern,3196,5318,8514,127840,212720,340560
5/2/2024,Ajantha Amarasekara,Hambantota,Ambalantota,Southern,1505,4232,5737,60200,169280,229480
5/3/2024,Ajantha Amarasekara,Hambantota,Ambalantota,Southern,1845,5915,7760,73800,236600,310400
5/4/2024,Ajantha Amarasekara,Hambantota,Ambalantota,Southern,728,1165,1893,29120,46600,75720
5/5/2024,Ajantha Amarasekara,Hambantota,Ambalantota,Southern,9298,5953,15251,371920,238120,610040
5/6/2024,Ajantha Amarasekara,Hambantota,Ambalantota,Southern,808,6848,7656,32320,273920,306240
5/7/2024,Ajantha Amarasekara,Hambantota,Ambalantota,Southern,2501,584,3085,100040,23360,123400
5/8/2024,Ajantha Amarasekara,Hambantota,Ambalantota,Southern,2741,1507,4248,109640,60280,169920
5/9/2024,Ajantha Amarasekara,Hambantota,Ambalantota,Southern,8304,8246,16550,332160,329840,662000
5/10/2024,Ajantha Amarasekara,Hambantota,Ambalantota,Southern,5519,8591,14110,220760,343640,564400
5/11/2024,Ajantha Amarasekara,Hambantota,Ambalantota,Southern,3045,2524,5569,121800,100960,222760
5/12/2024,Ajantha Amarasekara,Hambantota,Ambalantota,Southern,1576,1689,3265,63040,67560,130600
5/13/2024,Ajantha Amarasekara,Hambantota,Ambalantota,Southern,7198,1028,8226,287920,41120,329040
5/14/2024,Ajantha Amarasekara,Hambantota,Ambalantota,Southern,6616,92,6708,264640,3680,268320
5/15/2024,Ajantha Amarasekara,Hambantota,Ambalantota,Southern,8448,7245,15693,337920,289800,627720
5/16/2024,Ajantha Amarasekara,Hambantota,Ambalantota,Southern,513,3460,3973,20520,138400,158920
5/17/2024,Ajantha Amarasekara,Hambantota,Ambalantota,Southern,7128,5680,12808,285120,227200,512320
5/18/2024,Ajantha Amarasekara,Hambantota,Ambalantota,Southern,4975,64,5039,199000,2560,201560
5/19/2024,Ajantha Amarasekara,Hambantota,Ambalantota,Southern,3598,7232,10830,143920,289280,433200
5/20/2024,Ajantha Amarasekara,Hambantota,Ambalantota,Southern,4535,8160,12695,181400,326400,507800
5/21/2024,Ajantha Amarasekara,Hambantota,Ambalantota,Southern,5185,5389,10574,207400,215560,422960
5/22/2024,Ajantha Amarasekara,Hambantota,Ambalantota,Southern,988,9553,10541,39520,382120,421640
5/24/2024,Ajantha Amarasekara,Hambantota,Ambalantota,Southern,8986,1552,10538,359440,62080,421520
5/25/2024,Ajantha Amarasekara,Hambantota,Ambalantota,Southern,7447,2632,10079,297880,105280,403160
5/26/2024,Ajantha Amarasekara,Hambantota,Ambalantota,Southern,5468,8045,13513,218720,321800,540520
5/27/2024,Ajantha Amarasekara,Hambantota,Ambalantota,Southern,9643,875,10518,385720,35000,420720
5/28/2024,Ajantha Amarasekara,Hambantota,Ambalantota,Southern,4234,4949,9183,169360,197960,367320
5/29/2024,Ajantha Amarasekara,Hambantota,Ambalantota,Southern,2984,8742,11726,119360,349680,469040
5/30/2024,Ajantha Amarasekara,Hambantota,Ambalantota,Southern,5743,2469,8212,229720,98760,328480
5/31/2024,Ajantha Amarasekara,Hambantota,Ambalantota,Southern,433,6241,6674,17320,249640,266960
6/1/2024,Ajantha Amarasekara,Hambantota,Ambalantota,Southern,921,7930,8851,36840,317200,354040
6/2/2024,Ajantha Amarasekara,Hambantota,Ambalantota,Southern,9979,9367,19346,399160,374680,773840
6/3/2024,Ajantha Amarasekara,Hambantota,Ambalantota,Southern,4854,7247,12101,194160,289880,484040
6/4/2024,Ajantha Amarasekara,Hambantota,Ambalantota,Southern,9274,8434,17708,370960,337360,708320
6/5/2024,Ajantha Amarasekara,Hambantota,Ambalantota,Southern,9913,3446,13359,396520,137840,534360
6/6/2024,Ajantha Amarasekara,Hambantota,Ambalantota,Southern,1701,2275,3976,68040,91000,159040
6/7/2024,Ajantha Amarasekara,Hambantota,Ambalantota,Southern,2379,908,3287,95160,36320,131480
6/8/2024,Ajantha Amarasekara,Hambantota,Ambalantota,Southern,6167,3296,9463,246680,131840,378520
6/9/2024,Ajantha Amarasekara,Hambantota,Ambalantota,Southern,4122,3285,7407,164880,131400,296280
6/10/2024,Ajantha Amarasekara,Hambantota,Ambalantota,Southern,6982,6170,13152,279280,246800,526080
6/11/2024,Ajantha Amarasekara,Hambantota,Ambalantota,Southern,1671,4705,6376,66840,188200,255040
6/12/2024,Ajantha Amarasekara,Hambantota,Ambalantota,Southern,4680,2301,6981,187200,92040,279240
6/13/2024,Ajantha Amarasekara,Hambantota,Ambalantota,Southern,8134,3846,11980,325360,153840,479200
6/14/2024,Ajantha Amarasekara,Hambantota,Ambalantota,Southern,3767,404,4171,150680,16160,166840
6/15/2024,Ajantha Amarasekara,Hambantota,Ambalantota,Southern,9627,6840,16467,385080,273600,658680
6/16/2024,Ajantha Amarasekara,Hambantota,Ambalantota,Southern,811,9476,10287,32440,379040,411480
6/17/2024,Ajantha Amarasekara,Hambantota,Ambalantota,Southern,1863,9787,11650,74520,391480,466000
6/18/2024,Ajantha Amarasekara,Hambantota,Ambalantota,Southern,6875,109,6984,275000,4360,279360
6/19/2024,Ajantha Amarasekara,Hambantota,Ambalantota,Southern,604,9147,9751,24160,365880,390040
6/20/2024,Ajantha Amarasekara,Hambantota,Ambalantota,Southern,2055,1412,3467,82200,56480,138680
6/21/2024,Ajantha Amarasekara,Hambantota,Ambalantota,Southern,7597,2957,10554,303880,118280,422160
6/22/2024,Ajantha Amarasekara,Hambantota,Ambalantota,Southern,9117,3417,12534,364680,136680,501360
6/23/2024,Ajantha Amarasekara,Hambantota,Ambalantota,Southern,4703,5647,10350,188120,225880,414000
6/24/2024,Ajantha Amarasekara,Hambantota,Ambalantota,Southern,9214,1643,10857,368560,65720,434280
6/25/2024,Ajantha Amarasekara,Hambantota,Ambalantota,Southern,5831,6555,12386,233240,262200,495440
6/26/2024,Ajantha Amarasekara,Hambantota,Ambalantota,Southern,8905,5419,14324,356200,216760,572960
6/27/2024,Ajantha Amarasekara,Hambantota,Ambalantota,Southern,31,6525,6556,1240,261000,262240
6/28/2024,Ajantha Amarasekara,Hambantota,Ambalantota,Southern,5417,3221,8638,216680,128840,345520
6/29/2024,Ajantha Amarasekara,Hambantota,Ambalantota,Southern,3053,6297,9350,122120,251880,374000
6/30/2024,Ajantha Amarasekara,Hambantota,Ambalantota,Southern,4935,4924,9859,197400,196960,394360
7/1/2024,Ajantha Amarasekara,Hambantota,Ambalantota,Southern,4014,1847,5861,160560,73880,234440
7/2/2024,Ajantha Amarasekara,Hambantota,Ambalantota,Southern,7734,2245,9979,309360,89800,399160
7/3/2024,Ajantha Amarasekara,Hambantota,Ambalantota,Southern,693,8149,8842,27720,325960,353680
7/4/2024,Ajantha Amarasekara,Hambantota,Ambalantota,Southern,4884,5802,10686,195360,232080,427440
7/5/2024,Ajantha Amarasekara,Hambantota,Ambalantota,Southern,4266,1371,5637,170640,54840,225480
7/6/2024,Ajantha Amarasekara,Hambantota,Ambalantota,Southern,7221,1590,8811,288840,63600,352440
7/7/2024,Ajantha Amarasekara,Hambantota,Ambalantota,Southern,7405,5722,13127,296200,228880,525080
7/8/2024,Ajantha Amarasekara,Hambantota,Ambalantota,Southern,4105,3877,7982,164200,155080,319280
7/9/2024,Ajantha Amarasekara,Hambantota,Ambalantota,Southern,5038,8973,14011,201520,358920,560440
7/10/2024,Ajantha Amarasekara,Hambantota,Ambalantota,Southern,6787,4703,11490,271480,188120,459600
7/11/2024,Ajantha Amarasekara,Hambantota,Ambalantota,Southern,1422,2635,4057,56880,105400,162280
7/12/2024,Ajantha Amarasekara,Hambantota,Ambalantota,Southern,529,7004,7533,21160,280160,301320
7/13/2024,Ajantha Amarasekara,Hambantota,Ambalantota,Southern,3529,4080,7609,141160,163200,304360
7/14/2024,Ajantha Amarasekara,Hambantota,Ambalantota,Southern,6594,4119,10713,263760,164760,428520
7/15/2024,Ajantha Amarasekara,Hambantota,Ambalantota,Southern,6726,282,7008,269040,11280,280320
7/16/2024,Ajantha Amarasekara,Hambantota,Ambalantota,Southern,6485,6299,12784,259400,251960,511360
7/17/2024,Ajantha Amarasekara,Hambantota,Ambalantota,Southern,1943,2151,4094,77720,86040,163760
7/18/2024,Ajantha Amarasekara,Hambantota,Ambalantota,Southern,2145,441,2586,85800,17640,103440
7/19/2024,Ajantha Amarasekara,Hambantota,Ambalantota,Southern,8996,8584,17580,359840,343360,703200
7/20/2024,Ajantha Amarasekara,Hambantota,Ambalantota,Southern,293,9893,10186,11720,395720,407440
7/21/2024,Ajantha Amarasekara,Hambantota,Ambalantota,Southern,3654,8460,12114,146160,338400,484560
7/22/2024,Ajantha Amarasekara,Hambantota,Ambalantota,Southern,588,5890,6478,23520,235600,259120
7/23/2024,Ajantha Amarasekara,Hambantota,Ambalantota,Southern,9876,2735,12611,395040,109400,504440
7/24/2024,Ajantha Amarasekara,Hambantota,Ambalantota,Southern,6958,9717,16675,278320,388680,667000
7/25/2024,Ajantha Amarasekara,Hambantota,Ambalantota,Southern,6300,6212,12512,252000,248480,500480
7/26/2024,Ajantha Amarasekara,Hambantota,Ambalantota,Southern,4879,9561,14440,195160,382440,577600
7/27/2024,Ajantha Amarasekara,Hambantota,Ambalantota,Southern,4697,3587,8284,187880,143480,331360
7/28/2024,Ajantha Amarasekara,Hambantota,Ambalantota,Southern,1034,8897,9931,41360,355880,397240
7/29/2024,Ajantha Amarasekara,Hambantota,Ambalantota,Southern,8300,3783,12083,332000,151320,483320
7/30/2024,Ajantha Amarasekara,Hambantota,Ambalantota,Southern,2052,3230,5282,82080,129200,211280
7/31/2024,Ajantha Amarasekara,Hambantota,Ambalantota,Southern,8200,1678,9878,328000,67120,395120
8/1/2024,Ajantha Amarasekara,Hambantota,Ambalantota,Southern,9120,2850,11970,364800,114000,478800
8/2/2024,Ajantha Amarasekara,Hambantota,Ambalantota,Southern,529,5555,6084,21160,222200,243360
8/3/2024,Ajantha Amarasekara,Hambantota,Ambalantota,Southern,4523,9470,13993,180920,378800,559720
8/4/2024,Ajantha Amarasekara,Hambantota,Ambalantota,Southern,2393,7349,9742,95720,293960,389680
8/5/2024,Ajantha Amarasekara,Hambantota,Ambalantota,Southern,8422,1276,9698,336880,51040,387920
8/6/2024,Ajantha Amarasekara,Hambantota,Ambalantota,Southern,9275,8783,18058,371000,351320,722320
8/7/2024,Ajantha Amarasekara,Hambantota,Ambalantota,Southern,8594,4248,12842,343760,169920,513680
8/8/2024,Ajantha Amarasekara,Hambantota,Ambalantota,Southern,2117,1381,3498,84680,55240,139920
8/9/2024,Ajantha Amarasekara,Hambantota,Ambalantota,Southern,8154,4175,12329,326160,167000,493160
8/10/2024,Ajantha Amarasekara,Hambantota,Ambalantota,Southern,3645,8593,12238,145800,343720,489520
8/11/2024,Ajantha Amarasekara,Hambantota,Ambalantota,Southern,8638,2352,10990,345520,94080,439600
8/12/2024,Ajantha Amarasekara,Hambantota,Ambalantota,Southern,7955,67,8022,318200,2680,320880
8/13/2024,Ajantha Amarasekara,Hambantota,Ambalantota,Southern,3092,7738,10830,123680,309520,433200
8/14/2024,Ajantha Amarasekara,Hambantota,Ambalantota,Southern,54,91,145,2160,3640,5800
8/15/2024,Ajantha Amarasekara,Hambantota,Ambalantota,Southern,1870,92,1962,74800,3680,78480
8/16/2024,Ajantha Amarasekara,Hambantota,Ambalantota,Southern,7875,7100,14975,315000,284000,599000
8/17/2024,Ajantha Amarasekara,Hambantota,Ambalantota,Southern,1539,6810,8349,61560,272400,333960
8/18/2024,Ajantha Amarasekara,Hambantota,Ambalantota,Southern,9766,3383,13149,390640,135320,525960
8/19/2024,Ajantha Amarasekara,Hambantota,Ambalantota,Southern,7410,1132,8542,296400,45280,341680
8/20/2024,Ajantha Amarasekara,Hambantota,Ambalantota,Southern,8857,3318,12175,354280,132720,487000
8/21/2024,Ajantha Amarasekara,Hambantota,Ambalantota,Southern,2577,4355,6932,103080,174200,277280
8/22/2024,Ajantha Amarasekara,Hambantota,Ambalantota,Southern,8492,7370,15862,339680,294800,634480
8/23/2024,Ajantha Amarasekara,Hambantota,Ambalantota,Southern,5734,8411,14145,229360,336440,565800
8/24/2024,Ajantha Amarasekara,Hambantota,Ambalantota,Southern,766,4911,5677,30640,196440,227080
8/25/2024,Ajantha Amarasekara,Hambantota,Ambalantota,Southern,7370,3150,10520,294800,126000,420800
8/26/2024,Ajantha Amarasekara,Hambantota,Ambalantota,Southern,4241,1208,5449,169640,48320,217960
8/27/2024,Ajantha Amarasekara,Hambantota,Ambalantota,Southern,5622,6838,12460,224880,273520,498400
8/28/2024,Ajantha Amarasekara,Hambantota,Ambalantota,Southern,8277,6236,14513,331080,249440,580520
8/29/2024,Ajantha Amarasekara,Hambantota,Ambalantota,Southern,8274,287,8561,330960,11480,342440
8/30/2024,Ajantha Amarasekara,Hambantota,Ambalantota,Southern,7873,9157,17030,314920,366280,681200
8/31/2024,Ajantha Amarasekara,Hambantota,Ambalantota,Southern,37,71,108,1480,2840,4320
9/1/2024,Ajantha Amarasekara,Hambantota,Ambalantota,Southern,9639,4834,14473,385560,193360,578920
9/2/2024,Ajantha Amarasekara,Hambantota,Ambalantota,Southern,2196,4975,7171,87840,199000,286840
9/3/2024,Ajantha Amarasekara,Hambantota,Ambalantota,Southern,7810,4558,12368,312400,182320,494720
9/4/2024,Ajantha Amarasekara,Hambantota,Ambalantota,Southern,6624,5574,12198,264960,222960,487920
9/5/2024,Ajantha Amarasekara,Hambantota,Ambalantota,Southern,7236,7950,15186,289440,318000,607440
9/6/2024,Ajantha Amarasekara,Hambantota,Ambalantota,Southern,3922,1593,5515,156880,63720,220600
9/7/2024,Ajantha Amarasekara,Hambantota,Ambalantota,Southern,2131,1231,3362,85240,49240,134480
9/8/2024,Ajantha Amarasekara,Hambantota,Ambalantota,Southern,3145,7974,11119,125800,318960,444760
9/9/2024,Ajantha Amarasekara,Hambantota,Ambalantota,Southern,8498,1560,10058,339920,62400,402320
9/10/2024,Ajantha Amarasekara,Hambantota,Ambalantota,Southern,5322,5291,10613,212880,211640,424520
9/11/2024,Ajantha Amarasekara,Hambantota,Ambalantota,Southern,834,4572,5406,33360,182880,216240
9/12/2024,Ajantha Amarasekara,Hambantota,Ambalantota,Southern,4611,2684,7295,184440,107360,291800
9/13/2024,Ajantha Amarasekara,Hambantota,Ambalantota,Southern,8019,2678,10697,320760,107120,427880
9/14/2024,Ajantha Amarasekara,Hambantota,Ambalantota,Southern,3672,6908,10580,146880,276320,423200
9/15/2024,Ajantha Amarasekara,Hambantota,Ambalantota,Southern,8251,180,8431,330040,7200,337240
9/16/2024,Ajantha Amarasekara,Hambantota,Ambalantota,Southern,343,310,653,13720,12400,26120
9/17/2024,Ajantha Amarasekara,Hambantota,Ambalantota,Southern,6792,8761,15553,271680,350440,622120
9/18/2024,Ajantha Amarasekara,Hambantota,Ambalantota,Southern,9983,3529,13512,399320,141160,540480
9/19/2024,Ajantha Amarasekara,Hambantota,Ambalantota,Southern,2340,6024,8364,93600,240960,334560
9/20/2024,Ajantha Amarasekara,Hambantota,Ambalantota,Southern,6631,6538,13169,265240,261520,526760
9/21/2024,Ajantha Amarasekara,Hambantota,Ambalantota,Southern,192,9376,9568,7680,375040,382720
9/22/2024,Ajantha Amarasekara,Hambantota,Ambalantota,Southern,4874,5598,10472,194960,223920,418880
9/23/2024,Ajantha Amarasekara,Hambantota,Ambalantota,Southern,3099,7997,11096,123960,319880,443840
9/24/2024,Ajantha Amarasekara,Hambantota,Ambalantota,Southern,6769,7379,14148,270760,295160,565920
9/25/2024,Ajantha Amarasekara,Hambantota,Ambalantota,Southern,826,1979,2805,33040,79160,112200
9/26/2024,Ajantha Amarasekara,Hambantota,Ambalantota,Southern,618,7741,8359,24720,309640,334360
9/27/2024,Ajantha Amarasekara,Hambantota,Ambalantota,Southern,1399,7623,9022,55960,304920,360880
9/28/2024,Ajantha Amarasekara,Hambantota,Ambalantota,Southern,4374,2582,6956,174960,103280,278240
9/29/2024,Ajantha Amarasekara,Hambantota,Ambalantota,Southern,8969,7912,16881,358760,316480,675240
9/30/2024,Ajantha Amarasekara,Hambantota,Ambalantota,Southern,7634,3694,11328,305360,147760,453120
10/1/2024,Ajantha Amarasekara,Hambantota,Ambalantota,Southern,5159,9397,14556,206360,375880,582240
10/2/2024,Ajantha Amarasekara,Hambantota,Ambalantota,Southern,2035,6443,8478,81400,257720,339120
10/3/2024,Ajantha Amarasekara,Hambantota,Ambalantota,Southern,5499,4008,9507,219960,160320,380280
10/4/2024,Ajantha Amarasekara,Hambantota,Ambalantota,Southern,8350,5027,13377,334000,201080,535080
10/5/2024,Ajantha Amarasekara,Hambantota,Ambalantota,Southern,1239,5550,6789,49560,222000,271560
10/6/2024,Ajantha Amarasekara,Hambantota,Ambalantota,Southern,9394,7087,16481,375760,283480,659240
10/7/2024,Ajantha Amarasekara,Hambantota,Ambalantota,Southern,4028,4723,8751,161120,188920,350040
10/8/2024,Ajantha Amarasekara,Hambantota,Ambalantota,Southern,749,6858,7607,29960,274320,304280
10/9/2024,Ajantha Amarasekara,Hambantota,Ambalantota,Southern,6008,6001,12009,240320,240040,480360
10/10/2024,Ajantha Amarasekara,Hambantota,Ambalantota,Southern,9948,9891,19839,397920,395640,793560
10/11/2024,Ajantha Amarasekara,Hambantota,Ambalantota,Southern,1800,5666,7466,72000,226640,298640
10/12/2024,Ajantha Amarasekara,Hambantota,Ambalantota,Southern,1933,1630,3563,77320,65200,142520
10/13/2024,Ajantha Amarasekara,Hambantota,Ambalantota,Southern,8104,6054,14158,324160,242160,566320
10/14/2024,Ajantha Amarasekara,Hambantota,Ambalantota,Southern,9478,5820,15298,379120,232800,611920
10/15/2024,Ajantha Amarasekara,Hambantota,Ambalantota,Southern,2284,8309,10593,91360,332360,423720
10/16/2024,Ajantha Amarasekara,Hambantota,Ambalantota,Southern,5886,1548,7434,235440,61920,297360
10/17/2024,Ajantha Amarasekara,Hambantota,Ambalantota,Southern,801,9242,10043,32040,369680,401720
10/18/2024,Ajantha Amarasekara,Hambantota,Ambalantota,Southern,5888,614,6502,235520,24560,260080
10/19/2024,Ajantha Amarasekara,Hambantota,Ambalantota,Southern,698,5821,6519,27920,232840,260760
10/20/2024,Ajantha Amarasekara,Hambantota,Ambalantota,Southern,6440,905,7345,257600,36200,293800
10/21/2024,Ajantha Amarasekara,Hambantota,Ambalantota,Southern,475,8301,8776,19000,332040,351040
10/22/2024,Ajantha Amarasekara,Hambantota,Ambalantota,Southern,3799,7087,10886,151960,283480,435440
10/23/2024,Ajantha Amarasekara,Hambantota,Ambalantota,Southern,2407,1656,4063,96280,66240,162520
10/24/2024,Ajantha Amarasekara,Hambantota,Ambalantota,Southern,2135,1263,3398,85400,50520,135920
10/25/2024,Ajantha Amarasekara,Hambantota,Ambalantota,Southern,708,8559,9267,28320,342360,370680
10/26/2024,Ajantha Amarasekara,Hambantota,Ambalantota,Southern,5571,6137,11708,222840,245480,468320
10/27/2024,Ajantha Amarasekara,Hambantota,Ambalantota,Southern,6906,7266,14172,276240,290640,566880
10/28/2024,Ajantha Amarasekara,Hambantota,Ambalantota,Southern,9972,8783,18755,398880,351320,750200
10/29/2024,Ajantha Amarasekara,Hambantota,Ambalantota,Southern,2838,9327,12165,113520,373080,486600
10/30/2024,Ajantha Amarasekara,Hambantota,Ambalantota,Southern,6968,5623,12591,278720,224920,503640
10/31/2024,Ajantha Amarasekara,Hambantota,Ambalantota,Southern,5932,2047,7979,237280,81880,319160
11/1/2024,Ajantha Amarasekara,Hambantota,Ambalantota,Southern,9089,6168,15257,363560,246720,610280
11/2/2024,Ajantha Amarasekara,Hambantota,Ambalantota,Southern,9627,850,10477,385080,34000,419080
11/3/2024,Ajantha Amarasekara,Hambantota,Ambalantota,Southern,5450,1562,7012,218000,62480,280480
11/4/2024,Ajantha Amarasekara,Hambantota,Ambalantota,Southern,5398,9801,15199,215920,392040,607960
11/5/2024,Ajantha Amarasekara,Hambantota,Ambalantota,Southern,1314,7307,8621,52560,292280,344840
11/6/2024,Ajantha Amarasekara,Hambantota,Ambalantota,Southern,2965,1584,4549,118600,63360,181960
11/7/2024,Ajantha Amarasekara,Hambantota,Ambalantota,Southern,7134,1628,8762,285360,65120,350480
11/8/2024,Ajantha Amarasekara,Hambantota,Ambalantota,Southern,4928,8152,13080,197120,326080,523200
11/9/2024,Ajantha Amarasekara,Hambantota,Ambalantota,Southern,1409,7171,8580,56360,286840,343200
11/10/2024,Ajantha Amarasekara,Hambantota,Ambalantota,Southern,3237,9934,13171,129480,397360,526840
11/11/2024,Ajantha Amarasekara,Hambantota,Ambalantota,Southern,519,3579,4098,20760,143160,163920
11/12/2024,Ajantha Amarasekara,Hambantota,Ambalantota,Southern,1555,9115,10670,62200,364600,426800
11/13/2024,Ajantha Amarasekara,Hambantota,Ambalantota,Southern,1518,2181,3699,60720,87240,147960
11/14/2024,Ajantha Amarasekara,Hambantota,Ambalantota,Southern,6850,1404,8254,274000,56160,330160
11/15/2024,Ajantha Amarasekara,Hambantota,Ambalantota,Southern,4469,1760,6229,178760,70400,249160
11/16/2024,Ajantha Amarasekara,Hambantota,Ambalantota,Southern,5156,7999,13155,206240,319960,526200
11/17/2024,Ajantha Amarasekara,Hambantota,Ambalantota,Southern,6073,2121,8194,242920,84840,327760
11/18/2024,Ajantha Amarasekara,Hambantota,Ambalantota,Southern,4391,6751,11142,175640,270040,445680
11/19/2024,Ajantha Amarasekara,Hambantota,Ambalantota,Southern,9949,3541,13490,397960,141640,539600
11/20/2024,Ajantha Amarasekara,Hambantota,Ambalantota,Southern,5403,9608,15011,216120,384320,600440
11/21/2024,Ajantha Amarasekara,Hambantota,Ambalantota,Southern,3976,5322,9298,159040,212880,371920
11/22/2024,Ajantha Amarasekara,Hambantota,Ambalantota,Southern,3687,7088,10775,147480,283520,431000
11/23/2024,Ajantha Amarasekara,Hambantota,Ambalantota,Southern,1869,6484,8353,74760,259360,334120
11/24/2024,Ajantha Amarasekara,Hambantota,Ambalantota,Southern,7333,182,7515,293320,7280,300600
11/25/2024,Ajantha Amarasekara,Hambantota,Ambalantota,Southern,4983,3876,8859,199320,155040,354360
11/26/2024,Ajantha Amarasekara,Hambantota,Ambalantota,Southern,492,1604,2096,19680,64160,83840
11/27/2024,Ajantha Amarasekara,Hambantota,Ambalantota,Southern,1145,282,1427,45800,11280,57080
11/28/2024,Ajantha Amarasekara,Hambantota,Ambalantota,Southern,1359,3892,5251,54360,155680,210040
11/29/2024,Ajantha Amarasekara,Hambantota,Ambalantota,Southern,6650,6245,12895,266000,249800,515800
11/30/2024,Ajantha Amarasekara,Hambantota,Ambalantota,Southern,9233,8247,17480,369320,329880,699200
12/1/2024,Ajantha Amarasekara,Hambantota,Ambalantota,Southern,9791,2083,11874,391640,83320,474960
12/2/2024,Ajantha Amarasekara,Hambantota,Ambalantota,Southern,5316,5869,11185,212640,234760,447400
12/3/2024,Ajantha Amarasekara,Hambantota,Ambalantota,Southern,422,2796,3218,16880,111840,128720
12/4/2024,Ajantha Amarasekara,Hambantota,Ambalantota,Southern,8383,3753,12136,335320,150120,485440
12/5/2024,Ajantha Amarasekara,Hambantota,Ambalantota,Southern,2483,1133,3616,99320,45320,144640
12/6/2024,Ajantha Amarasekara,Hambantota,Ambalantota,Southern,1076,1491,2567,43040,59640,102680
12/7/2024,Ajantha Amarasekara,Hambantota,Ambalantota,Southern,9748,7181,16929,389920,287240,677160
12/8/2024,Ajantha Amarasekara,Hambantota,Ambalantota,Southern,6325,9842,16167,253000,393680,646680
12/9/2024,Ajantha Amarasekara,Hambantota,Ambalantota,Southern,8470,150,8620,338800,6000,344800
12/10/2024,Ajantha Amarasekara,Hambantota,Ambalantota,Southern,4788,2255,7043,191520,90200,281720
12/11/2024,Ajantha Amarasekara,Hambantota,Ambalantota,Southern,2435,1586,4021,97400,63440,160840
12/12/2024,Ajantha Amarasekara,Hambantota,Ambalantota,Southern,8741,9942,18683,349640,397680,747320
12/13/2024,Ajantha Amarasekara,Hambantota,Ambalantota,Southern,2651,7207,9858,106040,288280,394320
12/14/2024,Ajantha Amarasekara,Hambantota,Ambalantota,Southern,5388,8111,13499,215520,324440,539960
12/15/2024,Ajantha Amarasekara,Hambantota,Ambalantota,Southern,7153,5458,12611,286120,218320,504440
12/16/2024,Ajantha Amarasekara,Hambantota,Ambalantota,Southern,7837,1349,9186,313480,53960,367440
12/17/2024,Ajantha Amarasekara,Hambantota,Ambalantota,Southern,4747,2775,7522,189880,111000,300880
12/18/2024,Ajantha Amarasekara,Hambantota,Ambalantota,Southern,2457,2598,5055,98280,103920,202200
12/19/2024,Ajantha Amarasekara,Hambantota,Ambalantota,Southern,3441,5089,8530,137640,203560,341200
12/20/2024,Ajantha Amarasekara,Hambantota,Ambalantota,Southern,2341,4879,7220,93640,195160,288800
12/21/2024,Ajantha Amarasekara,Hambantota,Ambalantota,Southern,3011,2347,5358,120440,93880,214320
12/22/2024,Ajantha Amarasekara,Hambantota,Ambalantota,Southern,2370,3218,5588,94800,128720,223520
12/23/2024,Ajantha Amarasekara,Hambantota,Ambalantota,Southern,1541,4939,6480,61640,197560,259200
12/24/2024,Ajantha Amarasekara,Hambantota,Ambalantota,Southern,9149,2001,11150,365960,80040,446000
12/25/2024,Ajantha Amarasekara,Hambantota,Ambalantota,Southern,6961,634,7595,278440,25360,303800
12/26/2024,Ajantha Amarasekara,Hambantota,Ambalantota,Southern,5423,1396,6819,216920,55840,272760
12/27/2024,Ajantha Amarasekara,Hambantota,Ambalantota,Southern,8978,6244,15222,359120,249760,608880
12/28/2024,Ajantha Amarasekara,Hambantota,Ambalantota,Southern,1057,6333,7390,42280,253320,295600
12/29/2024,Ajantha Amarasekara,Hambantota,Ambalantota,Southern,1564,3609,5173,62560,144360,206920
12/30/2024,Ajantha Amarasekara,Hambantota,Ambalantota,Southern,3506,2520,6026,140240,100800,241040
12/31/2024,Ajantha Amarasekara,Hambantota,Ambalantota,Southern,6399,7284,13683,255960,291360,547320
1/1/2025,Ajantha Amarasekara,Hambantota,Ambalantota,Southern,9621,7889,17510,384840,315560,700400
1/2/2025,Ajantha Amarasekara,Hambantota,Ambalantota,Southern,1372,8897,10269,54880,355880,410760
1/3/2025,Ajantha Amarasekara,Hambantota,Ambalantota,Southern,6931,7315,14246,277240,292600,569840
1/4/2025,Ajantha Amarasekara,Hambantota,Ambalantota,Southern,8260,9731,17991,330400,389240,719640
1/5/2025,Ajantha Amarasekara,Hambantota,Ambalantota,Southern,8978,7237,16215,359120,289480,648600
1/6/2025,Ajantha Amarasekara,Hambantota,Ambalantota,Southern,4025,4250,8275,161000,170000,331000
1/7/2025,Ajantha Amarasekara,Hambantota,Ambalantota,Southern,286,4288,4574,11440,171520,182960
1/8/2025,Ajantha Amarasekara,Hambantota,Ambalantota,Southern,8422,3404,11826,336880,136160,473040
1/9/2025,Ajantha Amarasekara,Hambantota,Ambalantota,Southern,174,1713,1887,6960,68520,75480
1/10/2025,Ajantha Amarasekara,Hambantota,Ambalantota,Southern,6532,3877,10409,261280,155080,416360
1/11/2025,Ajantha Amarasekara,Hambantota,Ambalantota,Southern,6335,5390,11725,253400,215600,469000
1/12/2025,Ajantha Amarasekara,Hambantota,Ambalantota,Southern,5811,5628,11439,232440,225120,457560
1/13/2025,Ajantha Amarasekara,Hambantota,Ambalantota,Southern,5710,2158,7868,228400,86320,314720
1/14/2025,Ajantha Amarasekara,Hambantota,Ambalantota,Southern,9812,9266,19078,392480,370640,763120
1/15/2025,Ajantha Amarasekara,Hambantota,Ambalantota,Southern,1544,3749,5293,61760,149960,211720
1/16/2025,Ajantha Amarasekara,Hambantota,Ambalantota,Southern,7461,7022,14483,298440,280880,579320
1/17/2025,Ajantha Amarasekara,Hambantota,Ambalantota,Southern,822,3576,4398,32880,143040,175920
1/18/2025,Ajantha Amarasekara,Hambantota,Ambalantota,Southern,1394,7102,8496,55760,284080,339840
1/19/2025,Ajantha Amarasekara,Hambantota,Ambalantota,Southern,197,6735,6932,7880,269400,277280
1/20/2025,Ajantha Amarasekara,Hambantota,Ambalantota,Southern,9129,584,9713,365160,23360,388520
1/21/2025,Ajantha Amarasekara,Hambantota,Ambalantota,Southern,1160,9643,10803,46400,385720,432120
1/22/2025,Ajantha Amarasekara,Hambantota,Ambalantota,Southern,9474,6463,15937,378960,258520,637480
1/23/2025,Ajantha Amarasekara,Hambantota,Ambalantota,Southern,4714,1171,5885,188560,46840,235400
1/24/2025,Ajantha Amarasekara,Hambantota,Ambalantota,Southern,650,6018,6668,26000,240720,266720
1/25/2025,Ajantha Amarasekara,Hambantota,Ambalantota,Southern,7169,7294,14463,286760,291760,578520
1/26/2025,Ajantha Amarasekara,Hambantota,Ambalantota,Southern,7521,4780,12301,300840,191200,492040
1/27/2025,Ajantha Amarasekara,Hambantota,Ambalantota,Southern,1545,2666,4211,61800,106640,168440
1/28/2025,Ajantha Amarasekara,Hambantota,Ambalantota,Southern,476,9167,9643,19040,366680,385720
1/29/2025,Ajantha Amarasekara,Hambantota,Ambalantota,Southern,8804,7999,16803,352160,319960,672120
1/30/2025,Ajantha Amarasekara,Hambantota,Ambalantota,Southern,9369,607,9976,374760,24280,399040
1/31/2025,Ajantha Amarasekara,Hambantota,Ambalantota,Southern,7849,6087,13936,313960,243480,557440
2/1/2025,Ajantha Amarasekara,Hambantota,Ambalantota,Southern,936,1321,2257,37440,52840,90280
2/2/2025,Ajantha Amarasekara,Hambantota,Ambalantota,Southern,959,7426,8385,38360,297040,335400
2/3/2025,Ajantha Amarasekara,Hambantota,Ambalantota,Southern,8994,957,9951,359760,38280,398040
2/4/2025,Ajantha Amarasekara,Hambantota,Ambalantota,Southern,8471,6842,15313,338840,273680,612520
2/5/2025,Ajantha Amarasekara,Hambantota,Ambalantota,Southern,3841,369,4210,153640,14760,168400
2/6/2025,Ajantha Amarasekara,Hambantota,Ambalantota,Southern,8377,1639,10016,335080,65560,400640
2/7/2025,Ajantha Amarasekara,Hambantota,Ambalantota,Southern,3028,5784,8812,121120,231360,352480
2/8/2025,Ajantha Amarasekara,Hambantota,Ambalantota,Southern,7424,6074,13498,296960,242960,539920
2/9/2025,Ajantha Amarasekara,Hambantota,Ambalantota,Southern,2173,9761,11934,86920,390440,477360
2/10/2025,Ajantha Amarasekara,Hambantota,Ambalantota,Southern,1313,3050,4363,52520,122000,174520
2/11/2025,Ajantha Amarasekara,Hambantota,Ambalantota,Southern,7156,5834,12990,286240,233360,519600
2/12/2025,Ajantha Amarasekara,Hambantota,Ambalantota,Southern,890,9816,10706,35600,392640,428240
2/13/2025,Ajantha Amarasekara,Hambantota,Ambalantota,Southern,9360,2086,11446,374400,83440,457840
2/14/2025,Ajantha Amarasekara,Hambantota,Ambalantota,Southern,2991,7951,10942,119640,318040,437680
2/15/2025,Ajantha Amarasekara,Hambantota,Ambalantota,Southern,4104,5212,9316,164160,208480,372640
2/16/2025,Ajantha Amarasekara,Hambantota,Ambalantota,Southern,5340,992,6332,213600,39680,253280
2/17/2025,Ajantha Amarasekara,Hambantota,Ambalantota,Southern,885,1191,2076,35400,47640,83040
2/18/2025,Ajantha Amarasekara,Hambantota,Ambalantota,Southern,9791,51,9842,391640,2040,393680
2/19/2025,Ajantha Amarasekara,Hambantota,Ambalantota,Southern,5850,9199,15049,234000,367960,601960
2/20/2025,Ajantha Amarasekara,Hambantota,Ambalantota,Southern,9876,5095,14971,395040,203800,598840
2/21/2025,Ajantha Amarasekara,Hambantota,Ambalantota,Southern,5000,8594,13594,200000,343760,543760
2/22/2025,Ajantha Amarasekara,Hambantota,Ambalantota,Southern,3551,2329,5880,142040,93160,235200
2/23/2025,Ajantha Amarasekara,Hambantota,Ambalantota,Southern,2580,1962,4542,103200,78480,181680
2/24/2025,Ajantha Amarasekara,Hambantota,Ambalantota,Southern,2179,2953,5132,87160,118120,205280
2/25/2025,Ajantha Amarasekara,Hambantota,Ambalantota,Southern,5227,9410,14637,209080,376400,585480
2/26/2025,Ajantha Amarasekara,Hambantota,Ambalantota,Southern,1753,5140,6893,70120,205600,275720
2/27/2025,Ajantha Amarasekara,Hambantota,Ambalantota,Southern,1584,452,2036,63360,18080,81440
2/28/2025,Ajantha Amarasekara,Hambantota,Ambalantota,Southern,725,3005,3730,29000,120200,149200
3/1/2025,Ajantha Amarasekara,Hambantota,Ambalantota,Southern,888,8120,9008,35520,324800,360320
3/2/2025,Ajantha Amarasekara,Hambantota,Ambalantota,Southern,5506,7439,12945,220240,297560,517800
3/3/2025,Ajantha Amarasekara,Hambantota,Ambalantota,Southern,6630,6114,12744,265200,244560,509760
3/4/2025,Ajantha Amarasekara,Hambantota,Ambalantota,Southern,2411,545,2956,96440,21800,118240
3/5/2025,Ajantha Amarasekara,Hambantota,Ambalantota,Southern,3638,6145,9783,145520,245800,391320
3/6/2025,Ajantha Amarasekara,Hambantota,Ambalantota,Southern,785,9379,10164,31400,375160,406560
3/7/2025,Ajantha Amarasekara,Hambantota,Ambalantota,Southern,1601,9428,11029,64040,377120,441160
3/8/2025,Ajantha Amarasekara,Hambantota,Ambalantota,Southern,3445,7981,11426,137800,319240,457040
3/9/2025,Ajantha Amarasekara,Hambantota,Ambalantota,Southern,7679,4215,11894,307160,168600,475760
3/10/2025,Ajantha Amarasekara,Hambantota,Ambalantota,Southern,8724,2577,11301,348960,103080,452040
3/11/2025,Ajantha Amarasekara,Hambantota,Ambalantota,Southern,8698,5716,14414,347920,228640,576560
3/12/2025,Ajantha Amarasekara,Hambantota,Ambalantota,Southern,5345,2013,7358,213800,80520,294320
3/13/2025,Ajantha Amarasekara,Hambantota,Ambalantota,Southern,6423,1743,8166,256920,69720,326640
3/14/2025,Ajantha Amarasekara,Hambantota,Ambalantota,Southern,7177,1070,8247,287080,42800,329880
3/15/2025,Ajantha Amarasekara,Hambantota,Ambalantota,Southern,2194,246,2440,87760,9840,97600
3/16/2025,Ajantha Amarasekara,Hambantota,Ambalantota,Southern,6455,4609,11064,258200,184360,442560
3/17/2025,Ajantha Amarasekara,Hambantota,Ambalantota,Southern,3918,5140,9058,156720,205600,362320
3/18/2025,Ajantha Amarasekara,Hambantota,Ambalantota,Southern,7050,2275,9325,282000,91000,373000
3/19/2025,Ajantha Amarasekara,Hambantota,Ambalantota,Southern,662,1300,1962,26480,52000,78480
3/20/2025,Ajantha Amarasekara,Hambantota,Ambalantota,Southern,8563,2909,11472,342520,116360,458880
3/21/2025,Ajantha Amarasekara,Hambantota,Ambalantota,Southern,8719,2888,11607,348760,115520,464280
3/22/2025,Ajantha Amarasekara,Hambantota,Ambalantota,Southern,5256,316,5572,210240,12640,222880
3/23/2025,Ajantha Amarasekara,Hambantota,Ambalantota,Southern,4672,1802,6474,186880,72080,258960
3/25/2024,Sanjani Kanchana,Ampara,Chenkaladi,Eastern,8395,8799,17194,335800,351960,687760
3/26/2024,Sanjani Kanchana,Ampara,Chenkaladi,Eastern,9097,2703,11800,363880,108120,472000
3/27/2024,Sanjani Kanchana,Ampara,Chenkaladi,Eastern,2834,4976,7810,113360,199040,312400
3/28/2024,Sanjani Kanchana,Ampara,Chenkaladi,Eastern,4748,5726,10474,189920,229040,418960
3/29/2024,Sanjani Kanchana,Ampara,Chenkaladi,Eastern,8790,7422,16212,351600,296880,648480
3/30/2024,Sanjani Kanchana,Ampara,Chenkaladi,Eastern,4568,874,5442,182720,34960,217680
3/31/2024,Sanjani Kanchana,Ampara,Chenkaladi,Eastern,6155,4053,10208,246200,162120,408320
4/1/2024,Sanjani Kanchana,Ampara,Chenkaladi,Eastern,6751,4419,11170,270040,176760,446800
4/2/2024,Sanjani Kanchana,Ampara,Chenkaladi,Eastern,3201,8948,12149,128040,357920,485960
4/3/2024,Sanjani Kanchana,Ampara,Chenkaladi,Eastern,6030,8630,14660,241200,345200,586400
4/4/2024,Sanjani Kanchana,Ampara,Chenkaladi,Eastern,8011,7705,15716,320440,308200,628640
4/5/2024,Sanjani Kanchana,Ampara,Chenkaladi,Eastern,8377,3092,11469,335080,123680,458760
4/6/2024,Sanjani Kanchana,Ampara,Chenkaladi,Eastern,3596,3530,7126,143840,141200,285040
4/7/2024,Sanjani Kanchana,Ampara,Chenkaladi,Eastern,6762,4448,11210,270480,177920,448400
4/8/2024,Sanjani Kanchana,Ampara,Chenkaladi,Eastern,8575,25,8600,343000,1000,344000
4/9/2024,Sanjani Kanchana,Ampara,Chenkaladi,Eastern,422,5726,6148,16880,229040,245920
4/10/2024,Sanjani Kanchana,Ampara,Chenkaladi,Eastern,3179,9059,12238,127160,362360,489520
4/11/2024,Sanjani Kanchana,Ampara,Chenkaladi,Eastern,5292,7939,13231,211680,317560,529240
4/19/2024,Sanjani Kanchana,Ampara,Chenkaladi,Eastern,6805,5512,12317,272200,220480,492680
4/20/2024,Sanjani Kanchana,Ampara,Chenkaladi,Eastern,1517,6554,8071,60680,262160,322840
4/21/2024,Sanjani Kanchana,Ampara,Chenkaladi,Eastern,3932,6664,10596,157280,266560,423840
4/22/2024,Sanjani Kanchana,Ampara,Chenkaladi,Eastern,2595,4422,7017,103800,176880,280680
4/23/2024,Sanjani Kanchana,Ampara,Chenkaladi,Eastern,4611,2968,7579,184440,118720,303160
4/24/2024,Sanjani Kanchana,Ampara,Chenkaladi,Eastern,2018,5682,7700,80720,227280,308000
4/25/2024,Sanjani Kanchana,Ampara,Chenkaladi,Eastern,4588,9761,14349,183520,390440,573960
4/26/2024,Sanjani Kanchana,Ampara,Chenkaladi,Eastern,5748,1512,7260,229920,60480,290400
4/27/2024,Sanjani Kanchana,Ampara,Chenkaladi,Eastern,9072,2652,11724,362880,106080,468960
4/28/2024,Sanjani Kanchana,Ampara,Chenkaladi,Eastern,565,147,712,22600,5880,28480
4/29/2024,Sanjani Kanchana,Ampara,Chenkaladi,Eastern,2167,6900,9067,86680,276000,362680
4/30/2024,Sanjani Kanchana,Ampara,Chenkaladi,Eastern,7009,3236,10245,280360,129440,409800
5/1/2024,Sanjani Kanchana,Ampara,Chenkaladi,Eastern,7645,6723,14368,305800,268920,574720
5/2/2024,Sanjani Kanchana,Ampara,Chenkaladi,Eastern,8670,5478,14148,346800,219120,565920
5/3/2024,Sanjani Kanchana,Ampara,Chenkaladi,Eastern,5141,241,5382,205640,9640,215280
5/4/2024,Sanjani Kanchana,Ampara,Chenkaladi,Eastern,9786,2818,12604,391440,112720,504160
5/5/2024,Sanjani Kanchana,Ampara,Chenkaladi,Eastern,2529,4966,7495,101160,198640,299800
5/6/2024,Sanjani Kanchana,Ampara,Chenkaladi,Eastern,7235,9506,16741,289400,380240,669640
5/7/2024,Sanjani Kanchana,Ampara,Chenkaladi,Eastern,6208,1244,7452,248320,49760,298080
5/8/2024,Sanjani Kanchana,Ampara,Chenkaladi,Eastern,8674,1064,9738,346960,42560,389520
5/9/2024,Sanjani Kanchana,Ampara,Chenkaladi,Eastern,3224,3248,6472,128960,129920,258880
5/10/2024,Sanjani Kanchana,Ampara,Chenkaladi,Eastern,3434,650,4084,137360,26000,163360
5/11/2024,Sanjani Kanchana,Ampara,Chenkaladi,Eastern,9459,7127,16586,378360,285080,663440
5/12/2024,Sanjani Kanchana,Ampara,Chenkaladi,Eastern,9294,4661,13955,371760,186440,558200
5/13/2024,Sanjani Kanchana,Ampara,Chenkaladi,Eastern,7299,2419,9718,291960,96760,388720
5/14/2024,Sanjani Kanchana,Ampara,Chenkaladi,Eastern,7175,5542,12717,287000,221680,508680
5/15/2024,Sanjani Kanchana,Ampara,Chenkaladi,Eastern,9695,4515,14210,387800,180600,568400
5/16/2024,Sanjani Kanchana,Ampara,Chenkaladi,Eastern,4917,7954,12871,196680,318160,514840
5/17/2024,Sanjani Kanchana,Ampara,Chenkaladi,Eastern,1346,7442,8788,53840,297680,351520
5/18/2024,Sanjani Kanchana,Ampara,Chenkaladi,Eastern,8472,3383,11855,338880,135320,474200
5/19/2024,Sanjani Kanchana,Ampara,Chenkaladi,Eastern,5906,1586,7492,236240,63440,299680
5/20/2024,Sanjani Kanchana,Ampara,Chenkaladi,Eastern,6025,2120,8145,241000,84800,325800
5/21/2024,Sanjani Kanchana,Ampara,Chenkaladi,Eastern,2473,9429,11902,98920,377160,476080
5/22/2024,Sanjani Kanchana,Ampara,Chenkaladi,Eastern,9096,7532,16628,363840,301280,665120
5/24/2024,Sanjani Kanchana,Ampara,Chenkaladi,Eastern,4947,906,5853,197880,36240,234120
5/25/2024,Sanjani Kanchana,Ampara,Chenkaladi,Eastern,202,7783,7985,8080,311320,319400
5/26/2024,Sanjani Kanchana,Ampara,Chenkaladi,Eastern,3370,9097,12467,134800,363880,498680
5/27/2024,Sanjani Kanchana,Ampara,Chenkaladi,Eastern,4380,1537,5917,175200,61480,236680
5/28/2024,Sanjani Kanchana,Ampara,Chenkaladi,Eastern,6938,1941,8879,277520,77640,355160
5/29/2024,Sanjani Kanchana,Ampara,Chenkaladi,Eastern,6421,2494,8915,256840,99760,356600
5/30/2024,Sanjani Kanchana,Ampara,Chenkaladi,Eastern,6636,6883,13519,265440,275320,540760
5/31/2024,Sanjani Kanchana,Ampara,Chenkaladi,Eastern,7860,7586,15446,314400,303440,617840
6/1/2024,Sanjani Kanchana,Ampara,Chenkaladi,Eastern,4963,778,5741,198520,31120,229640
6/2/2024,Sanjani Kanchana,Ampara,Chenkaladi,Eastern,5443,7646,13089,217720,305840,523560
6/3/2024,Sanjani Kanchana,Ampara,Chenkaladi,Eastern,6837,249,7086,273480,9960,283440
6/4/2024,Sanjani Kanchana,Ampara,Chenkaladi,Eastern,3250,9370,12620,130000,374800,504800
6/5/2024,Sanjani Kanchana,Ampara,Chenkaladi,Eastern,8745,6013,14758,349800,240520,590320
6/6/2024,Sanjani Kanchana,Ampara,Chenkaladi,Eastern,9035,7647,16682,361400,305880,667280
6/7/2024,Sanjani Kanchana,Ampara,Chenkaladi,Eastern,1924,5498,7422,76960,219920,296880
6/8/2024,Sanjani Kanchana,Ampara,Chenkaladi,Eastern,6978,4450,11428,279120,178000,457120
6/9/2024,Sanjani Kanchana,Ampara,Chenkaladi,Eastern,7301,3319,10620,292040,132760,424800
6/10/2024,Sanjani Kanchana,Ampara,Chenkaladi,Eastern,166,7184,7350,6640,287360,294000
6/11/2024,Sanjani Kanchana,Ampara,Chenkaladi,Eastern,333,2463,2796,13320,98520,111840
6/12/2024,Sanjani Kanchana,Ampara,Chenkaladi,Eastern,9046,1865,10911,361840,74600,436440
6/13/2024,Sanjani Kanchana,Ampara,Chenkaladi,Eastern,6245,8691,14936,249800,347640,597440
6/14/2024,Sanjani Kanchana,Ampara,Chenkaladi,Eastern,3915,333,4248,156600,13320,169920
6/15/2024,Sanjani Kanchana,Ampara,Chenkaladi,Eastern,1093,8862,9955,43720,354480,398200
6/16/2024,Sanjani Kanchana,Ampara,Chenkaladi,Eastern,1742,5738,7480,69680,229520,299200
6/17/2024,Sanjani Kanchana,Ampara,Chenkaladi,Eastern,3172,6035,9207,126880,241400,368280
6/18/2024,Sanjani Kanchana,Ampara,Chenkaladi,Eastern,4871,7718,12589,194840,308720,503560
6/19/2024,Sanjani Kanchana,Ampara,Chenkaladi,Eastern,5792,928,6720,231680,37120,268800
6/20/2024,Sanjani Kanchana,Ampara,Chenkaladi,Eastern,6221,8130,14351,248840,325200,574040
6/21/2024,Sanjani Kanchana,Ampara,Chenkaladi,Eastern,3166,6120,9286,126640,244800,371440
6/22/2024,Sanjani Kanchana,Ampara,Chenkaladi,Eastern,5939,9454,15393,237560,378160,615720
6/23/2024,Sanjani Kanchana,Ampara,Chenkaladi,Eastern,7670,5685,13355,306800,227400,534200
6/24/2024,Sanjani Kanchana,Ampara,Chenkaladi,Eastern,4705,8460,13165,188200,338400,526600
6/25/2024,Sanjani Kanchana,Ampara,Chenkaladi,Eastern,6781,4122,10903,271240,164880,436120
6/26/2024,Sanjani Kanchana,Ampara,Chenkaladi,Eastern,5894,7749,13643,235760,309960,545720
6/27/2024,Sanjani Kanchana,Ampara,Chenkaladi,Eastern,1047,8020,9067,41880,320800,362680
6/28/2024,Sanjani Kanchana,Ampara,Chenkaladi,Eastern,4131,529,4660,165240,21160,186400
6/29/2024,Sanjani Kanchana,Ampara,Chenkaladi,Eastern,5807,5456,11263,232280,218240,450520
6/30/2024,Sanjani Kanchana,Ampara,Chenkaladi,Eastern,5663,1170,6833,226520,46800,273320
7/1/2024,Sanjani Kanchana,Ampara,Chenkaladi,Eastern,8127,4865,12992,325080,194600,519680
7/2/2024,Sanjani Kanchana,Ampara,Chenkaladi,Eastern,392,6313,6705,15680,252520,268200
7/3/2024,Sanjani Kanchana,Ampara,Chenkaladi,Eastern,6719,8106,14825,268760,324240,593000
7/4/2024,Sanjani Kanchana,Ampara,Chenkaladi,Eastern,5267,1772,7039,210680,70880,281560
7/5/2024,Sanjani Kanchana,Ampara,Chenkaladi,Eastern,4536,361,4897,181440,14440,195880
7/6/2024,Sanjani Kanchana,Ampara,Chenkaladi,Eastern,7940,7731,15671,317600,309240,626840
7/7/2024,Sanjani Kanchana,Ampara,Chenkaladi,Eastern,150,7108,7258,6000,284320,290320
7/8/2024,Sanjani Kanchana,Ampara,Chenkaladi,Eastern,872,6428,7300,34880,257120,292000
7/9/2024,Sanjani Kanchana,Ampara,Chenkaladi,Eastern,4970,9095,14065,198800,363800,562600
7/10/2024,Sanjani Kanchana,Ampara,Chenkaladi,Eastern,1119,2163,3282,44760,86520,131280
7/11/2024,Sanjani Kanchana,Ampara,Chenkaladi,Eastern,8124,3210,11334,324960,128400,453360
7/12/2024,Sanjani Kanchana,Ampara,Chenkaladi,Eastern,7429,1315,8744,297160,52600,349760
7/13/2024,Sanjani Kanchana,Ampara,Chenkaladi,Eastern,7907,885,8792,316280,35400,351680
7/14/2024,Sanjani Kanchana,Ampara,Chenkaladi,Eastern,8957,6606,15563,358280,264240,622520
7/15/2024,Sanjani Kanchana,Ampara,Chenkaladi,Eastern,4959,4431,9390,198360,177240,375600
7/16/2024,Sanjani Kanchana,Ampara,Chenkaladi,Eastern,9204,8357,17561,368160,334280,702440
7/17/2024,Sanjani Kanchana,Ampara,Chenkaladi,Eastern,3727,6541,10268,149080,261640,410720
7/18/2024,Sanjani Kanchana,Ampara,Chenkaladi,Eastern,9561,1114,10675,382440,44560,427000
7/19/2024,Sanjani Kanchana,Ampara,Chenkaladi,Eastern,8364,5216,13580,334560,208640,543200
7/20/2024,Sanjani Kanchana,Ampara,Chenkaladi,Eastern,5657,4662,10319,226280,186480,412760
7/21/2024,Sanjani Kanchana,Ampara,Chenkaladi,Eastern,4167,1209,5376,166680,48360,215040
7/22/2024,Sanjani Kanchana,Ampara,Chenkaladi,Eastern,5442,2824,8266,217680,112960,330640
7/23/2024,Sanjani Kanchana,Ampara,Chenkaladi,Eastern,3392,4574,7966,135680,182960,318640
7/24/2024,Sanjani Kanchana,Ampara,Chenkaladi,Eastern,8465,1887,10352,338600,75480,414080
7/25/2024,Sanjani Kanchana,Ampara,Chenkaladi,Eastern,641,1260,1901,25640,50400,76040
7/26/2024,Sanjani Kanchana,Ampara,Chenkaladi,Eastern,8759,7393,16152,350360,295720,646080
7/27/2024,Sanjani Kanchana,Ampara,Chenkaladi,Eastern,8092,6190,14282,323680,247600,571280
7/28/2024,Sanjani Kanchana,Ampara,Chenkaladi,Eastern,6812,8788,15600,272480,351520,624000
7/29/2024,Sanjani Kanchana,Ampara,Chenkaladi,Eastern,8080,8067,16147,323200,322680,645880
7/30/2024,Sanjani Kanchana,Ampara,Chenkaladi,Eastern,5645,9930,15575,225800,397200,623000
7/31/2024,Sanjani Kanchana,Ampara,Chenkaladi,Eastern,1888,3597,5485,75520,143880,219400
8/1/2024,Sanjani Kanchana,Ampara,Chenkaladi,Eastern,972,6196,7168,38880,247840,286720
8/2/2024,Sanjani Kanchana,Ampara,Chenkaladi,Eastern,6495,9777,16272,259800,391080,650880
8/3/2024,Sanjani Kanchana,Ampara,Chenkaladi,Eastern,2545,7575,10120,101800,303000,404800
8/4/2024,Sanjani Kanchana,Ampara,Chenkaladi,Eastern,6709,9585,16294,268360,383400,651760
8/5/2024,Sanjani Kanchana,Ampara,Chenkaladi,Eastern,5180,3756,8936,207200,150240,357440
8/6/2024,Sanjani Kanchana,Ampara,Chenkaladi,Eastern,8148,989,9137,325920,39560,365480
8/7/2024,Sanjani Kanchana,Ampara,Chenkaladi,Eastern,6760,5646,12406,270400,225840,496240
8/8/2024,Sanjani Kanchana,Ampara,Chenkaladi,Eastern,9300,5398,14698,372000,215920,587920
8/9/2024,Sanjani Kanchana,Ampara,Chenkaladi,Eastern,452,6082,6534,18080,243280,261360
8/10/2024,Sanjani Kanchana,Ampara,Chenkaladi,Eastern,7980,6346,14326,319200,253840,573040
8/11/2024,Sanjani Kanchana,Ampara,Chenkaladi,Eastern,7981,2665,10646,319240,106600,425840
8/12/2024,Sanjani Kanchana,Ampara,Chenkaladi,Eastern,2903,4178,7081,116120,167120,283240
8/13/2024,Sanjani Kanchana,Ampara,Chenkaladi,Eastern,8791,9041,17832,351640,361640,713280
8/14/2024,Sanjani Kanchana,Ampara,Chenkaladi,Eastern,205,5797,6002,8200,231880,240080
8/15/2024,Sanjani Kanchana,Ampara,Chenkaladi,Eastern,3116,8940,12056,124640,357600,482240
8/16/2024,Sanjani Kanchana,Ampara,Chenkaladi,Eastern,486,3313,3799,19440,132520,151960
8/17/2024,Sanjani Kanchana,Ampara,Chenkaladi,Eastern,5113,2295,7408,204520,91800,296320
8/18/2024,Sanjani Kanchana,Ampara,Chenkaladi,Eastern,6441,6871,13312,257640,274840,532480
8/19/2024,Sanjani Kanchana,Ampara,Chenkaladi,Eastern,1577,7017,8594,63080,280680,343760
8/20/2024,Sanjani Kanchana,Ampara,Chenkaladi,Eastern,8436,6753,15189,337440,270120,607560
8/21/2024,Sanjani Kanchana,Ampara,Chenkaladi,Eastern,1375,596,1971,55000,23840,78840
8/22/2024,Sanjani Kanchana,Ampara,Chenkaladi,Eastern,3776,9968,13744,151040,398720,549760
8/23/2024,Sanjani Kanchana,Ampara,Chenkaladi,Eastern,7854,9650,17504,314160,386000,700160
8/24/2024,Sanjani Kanchana,Ampara,Chenkaladi,Eastern,5963,7610,13573,238520,304400,542920
8/25/2024,Sanjani Kanchana,Ampara,Chenkaladi,Eastern,7256,1472,8728,290240,58880,349120
8/26/2024,Sanjani Kanchana,Ampara,Chenkaladi,Eastern,4112,1898,6010,164480,75920,240400
8/27/2024,Sanjani Kanchana,Ampara,Chenkaladi,Eastern,6220,7324,13544,248800,292960,541760
8/28/2024,Sanjani Kanchana,Ampara,Chenkaladi,Eastern,8005,5894,13899,320200,235760,555960
8/29/2024,Sanjani Kanchana,Ampara,Chenkaladi,Eastern,8662,7624,16286,346480,304960,651440
8/30/2024,Sanjani Kanchana,Ampara,Chenkaladi,Eastern,5546,3040,8586,221840,121600,343440
8/31/2024,Sanjani Kanchana,Ampara,Chenkaladi,Eastern,3748,2058,5806,149920,82320,232240
9/1/2024,Sanjani Kanchana,Ampara,Chenkaladi,Eastern,4501,8830,13331,180040,353200,533240
9/2/2024,Sanjani Kanchana,Ampara,Chenkaladi,Eastern,167,1296,1463,6680,51840,58520
9/3/2024,Sanjani Kanchana,Ampara,Chenkaladi,Eastern,1127,9972,11099,45080,398880,443960
9/4/2024,Sanjani Kanchana,Ampara,Chenkaladi,Eastern,6607,1489,8096,264280,59560,323840
9/5/2024,Sanjani Kanchana,Ampara,Chenkaladi,Eastern,3008,2097,5105,120320,83880,204200
9/6/2024,Sanjani Kanchana,Ampara,Chenkaladi,Eastern,9276,5645,14921,371040,225800,596840
9/7/2024,Sanjani Kanchana,Ampara,Chenkaladi,Eastern,3999,5271,9270,159960,210840,370800
9/8/2024,Sanjani Kanchana,Ampara,Chenkaladi,Eastern,7356,6981,14337,294240,279240,573480
9/9/2024,Sanjani Kanchana,Ampara,Chenkaladi,Eastern,4194,1171,5365,167760,46840,214600
9/10/2024,Sanjani Kanchana,Ampara,Chenkaladi,Eastern,1397,4641,6038,55880,185640,241520
9/11/2024,Sanjani Kanchana,Ampara,Chenkaladi,Eastern,4474,7727,12201,178960,309080,488040
9/12/2024,Sanjani Kanchana,Ampara,Chenkaladi,Eastern,8452,8487,16939,338080,339480,677560
9/13/2024,Sanjani Kanchana,Ampara,Chenkaladi,Eastern,983,4909,5892,39320,196360,235680
9/14/2024,Sanjani Kanchana,Ampara,Chenkaladi,Eastern,164,1418,1582,6560,56720,63280
9/15/2024,Sanjani Kanchana,Ampara,Chenkaladi,Eastern,2315,4018,6333,92600,160720,253320
9/16/2024,Sanjani Kanchana,Ampara,Chenkaladi,Eastern,4980,330,5310,199200,13200,212400
9/17/2024,Sanjani Kanchana,Ampara,Chenkaladi,Eastern,3622,4809,8431,144880,192360,337240
9/18/2024,Sanjani Kanchana,Ampara,Chenkaladi,Eastern,7982,8050,16032,319280,322000,641280
9/19/2024,Sanjani Kanchana,Ampara,Chenkaladi,Eastern,9764,4055,13819,390560,162200,552760
9/20/2024,Sanjani Kanchana,Ampara,Chenkaladi,Eastern,1965,4439,6404,78600,177560,256160
9/21/2024,Sanjani Kanchana,Ampara,Chenkaladi,Eastern,1214,6899,8113,48560,275960,324520
9/22/2024,Sanjani Kanchana,Ampara,Chenkaladi,Eastern,2117,1623,3740,84680,64920,149600
9/23/2024,Sanjani Kanchana,Ampara,Chenkaladi,Eastern,832,9925,10757,33280,397000,430280
9/24/2024,Sanjani Kanchana,Ampara,Chenkaladi,Eastern,7241,6756,13997,289640,270240,559880
9/25/2024,Sanjani Kanchana,Ampara,Chenkaladi,Eastern,4600,4036,8636,184000,161440,345440
9/26/2024,Sanjani Kanchana,Ampara,Chenkaladi,Eastern,7502,7449,14951,300080,297960,598040
9/27/2024,Sanjani Kanchana,Ampara,Chenkaladi,Eastern,5334,867,6201,213360,34680,248040
9/28/2024,Sanjani Kanchana,Ampara,Chenkaladi,Eastern,7517,1844,9361,300680,73760,374440
9/29/2024,Sanjani Kanchana,Ampara,Chenkaladi,Eastern,7119,4585,11704,284760,183400,468160
9/30/2024,Sanjani Kanchana,Ampara,Chenkaladi,Eastern,5304,4163,9467,212160,166520,378680
10/1/2024,Sanjani Kanchana,Ampara,Chenkaladi,Eastern,6298,1877,8175,251920,75080,327000
10/2/2024,Sanjani Kanchana,Ampara,Chenkaladi,Eastern,3180,5577,8757,127200,223080,350280
10/3/2024,Sanjani Kanchana,Ampara,Chenkaladi,Eastern,167,2253,2420,6680,90120,96800
10/4/2024,Sanjani Kanchana,Ampara,Chenkaladi,Eastern,9910,8165,18075,396400,326600,723000
10/5/2024,Sanjani Kanchana,Ampara,Chenkaladi,Eastern,401,1735,2136,16040,69400,85440
10/6/2024,Sanjani Kanchana,Ampara,Chenkaladi,Eastern,7876,4144,12020,315040,165760,480800
10/7/2024,Sanjani Kanchana,Ampara,Chenkaladi,Eastern,2630,2139,4769,105200,85560,190760
10/8/2024,Sanjani Kanchana,Ampara,Chenkaladi,Eastern,6171,9945,16116,246840,397800,644640
10/9/2024,Sanjani Kanchana,Ampara,Chenkaladi,Eastern,7470,8657,16127,298800,346280,645080
10/10/2024,Sanjani Kanchana,Ampara,Chenkaladi,Eastern,2008,4795,6803,80320,191800,272120
10/11/2024,Sanjani Kanchana,Ampara,Chenkaladi,Eastern,8190,7334,15524,327600,293360,620960
10/12/2024,Sanjani Kanchana,Ampara,Chenkaladi,Eastern,7723,7833,15556,308920,313320,622240
10/13/2024,Sanjani Kanchana,Ampara,Chenkaladi,Eastern,2476,3338,5814,99040,133520,232560
10/14/2024,Sanjani Kanchana,Ampara,Chenkaladi,Eastern,9984,6194,16178,399360,247760,647120
10/15/2024,Sanjani Kanchana,Ampara,Chenkaladi,Eastern,2454,1930,4384,98160,77200,175360
10/16/2024,Sanjani Kanchana,Ampara,Chenkaladi,Eastern,5835,5129,10964,233400,205160,438560
10/17/2024,Sanjani Kanchana,Ampara,Chenkaladi,Eastern,9845,25,9870,393800,1000,394800
10/18/2024,Sanjani Kanchana,Ampara,Chenkaladi,Eastern,6718,9720,16438,268720,388800,657520
10/19/2024,Sanjani Kanchana,Ampara,Chenkaladi,Eastern,2385,1853,4238,95400,74120,169520
10/20/2024,Sanjani Kanchana,Ampara,Chenkaladi,Eastern,7351,9553,16904,294040,382120,676160
10/21/2024,Sanjani Kanchana,Ampara,Chenkaladi,Eastern,8106,4247,12353,324240,169880,494120
10/22/2024,Sanjani Kanchana,Ampara,Chenkaladi,Eastern,3294,2880,6174,131760,115200,246960
10/23/2024,Sanjani Kanchana,Ampara,Chenkaladi,Eastern,9543,2359,11902,381720,94360,476080
10/24/2024,Sanjani Kanchana,Ampara,Chenkaladi,Eastern,2079,6042,8121,83160,241680,324840
10/25/2024,Sanjani Kanchana,Ampara,Chenkaladi,Eastern,414,5119,5533,16560,204760,221320
10/26/2024,Sanjani Kanchana,Ampara,Chenkaladi,Eastern,65,5827,5892,2600,233080,235680
10/27/2024,Sanjani Kanchana,Ampara,Chenkaladi,Eastern,7333,4720,12053,293320,188800,482120
10/28/2024,Sanjani Kanchana,Ampara,Chenkaladi,Eastern,8203,7953,16156,328120,318120,646240
10/29/2024,Sanjani Kanchana,Ampara,Chenkaladi,Eastern,6524,5051,11575,260960,202040,463000
10/30/2024,Sanjani Kanchana,Ampara,Chenkaladi,Eastern,422,8824,9246,16880,352960,369840
10/31/2024,Sanjani Kanchana,Ampara,Chenkaladi,Eastern,9930,6832,16762,397200,273280,670480
11/1/2024,Sanjani Kanchana,Ampara,Chenkaladi,Eastern,8827,9011,17838,353080,360440,713520
11/2/2024,Sanjani Kanchana,Ampara,Chenkaladi,Eastern,5429,2801,8230,217160,112040,329200
11/3/2024,Sanjani Kanchana,Ampara,Chenkaladi,Eastern,4666,1198,5864,186640,47920,234560
11/4/2024,Sanjani Kanchana,Ampara,Chenkaladi,Eastern,3746,3586,7332,149840,143440,293280
11/5/2024,Sanjani Kanchana,Ampara,Chenkaladi,Eastern,9023,4996,14019,360920,199840,560760
11/6/2024,Sanjani Kanchana,Ampara,Chenkaladi,Eastern,7885,559,8444,315400,22360,337760
11/7/2024,Sanjani Kanchana,Ampara,Chenkaladi,Eastern,4915,8734,13649,196600,349360,545960
11/8/2024,Sanjani Kanchana,Ampara,Chenkaladi,Eastern,1800,2393,4193,72000,95720,167720
11/9/2024,Sanjani Kanchana,Ampara,Chenkaladi,Eastern,832,683,1515,33280,27320,60600
11/10/2024,Sanjani Kanchana,Ampara,Chenkaladi,Eastern,3432,9058,12490,137280,362320,499600
11/11/2024,Sanjani Kanchana,Ampara,Chenkaladi,Eastern,6698,7675,14373,267920,307000,574920
11/12/2024,Sanjani Kanchana,Ampara,Chenkaladi,Eastern,3113,6383,9496,124520,255320,379840
11/13/2024,Sanjani Kanchana,Ampara,Chenkaladi,Eastern,1436,8884,10320,57440,355360,412800
11/14/2024,Sanjani Kanchana,Ampara,Chenkaladi,Eastern,4417,9407,13824,176680,376280,552960
11/15/2024,Sanjani Kanchana,Ampara,Chenkaladi,Eastern,6008,6730,12738,240320,269200,509520
11/16/2024,Sanjani Kanchana,Ampara,Chenkaladi,Eastern,9655,2465,12120,386200,98600,484800
11/17/2024,Sanjani Kanchana,Ampara,Chenkaladi,Eastern,6791,9292,16083,271640,371680,643320
11/18/2024,Sanjani Kanchana,Ampara,Chenkaladi,Eastern,7144,2232,9376,285760,89280,375040
11/19/2024,Sanjani Kanchana,Ampara,Chenkaladi,Eastern,8040,566,8606,321600,22640,344240
11/20/2024,Sanjani Kanchana,Ampara,Chenkaladi,Eastern,9690,9113,18803,387600,364520,752120
11/21/2024,Sanjani Kanchana,Ampara,Chenkaladi,Eastern,4218,8778,12996,168720,351120,519840
11/22/2024,Sanjani Kanchana,Ampara,Chenkaladi,Eastern,1924,4124,6048,76960,164960,241920
11/23/2024,Sanjani Kanchana,Ampara,Chenkaladi,Eastern,3528,9660,13188,141120,386400,527520
11/24/2024,Sanjani Kanchana,Ampara,Chenkaladi,Eastern,7980,1355,9335,319200,54200,373400
11/25/2024,Sanjani Kanchana,Ampara,Chenkaladi,Eastern,8575,4965,13540,343000,198600,541600
11/26/2024,Sanjani Kanchana,Ampara,Chenkaladi,Eastern,8127,4716,12843,325080,188640,513720
11/27/2024,Sanjani Kanchana,Ampara,Chenkaladi,Eastern,7745,2359,10104,309800,94360,404160
11/28/2024,Sanjani Kanchana,Ampara,Chenkaladi,Eastern,619,3455,4074,24760,138200,162960
11/29/2024,Sanjani Kanchana,Ampara,Chenkaladi,Eastern,2639,8355,10994,105560,334200,439760
11/30/2024,Sanjani Kanchana,Ampara,Chenkaladi,Eastern,3505,5409,8914,140200,216360,356560
12/1/2024,Sanjani Kanchana,Ampara,Chenkaladi,Eastern,1426,4514,5940,57040,180560,237600
12/2/2024,Sanjani Kanchana,Ampara,Chenkaladi,Eastern,7282,687,7969,291280,27480,318760
12/3/2024,Sanjani Kanchana,Ampara,Chenkaladi,Eastern,6214,5839,12053,248560,233560,482120
12/4/2024,Sanjani Kanchana,Ampara,Chenkaladi,Eastern,6762,7778,14540,270480,311120,581600
12/5/2024,Sanjani Kanchana,Ampara,Chenkaladi,Eastern,5011,4469,9480,200440,178760,379200
12/6/2024,Sanjani Kanchana,Ampara,Chenkaladi,Eastern,5802,6644,12446,232080,265760,497840
12/7/2024,Sanjani Kanchana,Ampara,Chenkaladi,Eastern,3313,4499,7812,132520,179960,312480
12/8/2024,Sanjani Kanchana,Ampara,Chenkaladi,Eastern,5587,7049,12636,223480,281960,505440
12/9/2024,Sanjani Kanchana,Ampara,Chenkaladi,Eastern,7952,2274,10226,318080,90960,409040
12/10/2024,Sanjani Kanchana,Ampara,Chenkaladi,Eastern,6716,5788,12504,268640,231520,500160
12/11/2024,Sanjani Kanchana,Ampara,Chenkaladi,Eastern,9057,2028,11085,362280,81120,443400
12/12/2024,Sanjani Kanchana,Ampara,Chenkaladi,Eastern,5519,3356,8875,220760,134240,355000
12/13/2024,Sanjani Kanchana,Ampara,Chenkaladi,Eastern,3126,9934,13060,125040,397360,522400
12/14/2024,Sanjani Kanchana,Ampara,Chenkaladi,Eastern,1366,2996,4362,54640,119840,174480
12/15/2024,Sanjani Kanchana,Ampara,Chenkaladi,Eastern,2381,9636,12017,95240,385440,480680
12/16/2024,Sanjani Kanchana,Ampara,Chenkaladi,Eastern,7028,1059,8087,281120,42360,323480
12/17/2024,Sanjani Kanchana,Ampara,Chenkaladi,Eastern,8815,456,9271,352600,18240,370840
12/18/2024,Sanjani Kanchana,Ampara,Chenkaladi,Eastern,3303,6370,9673,132120,254800,386920
12/19/2024,Sanjani Kanchana,Ampara,Chenkaladi,Eastern,7140,1762,8902,285600,70480,356080
12/20/2024,Sanjani Kanchana,Ampara,Chenkaladi,Eastern,3581,7116,10697,143240,284640,427880
12/21/2024,Sanjani Kanchana,Ampara,Chenkaladi,Eastern,7308,54,7362,292320,2160,294480
12/22/2024,Sanjani Kanchana,Ampara,Chenkaladi,Eastern,4553,1934,6487,182120,77360,259480
12/23/2024,Sanjani Kanchana,Ampara,Chenkaladi,Eastern,8863,4353,13216,354520,174120,528640
12/24/2024,Sanjani Kanchana,Ampara,Chenkaladi,Eastern,5325,1325,6650,213000,53000,266000
12/25/2024,Sanjani Kanchana,Ampara,Chenkaladi,Eastern,6265,772,7037,250600,30880,281480
12/26/2024,Sanjani Kanchana,Ampara,Chenkaladi,Eastern,9894,9884,19778,395760,395360,791120
12/27/2024,Sanjani Kanchana,Ampara,Chenkaladi,Eastern,9152,4897,14049,366080,195880,561960
12/28/2024,Sanjani Kanchana,Ampara,Chenkaladi,Eastern,532,1496,2028,21280,59840,81120
12/29/2024,Sanjani Kanchana,Ampara,Chenkaladi,Eastern,4869,1417,6286,194760,56680,251440
12/30/2024,Sanjani Kanchana,Ampara,Chenkaladi,Eastern,4778,5402,10180,191120,216080,407200
12/31/2024,Sanjani Kanchana,Ampara,Chenkaladi,Eastern,9545,1807,11352,381800,72280,454080
1/1/2025,Sanjani Kanchana,Ampara,Chenkaladi,Eastern,4119,2097,6216,164760,83880,248640
1/2/2025,Sanjani Kanchana,Ampara,Chenkaladi,Eastern,7125,2018,9143,285000,80720,365720
1/3/2025,Sanjani Kanchana,Ampara,Chenkaladi,Eastern,2867,8446,11313,114680,337840,452520
1/4/2025,Sanjani Kanchana,Ampara,Chenkaladi,Eastern,7835,437,8272,313400,17480,330880
1/5/2025,Sanjani Kanchana,Ampara,Chenkaladi,Eastern,1066,3315,4381,42640,132600,175240
1/6/2025,Sanjani Kanchana,Ampara,Chenkaladi,Eastern,2767,856,3623,110680,34240,144920
1/7/2025,Sanjani Kanchana,Ampara,Chenkaladi,Eastern,4714,961,5675,188560,38440,227000
1/8/2025,Sanjani Kanchana,Ampara,Chenkaladi,Eastern,5730,4700,10430,229200,188000,417200
1/9/2025,Sanjani Kanchana,Ampara,Chenkaladi,Eastern,2833,6690,9523,113320,267600,380920
1/10/2025,Sanjani Kanchana,Ampara,Chenkaladi,Eastern,9885,4968,14853,395400,198720,594120
1/11/2025,Sanjani Kanchana,Ampara,Chenkaladi,Eastern,6905,1480,8385,276200,59200,335400
1/12/2025,Sanjani Kanchana,Ampara,Chenkaladi,Eastern,5807,2361,8168,232280,94440,326720
1/13/2025,Sanjani Kanchana,Ampara,Chenkaladi,Eastern,7937,2071,10008,317480,82840,400320
1/14/2025,Sanjani Kanchana,Ampara,Chenkaladi,Eastern,596,9479,10075,23840,379160,403000
1/15/2025,Sanjani Kanchana,Ampara,Chenkaladi,Eastern,3102,4502,7604,124080,180080,304160
1/16/2025,Sanjani Kanchana,Ampara,Chenkaladi,Eastern,9235,970,10205,369400,38800,408200
1/17/2025,Sanjani Kanchana,Ampara,Chenkaladi,Eastern,7805,4511,12316,312200,180440,492640
1/18/2025,Sanjani Kanchana,Ampara,Chenkaladi,Eastern,5812,5700,11512,232480,228000,460480
1/19/2025,Sanjani Kanchana,Ampara,Chenkaladi,Eastern,7123,1041,8164,284920,41640,326560
1/20/2025,Sanjani Kanchana,Ampara,Chenkaladi,Eastern,3973,5057,9030,158920,202280,361200
1/21/2025,Sanjani Kanchana,Ampara,Chenkaladi,Eastern,6602,4121,10723,264080,164840,428920
1/22/2025,Sanjani Kanchana,Ampara,Chenkaladi,Eastern,4422,3008,7430,176880,120320,297200
1/23/2025,Sanjani Kanchana,Ampara,Chenkaladi,Eastern,1728,9515,11243,69120,380600,449720
1/24/2025,Sanjani Kanchana,Ampara,Chenkaladi,Eastern,6800,1496,8296,272000,59840,331840
1/25/2025,Sanjani Kanchana,Ampara,Chenkaladi,Eastern,708,9147,9855,28320,365880,394200
1/26/2025,Sanjani Kanchana,Ampara,Chenkaladi,Eastern,9112,6249,15361,364480,249960,614440
1/27/2025,Sanjani Kanchana,Ampara,Chenkaladi,Eastern,3536,9353,12889,141440,374120,515560
1/28/2025,Sanjani Kanchana,Ampara,Chenkaladi,Eastern,6803,7210,14013,272120,288400,560520
1/29/2025,Sanjani Kanchana,Ampara,Chenkaladi,Eastern,8958,9717,18675,358320,388680,747000
1/30/2025,Sanjani Kanchana,Ampara,Chenkaladi,Eastern,681,9878,10559,27240,395120,422360
1/31/2025,Sanjani Kanchana,Ampara,Chenkaladi,Eastern,6875,334,7209,275000,13360,288360
2/1/2025,Sanjani Kanchana,Ampara,Chenkaladi,Eastern,822,7507,8329,32880,300280,333160
2/2/2025,Sanjani Kanchana,Ampara,Chenkaladi,Eastern,1620,2102,3722,64800,84080,148880
2/3/2025,Sanjani Kanchana,Ampara,Chenkaladi,Eastern,5968,619,6587,238720,24760,263480
2/4/2025,Sanjani Kanchana,Ampara,Chenkaladi,Eastern,3263,9068,12331,130520,362720,493240
2/5/2025,Sanjani Kanchana,Ampara,Chenkaladi,Eastern,2295,4111,6406,91800,164440,256240
2/6/2025,Sanjani Kanchana,Ampara,Chenkaladi,Eastern,3244,7247,10491,129760,289880,419640
2/7/2025,Sanjani Kanchana,Ampara,Chenkaladi,Eastern,1444,488,1932,57760,19520,77280
2/8/2025,Sanjani Kanchana,Ampara,Chenkaladi,Eastern,2913,9013,11926,116520,360520,477040
2/9/2025,Sanjani Kanchana,Ampara,Chenkaladi,Eastern,66,604,670,2640,24160,26800
2/10/2025,Sanjani Kanchana,Ampara,Chenkaladi,Eastern,3483,2763,6246,139320,110520,249840
2/11/2025,Sanjani Kanchana,Ampara,Chenkaladi,Eastern,869,4866,5735,34760,194640,229400
2/12/2025,Sanjani Kanchana,Ampara,Chenkaladi,Eastern,7988,8674,16662,319520,346960,666480
2/13/2025,Sanjani Kanchana,Ampara,Chenkaladi,Eastern,7668,7317,14985,306720,292680,599400
2/14/2025,Sanjani Kanchana,Ampara,Chenkaladi,Eastern,1199,8861,10060,47960,354440,402400
2/15/2025,Sanjani Kanchana,Ampara,Chenkaladi,Eastern,6485,2721,9206,259400,108840,368240
2/16/2025,Sanjani Kanchana,Ampara,Chenkaladi,Eastern,9206,2993,12199,368240,119720,487960
2/17/2025,Sanjani Kanchana,Ampara,Chenkaladi,Eastern,1955,1048,3003,78200,41920,120120
2/18/2025,Sanjani Kanchana,Ampara,Chenkaladi,Eastern,1560,6203,7763,62400,248120,310520
2/19/2025,Sanjani Kanchana,Ampara,Chenkaladi,Eastern,8711,1857,10568,348440,74280,422720
2/20/2025,Sanjani Kanchana,Ampara,Chenkaladi,Eastern,5690,7621,13311,227600,304840,532440
2/21/2025,Sanjani Kanchana,Ampara,Chenkaladi,Eastern,5063,386,5449,202520,15440,217960
2/22/2025,Sanjani Kanchana,Ampara,Chenkaladi,Eastern,8726,2324,11050,349040,92960,442000
2/23/2025,Sanjani Kanchana,Ampara,Chenkaladi,Eastern,5791,6227,12018,231640,249080,480720
2/24/2025,Sanjani Kanchana,Ampara,Chenkaladi,Eastern,504,6519,7023,20160,260760,280920
2/25/2025,Sanjani Kanchana,Ampara,Chenkaladi,Eastern,962,3097,4059,38480,123880,162360
2/26/2025,Sanjani Kanchana,Ampara,Chenkaladi,Eastern,155,3853,4008,6200,154120,160320
2/27/2025,Sanjani Kanchana,Ampara,Chenkaladi,Eastern,8249,5564,13813,329960,222560,552520
2/28/2025,Sanjani Kanchana,Ampara,Chenkaladi,Eastern,9693,6368,16061,387720,254720,642440
3/1/2025,Sanjani Kanchana,Ampara,Chenkaladi,Eastern,2180,4728,6908,87200,189120,276320
3/2/2025,Sanjani Kanchana,Ampara,Chenkaladi,Eastern,3508,9211,12719,140320,368440,508760
3/3/2025,Sanjani Kanchana,Ampara,Chenkaladi,Eastern,4540,6642,11182,181600,265680,447280
3/4/2025,Sanjani Kanchana,Ampara,Chenkaladi,Eastern,6838,1986,8824,273520,79440,352960
3/5/2025,Sanjani Kanchana,Ampara,Chenkaladi,Eastern,917,3499,4416,36680,139960,176640
3/6/2025,Sanjani Kanchana,Ampara,Chenkaladi,Eastern,7428,9049,16477,297120,361960,659080
3/7/2025,Sanjani Kanchana,Ampara,Chenkaladi,Eastern,4377,6061,10438,175080,242440,417520
3/8/2025,Sanjani Kanchana,Ampara,Chenkaladi,Eastern,8403,6313,14716,336120,252520,588640
3/9/2025,Sanjani Kanchana,Ampara,Chenkaladi,Eastern,8294,2399,10693,331760,95960,427720
3/10/2025,Sanjani Kanchana,Ampara,Chenkaladi,Eastern,6862,4975,11837,274480,199000,473480
3/11/2025,Sanjani Kanchana,Ampara,Chenkaladi,Eastern,5241,467,5708,209640,18680,228320
3/12/2025,Sanjani Kanchana,Ampara,Chenkaladi,Eastern,6824,1313,8137,272960,52520,325480
3/13/2025,Sanjani Kanchana,Ampara,Chenkaladi,Eastern,294,7474,7768,11760,298960,310720
3/14/2025,Sanjani Kanchana,Ampara,Chenkaladi,Eastern,3650,1929,5579,146000,77160,223160
3/15/2025,Sanjani Kanchana,Ampara,Chenkaladi,Eastern,1952,5439,7391,78080,217560,295640
3/16/2025,Sanjani Kanchana,Ampara,Chenkaladi,Eastern,7904,4266,12170,316160,170640,486800
3/17/2025,Sanjani Kanchana,Ampara,Chenkaladi,Eastern,2858,9795,12653,114320,391800,506120
3/18/2025,Sanjani Kanchana,Ampara,Chenkaladi,Eastern,755,3325,4080,30200,133000,163200
3/19/2025,Sanjani Kanchana,Ampara,Chenkaladi,Eastern,2868,2151,5019,114720,86040,200760
3/20/2025,Sanjani Kanchana,Ampara,Chenkaladi,Eastern,2557,1614,4171,102280,64560,166840
3/21/2025,Sanjani Kanchana,Ampara,Chenkaladi,Eastern,8280,5431,13711,331200,217240,548440
3/22/2025,Sanjani Kanchana,Ampara,Chenkaladi,Eastern,7966,5846,13812,318640,233840,552480
3/23/2025,Sanjani Kanchana,Ampara,Chenkaladi,Eastern,6339,2588,8927,253560,103520,357080
3/25/2024,Dinesh Kularatne,Kandy,Peradeniya,Central,521,4362,4883,20840,174480,195320
3/26/2024,Dinesh Kularatne,Kandy,Peradeniya,Central,7564,6608,14172,302560,264320,566880
3/27/2024,Dinesh Kularatne,Kandy,Peradeniya,Central,3207,1633,4840,128280,65320,193600
3/28/2024,Dinesh Kularatne,Kandy,Peradeniya,Central,2503,7227,9730,100120,289080,389200
3/29/2024,Dinesh Kularatne,Kandy,Peradeniya,Central,6101,9717,15818,244040,388680,632720
3/30/2024,Dinesh Kularatne,Kandy,Peradeniya,Central,8553,4723,13276,342120,188920,531040
3/31/2024,Dinesh Kularatne,Kandy,Peradeniya,Central,1863,2494,4357,74520,99760,174280
4/1/2024,Dinesh Kularatne,Kandy,Peradeniya,Central,7171,9391,16562,286840,375640,662480
4/2/2024,Dinesh Kularatne,Kandy,Peradeniya,Central,9761,5629,15390,390440,225160,615600
4/3/2024,Dinesh Kularatne,Kandy,Peradeniya,Central,226,641,867,9040,25640,34680
4/4/2024,Dinesh Kularatne,Kandy,Peradeniya,Central,1545,9120,10665,61800,364800,426600
4/5/2024,Dinesh Kularatne,Kandy,Peradeniya,Central,8989,1652,10641,359560,66080,425640
4/6/2024,Dinesh Kularatne,Kandy,Peradeniya,Central,5547,8068,13615,221880,322720,544600
4/7/2024,Dinesh Kularatne,Kandy,Peradeniya,Central,1242,2404,3646,49680,96160,145840
4/8/2024,Dinesh Kularatne,Kandy,Peradeniya,Central,9286,4876,14162,371440,195040,566480
4/9/2024,Dinesh Kularatne,Kandy,Peradeniya,Central,1838,9310,11148,73520,372400,445920
4/10/2024,Dinesh Kularatne,Kandy,Peradeniya,Central,8051,8756,16807,322040,350240,672280
4/11/2024,Dinesh Kularatne,Kandy,Peradeniya,Central,1583,3779,5362,63320,151160,214480
4/19/2024,Dinesh Kularatne,Kandy,Peradeniya,Central,1203,4058,5261,48120,162320,210440
4/20/2024,Dinesh Kularatne,Kandy,Peradeniya,Central,7360,5478,12838,294400,219120,513520
4/21/2024,Dinesh Kularatne,Kandy,Peradeniya,Central,9300,5676,14976,372000,227040,599040
4/22/2024,Dinesh Kularatne,Kandy,Peradeniya,Central,6070,1952,8022,242800,78080,320880
4/23/2024,Dinesh Kularatne,Kandy,Peradeniya,Central,911,6299,7210,36440,251960,288400
4/24/2024,Dinesh Kularatne,Kandy,Peradeniya,Central,3569,2993,6562,142760,119720,262480
4/25/2024,Dinesh Kularatne,Kandy,Peradeniya,Central,6209,7191,13400,248360,287640,536000
4/26/2024,Dinesh Kularatne,Kandy,Peradeniya,Central,4089,5556,9645,163560,222240,385800
4/27/2024,Dinesh Kularatne,Kandy,Peradeniya,Central,8933,5562,14495,357320,222480,579800
4/28/2024,Dinesh Kularatne,Kandy,Peradeniya,Central,7392,929,8321,295680,37160,332840
4/29/2024,Dinesh Kularatne,Kandy,Peradeniya,Central,6104,2593,8697,244160,103720,347880
4/30/2024,Dinesh Kularatne,Kandy,Peradeniya,Central,9423,7379,16802,376920,295160,672080
5/1/2024,Dinesh Kularatne,Kandy,Peradeniya,Central,2752,790,3542,110080,31600,141680
5/2/2024,Dinesh Kularatne,Kandy,Peradeniya,Central,8666,937,9603,346640,37480,384120
5/3/2024,Dinesh Kularatne,Kandy,Peradeniya,Central,9775,9375,19150,391000,375000,766000
5/4/2024,Dinesh Kularatne,Kandy,Peradeniya,Central,2524,7932,10456,100960,317280,418240
5/5/2024,Dinesh Kularatne,Kandy,Peradeniya,Central,269,9765,10034,10760,390600,401360
5/6/2024,Dinesh Kularatne,Kandy,Peradeniya,Central,5788,7523,13311,231520,300920,532440
5/7/2024,Dinesh Kularatne,Kandy,Peradeniya,Central,5785,3417,9202,231400,136680,368080
5/8/2024,Dinesh Kularatne,Kandy,Peradeniya,Central,4885,8243,13128,195400,329720,525120
5/9/2024,Dinesh Kularatne,Kandy,Peradeniya,Central,9608,5512,15120,384320,220480,604800
5/10/2024,Dinesh Kularatne,Kandy,Peradeniya,Central,1084,5166,6250,43360,206640,250000
5/11/2024,Dinesh Kularatne,Kandy,Peradeniya,Central,2994,945,3939,119760,37800,157560
5/12/2024,Dinesh Kularatne,Kandy,Peradeniya,Central,8142,6871,15013,325680,274840,600520
5/13/2024,Dinesh Kularatne,Kandy,Peradeniya,Central,1166,8066,9232,46640,322640,369280
5/14/2024,Dinesh Kularatne,Kandy,Peradeniya,Central,2049,4565,6614,81960,182600,264560
5/15/2024,Dinesh Kularatne,Kandy,Peradeniya,Central,365,3546,3911,14600,141840,156440
5/16/2024,Dinesh Kularatne,Kandy,Peradeniya,Central,1036,3066,4102,41440,122640,164080
5/17/2024,Dinesh Kularatne,Kandy,Peradeniya,Central,7556,2204,9760,302240,88160,390400
5/18/2024,Dinesh Kularatne,Kandy,Peradeniya,Central,5308,7139,12447,212320,285560,497880
5/19/2024,Dinesh Kularatne,Kandy,Peradeniya,Central,9949,7949,17898,397960,317960,715920
5/20/2024,Dinesh Kularatne,Kandy,Peradeniya,Central,6155,2190,8345,246200,87600,333800
5/21/2024,Dinesh Kularatne,Kandy,Peradeniya,Central,7602,9560,17162,304080,382400,686480
5/22/2024,Dinesh Kularatne,Kandy,Peradeniya,Central,7275,5604,12879,291000,224160,515160
5/24/2024,Dinesh Kularatne,Kandy,Peradeniya,Central,2205,7217,9422,88200,288680,376880
5/25/2024,Dinesh Kularatne,Kandy,Peradeniya,Central,5968,7843,13811,238720,313720,552440
5/26/2024,Dinesh Kularatne,Kandy,Peradeniya,Central,2961,192,3153,118440,7680,126120
5/27/2024,Dinesh Kularatne,Kandy,Peradeniya,Central,387,7973,8360,15480,318920,334400
5/28/2024,Dinesh Kularatne,Kandy,Peradeniya,Central,6497,1700,8197,259880,68000,327880
5/29/2024,Dinesh Kularatne,Kandy,Peradeniya,Central,1305,4326,5631,52200,173040,225240
5/30/2024,Dinesh Kularatne,Kandy,Peradeniya,Central,243,8059,8302,9720,322360,332080
5/31/2024,Dinesh Kularatne,Kandy,Peradeniya,Central,8715,7619,16334,348600,304760,653360
6/1/2024,Dinesh Kularatne,Kandy,Peradeniya,Central,1529,9408,10937,61160,376320,437480
6/2/2024,Dinesh Kularatne,Kandy,Peradeniya,Central,8168,1239,9407,326720,49560,376280
6/3/2024,Dinesh Kularatne,Kandy,Peradeniya,Central,9143,6182,15325,365720,247280,613000
6/4/2024,Dinesh Kularatne,Kandy,Peradeniya,Central,9457,7436,16893,378280,297440,675720
6/5/2024,Dinesh Kularatne,Kandy,Peradeniya,Central,866,2999,3865,34640,119960,154600
6/6/2024,Dinesh Kularatne,Kandy,Peradeniya,Central,8262,9545,17807,330480,381800,712280
6/7/2024,Dinesh Kularatne,Kandy,Peradeniya,Central,1418,9552,10970,56720,382080,438800
6/8/2024,Dinesh Kularatne,Kandy,Peradeniya,Central,1407,8784,10191,56280,351360,407640
6/9/2024,Dinesh Kularatne,Kandy,Peradeniya,Central,8279,1864,10143,331160,74560,405720
6/10/2024,Dinesh Kularatne,Kandy,Peradeniya,Central,1561,5200,6761,62440,208000,270440
6/11/2024,Dinesh Kularatne,Kandy,Peradeniya,Central,6927,4489,11416,277080,179560,456640
6/12/2024,Dinesh Kularatne,Kandy,Peradeniya,Central,1839,2445,4284,73560,97800,171360
6/13/2024,Dinesh Kularatne,Kandy,Peradeniya,Central,4720,9124,13844,188800,364960,553760
6/14/2024,Dinesh Kularatne,Kandy,Peradeniya,Central,3018,7573,10591,120720,302920,423640
6/15/2024,Dinesh Kularatne,Kandy,Peradeniya,Central,7984,985,8969,319360,39400,358760
6/16/2024,Dinesh Kularatne,Kandy,Peradeniya,Central,362,630,992,14480,25200,39680
6/17/2024,Dinesh Kularatne,Kandy,Peradeniya,Central,6004,9617,15621,240160,384680,624840
6/18/2024,Dinesh Kularatne,Kandy,Peradeniya,Central,8979,7122,16101,359160,284880,644040
6/19/2024,Dinesh Kularatne,Kandy,Peradeniya,Central,4033,3222,7255,161320,128880,290200
6/20/2024,Dinesh Kularatne,Kandy,Peradeniya,Central,3215,3565,6780,128600,142600,271200
6/21/2024,Dinesh Kularatne,Kandy,Peradeniya,Central,5782,4673,10455,231280,186920,418200
6/22/2024,Dinesh Kularatne,Kandy,Peradeniya,Central,234,7454,7688,9360,298160,307520
6/23/2024,Dinesh Kularatne,Kandy,Peradeniya,Central,9275,190,9465,371000,7600,378600
6/24/2024,Dinesh Kularatne,Kandy,Peradeniya,Central,6646,3502,10148,265840,140080,405920
6/25/2024,Dinesh Kularatne,Kandy,Peradeniya,Central,7296,6424,13720,291840,256960,548800
6/26/2024,Dinesh Kularatne,Kandy,Peradeniya,Central,1655,3719,5374,66200,148760,214960
6/27/2024,Dinesh Kularatne,Kandy,Peradeniya,Central,2123,842,2965,84920,33680,118600
6/28/2024,Dinesh Kularatne,Kandy,Peradeniya,Central,4140,1419,5559,165600,56760,222360
6/29/2024,Dinesh Kularatne,Kandy,Peradeniya,Central,9177,184,9361,367080,7360,374440
6/30/2024,Dinesh Kularatne,Kandy,Peradeniya,Central,5128,5024,10152,205120,200960,406080
7/1/2024,Dinesh Kularatne,Kandy,Peradeniya,Central,8282,8728,17010,331280,349120,680400
7/2/2024,Dinesh Kularatne,Kandy,Peradeniya,Central,5616,5009,10625,224640,200360,425000
7/3/2024,Dinesh Kularatne,Kandy,Peradeniya,Central,8251,4189,12440,330040,167560,497600
7/4/2024,Dinesh Kularatne,Kandy,Peradeniya,Central,8434,8022,16456,337360,320880,658240
7/5/2024,Dinesh Kularatne,Kandy,Peradeniya,Central,8536,4994,13530,341440,199760,541200
7/6/2024,Dinesh Kularatne,Kandy,Peradeniya,Central,7320,4595,11915,292800,183800,476600
7/7/2024,Dinesh Kularatne,Kandy,Peradeniya,Central,4882,1229,6111,195280,49160,244440
7/8/2024,Dinesh Kularatne,Kandy,Peradeniya,Central,8472,24,8496,338880,960,339840
7/9/2024,Dinesh Kularatne,Kandy,Peradeniya,Central,67,9708,9775,2680,388320,391000
7/10/2024,Dinesh Kularatne,Kandy,Peradeniya,Central,3266,9588,12854,130640,383520,514160
7/11/2024,Dinesh Kularatne,Kandy,Peradeniya,Central,1977,930,2907,79080,37200,116280
7/12/2024,Dinesh Kularatne,Kandy,Peradeniya,Central,3760,8628,12388,150400,345120,495520
7/13/2024,Dinesh Kularatne,Kandy,Peradeniya,Central,6599,7197,13796,263960,287880,551840
7/14/2024,Dinesh Kularatne,Kandy,Peradeniya,Central,8519,8405,16924,340760,336200,676960
7/15/2024,Dinesh Kularatne,Kandy,Peradeniya,Central,2430,9152,11582,97200,366080,463280
7/16/2024,Dinesh Kularatne,Kandy,Peradeniya,Central,2621,8113,10734,104840,324520,429360
7/17/2024,Dinesh Kularatne,Kandy,Peradeniya,Central,7009,9097,16106,280360,363880,644240
7/18/2024,Dinesh Kularatne,Kandy,Peradeniya,Central,6362,7336,13698,254480,293440,547920
7/19/2024,Dinesh Kularatne,Kandy,Peradeniya,Central,994,2396,3390,39760,95840,135600
7/20/2024,Dinesh Kularatne,Kandy,Peradeniya,Central,2474,4322,6796,98960,172880,271840
7/21/2024,Dinesh Kularatne,Kandy,Peradeniya,Central,3089,2311,5400,123560,92440,216000
7/22/2024,Dinesh Kularatne,Kandy,Peradeniya,Central,6321,1784,8105,252840,71360,324200
7/23/2024,Dinesh Kularatne,Kandy,Peradeniya,Central,4935,2713,7648,197400,108520,305920
7/24/2024,Dinesh Kularatne,Kandy,Peradeniya,Central,400,4922,5322,16000,196880,212880
7/25/2024,Dinesh Kularatne,Kandy,Peradeniya,Central,2078,6971,9049,83120,278840,361960
7/26/2024,Dinesh Kularatne,Kandy,Peradeniya,Central,845,6365,7210,33800,254600,288400
7/27/2024,Dinesh Kularatne,Kandy,Peradeniya,Central,9618,8380,17998,384720,335200,719920
7/28/2024,Dinesh Kularatne,Kandy,Peradeniya,Central,4932,6019,10951,197280,240760,438040
7/29/2024,Dinesh Kularatne,Kandy,Peradeniya,Central,957,2343,3300,38280,93720,132000
7/30/2024,Dinesh Kularatne,Kandy,Peradeniya,Central,6332,677,7009,253280,27080,280360
7/31/2024,Dinesh Kularatne,Kandy,Peradeniya,Central,4947,4769,9716,197880,190760,388640
8/1/2024,Dinesh Kularatne,Kandy,Peradeniya,Central,6860,983,7843,274400,39320,313720
8/2/2024,Dinesh Kularatne,Kandy,Peradeniya,Central,4531,7567,12098,181240,302680,483920
8/3/2024,Dinesh Kularatne,Kandy,Peradeniya,Central,7645,7530,15175,305800,301200,607000
8/4/2024,Dinesh Kularatne,Kandy,Peradeniya,Central,8854,9238,18092,354160,369520,723680
8/5/2024,Dinesh Kularatne,Kandy,Peradeniya,Central,6297,5372,11669,251880,214880,466760
8/6/2024,Dinesh Kularatne,Kandy,Peradeniya,Central,8855,1349,10204,354200,53960,408160
8/7/2024,Dinesh Kularatne,Kandy,Peradeniya,Central,5891,4624,10515,235640,184960,420600
8/8/2024,Dinesh Kularatne,Kandy,Peradeniya,Central,2747,157,2904,109880,6280,116160
8/9/2024,Dinesh Kularatne,Kandy,Peradeniya,Central,9609,9849,19458,384360,393960,778320
8/10/2024,Dinesh Kularatne,Kandy,Peradeniya,Central,5647,551,6198,225880,22040,247920
8/11/2024,Dinesh Kularatne,Kandy,Peradeniya,Central,6249,5164,11413,249960,206560,456520
8/12/2024,Dinesh Kularatne,Kandy,Peradeniya,Central,7147,6435,13582,285880,257400,543280
8/13/2024,Dinesh Kularatne,Kandy,Peradeniya,Central,369,9630,9999,14760,385200,399960
8/14/2024,Dinesh Kularatne,Kandy,Peradeniya,Central,5422,6991,12413,216880,279640,496520
8/15/2024,Dinesh Kularatne,Kandy,Peradeniya,Central,228,4194,4422,9120,167760,176880
8/16/2024,Dinesh Kularatne,Kandy,Peradeniya,Central,4508,2264,6772,180320,90560,270880
8/17/2024,Dinesh Kularatne,Kandy,Peradeniya,Central,6584,9452,16036,263360,378080,641440
8/18/2024,Dinesh Kularatne,Kandy,Peradeniya,Central,5138,4070,9208,205520,162800,368320
8/19/2024,Dinesh Kularatne,Kandy,Peradeniya,Central,8008,6406,14414,320320,256240,576560
8/20/2024,Dinesh Kularatne,Kandy,Peradeniya,Central,228,9632,9860,9120,385280,394400
8/21/2024,Dinesh Kularatne,Kandy,Peradeniya,Central,6366,1070,7436,254640,42800,297440
8/22/2024,Dinesh Kularatne,Kandy,Peradeniya,Central,6836,3269,10105,273440,130760,404200
8/23/2024,Dinesh Kularatne,Kandy,Peradeniya,Central,8042,6780,14822,321680,271200,592880
8/24/2024,Dinesh Kularatne,Kandy,Peradeniya,Central,9194,5881,15075,367760,235240,603000
8/25/2024,Dinesh Kularatne,Kandy,Peradeniya,Central,4354,2957,7311,174160,118280,292440
8/26/2024,Dinesh Kularatne,Kandy,Peradeniya,Central,9327,1328,10655,373080,53120,426200
8/27/2024,Dinesh Kularatne,Kandy,Peradeniya,Central,571,2122,2693,22840,84880,107720
8/28/2024,Dinesh Kularatne,Kandy,Peradeniya,Central,3657,5948,9605,146280,237920,384200
8/29/2024,Dinesh Kularatne,Kandy,Peradeniya,Central,3923,354,4277,156920,14160,171080
8/30/2024,Dinesh Kularatne,Kandy,Peradeniya,Central,3406,2823,6229,136240,112920,249160
8/31/2024,Dinesh Kularatne,Kandy,Peradeniya,Central,1719,439,2158,68760,17560,86320
9/1/2024,Dinesh Kularatne,Kandy,Peradeniya,Central,3459,7257,10716,138360,290280,428640
9/2/2024,Dinesh Kularatne,Kandy,Peradeniya,Central,1572,951,2523,62880,38040,100920
9/3/2024,Dinesh Kularatne,Kandy,Peradeniya,Central,8496,8490,16986,339840,339600,679440
9/4/2024,Dinesh Kularatne,Kandy,Peradeniya,Central,3199,7467,10666,127960,298680,426640
9/5/2024,Dinesh Kularatne,Kandy,Peradeniya,Central,757,9292,10049,30280,371680,401960
9/6/2024,Dinesh Kularatne,Kandy,Peradeniya,Central,1940,4269,6209,77600,170760,248360
9/7/2024,Dinesh Kularatne,Kandy,Peradeniya,Central,6914,2509,9423,276560,100360,376920
9/8/2024,Dinesh Kularatne,Kandy,Peradeniya,Central,2668,8032,10700,106720,321280,428000
9/9/2024,Dinesh Kularatne,Kandy,Peradeniya,Central,7596,8071,15667,303840,322840,626680
9/10/2024,Dinesh Kularatne,Kandy,Peradeniya,Central,9370,4104,13474,374800,164160,538960
9/11/2024,Dinesh Kularatne,Kandy,Peradeniya,Central,7924,2646,10570,316960,105840,422800
9/12/2024,Dinesh Kularatne,Kandy,Peradeniya,Central,9972,1363,11335,398880,54520,453400
9/13/2024,Dinesh Kularatne,Kandy,Peradeniya,Central,3881,9286,13167,155240,371440,526680
9/14/2024,Dinesh Kularatne,Kandy,Peradeniya,Central,4321,1155,5476,172840,46200,219040
9/15/2024,Dinesh Kularatne,Kandy,Peradeniya,Central,3225,6597,9822,129000,263880,392880
9/16/2024,Dinesh Kularatne,Kandy,Peradeniya,Central,6727,1279,8006,269080,51160,320240
9/17/2024,Dinesh Kularatne,Kandy,Peradeniya,Central,7045,8812,15857,281800,352480,634280
9/18/2024,Dinesh Kularatne,Kandy,Peradeniya,Central,6926,802,7728,277040,32080,309120
9/19/2024,Dinesh Kularatne,Kandy,Peradeniya,Central,8881,5346,14227,355240,213840,569080
9/20/2024,Dinesh Kularatne,Kandy,Peradeniya,Central,804,9730,10534,32160,389200,421360
9/21/2024,Dinesh Kularatne,Kandy,Peradeniya,Central,9571,1624,11195,382840,64960,447800
9/22/2024,Dinesh Kularatne,Kandy,Peradeniya,Central,8427,7668,16095,337080,306720,643800
9/23/2024,Dinesh Kularatne,Kandy,Peradeniya,Central,694,4229,4923,27760,169160,196920
9/24/2024,Dinesh Kularatne,Kandy,Peradeniya,Central,9271,2715,11986,370840,108600,479440
9/25/2024,Dinesh Kularatne,Kandy,Peradeniya,Central,3587,7469,11056,143480,298760,442240
9/26/2024,Dinesh Kularatne,Kandy,Peradeniya,Central,1646,1288,2934,65840,51520,117360
9/27/2024,Dinesh Kularatne,Kandy,Peradeniya,Central,381,3852,4233,15240,154080,169320
9/28/2024,Dinesh Kularatne,Kandy,Peradeniya,Central,755,126,881,30200,5040,35240
9/29/2024,Dinesh Kularatne,Kandy,Peradeniya,Central,513,1354,1867,20520,54160,74680
9/30/2024,Dinesh Kularatne,Kandy,Peradeniya,Central,3241,7763,11004,129640,310520,440160
10/1/2024,Dinesh Kularatne,Kandy,Peradeniya,Central,5413,2271,7684,216520,90840,307360
10/2/2024,Dinesh Kularatne,Kandy,Peradeniya,Central,1677,2049,3726,67080,81960,149040
10/3/2024,Dinesh Kularatne,Kandy,Peradeniya,Central,7770,4234,12004,310800,169360,480160
10/4/2024,Dinesh Kularatne,Kandy,Peradeniya,Central,1067,9250,10317,42680,370000,412680
10/5/2024,Dinesh Kularatne,Kandy,Peradeniya,Central,4391,8066,12457,175640,322640,498280
10/6/2024,Dinesh Kularatne,Kandy,Peradeniya,Central,2144,4363,6507,85760,174520,260280
10/7/2024,Dinesh Kularatne,Kandy,Peradeniya,Central,242,2038,2280,9680,81520,91200
10/8/2024,Dinesh Kularatne,Kandy,Peradeniya,Central,5806,738,6544,232240,29520,261760
10/9/2024,Dinesh Kularatne,Kandy,Peradeniya,Central,354,4732,5086,14160,189280,203440
10/10/2024,Dinesh Kularatne,Kandy,Peradeniya,Central,9285,8484,17769,371400,339360,710760
10/11/2024,Dinesh Kularatne,Kandy,Peradeniya,Central,2900,8899,11799,116000,355960,471960
10/12/2024,Dinesh Kularatne,Kandy,Peradeniya,Central,8256,7191,15447,330240,287640,617880
10/13/2024,Dinesh Kularatne,Kandy,Peradeniya,Central,6607,8325,14932,264280,333000,597280
10/14/2024,Dinesh Kularatne,Kandy,Peradeniya,Central,2380,8745,11125,95200,349800,445000
10/15/2024,Dinesh Kularatne,Kandy,Peradeniya,Central,6652,5796,12448,266080,231840,497920
10/16/2024,Dinesh Kularatne,Kandy,Peradeniya,Central,2844,4240,7084,113760,169600,283360
10/17/2024,Dinesh Kularatne,Kandy,Peradeniya,Central,9785,4139,13924,391400,165560,556960
10/18/2024,Dinesh Kularatne,Kandy,Peradeniya,Central,1788,5497,7285,71520,219880,291400
10/19/2024,Dinesh Kularatne,Kandy,Peradeniya,Central,7701,7803,15504,308040,312120,620160
10/20/2024,Dinesh Kularatne,Kandy,Peradeniya,Central,5953,3720,9673,238120,148800,386920
10/21/2024,Dinesh Kularatne,Kandy,Peradeniya,Central,7422,4405,11827,296880,176200,473080
10/22/2024,Dinesh Kularatne,Kandy,Peradeniya,Central,7493,63,7556,299720,2520,302240
10/23/2024,Dinesh Kularatne,Kandy,Peradeniya,Central,6065,2209,8274,242600,88360,330960
10/24/2024,Dinesh Kularatne,Kandy,Peradeniya,Central,6803,3915,10718,272120,156600,428720
10/25/2024,Dinesh Kularatne,Kandy,Peradeniya,Central,544,17,561,21760,680,22440
10/26/2024,Dinesh Kularatne,Kandy,Peradeniya,Central,7318,9484,16802,292720,379360,672080
10/27/2024,Dinesh Kularatne,Kandy,Peradeniya,Central,9204,1723,10927,368160,68920,437080
10/28/2024,Dinesh Kularatne,Kandy,Peradeniya,Central,8626,6387,15013,345040,255480,600520
10/29/2024,Dinesh Kularatne,Kandy,Peradeniya,Central,9580,784,10364,383200,31360,414560
10/30/2024,Dinesh Kularatne,Kandy,Peradeniya,Central,6276,1060,7336,251040,42400,293440
10/31/2024,Dinesh Kularatne,Kandy,Peradeniya,Central,9504,979,10483,380160,39160,419320
11/1/2024,Dinesh Kularatne,Kandy,Peradeniya,Central,8480,5623,14103,339200,224920,564120
11/2/2024,Dinesh Kularatne,Kandy,Peradeniya,Central,7558,7199,14757,302320,287960,590280
11/3/2024,Dinesh Kularatne,Kandy,Peradeniya,Central,4753,3595,8348,190120,143800,333920
11/4/2024,Dinesh Kularatne,Kandy,Peradeniya,Central,5354,5811,11165,214160,232440,446600
11/5/2024,Dinesh Kularatne,Kandy,Peradeniya,Central,1743,7574,9317,69720,302960,372680
11/6/2024,Dinesh Kularatne,Kandy,Peradeniya,Central,4960,7380,12340,198400,295200,493600
11/7/2024,Dinesh Kularatne,Kandy,Peradeniya,Central,9468,4005,13473,378720,160200,538920
11/8/2024,Dinesh Kularatne,Kandy,Peradeniya,Central,3871,440,4311,154840,17600,172440
11/9/2024,Dinesh Kularatne,Kandy,Peradeniya,Central,3695,1029,4724,147800,41160,188960
11/10/2024,Dinesh Kularatne,Kandy,Peradeniya,Central,4468,115,4583,178720,4600,183320
11/11/2024,Dinesh Kularatne,Kandy,Peradeniya,Central,3625,6421,10046,145000,256840,401840
11/12/2024,Dinesh Kularatne,Kandy,Peradeniya,Central,5865,456,6321,234600,18240,252840
11/13/2024,Dinesh Kularatne,Kandy,Peradeniya,Central,596,2726,3322,23840,109040,132880
11/14/2024,Dinesh Kularatne,Kandy,Peradeniya,Central,9037,7171,16208,361480,286840,648320
11/15/2024,Dinesh Kularatne,Kandy,Peradeniya,Central,604,5614,6218,24160,224560,248720
11/16/2024,Dinesh Kularatne,Kandy,Peradeniya,Central,2682,1268,3950,107280,50720,158000
11/17/2024,Dinesh Kularatne,Kandy,Peradeniya,Central,1029,5309,6338,41160,212360,253520
11/18/2024,Dinesh Kularatne,Kandy,Peradeniya,Central,6521,6656,13177,260840,266240,527080
11/19/2024,Dinesh Kularatne,Kandy,Peradeniya,Central,3086,4164,7250,123440,166560,290000
11/20/2024,Dinesh Kularatne,Kandy,Peradeniya,Central,3383,6505,9888,135320,260200,395520
11/21/2024,Dinesh Kularatne,Kandy,Peradeniya,Central,1257,8050,9307,50280,322000,372280
11/22/2024,Dinesh Kularatne,Kandy,Peradeniya,Central,7798,4448,12246,311920,177920,489840
11/23/2024,Dinesh Kularatne,Kandy,Peradeniya,Central,172,968,1140,6880,38720,45600
11/24/2024,Dinesh Kularatne,Kandy,Peradeniya,Central,8285,8719,17004,331400,348760,680160
11/25/2024,Dinesh Kularatne,Kandy,Peradeniya,Central,6220,1583,7803,248800,63320,312120
11/26/2024,Dinesh Kularatne,Kandy,Peradeniya,Central,5735,7802,13537,229400,312080,541480
11/27/2024,Dinesh Kularatne,Kandy,Peradeniya,Central,1346,8926,10272,53840,357040,410880
11/28/2024,Dinesh Kularatne,Kandy,Peradeniya,Central,465,1942,2407,18600,77680,96280
11/29/2024,Dinesh Kularatne,Kandy,Peradeniya,Central,7085,8108,15193,283400,324320,607720
11/30/2024,Dinesh Kularatne,Kandy,Peradeniya,Central,8579,1734,10313,343160,69360,412520
12/1/2024,Dinesh Kularatne,Kandy,Peradeniya,Central,8863,7481,16344,354520,299240,653760
12/2/2024,Dinesh Kularatne,Kandy,Peradeniya,Central,5147,2219,7366,205880,88760,294640
12/3/2024,Dinesh Kularatne,Kandy,Peradeniya,Central,9950,429,10379,398000,17160,415160
12/4/2024,Dinesh Kularatne,Kandy,Peradeniya,Central,7696,2272,9968,307840,90880,398720
12/5/2024,Dinesh Kularatne,Kandy,Peradeniya,Central,1442,526,1968,57680,21040,78720
12/6/2024,Dinesh Kularatne,Kandy,Peradeniya,Central,7187,9912,17099,287480,396480,683960
12/7/2024,Dinesh Kularatne,Kandy,Peradeniya,Central,4623,7450,12073,184920,298000,482920
12/8/2024,Dinesh Kularatne,Kandy,Peradeniya,Central,8303,4396,12699,332120,175840,507960
12/9/2024,Dinesh Kularatne,Kandy,Peradeniya,Central,1204,7003,8207,48160,280120,328280
12/10/2024,Dinesh Kularatne,Kandy,Peradeniya,Central,8011,219,8230,320440,8760,329200
12/11/2024,Dinesh Kularatne,Kandy,Peradeniya,Central,9480,4933,14413,379200,197320,576520
12/12/2024,Dinesh Kularatne,Kandy,Peradeniya,Central,6079,1219,7298,243160,48760,291920
12/13/2024,Dinesh Kularatne,Kandy,Peradeniya,Central,2730,6501,9231,109200,260040,369240
12/14/2024,Dinesh Kularatne,Kandy,Peradeniya,Central,5002,7372,12374,200080,294880,494960
12/15/2024,Dinesh Kularatne,Kandy,Peradeniya,Central,3962,5780,9742,158480,231200,389680
12/16/2024,Dinesh Kularatne,Kandy,Peradeniya,Central,4048,7366,11414,161920,294640,456560
12/17/2024,Dinesh Kularatne,Kandy,Peradeniya,Central,2800,6626,9426,112000,265040,377040
12/18/2024,Dinesh Kularatne,Kandy,Peradeniya,Central,8316,9185,17501,332640,367400,700040
12/19/2024,Dinesh Kularatne,Kandy,Peradeniya,Central,6384,3092,9476,255360,123680,379040
12/20/2024,Dinesh Kularatne,Kandy,Peradeniya,Central,517,6027,6544,20680,241080,261760
12/21/2024,Dinesh Kularatne,Kandy,Peradeniya,Central,6994,3259,10253,279760,130360,410120
12/22/2024,Dinesh Kularatne,Kandy,Peradeniya,Central,8301,8392,16693,332040,335680,667720
12/23/2024,Dinesh Kularatne,Kandy,Peradeniya,Central,2273,4984,7257,90920,199360,290280
12/24/2024,Dinesh Kularatne,Kandy,Peradeniya,Central,7317,3642,10959,292680,145680,438360
12/25/2024,Dinesh Kularatne,Kandy,Peradeniya,Central,1866,7854,9720,74640,314160,388800
12/26/2024,Dinesh Kularatne,Kandy,Peradeniya,Central,1327,1688,3015,53080,67520,120600
12/27/2024,Dinesh Kularatne,Kandy,Peradeniya,Central,5444,8990,14434,217760,359600,577360
12/28/2024,Dinesh Kularatne,Kandy,Peradeniya,Central,7630,6617,14247,305200,264680,569880
12/29/2024,Dinesh Kularatne,Kandy,Peradeniya,Central,7834,817,8651,313360,32680,346040
12/30/2024,Dinesh Kularatne,Kandy,Peradeniya,Central,2995,8334,11329,119800,333360,453160
12/31/2024,Dinesh Kularatne,Kandy,Peradeniya,Central,4482,5690,10172,179280,227600,406880
1/1/2025,Dinesh Kularatne,Kandy,Peradeniya,Central,8934,48,8982,357360,1920,359280
1/2/2025,Dinesh Kularatne,Kandy,Peradeniya,Central,7619,6005,13624,304760,240200,544960
1/3/2025,Dinesh Kularatne,Kandy,Peradeniya,Central,5931,3298,9229,237240,131920,369160
1/4/2025,Dinesh Kularatne,Kandy,Peradeniya,Central,1711,4792,6503,68440,191680,260120
1/5/2025,Dinesh Kularatne,Kandy,Peradeniya,Central,7944,2942,10886,317760,117680,435440
1/6/2025,Dinesh Kularatne,Kandy,Peradeniya,Central,3083,2179,5262,123320,87160,210480
1/7/2025,Dinesh Kularatne,Kandy,Peradeniya,Central,1462,661,2123,58480,26440,84920
1/8/2025,Dinesh Kularatne,Kandy,Peradeniya,Central,2369,3596,5965,94760,143840,238600
1/9/2025,Dinesh Kularatne,Kandy,Peradeniya,Central,6037,7265,13302,241480,290600,532080
1/10/2025,Dinesh Kularatne,Kandy,Peradeniya,Central,824,7758,8582,32960,310320,343280
1/11/2025,Dinesh Kularatne,Kandy,Peradeniya,Central,3731,8906,12637,149240,356240,505480
1/12/2025,Dinesh Kularatne,Kandy,Peradeniya,Central,6363,6048,12411,254520,241920,496440
1/13/2025,Dinesh Kularatne,Kandy,Peradeniya,Central,3325,5841,9166,133000,233640,366640
1/14/2025,Dinesh Kularatne,Kandy,Peradeniya,Central,616,2696,3312,24640,107840,132480
1/15/2025,Dinesh Kularatne,Kandy,Peradeniya,Central,7138,5594,12732,285520,223760,509280
1/16/2025,Dinesh Kularatne,Kandy,Peradeniya,Central,7312,8934,16246,292480,357360,649840
1/17/2025,Dinesh Kularatne,Kandy,Peradeniya,Central,1563,3579,5142,62520,143160,205680
1/18/2025,Dinesh Kularatne,Kandy,Peradeniya,Central,713,953,1666,28520,38120,66640
1/19/2025,Dinesh Kularatne,Kandy,Peradeniya,Central,4808,3601,8409,192320,144040,336360
1/20/2025,Dinesh Kularatne,Kandy,Peradeniya,Central,8594,1469,10063,343760,58760,402520
1/21/2025,Dinesh Kularatne,Kandy,Peradeniya,Central,3600,5048,8648,144000,201920,345920
1/22/2025,Dinesh Kularatne,Kandy,Peradeniya,Central,6169,8068,14237,246760,322720,569480
1/23/2025,Dinesh Kularatne,Kandy,Peradeniya,Central,2138,4153,6291,85520,166120,251640
1/24/2025,Dinesh Kularatne,Kandy,Peradeniya,Central,5933,6739,12672,237320,269560,506880
1/25/2025,Dinesh Kularatne,Kandy,Peradeniya,Central,109,7507,7616,4360,300280,304640
1/26/2025,Dinesh Kularatne,Kandy,Peradeniya,Central,8412,6862,15274,336480,274480,610960
1/27/2025,Dinesh Kularatne,Kandy,Peradeniya,Central,5010,9404,14414,200400,376160,576560
1/28/2025,Dinesh Kularatne,Kandy,Peradeniya,Central,7025,3754,10779,281000,150160,431160
1/29/2025,Dinesh Kularatne,Kandy,Peradeniya,Central,5353,1241,6594,214120,49640,263760
1/30/2025,Dinesh Kularatne,Kandy,Peradeniya,Central,8349,90,8439,333960,3600,337560
1/31/2025,Dinesh Kularatne,Kandy,Peradeniya,Central,647,8428,9075,25880,337120,363000
2/1/2025,Dinesh Kularatne,Kandy,Peradeniya,Central,5975,80,6055,239000,3200,242200
2/2/2025,Dinesh Kularatne,Kandy,Peradeniya,Central,2425,9877,12302,97000,395080,492080
2/3/2025,Dinesh Kularatne,Kandy,Peradeniya,Central,2591,5186,7777,103640,207440,311080
2/4/2025,Dinesh Kularatne,Kandy,Peradeniya,Central,6746,8753,15499,269840,350120,619960
2/5/2025,Dinesh Kularatne,Kandy,Peradeniya,Central,5443,4983,10426,217720,199320,417040
2/6/2025,Dinesh Kularatne,Kandy,Peradeniya,Central,3716,9624,13340,148640,384960,533600
2/7/2025,Dinesh Kularatne,Kandy,Peradeniya,Central,8309,4061,12370,332360,162440,494800
2/8/2025,Dinesh Kularatne,Kandy,Peradeniya,Central,1393,6982,8375,55720,279280,335000
2/9/2025,Dinesh Kularatne,Kandy,Peradeniya,Central,6435,560,6995,257400,22400,279800
2/10/2025,Dinesh Kularatne,Kandy,Peradeniya,Central,3824,1542,5366,152960,61680,214640
2/11/2025,Dinesh Kularatne,Kandy,Peradeniya,Central,3689,3209,6898,147560,128360,275920
2/12/2025,Dinesh Kularatne,Kandy,Peradeniya,Central,7732,9047,16779,309280,361880,671160
2/13/2025,Dinesh Kularatne,Kandy,Peradeniya,Central,8819,844,9663,352760,33760,386520
2/14/2025,Dinesh Kularatne,Kandy,Peradeniya,Central,2891,3223,6114,115640,128920,244560
2/15/2025,Dinesh Kularatne,Kandy,Peradeniya,Central,5244,3061,8305,209760,122440,332200
2/16/2025,Dinesh Kularatne,Kandy,Peradeniya,Central,8568,8164,16732,342720,326560,669280
2/17/2025,Dinesh Kularatne,Kandy,Peradeniya,Central,4133,246,4379,165320,9840,175160
2/18/2025,Dinesh Kularatne,Kandy,Peradeniya,Central,9737,9183,18920,389480,367320,756800
2/19/2025,Dinesh Kularatne,Kandy,Peradeniya,Central,7220,6250,13470,288800,250000,538800
2/20/2025,Dinesh Kularatne,Kandy,Peradeniya,Central,1983,1108,3091,79320,44320,123640
2/21/2025,Dinesh Kularatne,Kandy,Peradeniya,Central,948,9192,10140,37920,367680,405600
2/22/2025,Dinesh Kularatne,Kandy,Peradeniya,Central,4669,8413,13082,186760,336520,523280
2/23/2025,Dinesh Kularatne,Kandy,Peradeniya,Central,3540,3834,7374,141600,153360,294960
2/24/2025,Dinesh Kularatne,Kandy,Peradeniya,Central,1040,8996,10036,41600,359840,401440
2/25/2025,Dinesh Kularatne,Kandy,Peradeniya,Central,8735,2389,11124,349400,95560,444960
2/26/2025,Dinesh Kularatne,Kandy,Peradeniya,Central,8292,4061,12353,331680,162440,494120
2/27/2025,Dinesh Kularatne,Kandy,Peradeniya,Central,2976,1768,4744,119040,70720,189760
2/28/2025,Dinesh Kularatne,Kandy,Peradeniya,Central,1506,4316,5822,60240,172640,232880
3/1/2025,Dinesh Kularatne,Kandy,Peradeniya,Central,2612,4275,6887,104480,171000,275480
3/2/2025,Dinesh Kularatne,Kandy,Peradeniya,Central,6919,5103,12022,276760,204120,480880
3/3/2025,Dinesh Kularatne,Kandy,Peradeniya,Central,6417,541,6958,256680,21640,278320
3/4/2025,Dinesh Kularatne,Kandy,Peradeniya,Central,7721,563,8284,308840,22520,331360
3/5/2025,Dinesh Kularatne,Kandy,Peradeniya,Central,5798,7838,13636,231920,313520,545440
3/6/2025,Dinesh Kularatne,Kandy,Peradeniya,Central,7657,5710,13367,306280,228400,534680
3/7/2025,Dinesh Kularatne,Kandy,Peradeniya,Central,688,5552,6240,27520,222080,249600
3/8/2025,Dinesh Kularatne,Kandy,Peradeniya,Central,5692,8415,14107,227680,336600,564280
3/9/2025,Dinesh Kularatne,Kandy,Peradeniya,Central,4816,2141,6957,192640,85640,278280
3/10/2025,Dinesh Kularatne,Kandy,Peradeniya,Central,2904,7195,10099,116160,287800,403960
3/11/2025,Dinesh Kularatne,Kandy,Peradeniya,Central,2881,5303,8184,115240,212120,327360
3/12/2025,Dinesh Kularatne,Kandy,Peradeniya,Central,1031,4700,5731,41240,188000,229240
3/13/2025,Dinesh Kularatne,Kandy,Peradeniya,Central,9738,6720,16458,389520,268800,658320
3/14/2025,Dinesh Kularatne,Kandy,Peradeniya,Central,14,8345,8359,560,333800,334360
3/15/2025,Dinesh Kularatne,Kandy,Peradeniya,Central,497,4100,4597,19880,164000,183880
3/16/2025,Dinesh Kularatne,Kandy,Peradeniya,Central,4004,5306,9310,160160,212240,372400
3/17/2025,Dinesh Kularatne,Kandy,Peradeniya,Central,7518,4593,12111,300720,183720,484440
3/18/2025,Dinesh Kularatne,Kandy,Peradeniya,Central,2107,1,2108,84280,40,84320
3/19/2025,Dinesh Kularatne,Kandy,Peradeniya,Central,7755,7801,15556,310200,312040,622240
3/20/2025,Dinesh Kularatne,Kandy,Peradeniya,Central,4941,4993,9934,197640,199720,397360
3/21/2025,Dinesh Kularatne,Kandy,Peradeniya,Central,1039,4860,5899,41560,194400,235960
3/22/2025,Dinesh Kularatne,Kandy,Peradeniya,Central,772,9566,10338,30880,382640,413520
3/23/2025,Dinesh Kularatne,Kandy,Peradeniya,Central,3734,8970,12704,149360,358800,508160
3/25/2024,Chathuranga Kalubowila,Polonnaruwa,Kahatagasdigiliya,North Central,781,3020,3801,31240,120800,152040
3/26/2024,Chathuranga Kalubowila,Polonnaruwa,Kahatagasdigiliya,North Central,71,7332,7403,2840,293280,296120
3/27/2024,Chathuranga Kalubowila,Polonnaruwa,Kahatagasdigiliya,North Central,4731,7906,12637,189240,316240,505480
3/28/2024,Chathuranga Kalubowila,Polonnaruwa,Kahatagasdigiliya,North Central,7007,6434,13441,280280,257360,537640
3/29/2024,Chathuranga Kalubowila,Polonnaruwa,Kahatagasdigiliya,North Central,7706,158,7864,308240,6320,314560
3/30/2024,Chathuranga Kalubowila,Polonnaruwa,Kahatagasdigiliya,North Central,3269,9588,12857,130760,383520,514280
3/31/2024,Chathuranga Kalubowila,Polonnaruwa,Kahatagasdigiliya,North Central,6679,5332,12011,267160,213280,480440
4/1/2024,Chathuranga Kalubowila,Polonnaruwa,Kahatagasdigiliya,North Central,2323,8188,10511,92920,327520,420440
4/2/2024,Chathuranga Kalubowila,Polonnaruwa,Kahatagasdigiliya,North Central,2573,379,2952,102920,15160,118080
4/3/2024,Chathuranga Kalubowila,Polonnaruwa,Kahatagasdigiliya,North Central,9789,5089,14878,391560,203560,595120
4/4/2024,Chathuranga Kalubowila,Polonnaruwa,Kahatagasdigiliya,North Central,4970,6535,11505,198800,261400,460200
4/5/2024,Chathuranga Kalubowila,Polonnaruwa,Kahatagasdigiliya,North Central,9320,2006,11326,372800,80240,453040
4/6/2024,Chathuranga Kalubowila,Polonnaruwa,Kahatagasdigiliya,North Central,5991,1862,7853,239640,74480,314120
4/7/2024,Chathuranga Kalubowila,Polonnaruwa,Kahatagasdigiliya,North Central,469,8170,8639,18760,326800,345560
4/8/2024,Chathuranga Kalubowila,Polonnaruwa,Kahatagasdigiliya,North Central,49,8970,9019,1960,358800,360760
4/9/2024,Chathuranga Kalubowila,Polonnaruwa,Kahatagasdigiliya,North Central,3003,62,3065,120120,2480,122600
4/10/2024,Chathuranga Kalubowila,Polonnaruwa,Kahatagasdigiliya,North Central,7411,21,7432,296440,840,297280
4/11/2024,Chathuranga Kalubowila,Polonnaruwa,Kahatagasdigiliya,North Central,5199,8189,13388,207960,327560,535520
4/19/2024,Chathuranga Kalubowila,Polonnaruwa,Kahatagasdigiliya,North Central,568,7964,8532,22720,318560,341280
4/20/2024,Chathuranga Kalubowila,Polonnaruwa,Kahatagasdigiliya,North Central,9101,5302,14403,364040,212080,576120
4/21/2024,Chathuranga Kalubowila,Polonnaruwa,Kahatagasdigiliya,North Central,340,857,1197,13600,34280,47880
4/22/2024,Chathuranga Kalubowila,Polonnaruwa,Kahatagasdigiliya,North Central,3027,9614,12641,121080,384560,505640
4/23/2024,Chathuranga Kalubowila,Polonnaruwa,Kahatagasdigiliya,North Central,1228,8451,9679,49120,338040,387160
4/24/2024,Chathuranga Kalubowila,Polonnaruwa,Kahatagasdigiliya,North Central,1628,23,1651,65120,920,66040
4/25/2024,Chathuranga Kalubowila,Polonnaruwa,Kahatagasdigiliya,North Central,7963,8430,16393,318520,337200,655720
4/26/2024,Chathuranga Kalubowila,Polonnaruwa,Kahatagasdigiliya,North Central,4034,8005,12039,161360,320200,481560
4/27/2024,Chathuranga Kalubowila,Polonnaruwa,Kahatagasdigiliya,North Central,2069,7151,9220,82760,286040,368800
4/28/2024,Chathuranga Kalubowila,Polonnaruwa,Kahatagasdigiliya,North Central,3119,8239,11358,124760,329560,454320
4/29/2024,Chathuranga Kalubowila,Polonnaruwa,Kahatagasdigiliya,North Central,1761,7970,9731,70440,318800,389240
4/30/2024,Chathuranga Kalubowila,Polonnaruwa,Kahatagasdigiliya,North Central,1862,4445,6307,74480,177800,252280
5/1/2024,Chathuranga Kalubowila,Polonnaruwa,Kahatagasdigiliya,North Central,4656,8125,12781,186240,325000,511240
5/2/2024,Chathuranga Kalubowila,Polonnaruwa,Kahatagasdigiliya,North Central,7162,3346,10508,286480,133840,420320
5/3/2024,Chathuranga Kalubowila,Polonnaruwa,Kahatagasdigiliya,North Central,5737,6397,12134,229480,255880,485360
5/4/2024,Chathuranga Kalubowila,Polonnaruwa,Kahatagasdigiliya,North Central,4039,6582,10621,161560,263280,424840
5/5/2024,Chathuranga Kalubowila,Polonnaruwa,Kahatagasdigiliya,North Central,8803,7922,16725,352120,316880,669000
5/6/2024,Chathuranga Kalubowila,Polonnaruwa,Kahatagasdigiliya,North Central,4982,5533,10515,199280,221320,420600
5/7/2024,Chathuranga Kalubowila,Polonnaruwa,Kahatagasdigiliya,North Central,3589,4410,7999,143560,176400,319960
5/8/2024,Chathuranga Kalubowila,Polonnaruwa,Kahatagasdigiliya,North Central,9733,4829,14562,389320,193160,582480
5/9/2024,Chathuranga Kalubowila,Polonnaruwa,Kahatagasdigiliya,North Central,8960,5115,14075,358400,204600,563000
5/10/2024,Chathuranga Kalubowila,Polonnaruwa,Kahatagasdigiliya,North Central,3863,5576,9439,154520,223040,377560
5/11/2024,Chathuranga Kalubowila,Polonnaruwa,Kahatagasdigiliya,North Central,4962,9235,14197,198480,369400,567880
5/12/2024,Chathuranga Kalubowila,Polonnaruwa,Kahatagasdigiliya,North Central,2446,1984,4430,97840,79360,177200
5/13/2024,Chathuranga Kalubowila,Polonnaruwa,Kahatagasdigiliya,North Central,2709,90,2799,108360,3600,111960
5/14/2024,Chathuranga Kalubowila,Polonnaruwa,Kahatagasdigiliya,North Central,3372,5217,8589,134880,208680,343560
5/15/2024,Chathuranga Kalubowila,Polonnaruwa,Kahatagasdigiliya,North Central,8986,347,9333,359440,13880,373320
5/16/2024,Chathuranga Kalubowila,Polonnaruwa,Kahatagasdigiliya,North Central,403,4842,5245,16120,193680,209800
5/17/2024,Chathuranga Kalubowila,Polonnaruwa,Kahatagasdigiliya,North Central,1255,8287,9542,50200,331480,381680
5/18/2024,Chathuranga Kalubowila,Polonnaruwa,Kahatagasdigiliya,North Central,1042,8466,9508,41680,338640,380320
5/19/2024,Chathuranga Kalubowila,Polonnaruwa,Kahatagasdigiliya,North Central,9683,1576,11259,387320,63040,450360
5/20/2024,Chathuranga Kalubowila,Polonnaruwa,Kahatagasdigiliya,North Central,2073,2225,4298,82920,89000,171920
5/21/2024,Chathuranga Kalubowila,Polonnaruwa,Kahatagasdigiliya,North Central,1852,837,2689,74080,33480,107560
5/22/2024,Chathuranga Kalubowila,Polonnaruwa,Kahatagasdigiliya,North Central,3722,951,4673,148880,38040,186920
5/24/2024,Chathuranga Kalubowila,Polonnaruwa,Kahatagasdigiliya,North Central,1533,896,2429,61320,35840,97160
5/25/2024,Chathuranga Kalubowila,Polonnaruwa,Kahatagasdigiliya,North Central,5531,4122,9653,221240,164880,386120
5/26/2024,Chathuranga Kalubowila,Polonnaruwa,Kahatagasdigiliya,North Central,1746,8175,9921,69840,327000,396840
5/27/2024,Chathuranga Kalubowila,Polonnaruwa,Kahatagasdigiliya,North Central,6539,3829,10368,261560,153160,414720
5/28/2024,Chathuranga Kalubowila,Polonnaruwa,Kahatagasdigiliya,North Central,6009,676,6685,240360,27040,267400
5/29/2024,Chathuranga Kalubowila,Polonnaruwa,Kahatagasdigiliya,North Central,7383,1269,8652,295320,50760,346080
5/30/2024,Chathuranga Kalubowila,Polonnaruwa,Kahatagasdigiliya,North Central,8454,8077,16531,338160,323080,661240
5/31/2024,Chathuranga Kalubowila,Polonnaruwa,Kahatagasdigiliya,North Central,2084,6046,8130,83360,241840,325200
6/1/2024,Chathuranga Kalubowila,Polonnaruwa,Kahatagasdigiliya,North Central,3998,970,4968,159920,38800,198720
6/2/2024,Chathuranga Kalubowila,Polonnaruwa,Kahatagasdigiliya,North Central,2525,5862,8387,101000,234480,335480
6/3/2024,Chathuranga Kalubowila,Polonnaruwa,Kahatagasdigiliya,North Central,4831,7017,11848,193240,280680,473920
6/4/2024,Chathuranga Kalubowila,Polonnaruwa,Kahatagasdigiliya,North Central,3324,9766,13090,132960,390640,523600
6/5/2024,Chathuranga Kalubowila,Polonnaruwa,Kahatagasdigiliya,North Central,6674,6606,13280,266960,264240,531200
6/6/2024,Chathuranga Kalubowila,Polonnaruwa,Kahatagasdigiliya,North Central,4916,2570,7486,196640,102800,299440
6/7/2024,Chathuranga Kalubowila,Polonnaruwa,Kahatagasdigiliya,North Central,8196,2035,10231,327840,81400,409240
6/8/2024,Chathuranga Kalubowila,Polonnaruwa,Kahatagasdigiliya,North Central,4814,9393,14207,192560,375720,568280
6/9/2024,Chathuranga Kalubowila,Polonnaruwa,Kahatagasdigiliya,North Central,8627,7553,16180,345080,302120,647200
6/10/2024,Chathuranga Kalubowila,Polonnaruwa,Kahatagasdigiliya,North Central,9055,8085,17140,362200,323400,685600
6/11/2024,Chathuranga Kalubowila,Polonnaruwa,Kahatagasdigiliya,North Central,5204,3079,8283,208160,123160,331320
6/12/2024,Chathuranga Kalubowila,Polonnaruwa,Kahatagasdigiliya,North Central,5758,4176,9934,230320,167040,397360
6/13/2024,Chathuranga Kalubowila,Polonnaruwa,Kahatagasdigiliya,North Central,7220,5368,12588,288800,214720,503520
6/14/2024,Chathuranga Kalubowila,Polonnaruwa,Kahatagasdigiliya,North Central,9449,9863,19312,377960,394520,772480
6/15/2024,Chathuranga Kalubowila,Polonnaruwa,Kahatagasdigiliya,North Central,1671,4808,6479,66840,192320,259160
6/16/2024,Chathuranga Kalubowila,Polonnaruwa,Kahatagasdigiliya,North Central,2198,2363,4561,87920,94520,182440
6/17/2024,Chathuranga Kalubowila,Polonnaruwa,Kahatagasdigiliya,North Central,2968,9276,12244,118720,371040,489760
6/18/2024,Chathuranga Kalubowila,Polonnaruwa,Kahatagasdigiliya,North Central,9594,2981,12575,383760,119240,503000
6/19/2024,Chathuranga Kalubowila,Polonnaruwa,Kahatagasdigiliya,North Central,657,9353,10010,26280,374120,400400
6/20/2024,Chathuranga Kalubowila,Polonnaruwa,Kahatagasdigiliya,North Central,4918,1447,6365,196720,57880,254600
6/21/2024,Chathuranga Kalubowila,Polonnaruwa,Kahatagasdigiliya,North Central,2849,957,3806,113960,38280,152240
6/22/2024,Chathuranga Kalubowila,Polonnaruwa,Kahatagasdigiliya,North Central,6543,6956,13499,261720,278240,539960
6/23/2024,Chathuranga Kalubowila,Polonnaruwa,Kahatagasdigiliya,North Central,3204,5276,8480,128160,211040,339200
6/24/2024,Chathuranga Kalubowila,Polonnaruwa,Kahatagasdigiliya,North Central,4,4153,4157,160,166120,166280
6/25/2024,Chathuranga Kalubowila,Polonnaruwa,Kahatagasdigiliya,North Central,4312,9879,14191,172480,395160,567640
6/26/2024,Chathuranga Kalubowila,Polonnaruwa,Kahatagasdigiliya,North Central,2086,4712,6798,83440,188480,271920
6/27/2024,Chathuranga Kalubowila,Polonnaruwa,Kahatagasdigiliya,North Central,9947,9650,19597,397880,386000,783880
6/28/2024,Chathuranga Kalubowila,Polonnaruwa,Kahatagasdigiliya,North Central,6653,2913,9566,266120,116520,382640
6/29/2024,Chathuranga Kalubowila,Polonnaruwa,Kahatagasdigiliya,North Central,386,8830,9216,15440,353200,368640
6/30/2024,Chathuranga Kalubowila,Polonnaruwa,Kahatagasdigiliya,North Central,4732,9843,14575,189280,393720,583000
7/1/2024,Chathuranga Kalubowila,Polonnaruwa,Kahatagasdigiliya,North Central,1894,619,2513,75760,24760,100520
7/2/2024,Chathuranga Kalubowila,Polonnaruwa,Kahatagasdigiliya,North Central,6830,5408,12238,273200,216320,489520
7/3/2024,Chathuranga Kalubowila,Polonnaruwa,Kahatagasdigiliya,North Central,3904,1453,5357,156160,58120,214280
7/4/2024,Chathuranga Kalubowila,Polonnaruwa,Kahatagasdigiliya,North Central,1873,9271,11144,74920,370840,445760
7/5/2024,Chathuranga Kalubowila,Polonnaruwa,Kahatagasdigiliya,North Central,1144,3087,4231,45760,123480,169240
7/6/2024,Chathuranga Kalubowila,Polonnaruwa,Kahatagasdigiliya,North Central,2539,3372,5911,101560,134880,236440
7/7/2024,Chathuranga Kalubowila,Polonnaruwa,Kahatagasdigiliya,North Central,6099,156,6255,243960,6240,250200
7/8/2024,Chathuranga Kalubowila,Polonnaruwa,Kahatagasdigiliya,North Central,360,8738,9098,14400,349520,363920
7/9/2024,Chathuranga Kalubowila,Polonnaruwa,Kahatagasdigiliya,North Central,9487,4955,14442,379480,198200,577680
7/10/2024,Chathuranga Kalubowila,Polonnaruwa,Kahatagasdigiliya,North Central,8026,3548,11574,321040,141920,462960
7/11/2024,Chathuranga Kalubowila,Polonnaruwa,Kahatagasdigiliya,North Central,3262,4077,7339,130480,163080,293560
7/12/2024,Chathuranga Kalubowila,Polonnaruwa,Kahatagasdigiliya,North Central,8713,8363,17076,348520,334520,683040
7/13/2024,Chathuranga Kalubowila,Polonnaruwa,Kahatagasdigiliya,North Central,5033,9519,14552,201320,380760,582080
7/14/2024,Chathuranga Kalubowila,Polonnaruwa,Kahatagasdigiliya,North Central,9358,2109,11467,374320,84360,458680
7/15/2024,Chathuranga Kalubowila,Polonnaruwa,Kahatagasdigiliya,North Central,8483,5350,13833,339320,214000,553320
7/16/2024,Chathuranga Kalubowila,Polonnaruwa,Kahatagasdigiliya,North Central,739,6282,7021,29560,251280,280840
7/17/2024,Chathuranga Kalubowila,Polonnaruwa,Kahatagasdigiliya,North Central,2299,7621,9920,91960,304840,396800
7/18/2024,Chathuranga Kalubowila,Polonnaruwa,Kahatagasdigiliya,North Central,1991,9122,11113,79640,364880,444520
7/19/2024,Chathuranga Kalubowila,Polonnaruwa,Kahatagasdigiliya,North Central,2067,6532,8599,82680,261280,343960
7/20/2024,Chathuranga Kalubowila,Polonnaruwa,Kahatagasdigiliya,North Central,4039,1966,6005,161560,78640,240200
7/21/2024,Chathuranga Kalubowila,Polonnaruwa,Kahatagasdigiliya,North Central,9045,6488,15533,361800,259520,621320
7/22/2024,Chathuranga Kalubowila,Polonnaruwa,Kahatagasdigiliya,North Central,6650,5098,11748,266000,203920,469920
7/23/2024,Chathuranga Kalubowila,Polonnaruwa,Kahatagasdigiliya,North Central,4972,2392,7364,198880,95680,294560
7/24/2024,Chathuranga Kalubowila,Polonnaruwa,Kahatagasdigiliya,North Central,7115,2775,9890,284600,111000,395600
7/25/2024,Chathuranga Kalubowila,Polonnaruwa,Kahatagasdigiliya,North Central,3830,9063,12893,153200,362520,515720
7/26/2024,Chathuranga Kalubowila,Polonnaruwa,Kahatagasdigiliya,North Central,6808,5700,12508,272320,228000,500320
7/27/2024,Chathuranga Kalubowila,Polonnaruwa,Kahatagasdigiliya,North Central,8973,5021,13994,358920,200840,559760
7/28/2024,Chathuranga Kalubowila,Polonnaruwa,Kahatagasdigiliya,North Central,9044,7585,16629,361760,303400,665160
7/29/2024,Chathuranga Kalubowila,Polonnaruwa,Kahatagasdigiliya,North Central,1701,9561,11262,68040,382440,450480
7/30/2024,Chathuranga Kalubowila,Polonnaruwa,Kahatagasdigiliya,North Central,2899,1708,4607,115960,68320,184280
7/31/2024,Chathuranga Kalubowila,Polonnaruwa,Kahatagasdigiliya,North Central,8713,3492,12205,348520,139680,488200
8/1/2024,Chathuranga Kalubowila,Polonnaruwa,Kahatagasdigiliya,North Central,2440,3971,6411,97600,158840,256440
8/2/2024,Chathuranga Kalubowila,Polonnaruwa,Kahatagasdigiliya,North Central,4471,2065,6536,178840,82600,261440
8/3/2024,Chathuranga Kalubowila,Polonnaruwa,Kahatagasdigiliya,North Central,5611,5560,11171,224440,222400,446840
8/4/2024,Chathuranga Kalubowila,Polonnaruwa,Kahatagasdigiliya,North Central,9969,8769,18738,398760,350760,749520
8/5/2024,Chathuranga Kalubowila,Polonnaruwa,Kahatagasdigiliya,North Central,5179,1861,7040,207160,74440,281600
8/6/2024,Chathuranga Kalubowila,Polonnaruwa,Kahatagasdigiliya,North Central,987,2977,3964,39480,119080,158560
8/7/2024,Chathuranga Kalubowila,Polonnaruwa,Kahatagasdigiliya,North Central,8036,1141,9177,321440,45640,367080
8/8/2024,Chathuranga Kalubowila,Polonnaruwa,Kahatagasdigiliya,North Central,4284,3866,8150,171360,154640,326000
8/9/2024,Chathuranga Kalubowila,Polonnaruwa,Kahatagasdigiliya,North Central,2303,5425,7728,92120,217000,309120
8/10/2024,Chathuranga Kalubowila,Polonnaruwa,Kahatagasdigiliya,North Central,9537,3060,12597,381480,122400,503880
8/11/2024,Chathuranga Kalubowila,Polonnaruwa,Kahatagasdigiliya,North Central,1275,5119,6394,51000,204760,255760
8/12/2024,Chathuranga Kalubowila,Polonnaruwa,Kahatagasdigiliya,North Central,6504,4155,10659,260160,166200,426360
8/13/2024,Chathuranga Kalubowila,Polonnaruwa,Kahatagasdigiliya,North Central,4089,3163,7252,163560,126520,290080
8/14/2024,Chathuranga Kalubowila,Polonnaruwa,Kahatagasdigiliya,North Central,6593,2152,8745,263720,86080,349800
8/15/2024,Chathuranga Kalubowila,Polonnaruwa,Kahatagasdigiliya,North Central,714,6048,6762,28560,241920,270480
8/16/2024,Chathuranga Kalubowila,Polonnaruwa,Kahatagasdigiliya,North Central,3983,5510,9493,159320,220400,379720
8/17/2024,Chathuranga Kalubowila,Polonnaruwa,Kahatagasdigiliya,North Central,737,6168,6905,29480,246720,276200
8/18/2024,Chathuranga Kalubowila,Polonnaruwa,Kahatagasdigiliya,North Central,1892,7067,8959,75680,282680,358360
8/19/2024,Chathuranga Kalubowila,Polonnaruwa,Kahatagasdigiliya,North Central,2597,5540,8137,103880,221600,325480
8/20/2024,Chathuranga Kalubowila,Polonnaruwa,Kahatagasdigiliya,North Central,6839,3796,10635,273560,151840,425400
8/21/2024,Chathuranga Kalubowila,Polonnaruwa,Kahatagasdigiliya,North Central,8363,6076,14439,334520,243040,577560
8/22/2024,Chathuranga Kalubowila,Polonnaruwa,Kahatagasdigiliya,North Central,2152,2055,4207,86080,82200,168280
8/23/2024,Chathuranga Kalubowila,Polonnaruwa,Kahatagasdigiliya,North Central,3353,5463,8816,134120,218520,352640
8/24/2024,Chathuranga Kalubowila,Polonnaruwa,Kahatagasdigiliya,North Central,9813,7872,17685,392520,314880,707400
8/25/2024,Chathuranga Kalubowila,Polonnaruwa,Kahatagasdigiliya,North Central,6037,3126,9163,241480,125040,366520
8/26/2024,Chathuranga Kalubowila,Polonnaruwa,Kahatagasdigiliya,North Central,1857,771,2628,74280,30840,105120
8/27/2024,Chathuranga Kalubowila,Polonnaruwa,Kahatagasdigiliya,North Central,8616,6469,15085,344640,258760,603400
8/28/2024,Chathuranga Kalubowila,Polonnaruwa,Kahatagasdigiliya,North Central,2327,7808,10135,93080,312320,405400
8/29/2024,Chathuranga Kalubowila,Polonnaruwa,Kahatagasdigiliya,North Central,2815,7688,10503,112600,307520,420120
8/30/2024,Chathuranga Kalubowila,Polonnaruwa,Kahatagasdigiliya,North Central,3240,9448,12688,129600,377920,507520
8/31/2024,Chathuranga Kalubowila,Polonnaruwa,Kahatagasdigiliya,North Central,5316,1488,6804,212640,59520,272160
9/1/2024,Chathuranga Kalubowila,Polonnaruwa,Kahatagasdigiliya,North Central,9280,1448,10728,371200,57920,429120
9/2/2024,Chathuranga Kalubowila,Polonnaruwa,Kahatagasdigiliya,North Central,374,3429,3803,14960,137160,152120
9/3/2024,Chathuranga Kalubowila,Polonnaruwa,Kahatagasdigiliya,North Central,975,4402,5377,39000,176080,215080
9/4/2024,Chathuranga Kalubowila,Polonnaruwa,Kahatagasdigiliya,North Central,1029,2965,3994,41160,118600,159760
9/5/2024,Chathuranga Kalubowila,Polonnaruwa,Kahatagasdigiliya,North Central,329,7017,7346,13160,280680,293840
9/6/2024,Chathuranga Kalubowila,Polonnaruwa,Kahatagasdigiliya,North Central,5603,1677,7280,224120,67080,291200
9/7/2024,Chathuranga Kalubowila,Polonnaruwa,Kahatagasdigiliya,North Central,9080,5718,14798,363200,228720,591920
9/8/2024,Chathuranga Kalubowila,Polonnaruwa,Kahatagasdigiliya,North Central,7761,5603,13364,310440,224120,534560
9/9/2024,Chathuranga Kalubowila,Polonnaruwa,Kahatagasdigiliya,North Central,1711,4829,6540,68440,193160,261600
9/10/2024,Chathuranga Kalubowila,Polonnaruwa,Kahatagasdigiliya,North Central,5069,2073,7142,202760,82920,285680
9/11/2024,Chathuranga Kalubowila,Polonnaruwa,Kahatagasdigiliya,North Central,7590,8181,15771,303600,327240,630840
9/12/2024,Chathuranga Kalubowila,Polonnaruwa,Kahatagasdigiliya,North Central,6659,6888,13547,266360,275520,541880
9/13/2024,Chathuranga Kalubowila,Polonnaruwa,Kahatagasdigiliya,North Central,9304,8567,17871,372160,342680,714840
9/14/2024,Chathuranga Kalubowila,Polonnaruwa,Kahatagasdigiliya,North Central,2279,4468,6747,91160,178720,269880
9/15/2024,Chathuranga Kalubowila,Polonnaruwa,Kahatagasdigiliya,North Central,8471,3935,12406,338840,157400,496240
9/16/2024,Chathuranga Kalubowila,Polonnaruwa,Kahatagasdigiliya,North Central,6207,9482,15689,248280,379280,627560
9/17/2024,Chathuranga Kalubowila,Polonnaruwa,Kahatagasdigiliya,North Central,659,2481,3140,26360,99240,125600
9/18/2024,Chathuranga Kalubowila,Polonnaruwa,Kahatagasdigiliya,North Central,705,1215,1920,28200,48600,76800
9/19/2024,Chathuranga Kalubowila,Polonnaruwa,Kahatagasdigiliya,North Central,2395,1518,3913,95800,60720,156520
9/20/2024,Chathuranga Kalubowila,Polonnaruwa,Kahatagasdigiliya,North Central,4061,3904,7965,162440,156160,318600
9/21/2024,Chathuranga Kalubowila,Polonnaruwa,Kahatagasdigiliya,North Central,8063,66,8129,322520,2640,325160
9/22/2024,Chathuranga Kalubowila,Polonnaruwa,Kahatagasdigiliya,North Central,8466,6735,15201,338640,269400,608040
9/23/2024,Chathuranga Kalubowila,Polonnaruwa,Kahatagasdigiliya,North Central,1252,3208,4460,50080,128320,178400
9/24/2024,Chathuranga Kalubowila,Polonnaruwa,Kahatagasdigiliya,North Central,734,311,1045,29360,12440,41800
9/25/2024,Chathuranga Kalubowila,Polonnaruwa,Kahatagasdigiliya,North Central,6288,8121,14409,251520,324840,576360
9/26/2024,Chathuranga Kalubowila,Polonnaruwa,Kahatagasdigiliya,North Central,1753,7790,9543,70120,311600,381720
9/27/2024,Chathuranga Kalubowila,Polonnaruwa,Kahatagasdigiliya,North Central,7925,1911,9836,317000,76440,393440
9/28/2024,Chathuranga Kalubowila,Polonnaruwa,Kahatagasdigiliya,North Central,7402,178,7580,296080,7120,303200
9/29/2024,Chathuranga Kalubowila,Polonnaruwa,Kahatagasdigiliya,North Central,4394,8664,13058,175760,346560,522320
9/30/2024,Chathuranga Kalubowila,Polonnaruwa,Kahatagasdigiliya,North Central,3123,9256,12379,124920,370240,495160
10/1/2024,Chathuranga Kalubowila,Polonnaruwa,Kahatagasdigiliya,North Central,9769,1281,11050,390760,51240,442000
10/2/2024,Chathuranga Kalubowila,Polonnaruwa,Kahatagasdigiliya,North Central,5421,8613,14034,216840,344520,561360
10/3/2024,Chathuranga Kalubowila,Polonnaruwa,Kahatagasdigiliya,North Central,1202,4447,5649,48080,177880,225960
10/4/2024,Chathuranga Kalubowila,Polonnaruwa,Kahatagasdigiliya,North Central,995,3921,4916,39800,156840,196640
10/5/2024,Chathuranga Kalubowila,Polonnaruwa,Kahatagasdigiliya,North Central,9792,5291,15083,391680,211640,603320
10/6/2024,Chathuranga Kalubowila,Polonnaruwa,Kahatagasdigiliya,North Central,532,4236,4768,21280,169440,190720
10/7/2024,Chathuranga Kalubowila,Polonnaruwa,Kahatagasdigiliya,North Central,5927,774,6701,237080,30960,268040
10/8/2024,Chathuranga Kalubowila,Polonnaruwa,Kahatagasdigiliya,North Central,234,7246,7480,9360,289840,299200
10/9/2024,Chathuranga Kalubowila,Polonnaruwa,Kahatagasdigiliya,North Central,5265,5713,10978,210600,228520,439120
10/10/2024,Chathuranga Kalubowila,Polonnaruwa,Kahatagasdigiliya,North Central,6227,8787,15014,249080,351480,600560
10/11/2024,Chathuranga Kalubowila,Polonnaruwa,Kahatagasdigiliya,North Central,3888,9521,13409,155520,380840,536360
10/12/2024,Chathuranga Kalubowila,Polonnaruwa,Kahatagasdigiliya,North Central,1194,7543,8737,47760,301720,349480
10/13/2024,Chathuranga Kalubowila,Polonnaruwa,Kahatagasdigiliya,North Central,2794,9356,12150,111760,374240,486000
10/14/2024,Chathuranga Kalubowila,Polonnaruwa,Kahatagasdigiliya,North Central,2657,362,3019,106280,14480,120760
10/15/2024,Chathuranga Kalubowila,Polonnaruwa,Kahatagasdigiliya,North Central,8141,5724,13865,325640,228960,554600
10/16/2024,Chathuranga Kalubowila,Polonnaruwa,Kahatagasdigiliya,North Central,1234,8894,10128,49360,355760,405120
10/17/2024,Chathuranga Kalubowila,Polonnaruwa,Kahatagasdigiliya,North Central,592,7252,7844,23680,290080,313760
10/18/2024,Chathuranga Kalubowila,Polonnaruwa,Kahatagasdigiliya,North Central,3098,202,3300,123920,8080,132000
10/19/2024,Chathuranga Kalubowila,Polonnaruwa,Kahatagasdigiliya,North Central,8142,2453,10595,325680,98120,423800
10/20/2024,Chathuranga Kalubowila,Polonnaruwa,Kahatagasdigiliya,North Central,1290,9261,10551,51600,370440,422040
10/21/2024,Chathuranga Kalubowila,Polonnaruwa,Kahatagasdigiliya,North Central,1524,5467,6991,60960,218680,279640
10/22/2024,Chathuranga Kalubowila,Polonnaruwa,Kahatagasdigiliya,North Central,2296,5704,8000,91840,228160,320000
10/23/2024,Chathuranga Kalubowila,Polonnaruwa,Kahatagasdigiliya,North Central,7871,9444,17315,314840,377760,692600
10/24/2024,Chathuranga Kalubowila,Polonnaruwa,Kahatagasdigiliya,North Central,8954,9887,18841,358160,395480,753640
10/25/2024,Chathuranga Kalubowila,Polonnaruwa,Kahatagasdigiliya,North Central,3937,5719,9656,157480,228760,386240
10/26/2024,Chathuranga Kalubowila,Polonnaruwa,Kahatagasdigiliya,North Central,4766,3305,8071,190640,132200,322840
10/27/2024,Chathuranga Kalubowila,Polonnaruwa,Kahatagasdigiliya,North Central,8108,7292,15400,324320,291680,616000
10/28/2024,Chathuranga Kalubowila,Polonnaruwa,Kahatagasdigiliya,North Central,4906,5992,10898,196240,239680,435920
10/29/2024,Chathuranga Kalubowila,Polonnaruwa,Kahatagasdigiliya,North Central,1151,5556,6707,46040,222240,268280
10/30/2024,Chathuranga Kalubowila,Polonnaruwa,Kahatagasdigiliya,North Central,1217,3041,4258,48680,121640,170320
10/31/2024,Chathuranga Kalubowila,Polonnaruwa,Kahatagasdigiliya,North Central,6171,8911,15082,246840,356440,603280
11/1/2024,Chathuranga Kalubowila,Polonnaruwa,Kahatagasdigiliya,North Central,6187,3104,9291,247480,124160,371640
11/2/2024,Chathuranga Kalubowila,Polonnaruwa,Kahatagasdigiliya,North Central,7398,1131,8529,295920,45240,341160
11/3/2024,Chathuranga Kalubowila,Polonnaruwa,Kahatagasdigiliya,North Central,7815,3925,11740,312600,157000,469600
11/4/2024,Chathuranga Kalubowila,Polonnaruwa,Kahatagasdigiliya,North Central,6495,1337,7832,259800,53480,313280
11/5/2024,Chathuranga Kalubowila,Polonnaruwa,Kahatagasdigiliya,North Central,8534,5941,14475,341360,237640,579000
11/6/2024,Chathuranga Kalubowila,Polonnaruwa,Kahatagasdigiliya,North Central,1003,3597,4600,40120,143880,184000
11/7/2024,Chathuranga Kalubowila,Polonnaruwa,Kahatagasdigiliya,North Central,8555,1408,9963,342200,56320,398520
11/8/2024,Chathuranga Kalubowila,Polonnaruwa,Kahatagasdigiliya,North Central,7629,7419,15048,305160,296760,601920
11/9/2024,Chathuranga Kalubowila,Polonnaruwa,Kahatagasdigiliya,North Central,2575,5391,7966,103000,215640,318640
11/10/2024,Chathuranga Kalubowila,Polonnaruwa,Kahatagasdigiliya,North Central,8196,871,9067,327840,34840,362680
11/11/2024,Chathuranga Kalubowila,Polonnaruwa,Kahatagasdigiliya,North Central,4126,5523,9649,165040,220920,385960
11/12/2024,Chathuranga Kalubowila,Polonnaruwa,Kahatagasdigiliya,North Central,9649,2485,12134,385960,99400,485360
11/13/2024,Chathuranga Kalubowila,Polonnaruwa,Kahatagasdigiliya,North Central,7490,6639,14129,299600,265560,565160
11/14/2024,Chathuranga Kalubowila,Polonnaruwa,Kahatagasdigiliya,North Central,6305,7749,14054,252200,309960,562160
11/15/2024,Chathuranga Kalubowila,Polonnaruwa,Kahatagasdigiliya,North Central,3431,3195,6626,137240,127800,265040
11/16/2024,Chathuranga Kalubowila,Polonnaruwa,Kahatagasdigiliya,North Central,7085,7110,14195,283400,284400,567800
11/17/2024,Chathuranga Kalubowila,Polonnaruwa,Kahatagasdigiliya,North Central,8685,2280,10965,347400,91200,438600
11/18/2024,Chathuranga Kalubowila,Polonnaruwa,Kahatagasdigiliya,North Central,1297,6202,7499,51880,248080,299960
11/19/2024,Chathuranga Kalubowila,Polonnaruwa,Kahatagasdigiliya,North Central,6716,3214,9930,268640,128560,397200
11/20/2024,Chathuranga Kalubowila,Polonnaruwa,Kahatagasdigiliya,North Central,820,5073,5893,32800,202920,235720
11/21/2024,Chathuranga Kalubowila,Polonnaruwa,Kahatagasdigiliya,North Central,5895,7628,13523,235800,305120,540920
11/22/2024,Chathuranga Kalubowila,Polonnaruwa,Kahatagasdigiliya,North Central,6488,8719,15207,259520,348760,608280
11/23/2024,Chathuranga Kalubowila,Polonnaruwa,Kahatagasdigiliya,North Central,2104,6395,8499,84160,255800,339960
11/24/2024,Chathuranga Kalubowila,Polonnaruwa,Kahatagasdigiliya,North Central,4342,3071,7413,173680,122840,296520
11/25/2024,Chathuranga Kalubowila,Polonnaruwa,Kahatagasdigiliya,North Central,7591,9472,17063,303640,378880,682520
11/26/2024,Chathuranga Kalubowila,Polonnaruwa,Kahatagasdigiliya,North Central,4670,8164,12834,186800,326560,513360
11/27/2024,Chathuranga Kalubowila,Polonnaruwa,Kahatagasdigiliya,North Central,565,6010,6575,22600,240400,263000
11/28/2024,Chathuranga Kalubowila,Polonnaruwa,Kahatagasdigiliya,North Central,9685,6741,16426,387400,269640,657040
11/29/2024,Chathuranga Kalubowila,Polonnaruwa,Kahatagasdigiliya,North Central,8404,5139,13543,336160,205560,541720
11/30/2024,Chathuranga Kalubowila,Polonnaruwa,Kahatagasdigiliya,North Central,1950,8348,10298,78000,333920,411920
12/1/2024,Chathuranga Kalubowila,Polonnaruwa,Kahatagasdigiliya,North Central,357,8933,9290,14280,357320,371600
12/2/2024,Chathuranga Kalubowila,Polonnaruwa,Kahatagasdigiliya,North Central,7134,3954,11088,285360,158160,443520
12/3/2024,Chathuranga Kalubowila,Polonnaruwa,Kahatagasdigiliya,North Central,6983,8085,15068,279320,323400,602720
12/4/2024,Chathuranga Kalubowila,Polonnaruwa,Kahatagasdigiliya,North Central,7786,6333,14119,311440,253320,564760
12/5/2024,Chathuranga Kalubowila,Polonnaruwa,Kahatagasdigiliya,North Central,6701,8900,15601,268040,356000,624040
12/6/2024,Chathuranga Kalubowila,Polonnaruwa,Kahatagasdigiliya,North Central,5269,8026,13295,210760,321040,531800
12/7/2024,Chathuranga Kalubowila,Polonnaruwa,Kahatagasdigiliya,North Central,4889,1741,6630,195560,69640,265200
12/8/2024,Chathuranga Kalubowila,Polonnaruwa,Kahatagasdigiliya,North Central,8425,5634,14059,337000,225360,562360
12/9/2024,Chathuranga Kalubowila,Polonnaruwa,Kahatagasdigiliya,North Central,3666,7141,10807,146640,285640,432280
12/10/2024,Chathuranga Kalubowila,Polonnaruwa,Kahatagasdigiliya,North Central,6565,4308,10873,262600,172320,434920
12/11/2024,Chathuranga Kalubowila,Polonnaruwa,Kahatagasdigiliya,North Central,6365,6330,12695,254600,253200,507800
12/12/2024,Chathuranga Kalubowila,Polonnaruwa,Kahatagasdigiliya,North Central,8304,8842,17146,332160,353680,685840
12/13/2024,Chathuranga Kalubowila,Polonnaruwa,Kahatagasdigiliya,North Central,1549,6255,7804,61960,250200,312160
12/14/2024,Chathuranga Kalubowila,Polonnaruwa,Kahatagasdigiliya,North Central,3411,3535,6946,136440,141400,277840
12/15/2024,Chathuranga Kalubowila,Polonnaruwa,Kahatagasdigiliya,North Central,4979,9857,14836,199160,394280,593440
12/16/2024,Chathuranga Kalubowila,Polonnaruwa,Kahatagasdigiliya,North Central,7044,8397,15441,281760,335880,617640
12/17/2024,Chathuranga Kalubowila,Polonnaruwa,Kahatagasdigiliya,North Central,1720,8438,10158,68800,337520,406320
12/18/2024,Chathuranga Kalubowila,Polonnaruwa,Kahatagasdigiliya,North Central,2624,8127,10751,104960,325080,430040
12/19/2024,Chathuranga Kalubowila,Polonnaruwa,Kahatagasdigiliya,North Central,1436,2319,3755,57440,92760,150200
12/20/2024,Chathuranga Kalubowila,Polonnaruwa,Kahatagasdigiliya,North Central,5907,1695,7602,236280,67800,304080
12/21/2024,Chathuranga Kalubowila,Polonnaruwa,Kahatagasdigiliya,North Central,5279,6676,11955,211160,267040,478200
12/22/2024,Chathuranga Kalubowila,Polonnaruwa,Kahatagasdigiliya,North Central,7738,4846,12584,309520,193840,503360
12/23/2024,Chathuranga Kalubowila,Polonnaruwa,Kahatagasdigiliya,North Central,8360,8856,17216,334400,354240,688640
12/24/2024,Chathuranga Kalubowila,Polonnaruwa,Kahatagasdigiliya,North Central,8062,3690,11752,322480,147600,470080
12/25/2024,Chathuranga Kalubowila,Polonnaruwa,Kahatagasdigiliya,North Central,1359,6813,8172,54360,272520,326880
12/26/2024,Chathuranga Kalubowila,Polonnaruwa,Kahatagasdigiliya,North Central,722,9293,10015,28880,371720,400600
12/27/2024,Chathuranga Kalubowila,Polonnaruwa,Kahatagasdigiliya,North Central,2278,9358,11636,91120,374320,465440
12/28/2024,Chathuranga Kalubowila,Polonnaruwa,Kahatagasdigiliya,North Central,4447,3046,7493,177880,121840,299720
12/29/2024,Chathuranga Kalubowila,Polonnaruwa,Kahatagasdigiliya,North Central,4912,1490,6402,196480,59600,256080
12/30/2024,Chathuranga Kalubowila,Polonnaruwa,Kahatagasdigiliya,North Central,8639,8737,17376,345560,349480,695040
12/31/2024,Chathuranga Kalubowila,Polonnaruwa,Kahatagasdigiliya,North Central,434,6719,7153,17360,268760,286120
1/1/2025,Chathuranga Kalubowila,Polonnaruwa,Kahatagasdigiliya,North Central,652,2990,3642,26080,119600,145680
1/2/2025,Chathuranga Kalubowila,Polonnaruwa,Kahatagasdigiliya,North Central,3847,3250,7097,153880,130000,283880
1/3/2025,Chathuranga Kalubowila,Polonnaruwa,Kahatagasdigiliya,North Central,78,1225,1303,3120,49000,52120
1/4/2025,Chathuranga Kalubowila,Polonnaruwa,Kahatagasdigiliya,North Central,7020,4113,11133,280800,164520,445320
1/5/2025,Chathuranga Kalubowila,Polonnaruwa,Kahatagasdigiliya,North Central,7299,5905,13204,291960,236200,528160
1/6/2025,Chathuranga Kalubowila,Polonnaruwa,Kahatagasdigiliya,North Central,3811,6427,10238,152440,257080,409520
1/7/2025,Chathuranga Kalubowila,Polonnaruwa,Kahatagasdigiliya,North Central,1620,1586,3206,64800,63440,128240
1/8/2025,Chathuranga Kalubowila,Polonnaruwa,Kahatagasdigiliya,North Central,5124,2246,7370,204960,89840,294800
1/9/2025,Chathuranga Kalubowila,Polonnaruwa,Kahatagasdigiliya,North Central,3964,1682,5646,158560,67280,225840
1/10/2025,Chathuranga Kalubowila,Polonnaruwa,Kahatagasdigiliya,North Central,9133,9767,18900,365320,390680,756000
1/11/2025,Chathuranga Kalubowila,Polonnaruwa,Kahatagasdigiliya,North Central,2529,694,3223,101160,27760,128920
1/12/2025,Chathuranga Kalubowila,Polonnaruwa,Kahatagasdigiliya,North Central,494,9735,10229,19760,389400,409160
1/13/2025,Chathuranga Kalubowila,Polonnaruwa,Kahatagasdigiliya,North Central,2795,3844,6639,111800,153760,265560
1/14/2025,Chathuranga Kalubowila,Polonnaruwa,Kahatagasdigiliya,North Central,6572,4919,11491,262880,196760,459640
1/15/2025,Chathuranga Kalubowila,Polonnaruwa,Kahatagasdigiliya,North Central,5191,9166,14357,207640,366640,574280
1/16/2025,Chathuranga Kalubowila,Polonnaruwa,Kahatagasdigiliya,North Central,633,2040,2673,25320,81600,106920
1/17/2025,Chathuranga Kalubowila,Polonnaruwa,Kahatagasdigiliya,North Central,9725,2862,12587,389000,114480,503480
1/18/2025,Chathuranga Kalubowila,Polonnaruwa,Kahatagasdigiliya,North Central,8351,1942,10293,334040,77680,411720
1/19/2025,Chathuranga Kalubowila,Polonnaruwa,Kahatagasdigiliya,North Central,4489,7311,11800,179560,292440,472000
1/20/2025,Chathuranga Kalubowila,Polonnaruwa,Kahatagasdigiliya,North Central,6654,9091,15745,266160,363640,629800
1/21/2025,Chathuranga Kalubowila,Polonnaruwa,Kahatagasdigiliya,North Central,9638,9658,19296,385520,386320,771840
1/22/2025,Chathuranga Kalubowila,Polonnaruwa,Kahatagasdigiliya,North Central,4901,7912,12813,196040,316480,512520
1/23/2025,Chathuranga Kalubowila,Polonnaruwa,Kahatagasdigiliya,North Central,946,4440,5386,37840,177600,215440
1/24/2025,Chathuranga Kalubowila,Polonnaruwa,Kahatagasdigiliya,North Central,7252,6187,13439,290080,247480,537560
1/25/2025,Chathuranga Kalubowila,Polonnaruwa,Kahatagasdigiliya,North Central,4545,4167,8712,181800,166680,348480
1/26/2025,Chathuranga Kalubowila,Polonnaruwa,Kahatagasdigiliya,North Central,535,8664,9199,21400,346560,367960
1/27/2025,Chathuranga Kalubowila,Polonnaruwa,Kahatagasdigiliya,North Central,6132,4028,10160,245280,161120,406400
1/28/2025,Chathuranga Kalubowila,Polonnaruwa,Kahatagasdigiliya,North Central,6180,3458,9638,247200,138320,385520
1/29/2025,Chathuranga Kalubowila,Polonnaruwa,Kahatagasdigiliya,North Central,7240,7080,14320,289600,283200,572800
1/30/2025,Chathuranga Kalubowila,Polonnaruwa,Kahatagasdigiliya,North Central,3941,4693,8634,157640,187720,345360
1/31/2025,Chathuranga Kalubowila,Polonnaruwa,Kahatagasdigiliya,North Central,8151,9358,17509,326040,374320,700360
2/1/2025,Chathuranga Kalubowila,Polonnaruwa,Kahatagasdigiliya,North Central,603,3936,4539,24120,157440,181560
2/2/2025,Chathuranga Kalubowila,Polonnaruwa,Kahatagasdigiliya,North Central,2964,4046,7010,118560,161840,280400
2/3/2025,Chathuranga Kalubowila,Polonnaruwa,Kahatagasdigiliya,North Central,9690,7744,17434,387600,309760,697360
2/4/2025,Chathuranga Kalubowila,Polonnaruwa,Kahatagasdigiliya,North Central,8387,8995,17382,335480,359800,695280
2/5/2025,Chathuranga Kalubowila,Polonnaruwa,Kahatagasdigiliya,North Central,1015,5913,6928,40600,236520,277120
2/6/2025,Chathuranga Kalubowila,Polonnaruwa,Kahatagasdigiliya,North Central,5839,919,6758,233560,36760,270320
2/7/2025,Chathuranga Kalubowila,Polonnaruwa,Kahatagasdigiliya,North Central,6224,6130,12354,248960,245200,494160
2/8/2025,Chathuranga Kalubowila,Polonnaruwa,Kahatagasdigiliya,North Central,9973,5856,15829,398920,234240,633160
2/9/2025,Chathuranga Kalubowila,Polonnaruwa,Kahatagasdigiliya,North Central,3583,4943,8526,143320,197720,341040
2/10/2025,Chathuranga Kalubowila,Polonnaruwa,Kahatagasdigiliya,North Central,6480,183,6663,259200,7320,266520
2/11/2025,Chathuranga Kalubowila,Polonnaruwa,Kahatagasdigiliya,North Central,9402,7406,16808,376080,296240,672320
2/12/2025,Chathuranga Kalubowila,Polonnaruwa,Kahatagasdigiliya,North Central,6242,2831,9073,249680,113240,362920
2/13/2025,Chathuranga Kalubowila,Polonnaruwa,Kahatagasdigiliya,North Central,4758,2648,7406,190320,105920,296240
2/14/2025,Chathuranga Kalubowila,Polonnaruwa,Kahatagasdigiliya,North Central,614,3963,4577,24560,158520,183080
2/15/2025,Chathuranga Kalubowila,Polonnaruwa,Kahatagasdigiliya,North Central,3148,1337,4485,125920,53480,179400
2/16/2025,Chathuranga Kalubowila,Polonnaruwa,Kahatagasdigiliya,North Central,3247,8535,11782,129880,341400,471280
2/17/2025,Chathuranga Kalubowila,Polonnaruwa,Kahatagasdigiliya,North Central,655,9889,10544,26200,395560,421760
2/18/2025,Chathuranga Kalubowila,Polonnaruwa,Kahatagasdigiliya,North Central,2778,4292,7070,111120,171680,282800
2/19/2025,Chathuranga Kalubowila,Polonnaruwa,Kahatagasdigiliya,North Central,2745,822,3567,109800,32880,142680
2/20/2025,Chathuranga Kalubowila,Polonnaruwa,Kahatagasdigiliya,North Central,7355,928,8283,294200,37120,331320
2/21/2025,Chathuranga Kalubowila,Polonnaruwa,Kahatagasdigiliya,North Central,529,1617,2146,21160,64680,85840
2/22/2025,Chathuranga Kalubowila,Polonnaruwa,Kahatagasdigiliya,North Central,9917,8341,18258,396680,333640,730320
2/23/2025,Chathuranga Kalubowila,Polonnaruwa,Kahatagasdigiliya,North Central,3275,6849,10124,131000,273960,404960
2/24/2025,Chathuranga Kalubowila,Polonnaruwa,Kahatagasdigiliya,North Central,347,4694,5041,13880,187760,201640
2/25/2025,Chathuranga Kalubowila,Polonnaruwa,Kahatagasdigiliya,North Central,8524,2750,11274,340960,110000,450960
2/26/2025,Chathuranga Kalubowila,Polonnaruwa,Kahatagasdigiliya,North Central,7735,7836,15571,309400,313440,622840
2/27/2025,Chathuranga Kalubowila,Polonnaruwa,Kahatagasdigiliya,North Central,9127,8956,18083,365080,358240,723320
2/28/2025,Chathuranga Kalubowila,Polonnaruwa,Kahatagasdigiliya,North Central,7057,4360,11417,282280,174400,456680
3/1/2025,Chathuranga Kalubowila,Polonnaruwa,Kahatagasdigiliya,North Central,8145,1593,9738,325800,63720,389520
3/2/2025,Chathuranga Kalubowila,Polonnaruwa,Kahatagasdigiliya,North Central,6306,8986,15292,252240,359440,611680
3/3/2025,Chathuranga Kalubowila,Polonnaruwa,Kahatagasdigiliya,North Central,4555,9493,14048,182200,379720,561920
3/4/2025,Chathuranga Kalubowila,Polonnaruwa,Kahatagasdigiliya,North Central,2483,5363,7846,99320,214520,313840
3/5/2025,Chathuranga Kalubowila,Polonnaruwa,Kahatagasdigiliya,North Central,2893,4593,7486,115720,183720,299440
3/6/2025,Chathuranga Kalubowila,Polonnaruwa,Kahatagasdigiliya,North Central,2952,3892,6844,118080,155680,273760
3/7/2025,Chathuranga Kalubowila,Polonnaruwa,Kahatagasdigiliya,North Central,4813,1017,5830,192520,40680,233200
3/8/2025,Chathuranga Kalubowila,Polonnaruwa,Kahatagasdigiliya,North Central,8757,4700,13457,350280,188000,538280
3/9/2025,Chathuranga Kalubowila,Polonnaruwa,Kahatagasdigiliya,North Central,4065,6678,10743,162600,267120,429720
3/10/2025,Chathuranga Kalubowila,Polonnaruwa,Kahatagasdigiliya,North Central,8463,1375,9838,338520,55000,393520
3/11/2025,Chathuranga Kalubowila,Polonnaruwa,Kahatagasdigiliya,North Central,3676,3534,7210,147040,141360,288400
3/12/2025,Chathuranga Kalubowila,Polonnaruwa,Kahatagasdigiliya,North Central,3162,7996,11158,126480,319840,446320
3/13/2025,Chathuranga Kalubowila,Polonnaruwa,Kahatagasdigiliya,North Central,9074,884,9958,362960,35360,398320
3/14/2025,Chathuranga Kalubowila,Polonnaruwa,Kahatagasdigiliya,North Central,5691,9740,15431,227640,389600,617240
3/15/2025,Chathuranga Kalubowila,Polonnaruwa,Kahatagasdigiliya,North Central,2964,1199,4163,118560,47960,166520
3/16/2025,Chathuranga Kalubowila,Polonnaruwa,Kahatagasdigiliya,North Central,5331,8560,13891,213240,342400,555640
3/17/2025,Chathuranga Kalubowila,Polonnaruwa,Kahatagasdigiliya,North Central,5145,7391,12536,205800,295640,501440
3/18/2025,Chathuranga Kalubowila,Polonnaruwa,Kahatagasdigiliya,North Central,6167,7171,13338,246680,286840,533520
3/19/2025,Chathuranga Kalubowila,Polonnaruwa,Kahatagasdigiliya,North Central,3535,9219,12754,141400,368760,510160
3/20/2025,Chathuranga Kalubowila,Polonnaruwa,Kahatagasdigiliya,North Central,5998,8148,14146,239920,325920,565840
3/21/2025,Chathuranga Kalubowila,Polonnaruwa,Kahatagasdigiliya,North Central,5662,8889,14551,226480,355560,582040
3/22/2025,Chathuranga Kalubowila,Polonnaruwa,Kahatagasdigiliya,North Central,195,1826,2021,7800,73040,80840
3/23/2025,Chathuranga Kalubowila,Polonnaruwa,Kahatagasdigiliya,North Central,7541,7192,14733,301640,287680,589320
3/25/2024,Amara Weerasinghe,Matara,Dikwella,Southern,2246,917,3163,89840,36680,126520
3/26/2024,Amara Weerasinghe,Matara,Dikwella,Southern,3475,4467,7942,139000,178680,317680
3/27/2024,Amara Weerasinghe,Matara,Dikwella,Southern,3160,4910,8070,126400,196400,322800
3/28/2024,Amara Weerasinghe,Matara,Dikwella,Southern,6939,7164,14103,277560,286560,564120
3/29/2024,Amara Weerasinghe,Matara,Dikwella,Southern,3229,3667,6896,129160,146680,275840
3/30/2024,Amara Weerasinghe,Matara,Dikwella,Southern,2565,4422,6987,102600,176880,279480
3/31/2024,Amara Weerasinghe,Matara,Dikwella,Southern,2227,7466,9693,89080,298640,387720
4/1/2024,Amara Weerasinghe,Matara,Dikwella,Southern,1760,6152,7912,70400,246080,316480
4/2/2024,Amara Weerasinghe,Matara,Dikwella,Southern,8009,9400,17409,320360,376000,696360
4/3/2024,Amara Weerasinghe,Matara,Dikwella,Southern,1373,325,1698,54920,13000,67920
4/4/2024,Amara Weerasinghe,Matara,Dikwella,Southern,5419,8319,13738,216760,332760,549520
4/5/2024,Amara Weerasinghe,Matara,Dikwella,Southern,9347,1775,11122,373880,71000,444880
4/6/2024,Amara Weerasinghe,Matara,Dikwella,Southern,4327,5085,9412,173080,203400,376480
4/7/2024,Amara Weerasinghe,Matara,Dikwella,Southern,5572,5767,11339,222880,230680,453560
4/8/2024,Amara Weerasinghe,Matara,Dikwella,Southern,5749,8906,14655,229960,356240,586200
4/9/2024,Amara Weerasinghe,Matara,Dikwella,Southern,2111,1186,3297,84440,47440,131880
4/10/2024,Amara Weerasinghe,Matara,Dikwella,Southern,6138,594,6732,245520,23760,269280
4/11/2024,Amara Weerasinghe,Matara,Dikwella,Southern,2383,9871,12254,95320,394840,490160
4/19/2024,Amara Weerasinghe,Matara,Dikwella,Southern,2599,7292,9891,103960,291680,395640
4/20/2024,Amara Weerasinghe,Matara,Dikwella,Southern,4919,610,5529,196760,24400,221160
4/21/2024,Amara Weerasinghe,Matara,Dikwella,Southern,2837,9568,12405,113480,382720,496200
4/22/2024,Amara Weerasinghe,Matara,Dikwella,Southern,1777,3226,5003,71080,129040,200120
4/23/2024,Amara Weerasinghe,Matara,Dikwella,Southern,8325,4026,12351,333000,161040,494040
4/24/2024,Amara Weerasinghe,Matara,Dikwella,Southern,548,5944,6492,21920,237760,259680
4/25/2024,Amara Weerasinghe,Matara,Dikwella,Southern,6293,1829,8122,251720,73160,324880
4/26/2024,Amara Weerasinghe,Matara,Dikwella,Southern,4942,9200,14142,197680,368000,565680
4/27/2024,Amara Weerasinghe,Matara,Dikwella,Southern,6781,5048,11829,271240,201920,473160
4/28/2024,Amara Weerasinghe,Matara,Dikwella,Southern,5525,3993,9518,221000,159720,380720
4/29/2024,Amara Weerasinghe,Matara,Dikwella,Southern,2765,3750,6515,110600,150000,260600
4/30/2024,Amara Weerasinghe,Matara,Dikwella,Southern,840,1298,2138,33600,51920,85520
5/1/2024,Amara Weerasinghe,Matara,Dikwella,Southern,3558,2261,5819,142320,90440,232760
5/2/2024,Amara Weerasinghe,Matara,Dikwella,Southern,2553,5837,8390,102120,233480,335600
5/3/2024,Amara Weerasinghe,Matara,Dikwella,Southern,8339,3687,12026,333560,147480,481040
5/4/2024,Amara Weerasinghe,Matara,Dikwella,Southern,429,2299,2728,17160,91960,109120
5/5/2024,Amara Weerasinghe,Matara,Dikwella,Southern,1168,2242,3410,46720,89680,136400
5/6/2024,Amara Weerasinghe,Matara,Dikwella,Southern,79,4089,4168,3160,163560,166720
5/7/2024,Amara Weerasinghe,Matara,Dikwella,Southern,5409,2379,7788,216360,95160,311520
5/8/2024,Amara Weerasinghe,Matara,Dikwella,Southern,4936,7609,12545,197440,304360,501800
5/9/2024,Amara Weerasinghe,Matara,Dikwella,Southern,9757,7252,17009,390280,290080,680360
5/10/2024,Amara Weerasinghe,Matara,Dikwella,Southern,3826,1014,4840,153040,40560,193600
5/11/2024,Amara Weerasinghe,Matara,Dikwella,Southern,6695,7198,13893,267800,287920,555720
5/12/2024,Amara Weerasinghe,Matara,Dikwella,Southern,5894,7728,13622,235760,309120,544880
5/13/2024,Amara Weerasinghe,Matara,Dikwella,Southern,1442,1708,3150,57680,68320,126000
5/14/2024,Amara Weerasinghe,Matara,Dikwella,Southern,869,4109,4978,34760,164360,199120
5/15/2024,Amara Weerasinghe,Matara,Dikwella,Southern,8075,4767,12842,323000,190680,513680
5/16/2024,Amara Weerasinghe,Matara,Dikwella,Southern,6814,2051,8865,272560,82040,354600
5/17/2024,Amara Weerasinghe,Matara,Dikwella,Southern,3209,8230,11439,128360,329200,457560
5/18/2024,Amara Weerasinghe,Matara,Dikwella,Southern,8010,4305,12315,320400,172200,492600
5/19/2024,Amara Weerasinghe,Matara,Dikwella,Southern,3615,3728,7343,144600,149120,293720
5/20/2024,Amara Weerasinghe,Matara,Dikwella,Southern,6761,6860,13621,270440,274400,544840
5/21/2024,Amara Weerasinghe,Matara,Dikwella,Southern,5244,5564,10808,209760,222560,432320
5/22/2024,Amara Weerasinghe,Matara,Dikwella,Southern,14,3028,3042,560,121120,121680
5/24/2024,Amara Weerasinghe,Matara,Dikwella,Southern,1095,6953,8048,43800,278120,321920
5/25/2024,Amara Weerasinghe,Matara,Dikwella,Southern,5828,4947,10775,233120,197880,431000
5/26/2024,Amara Weerasinghe,Matara,Dikwella,Southern,5094,2168,7262,203760,86720,290480
5/27/2024,Amara Weerasinghe,Matara,Dikwella,Southern,3166,9167,12333,126640,366680,493320
5/28/2024,Amara Weerasinghe,Matara,Dikwella,Southern,8022,3523,11545,320880,140920,461800
5/29/2024,Amara Weerasinghe,Matara,Dikwella,Southern,404,1692,2096,16160,67680,83840
5/30/2024,Amara Weerasinghe,Matara,Dikwella,Southern,6191,168,6359,247640,6720,254360
5/31/2024,Amara Weerasinghe,Matara,Dikwella,Southern,6590,7837,14427,263600,313480,577080
6/1/2024,Amara Weerasinghe,Matara,Dikwella,Southern,6839,1995,8834,273560,79800,353360
6/2/2024,Amara Weerasinghe,Matara,Dikwella,Southern,1079,2851,3930,43160,114040,157200
6/3/2024,Amara Weerasinghe,Matara,Dikwella,Southern,1136,1562,2698,45440,62480,107920
6/4/2024,Amara Weerasinghe,Matara,Dikwella,Southern,1863,1678,3541,74520,67120,141640
6/5/2024,Amara Weerasinghe,Matara,Dikwella,Southern,5059,7486,12545,202360,299440,501800
6/6/2024,Amara Weerasinghe,Matara,Dikwella,Southern,6519,1618,8137,260760,64720,325480
6/7/2024,Amara Weerasinghe,Matara,Dikwella,Southern,4525,9573,14098,181000,382920,563920
6/8/2024,Amara Weerasinghe,Matara,Dikwella,Southern,4701,7265,11966,188040,290600,478640
6/9/2024,Amara Weerasinghe,Matara,Dikwella,Southern,1541,4182,5723,61640,167280,228920
6/10/2024,Amara Weerasinghe,Matara,Dikwella,Southern,991,9403,10394,39640,376120,415760
6/11/2024,Amara Weerasinghe,Matara,Dikwella,Southern,9804,534,10338,392160,21360,413520
6/12/2024,Amara Weerasinghe,Matara,Dikwella,Southern,2242,5102,7344,89680,204080,293760
6/13/2024,Amara Weerasinghe,Matara,Dikwella,Southern,1005,6677,7682,40200,267080,307280
6/14/2024,Amara Weerasinghe,Matara,Dikwella,Southern,5331,2334,7665,213240,93360,306600
6/15/2024,Amara Weerasinghe,Matara,Dikwella,Southern,2725,2217,4942,109000,88680,197680
6/16/2024,Amara Weerasinghe,Matara,Dikwella,Southern,6818,6663,13481,272720,266520,539240
6/17/2024,Amara Weerasinghe,Matara,Dikwella,Southern,8043,6395,14438,321720,255800,577520
6/18/2024,Amara Weerasinghe,Matara,Dikwella,Southern,6858,6342,13200,274320,253680,528000
6/19/2024,Amara Weerasinghe,Matara,Dikwella,Southern,1983,5397,7380,79320,215880,295200
6/20/2024,Amara Weerasinghe,Matara,Dikwella,Southern,6761,9353,16114,270440,374120,644560
6/21/2024,Amara Weerasinghe,Matara,Dikwella,Southern,2069,1114,3183,82760,44560,127320
6/22/2024,Amara Weerasinghe,Matara,Dikwella,Southern,5001,4616,9617,200040,184640,384680
6/23/2024,Amara Weerasinghe,Matara,Dikwella,Southern,4487,6317,10804,179480,252680,432160
6/24/2024,Amara Weerasinghe,Matara,Dikwella,Southern,7010,4578,11588,280400,183120,463520
6/25/2024,Amara Weerasinghe,Matara,Dikwella,Southern,8792,8382,17174,351680,335280,686960
6/26/2024,Amara Weerasinghe,Matara,Dikwella,Southern,7998,5739,13737,319920,229560,549480
6/27/2024,Amara Weerasinghe,Matara,Dikwella,Southern,3153,7262,10415,126120,290480,416600
6/28/2024,Amara Weerasinghe,Matara,Dikwella,Southern,1807,8678,10485,72280,347120,419400
6/29/2024,Amara Weerasinghe,Matara,Dikwella,Southern,6249,8745,14994,249960,349800,599760
6/30/2024,Amara Weerasinghe,Matara,Dikwella,Southern,8137,3443,11580,325480,137720,463200
7/1/2024,Amara Weerasinghe,Matara,Dikwella,Southern,8915,5694,14609,356600,227760,584360
7/2/2024,Amara Weerasinghe,Matara,Dikwella,Southern,5697,420,6117,227880,16800,244680
7/3/2024,Amara Weerasinghe,Matara,Dikwella,Southern,2686,3233,5919,107440,129320,236760
7/4/2024,Amara Weerasinghe,Matara,Dikwella,Southern,9899,6239,16138,395960,249560,645520
7/5/2024,Amara Weerasinghe,Matara,Dikwella,Southern,5856,3738,9594,234240,149520,383760
7/6/2024,Amara Weerasinghe,Matara,Dikwella,Southern,8389,9492,17881,335560,379680,715240
7/7/2024,Amara Weerasinghe,Matara,Dikwella,Southern,6989,9816,16805,279560,392640,672200
7/8/2024,Amara Weerasinghe,Matara,Dikwella,Southern,6224,4178,10402,248960,167120,416080
7/9/2024,Amara Weerasinghe,Matara,Dikwella,Southern,4795,2626,7421,191800,105040,296840
7/10/2024,Amara Weerasinghe,Matara,Dikwella,Southern,2503,8738,11241,100120,349520,449640
7/11/2024,Amara Weerasinghe,Matara,Dikwella,Southern,2377,3181,5558,95080,127240,222320
7/12/2024,Amara Weerasinghe,Matara,Dikwella,Southern,3565,2900,6465,142600,116000,258600
7/13/2024,Amara Weerasinghe,Matara,Dikwella,Southern,7787,2272,10059,311480,90880,402360
7/14/2024,Amara Weerasinghe,Matara,Dikwella,Southern,7316,1707,9023,292640,68280,360920
7/15/2024,Amara Weerasinghe,Matara,Dikwella,Southern,9858,3806,13664,394320,152240,546560
7/16/2024,Amara Weerasinghe,Matara,Dikwella,Southern,4873,194,5067,194920,7760,202680
7/17/2024,Amara Weerasinghe,Matara,Dikwella,Southern,3809,8947,12756,152360,357880,510240
7/18/2024,Amara Weerasinghe,Matara,Dikwella,Southern,3712,1266,4978,148480,50640,199120
7/19/2024,Amara Weerasinghe,Matara,Dikwella,Southern,2900,7900,10800,116000,316000,432000
7/20/2024,Amara Weerasinghe,Matara,Dikwella,Southern,5297,4797,10094,211880,191880,403760
7/21/2024,Amara Weerasinghe,Matara,Dikwella,Southern,342,5217,5559,13680,208680,222360
7/22/2024,Amara Weerasinghe,Matara,Dikwella,Southern,3170,2259,5429,126800,90360,217160
7/23/2024,Amara Weerasinghe,Matara,Dikwella,Southern,9767,1372,11139,390680,54880,445560
7/24/2024,Amara Weerasinghe,Matara,Dikwella,Southern,5624,627,6251,224960,25080,250040
7/25/2024,Amara Weerasinghe,Matara,Dikwella,Southern,2286,4897,7183,91440,195880,287320
7/26/2024,Amara Weerasinghe,Matara,Dikwella,Southern,3493,2397,5890,139720,95880,235600
7/27/2024,Amara Weerasinghe,Matara,Dikwella,Southern,4332,8835,13167,173280,353400,526680
7/28/2024,Amara Weerasinghe,Matara,Dikwella,Southern,3793,4658,8451,151720,186320,338040
7/29/2024,Amara Weerasinghe,Matara,Dikwella,Southern,8996,3460,12456,359840,138400,498240
7/30/2024,Amara Weerasinghe,Matara,Dikwella,Southern,6854,8425,15279,274160,337000,611160
7/31/2024,Amara Weerasinghe,Matara,Dikwella,Southern,4280,8250,12530,171200,330000,501200
8/1/2024,Amara Weerasinghe,Matara,Dikwella,Southern,9704,2316,12020,388160,92640,480800
8/2/2024,Amara Weerasinghe,Matara,Dikwella,Southern,9117,6889,16006,364680,275560,640240
8/3/2024,Amara Weerasinghe,Matara,Dikwella,Southern,8634,9649,18283,345360,385960,731320
8/4/2024,Amara Weerasinghe,Matara,Dikwella,Southern,9371,9904,19275,374840,396160,771000
8/5/2024,Amara Weerasinghe,Matara,Dikwella,Southern,1650,5415,7065,66000,216600,282600
8/6/2024,Amara Weerasinghe,Matara,Dikwella,Southern,4523,943,5466,180920,37720,218640
8/7/2024,Amara Weerasinghe,Matara,Dikwella,Southern,6525,1531,8056,261000,61240,322240
8/8/2024,Amara Weerasinghe,Matara,Dikwella,Southern,3213,1053,4266,128520,42120,170640
8/9/2024,Amara Weerasinghe,Matara,Dikwella,Southern,5458,9315,14773,218320,372600,590920
8/10/2024,Amara Weerasinghe,Matara,Dikwella,Southern,2922,4040,6962,116880,161600,278480
8/11/2024,Amara Weerasinghe,Matara,Dikwella,Southern,8908,7200,16108,356320,288000,644320
8/12/2024,Amara Weerasinghe,Matara,Dikwella,Southern,771,3904,4675,30840,156160,187000
8/13/2024,Amara Weerasinghe,Matara,Dikwella,Southern,1225,5628,6853,49000,225120,274120
8/14/2024,Amara Weerasinghe,Matara,Dikwella,Southern,9241,8070,17311,369640,322800,692440
8/15/2024,Amara Weerasinghe,Matara,Dikwella,Southern,6997,1289,8286,279880,51560,331440
8/16/2024,Amara Weerasinghe,Matara,Dikwella,Southern,8779,8599,17378,351160,343960,695120
8/17/2024,Amara Weerasinghe,Matara,Dikwella,Southern,4725,7018,11743,189000,280720,469720
8/18/2024,Amara Weerasinghe,Matara,Dikwella,Southern,6461,2853,9314,258440,114120,372560
8/19/2024,Amara Weerasinghe,Matara,Dikwella,Southern,8777,9716,18493,351080,388640,739720
8/20/2024,Amara Weerasinghe,Matara,Dikwella,Southern,3108,7038,10146,124320,281520,405840
8/21/2024,Amara Weerasinghe,Matara,Dikwella,Southern,1180,3741,4921,47200,149640,196840
8/22/2024,Amara Weerasinghe,Matara,Dikwella,Southern,6585,297,6882,263400,11880,275280
8/23/2024,Amara Weerasinghe,Matara,Dikwella,Southern,6110,5493,11603,244400,219720,464120
8/24/2024,Amara Weerasinghe,Matara,Dikwella,Southern,7443,9202,16645,297720,368080,665800
8/25/2024,Amara Weerasinghe,Matara,Dikwella,Southern,9611,4443,14054,384440,177720,562160
8/26/2024,Amara Weerasinghe,Matara,Dikwella,Southern,1704,6175,7879,68160,247000,315160
8/27/2024,Amara Weerasinghe,Matara,Dikwella,Southern,8431,8323,16754,337240,332920,670160
8/28/2024,Amara Weerasinghe,Matara,Dikwella,Southern,9683,8783,18466,387320,351320,738640
8/29/2024,Amara Weerasinghe,Matara,Dikwella,Southern,9698,8893,18591,387920,355720,743640
8/30/2024,Amara Weerasinghe,Matara,Dikwella,Southern,427,2373,2800,17080,94920,112000
8/31/2024,Amara Weerasinghe,Matara,Dikwella,Southern,2417,7054,9471,96680,282160,378840
9/1/2024,Amara Weerasinghe,Matara,Dikwella,Southern,1419,7078,8497,56760,283120,339880
9/2/2024,Amara Weerasinghe,Matara,Dikwella,Southern,5959,6684,12643,238360,267360,505720
9/3/2024,Amara Weerasinghe,Matara,Dikwella,Southern,3715,4359,8074,148600,174360,322960
9/4/2024,Amara Weerasinghe,Matara,Dikwella,Southern,9923,7903,17826,396920,316120,713040
9/5/2024,Amara Weerasinghe,Matara,Dikwella,Southern,7362,7786,15148,294480,311440,605920
9/6/2024,Amara Weerasinghe,Matara,Dikwella,Southern,828,658,1486,33120,26320,59440
9/7/2024,Amara Weerasinghe,Matara,Dikwella,Southern,2162,7227,9389,86480,289080,375560
9/8/2024,Amara Weerasinghe,Matara,Dikwella,Southern,4492,6468,10960,179680,258720,438400
9/9/2024,Amara Weerasinghe,Matara,Dikwella,Southern,6374,7423,13797,254960,296920,551880
9/10/2024,Amara Weerasinghe,Matara,Dikwella,Southern,8693,7753,16446,347720,310120,657840
9/11/2024,Amara Weerasinghe,Matara,Dikwella,Southern,3705,2228,5933,148200,89120,237320
9/12/2024,Amara Weerasinghe,Matara,Dikwella,Southern,8821,7692,16513,352840,307680,660520
9/13/2024,Amara Weerasinghe,Matara,Dikwella,Southern,3151,7385,10536,126040,295400,421440
9/14/2024,Amara Weerasinghe,Matara,Dikwella,Southern,5332,995,6327,213280,39800,253080
9/15/2024,Amara Weerasinghe,Matara,Dikwella,Southern,7211,3801,11012,288440,152040,440480
9/16/2024,Amara Weerasinghe,Matara,Dikwella,Southern,7937,2980,10917,317480,119200,436680
9/17/2024,Amara Weerasinghe,Matara,Dikwella,Southern,2602,5305,7907,104080,212200,316280
9/18/2024,Amara Weerasinghe,Matara,Dikwella,Southern,9064,1077,10141,362560,43080,405640
9/19/2024,Amara Weerasinghe,Matara,Dikwella,Southern,1191,5564,6755,47640,222560,270200
9/20/2024,Amara Weerasinghe,Matara,Dikwella,Southern,554,6818,7372,22160,272720,294880
9/21/2024,Amara Weerasinghe,Matara,Dikwella,Southern,4793,1698,6491,191720,67920,259640
9/22/2024,Amara Weerasinghe,Matara,Dikwella,Southern,4225,9415,13640,169000,376600,545600
9/23/2024,Amara Weerasinghe,Matara,Dikwella,Southern,8081,5725,13806,323240,229000,552240
9/24/2024,Amara Weerasinghe,Matara,Dikwella,Southern,6504,617,7121,260160,24680,284840
9/25/2024,Amara Weerasinghe,Matara,Dikwella,Southern,9567,3641,13208,382680,145640,528320
9/26/2024,Amara Weerasinghe,Matara,Dikwella,Southern,1764,7570,9334,70560,302800,373360
9/27/2024,Amara Weerasinghe,Matara,Dikwella,Southern,9466,8830,18296,378640,353200,731840
9/28/2024,Amara Weerasinghe,Matara,Dikwella,Southern,9262,4958,14220,370480,198320,568800
9/29/2024,Amara Weerasinghe,Matara,Dikwella,Southern,617,841,1458,24680,33640,58320
9/30/2024,Amara Weerasinghe,Matara,Dikwella,Southern,3420,1334,4754,136800,53360,190160
10/1/2024,Amara Weerasinghe,Matara,Dikwella,Southern,6408,6066,12474,256320,242640,498960
10/2/2024,Amara Weerasinghe,Matara,Dikwella,Southern,1465,7570,9035,58600,302800,361400
10/3/2024,Amara Weerasinghe,Matara,Dikwella,Southern,8489,9540,18029,339560,381600,721160
10/4/2024,Amara Weerasinghe,Matara,Dikwella,Southern,6936,6016,12952,277440,240640,518080
10/5/2024,Amara Weerasinghe,Matara,Dikwella,Southern,3926,9741,13667,157040,389640,546680
10/6/2024,Amara Weerasinghe,Matara,Dikwella,Southern,7062,4122,11184,282480,164880,447360
10/7/2024,Amara Weerasinghe,Matara,Dikwella,Southern,6714,1799,8513,268560,71960,340520
10/8/2024,Amara Weerasinghe,Matara,Dikwella,Southern,5603,5717,11320,224120,228680,452800
10/9/2024,Amara Weerasinghe,Matara,Dikwella,Southern,4760,5055,9815,190400,202200,392600
10/10/2024,Amara Weerasinghe,Matara,Dikwella,Southern,8162,7568,15730,326480,302720,629200
10/11/2024,Amara Weerasinghe,Matara,Dikwella,Southern,9511,2909,12420,380440,116360,496800
10/12/2024,Amara Weerasinghe,Matara,Dikwella,Southern,4955,3837,8792,198200,153480,351680
10/13/2024,Amara Weerasinghe,Matara,Dikwella,Southern,7429,4007,11436,297160,160280,457440
10/14/2024,Amara Weerasinghe,Matara,Dikwella,Southern,1366,7772,9138,54640,310880,365520
10/15/2024,Amara Weerasinghe,Matara,Dikwella,Southern,9173,8715,17888,366920,348600,715520
10/16/2024,Amara Weerasinghe,Matara,Dikwella,Southern,77,9656,9733,3080,386240,389320
10/17/2024,Amara Weerasinghe,Matara,Dikwella,Southern,8218,6290,14508,328720,251600,580320
10/18/2024,Amara Weerasinghe,Matara,Dikwella,Southern,8161,401,8562,326440,16040,342480
10/19/2024,Amara Weerasinghe,Matara,Dikwella,Southern,1627,7555,9182,65080,302200,367280
10/20/2024,Amara Weerasinghe,Matara,Dikwella,Southern,9920,9000,18920,396800,360000,756800
10/21/2024,Amara Weerasinghe,Matara,Dikwella,Southern,1082,4363,5445,43280,174520,217800
10/22/2024,Amara Weerasinghe,Matara,Dikwella,Southern,9159,1303,10462,366360,52120,418480
10/23/2024,Amara Weerasinghe,Matara,Dikwella,Southern,9151,7232,16383,366040,289280,655320
10/24/2024,Amara Weerasinghe,Matara,Dikwella,Southern,6118,5370,11488,244720,214800,459520
10/25/2024,Amara Weerasinghe,Matara,Dikwella,Southern,8279,8495,16774,331160,339800,670960
10/26/2024,Amara Weerasinghe,Matara,Dikwella,Southern,8430,4660,13090,337200,186400,523600
10/27/2024,Amara Weerasinghe,Matara,Dikwella,Southern,7659,8183,15842,306360,327320,633680
10/28/2024,Amara Weerasinghe,Matara,Dikwella,Southern,2350,9882,12232,94000,395280,489280
10/29/2024,Amara Weerasinghe,Matara,Dikwella,Southern,9888,5759,15647,395520,230360,625880
10/30/2024,Amara Weerasinghe,Matara,Dikwella,Southern,7658,1036,8694,306320,41440,347760
10/31/2024,Amara Weerasinghe,Matara,Dikwella,Southern,5467,5956,11423,218680,238240,456920
11/1/2024,Amara Weerasinghe,Matara,Dikwella,Southern,1836,3870,5706,73440,154800,228240
11/2/2024,Amara Weerasinghe,Matara,Dikwella,Southern,9479,1727,11206,379160,69080,448240
11/3/2024,Amara Weerasinghe,Matara,Dikwella,Southern,3751,3976,7727,150040,159040,309080
11/4/2024,Amara Weerasinghe,Matara,Dikwella,Southern,567,5838,6405,22680,233520,256200
11/5/2024,Amara Weerasinghe,Matara,Dikwella,Southern,6103,3233,9336,244120,129320,373440
11/6/2024,Amara Weerasinghe,Matara,Dikwella,Southern,1949,4275,6224,77960,171000,248960
11/7/2024,Amara Weerasinghe,Matara,Dikwella,Southern,1792,9519,11311,71680,380760,452440
11/8/2024,Amara Weerasinghe,Matara,Dikwella,Southern,3938,5879,9817,157520,235160,392680
11/9/2024,Amara Weerasinghe,Matara,Dikwella,Southern,3721,1352,5073,148840,54080,202920
11/10/2024,Amara Weerasinghe,Matara,Dikwella,Southern,7682,457,8139,307280,18280,325560
11/11/2024,Amara Weerasinghe,Matara,Dikwella,Southern,376,422,798,15040,16880,31920
11/12/2024,Amara Weerasinghe,Matara,Dikwella,Southern,6275,5021,11296,251000,200840,451840
11/13/2024,Amara Weerasinghe,Matara,Dikwella,Southern,3341,1371,4712,133640,54840,188480
11/14/2024,Amara Weerasinghe,Matara,Dikwella,Southern,959,6610,7569,38360,264400,302760
11/15/2024,Amara Weerasinghe,Matara,Dikwella,Southern,8424,5534,13958,336960,221360,558320
11/16/2024,Amara Weerasinghe,Matara,Dikwella,Southern,8079,2894,10973,323160,115760,438920
11/17/2024,Amara Weerasinghe,Matara,Dikwella,Southern,2959,6427,9386,118360,257080,375440
11/18/2024,Amara Weerasinghe,Matara,Dikwella,Southern,1733,2991,4724,69320,119640,188960
11/19/2024,Amara Weerasinghe,Matara,Dikwella,Southern,5459,6276,11735,218360,251040,469400
11/20/2024,Amara Weerasinghe,Matara,Dikwella,Southern,279,341,620,11160,13640,24800
11/21/2024,Amara Weerasinghe,Matara,Dikwella,Southern,5758,87,5845,230320,3480,233800
11/22/2024,Amara Weerasinghe,Matara,Dikwella,Southern,8903,1209,10112,356120,48360,404480
11/23/2024,Amara Weerasinghe,Matara,Dikwella,Southern,5339,9591,14930,213560,383640,597200
11/24/2024,Amara Weerasinghe,Matara,Dikwella,Southern,8445,9810,18255,337800,392400,730200
11/25/2024,Amara Weerasinghe,Matara,Dikwella,Southern,6057,7033,13090,242280,281320,523600
11/26/2024,Amara Weerasinghe,Matara,Dikwella,Southern,7991,5300,13291,319640,212000,531640
11/27/2024,Amara Weerasinghe,Matara,Dikwella,Southern,1364,3273,4637,54560,130920,185480
11/28/2024,Amara Weerasinghe,Matara,Dikwella,Southern,9155,1395,10550,366200,55800,422000
11/29/2024,Amara Weerasinghe,Matara,Dikwella,Southern,492,9718,10210,19680,388720,408400
11/30/2024,Amara Weerasinghe,Matara,Dikwella,Southern,8885,5365,14250,355400,214600,570000
12/1/2024,Amara Weerasinghe,Matara,Dikwella,Southern,7369,7014,14383,294760,280560,575320
12/2/2024,Amara Weerasinghe,Matara,Dikwella,Southern,9243,2347,11590,369720,93880,463600
12/3/2024,Amara Weerasinghe,Matara,Dikwella,Southern,6437,5342,11779,257480,213680,471160
12/4/2024,Amara Weerasinghe,Matara,Dikwella,Southern,1121,7634,8755,44840,305360,350200
12/5/2024,Amara Weerasinghe,Matara,Dikwella,Southern,4951,8223,13174,198040,328920,526960
12/6/2024,Amara Weerasinghe,Matara,Dikwella,Southern,6771,3109,9880,270840,124360,395200
12/7/2024,Amara Weerasinghe,Matara,Dikwella,Southern,9643,5140,14783,385720,205600,591320
12/8/2024,Amara Weerasinghe,Matara,Dikwella,Southern,1177,3930,5107,47080,157200,204280
12/9/2024,Amara Weerasinghe,Matara,Dikwella,Southern,9361,1238,10599,374440,49520,423960
12/10/2024,Amara Weerasinghe,Matara,Dikwella,Southern,3780,8732,12512,151200,349280,500480
12/11/2024,Amara Weerasinghe,Matara,Dikwella,Southern,2640,7915,10555,105600,316600,422200
12/12/2024,Amara Weerasinghe,Matara,Dikwella,Southern,4215,5001,9216,168600,200040,368640
12/13/2024,Amara Weerasinghe,Matara,Dikwella,Southern,7928,6075,14003,317120,243000,560120
12/14/2024,Amara Weerasinghe,Matara,Dikwella,Southern,100,5959,6059,4000,238360,242360
12/15/2024,Amara Weerasinghe,Matara,Dikwella,Southern,1402,1479,2881,56080,59160,115240
12/16/2024,Amara Weerasinghe,Matara,Dikwella,Southern,4370,4327,8697,174800,173080,347880
12/17/2024,Amara Weerasinghe,Matara,Dikwella,Southern,8554,2652,11206,342160,106080,448240
12/18/2024,Amara Weerasinghe,Matara,Dikwella,Southern,5945,154,6099,237800,6160,243960
12/19/2024,Amara Weerasinghe,Matara,Dikwella,Southern,336,7075,7411,13440,283000,296440
12/20/2024,Amara Weerasinghe,Matara,Dikwella,Southern,77,4883,4960,3080,195320,198400
12/21/2024,Amara Weerasinghe,Matara,Dikwella,Southern,3265,2303,5568,130600,92120,222720
12/22/2024,Amara Weerasinghe,Matara,Dikwella,Southern,9103,6409,15512,364120,256360,620480
12/23/2024,Amara Weerasinghe,Matara,Dikwella,Southern,6000,9532,15532,240000,381280,621280
12/24/2024,Amara Weerasinghe,Matara,Dikwella,Southern,3306,6643,9949,132240,265720,397960
12/25/2024,Amara Weerasinghe,Matara,Dikwella,Southern,1905,6229,8134,76200,249160,325360
12/26/2024,Amara Weerasinghe,Matara,Dikwella,Southern,641,7680,8321,25640,307200,332840
12/27/2024,Amara Weerasinghe,Matara,Dikwella,Southern,6433,3734,10167,257320,149360,406680
12/28/2024,Amara Weerasinghe,Matara,Dikwella,Southern,1223,3687,4910,48920,147480,196400
12/29/2024,Amara Weerasinghe,Matara,Dikwella,Southern,2930,671,3601,117200,26840,144040
12/30/2024,Amara Weerasinghe,Matara,Dikwella,Southern,1655,3719,5374,66200,148760,214960
12/31/2024,Amara Weerasinghe,Matara,Dikwella,Southern,9564,3117,12681,382560,124680,507240
1/1/2025,Amara Weerasinghe,Matara,Dikwella,Southern,7557,7050,14607,302280,282000,584280
1/2/2025,Amara Weerasinghe,Matara,Dikwella,Southern,3110,1508,4618,124400,60320,184720
1/3/2025,Amara Weerasinghe,Matara,Dikwella,Southern,8574,1465,10039,342960,58600,401560
1/4/2025,Amara Weerasinghe,Matara,Dikwella,Southern,4919,4044,8963,196760,161760,358520
1/5/2025,Amara Weerasinghe,Matara,Dikwella,Southern,9195,8558,17753,367800,342320,710120
1/6/2025,Amara Weerasinghe,Matara,Dikwella,Southern,5585,8831,14416,223400,353240,576640
1/7/2025,Amara Weerasinghe,Matara,Dikwella,Southern,1741,964,2705,69640,38560,108200
1/8/2025,Amara Weerasinghe,Matara,Dikwella,Southern,6810,8832,15642,272400,353280,625680
1/9/2025,Amara Weerasinghe,Matara,Dikwella,Southern,264,2181,2445,10560,87240,97800
1/10/2025,Amara Weerasinghe,Matara,Dikwella,Southern,262,4826,5088,10480,193040,203520
1/11/2025,Amara Weerasinghe,Matara,Dikwella,Southern,2799,5740,8539,111960,229600,341560
1/12/2025,Amara Weerasinghe,Matara,Dikwella,Southern,2700,4586,7286,108000,183440,291440
1/13/2025,Amara Weerasinghe,Matara,Dikwella,Southern,5656,2108,7764,226240,84320,310560
1/14/2025,Amara Weerasinghe,Matara,Dikwella,Southern,3221,7395,10616,128840,295800,424640
1/15/2025,Amara Weerasinghe,Matara,Dikwella,Southern,2592,9884,12476,103680,395360,499040
1/16/2025,Amara Weerasinghe,Matara,Dikwella,Southern,3431,9449,12880,137240,377960,515200
1/17/2025,Amara Weerasinghe,Matara,Dikwella,Southern,7903,3303,11206,316120,132120,448240
1/18/2025,Amara Weerasinghe,Matara,Dikwella,Southern,455,2570,3025,18200,102800,121000
1/19/2025,Amara Weerasinghe,Matara,Dikwella,Southern,3155,2703,5858,126200,108120,234320
1/20/2025,Amara Weerasinghe,Matara,Dikwella,Southern,8298,5553,13851,331920,222120,554040
1/21/2025,Amara Weerasinghe,Matara,Dikwella,Southern,8125,338,8463,325000,13520,338520
1/22/2025,Amara Weerasinghe,Matara,Dikwella,Southern,6309,1868,8177,252360,74720,327080
1/23/2025,Amara Weerasinghe,Matara,Dikwella,Southern,7061,1902,8963,282440,76080,358520
1/24/2025,Amara Weerasinghe,Matara,Dikwella,Southern,3018,8985,12003,120720,359400,480120
1/25/2025,Amara Weerasinghe,Matara,Dikwella,Southern,455,8385,8840,18200,335400,353600
1/26/2025,Amara Weerasinghe,Matara,Dikwella,Southern,4834,7819,12653,193360,312760,506120
1/27/2025,Amara Weerasinghe,Matara,Dikwella,Southern,1011,7006,8017,40440,280240,320680
1/28/2025,Amara Weerasinghe,Matara,Dikwella,Southern,8135,6360,14495,325400,254400,579800
1/29/2025,Amara Weerasinghe,Matara,Dikwella,Southern,779,1160,1939,31160,46400,77560
1/30/2025,Amara Weerasinghe,Matara,Dikwella,Southern,7523,5884,13407,300920,235360,536280
1/31/2025,Amara Weerasinghe,Matara,Dikwella,Southern,8954,2915,11869,358160,116600,474760
2/1/2025,Amara Weerasinghe,Matara,Dikwella,Southern,4909,3800,8709,196360,152000,348360
2/2/2025,Amara Weerasinghe,Matara,Dikwella,Southern,1564,8043,9607,62560,321720,384280
2/3/2025,Amara Weerasinghe,Matara,Dikwella,Southern,840,601,1441,33600,24040,57640
2/4/2025,Amara Weerasinghe,Matara,Dikwella,Southern,3892,2401,6293,155680,96040,251720
2/5/2025,Amara Weerasinghe,Matara,Dikwella,Southern,3241,8669,11910,129640,346760,476400
2/6/2025,Amara Weerasinghe,Matara,Dikwella,Southern,3938,6590,10528,157520,263600,421120
2/7/2025,Amara Weerasinghe,Matara,Dikwella,Southern,5463,401,5864,218520,16040,234560
2/8/2025,Amara Weerasinghe,Matara,Dikwella,Southern,2097,2112,4209,83880,84480,168360
2/9/2025,Amara Weerasinghe,Matara,Dikwella,Southern,4566,9271,13837,182640,370840,553480
2/10/2025,Amara Weerasinghe,Matara,Dikwella,Southern,2462,1151,3613,98480,46040,144520
2/11/2025,Amara Weerasinghe,Matara,Dikwella,Southern,2225,9798,12023,89000,391920,480920
2/12/2025,Amara Weerasinghe,Matara,Dikwella,Southern,9415,9721,19136,376600,388840,765440
2/13/2025,Amara Weerasinghe,Matara,Dikwella,Southern,8009,1762,9771,320360,70480,390840
2/14/2025,Amara Weerasinghe,Matara,Dikwella,Southern,9796,791,10587,391840,31640,423480
2/15/2025,Amara Weerasinghe,Matara,Dikwella,Southern,6896,7372,14268,275840,294880,570720
2/16/2025,Amara Weerasinghe,Matara,Dikwella,Southern,1259,867,2126,50360,34680,85040
2/17/2025,Amara Weerasinghe,Matara,Dikwella,Southern,6632,2269,8901,265280,90760,356040
2/18/2025,Amara Weerasinghe,Matara,Dikwella,Southern,8926,5365,14291,357040,214600,571640
2/19/2025,Amara Weerasinghe,Matara,Dikwella,Southern,6345,2269,8614,253800,90760,344560
2/20/2025,Amara Weerasinghe,Matara,Dikwella,Southern,5855,247,6102,234200,9880,244080
2/21/2025,Amara Weerasinghe,Matara,Dikwella,Southern,2489,3653,6142,99560,146120,245680
2/22/2025,Amara Weerasinghe,Matara,Dikwella,Southern,7979,3473,11452,319160,138920,458080
2/23/2025,Amara Weerasinghe,Matara,Dikwella,Southern,7537,3313,10850,301480,132520,434000
2/24/2025,Amara Weerasinghe,Matara,Dikwella,Southern,5451,1157,6608,218040,46280,264320
2/25/2025,Amara Weerasinghe,Matara,Dikwella,Southern,5984,2411,8395,239360,96440,335800
2/26/2025,Amara Weerasinghe,Matara,Dikwella,Southern,3618,7932,11550,144720,317280,462000
2/27/2025,Amara Weerasinghe,Matara,Dikwella,Southern,8787,3219,12006,351480,128760,480240
2/28/2025,Amara Weerasinghe,Matara,Dikwella,Southern,8118,8583,16701,324720,343320,668040
3/1/2025,Amara Weerasinghe,Matara,Dikwella,Southern,6181,8960,15141,247240,358400,605640
3/2/2025,Amara Weerasinghe,Matara,Dikwella,Southern,9987,9591,19578,399480,383640,783120
3/3/2025,Amara Weerasinghe,Matara,Dikwella,Southern,4327,1214,5541,173080,48560,221640
3/4/2025,Amara Weerasinghe,Matara,Dikwella,Southern,5217,5295,10512,208680,211800,420480
3/5/2025,Amara Weerasinghe,Matara,Dikwella,Southern,6783,5317,12100,271320,212680,484000
3/6/2025,Amara Weerasinghe,Matara,Dikwella,Southern,2049,5324,7373,81960,212960,294920
3/7/2025,Amara Weerasinghe,Matara,Dikwella,Southern,2650,4305,6955,106000,172200,278200
3/8/2025,Amara Weerasinghe,Matara,Dikwella,Southern,6579,8749,15328,263160,349960,613120
3/9/2025,Amara Weerasinghe,Matara,Dikwella,Southern,1840,6932,8772,73600,277280,350880
3/10/2025,Amara Weerasinghe,Matara,Dikwella,Southern,6723,6775,13498,268920,271000,539920
3/11/2025,Amara Weerasinghe,Matara,Dikwella,Southern,8803,1939,10742,352120,77560,429680
3/12/2025,Amara Weerasinghe,Matara,Dikwella,Southern,1529,5162,6691,61160,206480,267640
3/13/2025,Amara Weerasinghe,Matara,Dikwella,Southern,3547,3958,7505,141880,158320,300200
3/14/2025,Amara Weerasinghe,Matara,Dikwella,Southern,5684,6327,12011,227360,253080,480440
3/15/2025,Amara Weerasinghe,Matara,Dikwella,Southern,4645,1503,6148,185800,60120,245920
3/16/2025,Amara Weerasinghe,Matara,Dikwella,Southern,9244,8695,17939,369760,347800,717560
3/17/2025,Amara Weerasinghe,Matara,Dikwella,Southern,5509,6982,12491,220360,279280,499640
3/18/2025,Amara Weerasinghe,Matara,Dikwella,Southern,8110,861,8971,324400,34440,358840
3/19/2025,Amara Weerasinghe,Matara,Dikwella,Southern,9009,3241,12250,360360,129640,490000
3/20/2025,Amara Weerasinghe,Matara,Dikwella,Southern,1077,9131,10208,43080,365240,408320
3/21/2025,Amara Weerasinghe,Matara,Dikwella,Southern,6634,3747,10381,265360,149880,415240
3/22/2025,Amara Weerasinghe,Matara,Dikwella,Southern,6442,1784,8226,257680,71360,329040
3/23/2025,Amara Weerasinghe,Matara,Dikwella,Southern,9777,5954,15731,391080,238160,629240
3/25/2024,Uthpala Pathirana,Kandy,Kandy,Central,6448,9644,16092,257920,385760,643680
3/26/2024,Uthpala Pathirana,Kandy,Kandy,Central,2718,2795,5513,108720,111800,220520
3/27/2024,Uthpala Pathirana,Kandy,Kandy,Central,3019,9388,12407,120760,375520,496280
3/28/2024,Uthpala Pathirana,Kandy,Kandy,Central,9428,9380,18808,377120,375200,752320
3/29/2024,Uthpala Pathirana,Kandy,Kandy,Central,86,4233,4319,3440,169320,172760
3/30/2024,Uthpala Pathirana,Kandy,Kandy,Central,4560,7403,11963,182400,296120,478520
3/31/2024,Uthpala Pathirana,Kandy,Kandy,Central,7426,2287,9713,297040,91480,388520
4/1/2024,Uthpala Pathirana,Kandy,Kandy,Central,9606,3895,13501,384240,155800,540040
4/2/2024,Uthpala Pathirana,Kandy,Kandy,Central,2798,9491,12289,111920,379640,491560
4/3/2024,Uthpala Pathirana,Kandy,Kandy,Central,6758,3694,10452,270320,147760,418080
4/4/2024,Uthpala Pathirana,Kandy,Kandy,Central,4323,8201,12524,172920,328040,500960
4/5/2024,Uthpala Pathirana,Kandy,Kandy,Central,1825,8174,9999,73000,326960,399960
4/6/2024,Uthpala Pathirana,Kandy,Kandy,Central,9011,3590,12601,360440,143600,504040
4/7/2024,Uthpala Pathirana,Kandy,Kandy,Central,1277,8137,9414,51080,325480,376560
4/8/2024,Uthpala Pathirana,Kandy,Kandy,Central,1251,2715,3966,50040,108600,158640
4/9/2024,Uthpala Pathirana,Kandy,Kandy,Central,2143,5034,7177,85720,201360,287080
4/10/2024,Uthpala Pathirana,Kandy,Kandy,Central,7906,4718,12624,316240,188720,504960
4/11/2024,Uthpala Pathirana,Kandy,Kandy,Central,3058,3528,6586,122320,141120,263440
4/19/2024,Uthpala Pathirana,Kandy,Kandy,Central,6280,4105,10385,251200,164200,415400
4/20/2024,Uthpala Pathirana,Kandy,Kandy,Central,1529,8734,10263,61160,349360,410520
4/21/2024,Uthpala Pathirana,Kandy,Kandy,Central,1177,1621,2798,47080,64840,111920
4/22/2024,Uthpala Pathirana,Kandy,Kandy,Central,3662,2861,6523,146480,114440,260920
4/23/2024,Uthpala Pathirana,Kandy,Kandy,Central,3224,3252,6476,128960,130080,259040
4/24/2024,Uthpala Pathirana,Kandy,Kandy,Central,312,7230,7542,12480,289200,301680
4/25/2024,Uthpala Pathirana,Kandy,Kandy,Central,8362,2263,10625,334480,90520,425000
4/26/2024,Uthpala Pathirana,Kandy,Kandy,Central,3338,9810,13148,133520,392400,525920
4/27/2024,Uthpala Pathirana,Kandy,Kandy,Central,7882,3516,11398,315280,140640,455920
4/28/2024,Uthpala Pathirana,Kandy,Kandy,Central,9901,3618,13519,396040,144720,540760
4/29/2024,Uthpala Pathirana,Kandy,Kandy,Central,4573,6339,10912,182920,253560,436480
4/30/2024,Uthpala Pathirana,Kandy,Kandy,Central,1009,6123,7132,40360,244920,285280
5/1/2024,Uthpala Pathirana,Kandy,Kandy,Central,2616,9053,11669,104640,362120,466760
5/2/2024,Uthpala Pathirana,Kandy,Kandy,Central,7309,1548,8857,292360,61920,354280
5/3/2024,Uthpala Pathirana,Kandy,Kandy,Central,6153,4691,10844,246120,187640,433760
5/4/2024,Uthpala Pathirana,Kandy,Kandy,Central,957,6313,7270,38280,252520,290800
5/5/2024,Uthpala Pathirana,Kandy,Kandy,Central,3113,8285,11398,124520,331400,455920
5/6/2024,Uthpala Pathirana,Kandy,Kandy,Central,710,1559,2269,28400,62360,90760
5/7/2024,Uthpala Pathirana,Kandy,Kandy,Central,9956,4513,14469,398240,180520,578760
5/8/2024,Uthpala Pathirana,Kandy,Kandy,Central,1076,7701,8777,43040,308040,351080
5/9/2024,Uthpala Pathirana,Kandy,Kandy,Central,7692,473,8165,307680,18920,326600
5/10/2024,Uthpala Pathirana,Kandy,Kandy,Central,4951,1522,6473,198040,60880,258920
5/11/2024,Uthpala Pathirana,Kandy,Kandy,Central,8474,4297,12771,338960,171880,510840
5/12/2024,Uthpala Pathirana,Kandy,Kandy,Central,1776,3837,5613,71040,153480,224520
5/13/2024,Uthpala Pathirana,Kandy,Kandy,Central,342,3918,4260,13680,156720,170400
5/14/2024,Uthpala Pathirana,Kandy,Kandy,Central,7542,7555,15097,301680,302200,603880
5/15/2024,Uthpala Pathirana,Kandy,Kandy,Central,9668,1099,10767,386720,43960,430680
5/16/2024,Uthpala Pathirana,Kandy,Kandy,Central,4642,4236,8878,185680,169440,355120
5/17/2024,Uthpala Pathirana,Kandy,Kandy,Central,6002,6580,12582,240080,263200,503280
5/18/2024,Uthpala Pathirana,Kandy,Kandy,Central,1642,4712,6354,65680,188480,254160
5/19/2024,Uthpala Pathirana,Kandy,Kandy,Central,6565,2409,8974,262600,96360,358960
5/20/2024,Uthpala Pathirana,Kandy,Kandy,Central,2665,5350,8015,106600,214000,320600
5/21/2024,Uthpala Pathirana,Kandy,Kandy,Central,824,314,1138,32960,12560,45520
5/22/2024,Uthpala Pathirana,Kandy,Kandy,Central,5743,9798,15541,229720,391920,621640
5/24/2024,Uthpala Pathirana,Kandy,Kandy,Central,9814,9485,19299,392560,379400,771960
5/25/2024,Uthpala Pathirana,Kandy,Kandy,Central,2201,1008,3209,88040,40320,128360
5/26/2024,Uthpala Pathirana,Kandy,Kandy,Central,1733,8965,10698,69320,358600,427920
5/27/2024,Uthpala Pathirana,Kandy,Kandy,Central,3143,5923,9066,125720,236920,362640
5/28/2024,Uthpala Pathirana,Kandy,Kandy,Central,1673,1266,2939,66920,50640,117560
5/29/2024,Uthpala Pathirana,Kandy,Kandy,Central,5746,3082,8828,229840,123280,353120
5/30/2024,Uthpala Pathirana,Kandy,Kandy,Central,3031,3109,6140,121240,124360,245600
5/31/2024,Uthpala Pathirana,Kandy,Kandy,Central,6562,6972,13534,262480,278880,541360
6/1/2024,Uthpala Pathirana,Kandy,Kandy,Central,2719,5997,8716,108760,239880,348640
6/2/2024,Uthpala Pathirana,Kandy,Kandy,Central,763,5688,6451,30520,227520,258040
6/3/2024,Uthpala Pathirana,Kandy,Kandy,Central,4642,5848,10490,185680,233920,419600
6/4/2024,Uthpala Pathirana,Kandy,Kandy,Central,2805,2525,5330,112200,101000,213200
6/5/2024,Uthpala Pathirana,Kandy,Kandy,Central,8917,4359,13276,356680,174360,531040
6/6/2024,Uthpala Pathirana,Kandy,Kandy,Central,2343,2113,4456,93720,84520,178240
6/7/2024,Uthpala Pathirana,Kandy,Kandy,Central,8137,4431,12568,325480,177240,502720
6/8/2024,Uthpala Pathirana,Kandy,Kandy,Central,5572,5912,11484,222880,236480,459360
6/9/2024,Uthpala Pathirana,Kandy,Kandy,Central,6392,9419,15811,255680,376760,632440
6/10/2024,Uthpala Pathirana,Kandy,Kandy,Central,7413,3467,10880,296520,138680,435200
6/11/2024,Uthpala Pathirana,Kandy,Kandy,Central,594,7554,8148,23760,302160,325920
6/12/2024,Uthpala Pathirana,Kandy,Kandy,Central,9918,1093,11011,396720,43720,440440
6/13/2024,Uthpala Pathirana,Kandy,Kandy,Central,940,3523,4463,37600,140920,178520
6/14/2024,Uthpala Pathirana,Kandy,Kandy,Central,3673,4683,8356,146920,187320,334240
6/15/2024,Uthpala Pathirana,Kandy,Kandy,Central,8752,3395,12147,350080,135800,485880
6/16/2024,Uthpala Pathirana,Kandy,Kandy,Central,7086,7271,14357,283440,290840,574280
6/17/2024,Uthpala Pathirana,Kandy,Kandy,Central,9753,6395,16148,390120,255800,645920
6/18/2024,Uthpala Pathirana,Kandy,Kandy,Central,3838,3465,7303,153520,138600,292120
6/19/2024,Uthpala Pathirana,Kandy,Kandy,Central,93,5363,5456,3720,214520,218240
6/20/2024,Uthpala Pathirana,Kandy,Kandy,Central,8405,7572,15977,336200,302880,639080
6/21/2024,Uthpala Pathirana,Kandy,Kandy,Central,5316,777,6093,212640,31080,243720
6/22/2024,Uthpala Pathirana,Kandy,Kandy,Central,208,6309,6517,8320,252360,260680
6/23/2024,Uthpala Pathirana,Kandy,Kandy,Central,9445,9205,18650,377800,368200,746000
6/24/2024,Uthpala Pathirana,Kandy,Kandy,Central,9723,6454,16177,388920,258160,647080
6/25/2024,Uthpala Pathirana,Kandy,Kandy,Central,6436,3529,9965,257440,141160,398600
6/26/2024,Uthpala Pathirana,Kandy,Kandy,Central,9391,2224,11615,375640,88960,464600
6/27/2024,Uthpala Pathirana,Kandy,Kandy,Central,1041,8707,9748,41640,348280,389920
6/28/2024,Uthpala Pathirana,Kandy,Kandy,Central,7518,1476,8994,300720,59040,359760
6/29/2024,Uthpala Pathirana,Kandy,Kandy,Central,2696,4120,6816,107840,164800,272640
6/30/2024,Uthpala Pathirana,Kandy,Kandy,Central,7489,2443,9932,299560,97720,397280
7/1/2024,Uthpala Pathirana,Kandy,Kandy,Central,2353,2883,5236,94120,115320,209440
7/2/2024,Uthpala Pathirana,Kandy,Kandy,Central,6165,3159,9324,246600,126360,372960
7/3/2024,Uthpala Pathirana,Kandy,Kandy,Central,2224,2363,4587,88960,94520,183480
7/4/2024,Uthpala Pathirana,Kandy,Kandy,Central,1195,2729,3924,47800,109160,156960
7/5/2024,Uthpala Pathirana,Kandy,Kandy,Central,2865,6025,8890,114600,241000,355600
7/6/2024,Uthpala Pathirana,Kandy,Kandy,Central,2865,1913,4778,114600,76520,191120
7/7/2024,Uthpala Pathirana,Kandy,Kandy,Central,7251,8120,15371,290040,324800,614840
7/8/2024,Uthpala Pathirana,Kandy,Kandy,Central,586,5044,5630,23440,201760,225200
7/9/2024,Uthpala Pathirana,Kandy,Kandy,Central,7351,2531,9882,294040,101240,395280
7/10/2024,Uthpala Pathirana,Kandy,Kandy,Central,6719,2517,9236,268760,100680,369440
7/11/2024,Uthpala Pathirana,Kandy,Kandy,Central,6621,1225,7846,264840,49000,313840
7/12/2024,Uthpala Pathirana,Kandy,Kandy,Central,5272,6319,11591,210880,252760,463640
7/13/2024,Uthpala Pathirana,Kandy,Kandy,Central,8384,9182,17566,335360,367280,702640
7/14/2024,Uthpala Pathirana,Kandy,Kandy,Central,6830,6718,13548,273200,268720,541920
7/15/2024,Uthpala Pathirana,Kandy,Kandy,Central,3468,3689,7157,138720,147560,286280
7/16/2024,Uthpala Pathirana,Kandy,Kandy,Central,4482,8984,13466,179280,359360,538640
7/17/2024,Uthpala Pathirana,Kandy,Kandy,Central,1027,8785,9812,41080,351400,392480
7/18/2024,Uthpala Pathirana,Kandy,Kandy,Central,4785,99,4884,191400,3960,195360
7/19/2024,Uthpala Pathirana,Kandy,Kandy,Central,541,4905,5446,21640,196200,217840
7/20/2024,Uthpala Pathirana,Kandy,Kandy,Central,1225,4454,5679,49000,178160,227160
7/21/2024,Uthpala Pathirana,Kandy,Kandy,Central,3107,4451,7558,124280,178040,302320
7/22/2024,Uthpala Pathirana,Kandy,Kandy,Central,8441,1585,10026,337640,63400,401040
7/23/2024,Uthpala Pathirana,Kandy,Kandy,Central,1586,451,2037,63440,18040,81480
7/24/2024,Uthpala Pathirana,Kandy,Kandy,Central,1731,2512,4243,69240,100480,169720
7/25/2024,Uthpala Pathirana,Kandy,Kandy,Central,982,281,1263,39280,11240,50520
7/26/2024,Uthpala Pathirana,Kandy,Kandy,Central,1566,7266,8832,62640,290640,353280
7/27/2024,Uthpala Pathirana,Kandy,Kandy,Central,8156,7287,15443,326240,291480,617720
7/28/2024,Uthpala Pathirana,Kandy,Kandy,Central,285,2641,2926,11400,105640,117040
7/29/2024,Uthpala Pathirana,Kandy,Kandy,Central,1770,1339,3109,70800,53560,124360
7/30/2024,Uthpala Pathirana,Kandy,Kandy,Central,1329,6196,7525,53160,247840,301000
7/31/2024,Uthpala Pathirana,Kandy,Kandy,Central,8286,4211,12497,331440,168440,499880
8/1/2024,Uthpala Pathirana,Kandy,Kandy,Central,691,7387,8078,27640,295480,323120
8/2/2024,Uthpala Pathirana,Kandy,Kandy,Central,8837,4211,13048,353480,168440,521920
8/3/2024,Uthpala Pathirana,Kandy,Kandy,Central,4033,5362,9395,161320,214480,375800
8/4/2024,Uthpala Pathirana,Kandy,Kandy,Central,6774,1247,8021,270960,49880,320840
8/5/2024,Uthpala Pathirana,Kandy,Kandy,Central,3347,6548,9895,133880,261920,395800
8/6/2024,Uthpala Pathirana,Kandy,Kandy,Central,7613,5770,13383,304520,230800,535320
8/7/2024,Uthpala Pathirana,Kandy,Kandy,Central,2578,7178,9756,103120,287120,390240
8/8/2024,Uthpala Pathirana,Kandy,Kandy,Central,2278,4360,6638,91120,174400,265520
8/9/2024,Uthpala Pathirana,Kandy,Kandy,Central,9565,3423,12988,382600,136920,519520
8/10/2024,Uthpala Pathirana,Kandy,Kandy,Central,6279,2841,9120,251160,113640,364800
8/11/2024,Uthpala Pathirana,Kandy,Kandy,Central,349,123,472,13960,4920,18880
8/12/2024,Uthpala Pathirana,Kandy,Kandy,Central,8161,4584,12745,326440,183360,509800
8/13/2024,Uthpala Pathirana,Kandy,Kandy,Central,9853,1654,11507,394120,66160,460280
8/14/2024,Uthpala Pathirana,Kandy,Kandy,Central,8374,2491,10865,334960,99640,434600
8/15/2024,Uthpala Pathirana,Kandy,Kandy,Central,2930,3241,6171,117200,129640,246840
8/16/2024,Uthpala Pathirana,Kandy,Kandy,Central,1899,1070,2969,75960,42800,118760
8/17/2024,Uthpala Pathirana,Kandy,Kandy,Central,4858,6890,11748,194320,275600,469920
8/18/2024,Uthpala Pathirana,Kandy,Kandy,Central,2314,5604,7918,92560,224160,316720
8/19/2024,Uthpala Pathirana,Kandy,Kandy,Central,355,5461,5816,14200,218440,232640
8/20/2024,Uthpala Pathirana,Kandy,Kandy,Central,5229,4264,9493,209160,170560,379720
8/21/2024,Uthpala Pathirana,Kandy,Kandy,Central,3096,9863,12959,123840,394520,518360
8/22/2024,Uthpala Pathirana,Kandy,Kandy,Central,5282,8122,13404,211280,324880,536160
8/23/2024,Uthpala Pathirana,Kandy,Kandy,Central,788,5285,6073,31520,211400,242920
8/24/2024,Uthpala Pathirana,Kandy,Kandy,Central,5676,2968,8644,227040,118720,345760
8/25/2024,Uthpala Pathirana,Kandy,Kandy,Central,9832,8932,18764,393280,357280,750560
8/26/2024,Uthpala Pathirana,Kandy,Kandy,Central,185,3701,3886,7400,148040,155440
8/27/2024,Uthpala Pathirana,Kandy,Kandy,Central,9573,4235,13808,382920,169400,552320
8/28/2024,Uthpala Pathirana,Kandy,Kandy,Central,8994,5116,14110,359760,204640,564400
8/29/2024,Uthpala Pathirana,Kandy,Kandy,Central,3221,7869,11090,128840,314760,443600
8/30/2024,Uthpala Pathirana,Kandy,Kandy,Central,4598,4486,9084,183920,179440,363360
8/31/2024,Uthpala Pathirana,Kandy,Kandy,Central,3609,9422,13031,144360,376880,521240
9/1/2024,Uthpala Pathirana,Kandy,Kandy,Central,7409,1944,9353,296360,77760,374120
9/2/2024,Uthpala Pathirana,Kandy,Kandy,Central,2146,9183,11329,85840,367320,453160
9/3/2024,Uthpala Pathirana,Kandy,Kandy,Central,698,3817,4515,27920,152680,180600
9/4/2024,Uthpala Pathirana,Kandy,Kandy,Central,7514,4080,11594,300560,163200,463760
9/5/2024,Uthpala Pathirana,Kandy,Kandy,Central,5880,5753,11633,235200,230120,465320
9/6/2024,Uthpala Pathirana,Kandy,Kandy,Central,3676,8178,11854,147040,327120,474160
9/7/2024,Uthpala Pathirana,Kandy,Kandy,Central,8429,6478,14907,337160,259120,596280
9/8/2024,Uthpala Pathirana,Kandy,Kandy,Central,3750,4105,7855,150000,164200,314200
9/9/2024,Uthpala Pathirana,Kandy,Kandy,Central,1604,7792,9396,64160,311680,375840
9/10/2024,Uthpala Pathirana,Kandy,Kandy,Central,40,8002,8042,1600,320080,321680
9/11/2024,Uthpala Pathirana,Kandy,Kandy,Central,3585,6380,9965,143400,255200,398600
9/12/2024,Uthpala Pathirana,Kandy,Kandy,Central,4317,7489,11806,172680,299560,472240
9/13/2024,Uthpala Pathirana,Kandy,Kandy,Central,2139,3016,5155,85560,120640,206200
9/14/2024,Uthpala Pathirana,Kandy,Kandy,Central,4694,3419,8113,187760,136760,324520
9/15/2024,Uthpala Pathirana,Kandy,Kandy,Central,6639,8067,14706,265560,322680,588240
9/16/2024,Uthpala Pathirana,Kandy,Kandy,Central,5194,9924,15118,207760,396960,604720
9/17/2024,Uthpala Pathirana,Kandy,Kandy,Central,2670,2017,4687,106800,80680,187480
9/18/2024,Uthpala Pathirana,Kandy,Kandy,Central,7020,1388,8408,280800,55520,336320
9/19/2024,Uthpala Pathirana,Kandy,Kandy,Central,2098,8398,10496,83920,335920,419840
9/20/2024,Uthpala Pathirana,Kandy,Kandy,Central,2604,9754,12358,104160,390160,494320
9/21/2024,Uthpala Pathirana,Kandy,Kandy,Central,2805,1811,4616,112200,72440,184640
9/22/2024,Uthpala Pathirana,Kandy,Kandy,Central,5092,7103,12195,203680,284120,487800
9/23/2024,Uthpala Pathirana,Kandy,Kandy,Central,1197,7605,8802,47880,304200,352080
9/24/2024,Uthpala Pathirana,Kandy,Kandy,Central,3916,1509,5425,156640,60360,217000
9/25/2024,Uthpala Pathirana,Kandy,Kandy,Central,2926,2558,5484,117040,102320,219360
9/26/2024,Uthpala Pathirana,Kandy,Kandy,Central,1320,9938,11258,52800,397520,450320
9/27/2024,Uthpala Pathirana,Kandy,Kandy,Central,3611,7856,11467,144440,314240,458680
9/28/2024,Uthpala Pathirana,Kandy,Kandy,Central,3345,3030,6375,133800,121200,255000
9/29/2024,Uthpala Pathirana,Kandy,Kandy,Central,120,4071,4191,4800,162840,167640
9/30/2024,Uthpala Pathirana,Kandy,Kandy,Central,7882,9725,17607,315280,389000,704280
10/1/2024,Uthpala Pathirana,Kandy,Kandy,Central,3972,3688,7660,158880,147520,306400
10/2/2024,Uthpala Pathirana,Kandy,Kandy,Central,677,4802,5479,27080,192080,219160
10/3/2024,Uthpala Pathirana,Kandy,Kandy,Central,5055,9434,14489,202200,377360,579560
10/4/2024,Uthpala Pathirana,Kandy,Kandy,Central,4666,7866,12532,186640,314640,501280
10/5/2024,Uthpala Pathirana,Kandy,Kandy,Central,7972,7029,15001,318880,281160,600040
10/6/2024,Uthpala Pathirana,Kandy,Kandy,Central,5340,295,5635,213600,11800,225400
10/7/2024,Uthpala Pathirana,Kandy,Kandy,Central,2140,7025,9165,85600,281000,366600
10/8/2024,Uthpala Pathirana,Kandy,Kandy,Central,9500,9420,18920,380000,376800,756800
10/9/2024,Uthpala Pathirana,Kandy,Kandy,Central,1591,7562,9153,63640,302480,366120
10/10/2024,Uthpala Pathirana,Kandy,Kandy,Central,8375,7654,16029,335000,306160,641160
10/11/2024,Uthpala Pathirana,Kandy,Kandy,Central,6947,7150,14097,277880,286000,563880
10/12/2024,Uthpala Pathirana,Kandy,Kandy,Central,1773,9586,11359,70920,383440,454360
10/13/2024,Uthpala Pathirana,Kandy,Kandy,Central,8764,4554,13318,350560,182160,532720
10/14/2024,Uthpala Pathirana,Kandy,Kandy,Central,2731,6632,9363,109240,265280,374520
10/15/2024,Uthpala Pathirana,Kandy,Kandy,Central,5930,2227,8157,237200,89080,326280
10/16/2024,Uthpala Pathirana,Kandy,Kandy,Central,4400,4256,8656,176000,170240,346240
10/17/2024,Uthpala Pathirana,Kandy,Kandy,Central,7620,8521,16141,304800,340840,645640
10/18/2024,Uthpala Pathirana,Kandy,Kandy,Central,2921,1244,4165,116840,49760,166600
10/19/2024,Uthpala Pathirana,Kandy,Kandy,Central,3410,2611,6021,136400,104440,240840
10/20/2024,Uthpala Pathirana,Kandy,Kandy,Central,3794,1062,4856,151760,42480,194240
10/21/2024,Uthpala Pathirana,Kandy,Kandy,Central,4852,7697,12549,194080,307880,501960
10/22/2024,Uthpala Pathirana,Kandy,Kandy,Central,628,6223,6851,25120,248920,274040
10/23/2024,Uthpala Pathirana,Kandy,Kandy,Central,2139,4363,6502,85560,174520,260080
10/24/2024,Uthpala Pathirana,Kandy,Kandy,Central,2536,2093,4629,101440,83720,185160
10/25/2024,Uthpala Pathirana,Kandy,Kandy,Central,7232,2060,9292,289280,82400,371680
10/26/2024,Uthpala Pathirana,Kandy,Kandy,Central,9781,5375,15156,391240,215000,606240
10/27/2024,Uthpala Pathirana,Kandy,Kandy,Central,605,5036,5641,24200,201440,225640
10/28/2024,Uthpala Pathirana,Kandy,Kandy,Central,1354,620,1974,54160,24800,78960
10/29/2024,Uthpala Pathirana,Kandy,Kandy,Central,8986,5983,14969,359440,239320,598760
10/30/2024,Uthpala Pathirana,Kandy,Kandy,Central,4230,3477,7707,169200,139080,308280
10/31/2024,Uthpala Pathirana,Kandy,Kandy,Central,6605,1198,7803,264200,47920,312120
11/1/2024,Uthpala Pathirana,Kandy,Kandy,Central,5486,4461,9947,219440,178440,397880
11/2/2024,Uthpala Pathirana,Kandy,Kandy,Central,8466,9374,17840,338640,374960,713600
11/3/2024,Uthpala Pathirana,Kandy,Kandy,Central,8419,1596,10015,336760,63840,400600
11/4/2024,Uthpala Pathirana,Kandy,Kandy,Central,9177,7983,17160,367080,319320,686400
11/5/2024,Uthpala Pathirana,Kandy,Kandy,Central,1600,5488,7088,64000,219520,283520
11/6/2024,Uthpala Pathirana,Kandy,Kandy,Central,9474,4200,13674,378960,168000,546960
11/7/2024,Uthpala Pathirana,Kandy,Kandy,Central,2764,356,3120,110560,14240,124800
11/8/2024,Uthpala Pathirana,Kandy,Kandy,Central,8706,3626,12332,348240,145040,493280
11/9/2024,Uthpala Pathirana,Kandy,Kandy,Central,9105,317,9422,364200,12680,376880
11/10/2024,Uthpala Pathirana,Kandy,Kandy,Central,2560,969,3529,102400,38760,141160
11/11/2024,Uthpala Pathirana,Kandy,Kandy,Central,3905,1561,5466,156200,62440,218640
11/12/2024,Uthpala Pathirana,Kandy,Kandy,Central,9558,5005,14563,382320,200200,582520
11/13/2024,Uthpala Pathirana,Kandy,Kandy,Central,8597,383,8980,343880,15320,359200
11/14/2024,Uthpala Pathirana,Kandy,Kandy,Central,6009,1734,7743,240360,69360,309720
11/15/2024,Uthpala Pathirana,Kandy,Kandy,Central,1142,549,1691,45680,21960,67640
11/16/2024,Uthpala Pathirana,Kandy,Kandy,Central,655,355,1010,26200,14200,40400
11/17/2024,Uthpala Pathirana,Kandy,Kandy,Central,5365,103,5468,214600,4120,218720
11/18/2024,Uthpala Pathirana,Kandy,Kandy,Central,7877,2218,10095,315080,88720,403800
11/19/2024,Uthpala Pathirana,Kandy,Kandy,Central,3114,2060,5174,124560,82400,206960
11/20/2024,Uthpala Pathirana,Kandy,Kandy,Central,2701,9234,11935,108040,369360,477400
11/21/2024,Uthpala Pathirana,Kandy,Kandy,Central,6297,7260,13557,251880,290400,542280
11/22/2024,Uthpala Pathirana,Kandy,Kandy,Central,7296,1564,8860,291840,62560,354400
11/23/2024,Uthpala Pathirana,Kandy,Kandy,Central,9124,5648,14772,364960,225920,590880
11/24/2024,Uthpala Pathirana,Kandy,Kandy,Central,3376,4359,7735,135040,174360,309400
11/25/2024,Uthpala Pathirana,Kandy,Kandy,Central,2207,5480,7687,88280,219200,307480
11/26/2024,Uthpala Pathirana,Kandy,Kandy,Central,5486,3035,8521,219440,121400,340840
11/27/2024,Uthpala Pathirana,Kandy,Kandy,Central,396,4909,5305,15840,196360,212200
11/28/2024,Uthpala Pathirana,Kandy,Kandy,Central,1705,7173,8878,68200,286920,355120
11/29/2024,Uthpala Pathirana,Kandy,Kandy,Central,1761,5459,7220,70440,218360,288800
11/30/2024,Uthpala Pathirana,Kandy,Kandy,Central,3921,9841,13762,156840,393640,550480
12/1/2024,Uthpala Pathirana,Kandy,Kandy,Central,5211,8784,13995,208440,351360,559800
12/2/2024,Uthpala Pathirana,Kandy,Kandy,Central,1671,9577,11248,66840,383080,449920
12/3/2024,Uthpala Pathirana,Kandy,Kandy,Central,731,213,944,29240,8520,37760
12/4/2024,Uthpala Pathirana,Kandy,Kandy,Central,8078,6038,14116,323120,241520,564640
12/5/2024,Uthpala Pathirana,Kandy,Kandy,Central,8432,1698,10130,337280,67920,405200
12/6/2024,Uthpala Pathirana,Kandy,Kandy,Central,854,7395,8249,34160,295800,329960
12/7/2024,Uthpala Pathirana,Kandy,Kandy,Central,3536,7047,10583,141440,281880,423320
12/8/2024,Uthpala Pathirana,Kandy,Kandy,Central,6528,5857,12385,261120,234280,495400
12/9/2024,Uthpala Pathirana,Kandy,Kandy,Central,3880,6181,10061,155200,247240,402440
12/10/2024,Uthpala Pathirana,Kandy,Kandy,Central,8796,758,9554,351840,30320,382160
12/11/2024,Uthpala Pathirana,Kandy,Kandy,Central,5122,6109,11231,204880,244360,449240
12/12/2024,Uthpala Pathirana,Kandy,Kandy,Central,7311,1502,8813,292440,60080,352520
12/13/2024,Uthpala Pathirana,Kandy,Kandy,Central,9241,5106,14347,369640,204240,573880
12/14/2024,Uthpala Pathirana,Kandy,Kandy,Central,9347,2174,11521,373880,86960,460840
12/15/2024,Uthpala Pathirana,Kandy,Kandy,Central,4004,7288,11292,160160,291520,451680
12/16/2024,Uthpala Pathirana,Kandy,Kandy,Central,4353,1243,5596,174120,49720,223840
12/17/2024,Uthpala Pathirana,Kandy,Kandy,Central,1679,1970,3649,67160,78800,145960
12/18/2024,Uthpala Pathirana,Kandy,Kandy,Central,3148,930,4078,125920,37200,163120
12/19/2024,Uthpala Pathirana,Kandy,Kandy,Central,5809,4371,10180,232360,174840,407200
12/20/2024,Uthpala Pathirana,Kandy,Kandy,Central,8990,1239,10229,359600,49560,409160
12/21/2024,Uthpala Pathirana,Kandy,Kandy,Central,8181,9501,17682,327240,380040,707280
12/22/2024,Uthpala Pathirana,Kandy,Kandy,Central,9044,8009,17053,361760,320360,682120
12/23/2024,Uthpala Pathirana,Kandy,Kandy,Central,7338,8791,16129,293520,351640,645160
12/24/2024,Uthpala Pathirana,Kandy,Kandy,Central,2477,1340,3817,99080,53600,152680
12/25/2024,Uthpala Pathirana,Kandy,Kandy,Central,5223,3669,8892,208920,146760,355680
12/26/2024,Uthpala Pathirana,Kandy,Kandy,Central,8278,4856,13134,331120,194240,525360
12/27/2024,Uthpala Pathirana,Kandy,Kandy,Central,5933,2469,8402,237320,98760,336080
12/28/2024,Uthpala Pathirana,Kandy,Kandy,Central,5424,7156,12580,216960,286240,503200
12/29/2024,Uthpala Pathirana,Kandy,Kandy,Central,9836,7465,17301,393440,298600,692040
12/30/2024,Uthpala Pathirana,Kandy,Kandy,Central,9895,1352,11247,395800,54080,449880
12/31/2024,Uthpala Pathirana,Kandy,Kandy,Central,1094,6883,7977,43760,275320,319080
1/1/2025,Uthpala Pathirana,Kandy,Kandy,Central,8824,80,8904,352960,3200,356160
1/2/2025,Uthpala Pathirana,Kandy,Kandy,Central,3508,1846,5354,140320,73840,214160
1/3/2025,Uthpala Pathirana,Kandy,Kandy,Central,711,6956,7667,28440,278240,306680
1/4/2025,Uthpala Pathirana,Kandy,Kandy,Central,7175,7579,14754,287000,303160,590160
1/5/2025,Uthpala Pathirana,Kandy,Kandy,Central,1488,7507,8995,59520,300280,359800
1/6/2025,Uthpala Pathirana,Kandy,Kandy,Central,3711,3298,7009,148440,131920,280360
1/7/2025,Uthpala Pathirana,Kandy,Kandy,Central,6506,4862,11368,260240,194480,454720
1/8/2025,Uthpala Pathirana,Kandy,Kandy,Central,3651,9773,13424,146040,390920,536960
1/9/2025,Uthpala Pathirana,Kandy,Kandy,Central,6888,6052,12940,275520,242080,517600
1/10/2025,Uthpala Pathirana,Kandy,Kandy,Central,537,3018,3555,21480,120720,142200
1/11/2025,Uthpala Pathirana,Kandy,Kandy,Central,3369,4248,7617,134760,169920,304680
1/12/2025,Uthpala Pathirana,Kandy,Kandy,Central,2077,8917,10994,83080,356680,439760
1/13/2025,Uthpala Pathirana,Kandy,Kandy,Central,6244,5395,11639,249760,215800,465560
1/14/2025,Uthpala Pathirana,Kandy,Kandy,Central,4837,8761,13598,193480,350440,543920
1/15/2025,Uthpala Pathirana,Kandy,Kandy,Central,8924,9355,18279,356960,374200,731160
1/16/2025,Uthpala Pathirana,Kandy,Kandy,Central,5337,5398,10735,213480,215920,429400
1/17/2025,Uthpala Pathirana,Kandy,Kandy,Central,786,5960,6746,31440,238400,269840
1/18/2025,Uthpala Pathirana,Kandy,Kandy,Central,1836,4010,5846,73440,160400,233840
1/19/2025,Uthpala Pathirana,Kandy,Kandy,Central,7342,6808,14150,293680,272320,566000
1/20/2025,Uthpala Pathirana,Kandy,Kandy,Central,9500,3613,13113,380000,144520,524520
1/21/2025,Uthpala Pathirana,Kandy,Kandy,Central,1205,2891,4096,48200,115640,163840
1/22/2025,Uthpala Pathirana,Kandy,Kandy,Central,5990,9778,15768,239600,391120,630720
1/23/2025,Uthpala Pathirana,Kandy,Kandy,Central,3053,6642,9695,122120,265680,387800
1/24/2025,Uthpala Pathirana,Kandy,Kandy,Central,4889,2568,7457,195560,102720,298280
1/25/2025,Uthpala Pathirana,Kandy,Kandy,Central,6526,3060,9586,261040,122400,383440
1/26/2025,Uthpala Pathirana,Kandy,Kandy,Central,9886,8603,18489,395440,344120,739560
1/27/2025,Uthpala Pathirana,Kandy,Kandy,Central,9362,6517,15879,374480,260680,635160
1/28/2025,Uthpala Pathirana,Kandy,Kandy,Central,9598,407,10005,383920,16280,400200
1/29/2025,Uthpala Pathirana,Kandy,Kandy,Central,2481,500,2981,99240,20000,119240
1/30/2025,Uthpala Pathirana,Kandy,Kandy,Central,4300,8047,12347,172000,321880,493880
1/31/2025,Uthpala Pathirana,Kandy,Kandy,Central,4199,1368,5567,167960,54720,222680
2/1/2025,Uthpala Pathirana,Kandy,Kandy,Central,9736,2081,11817,389440,83240,472680
2/2/2025,Uthpala Pathirana,Kandy,Kandy,Central,9062,7627,16689,362480,305080,667560
2/3/2025,Uthpala Pathirana,Kandy,Kandy,Central,7590,1216,8806,303600,48640,352240
2/4/2025,Uthpala Pathirana,Kandy,Kandy,Central,8929,6385,15314,357160,255400,612560
2/5/2025,Uthpala Pathirana,Kandy,Kandy,Central,5555,9669,15224,222200,386760,608960
2/6/2025,Uthpala Pathirana,Kandy,Kandy,Central,691,4541,5232,27640,181640,209280
2/7/2025,Uthpala Pathirana,Kandy,Kandy,Central,2363,39,2402,94520,1560,96080
2/8/2025,Uthpala Pathirana,Kandy,Kandy,Central,3585,7727,11312,143400,309080,452480
2/9/2025,Uthpala Pathirana,Kandy,Kandy,Central,8994,3372,12366,359760,134880,494640
2/10/2025,Uthpala Pathirana,Kandy,Kandy,Central,9374,3402,12776,374960,136080,511040
2/11/2025,Uthpala Pathirana,Kandy,Kandy,Central,363,8126,8489,14520,325040,339560
2/12/2025,Uthpala Pathirana,Kandy,Kandy,Central,4639,414,5053,185560,16560,202120
2/13/2025,Uthpala Pathirana,Kandy,Kandy,Central,9989,9911,19900,399560,396440,796000
2/14/2025,Uthpala Pathirana,Kandy,Kandy,Central,871,1075,1946,34840,43000,77840
2/15/2025,Uthpala Pathirana,Kandy,Kandy,Central,5107,6346,11453,204280,253840,458120
2/16/2025,Uthpala Pathirana,Kandy,Kandy,Central,8255,383,8638,330200,15320,345520
2/17/2025,Uthpala Pathirana,Kandy,Kandy,Central,1292,9928,11220,51680,397120,448800
2/18/2025,Uthpala Pathirana,Kandy,Kandy,Central,9753,39,9792,390120,1560,391680
2/19/2025,Uthpala Pathirana,Kandy,Kandy,Central,3121,2491,5612,124840,99640,224480
2/20/2025,Uthpala Pathirana,Kandy,Kandy,Central,9017,8340,17357,360680,333600,694280
2/21/2025,Uthpala Pathirana,Kandy,Kandy,Central,8821,3998,12819,352840,159920,512760
2/22/2025,Uthpala Pathirana,Kandy,Kandy,Central,8029,828,8857,321160,33120,354280
2/23/2025,Uthpala Pathirana,Kandy,Kandy,Central,5377,177,5554,215080,7080,222160
2/24/2025,Uthpala Pathirana,Kandy,Kandy,Central,4440,8742,13182,177600,349680,527280
2/25/2025,Uthpala Pathirana,Kandy,Kandy,Central,7670,7831,15501,306800,313240,620040
2/26/2025,Uthpala Pathirana,Kandy,Kandy,Central,2063,5357,7420,82520,214280,296800
2/27/2025,Uthpala Pathirana,Kandy,Kandy,Central,8395,976,9371,335800,39040,374840
2/28/2025,Uthpala Pathirana,Kandy,Kandy,Central,6810,2447,9257,272400,97880,370280
3/1/2025,Uthpala Pathirana,Kandy,Kandy,Central,9130,4400,13530,365200,176000,541200
3/2/2025,Uthpala Pathirana,Kandy,Kandy,Central,6197,4503,10700,247880,180120,428000
3/3/2025,Uthpala Pathirana,Kandy,Kandy,Central,5457,2895,8352,218280,115800,334080
3/4/2025,Uthpala Pathirana,Kandy,Kandy,Central,5779,4789,10568,231160,191560,422720
3/5/2025,Uthpala Pathirana,Kandy,Kandy,Central,6554,3348,9902,262160,133920,396080
3/6/2025,Uthpala Pathirana,Kandy,Kandy,Central,3461,1846,5307,138440,73840,212280
3/7/2025,Uthpala Pathirana,Kandy,Kandy,Central,5841,729,6570,233640,29160,262800
3/8/2025,Uthpala Pathirana,Kandy,Kandy,Central,5749,4767,10516,229960,190680,420640
3/9/2025,Uthpala Pathirana,Kandy,Kandy,Central,6888,9648,16536,275520,385920,661440
3/10/2025,Uthpala Pathirana,Kandy,Kandy,Central,4543,5408,9951,181720,216320,398040
3/11/2025,Uthpala Pathirana,Kandy,Kandy,Central,7926,3617,11543,317040,144680,461720
3/12/2025,Uthpala Pathirana,Kandy,Kandy,Central,6007,6601,12608,240280,264040,504320
3/13/2025,Uthpala Pathirana,Kandy,Kandy,Central,3862,2224,6086,154480,88960,243440
3/14/2025,Uthpala Pathirana,Kandy,Kandy,Central,7918,9358,17276,316720,374320,691040
3/15/2025,Uthpala Pathirana,Kandy,Kandy,Central,8381,806,9187,335240,32240,367480
3/16/2025,Uthpala Pathirana,Kandy,Kandy,Central,3153,202,3355,126120,8080,134200
3/17/2025,Uthpala Pathirana,Kandy,Kandy,Central,2142,4768,6910,85680,190720,276400
3/18/2025,Uthpala Pathirana,Kandy,Kandy,Central,8480,5815,14295,339200,232600,571800
3/19/2025,Uthpala Pathirana,Kandy,Kandy,Central,1227,2337,3564,49080,93480,142560
3/20/2025,Uthpala Pathirana,Kandy,Kandy,Central,6864,1403,8267,274560,56120,330680
3/21/2025,Uthpala Pathirana,Kandy,Kandy,Central,8809,8755,17564,352360,350200,702560
3/22/2025,Uthpala Pathirana,Kandy,Kandy,Central,527,7638,8165,21080,305520,326600
3/23/2025,Uthpala Pathirana,Kandy,Kandy,Central,4283,4459,8742,171320,178360,349680
3/25/2024,Mithula Senanayake,Batticaloa,Kattankudy,Eastern,8760,4000,12760,350400,160000,510400
3/26/2024,Mithula Senanayake,Batticaloa,Kattankudy,Eastern,9952,149,10101,398080,5960,404040
3/27/2024,Mithula Senanayake,Batticaloa,Kattankudy,Eastern,8133,5562,13695,325320,222480,547800
3/28/2024,Mithula Senanayake,Batticaloa,Kattankudy,Eastern,4769,9727,14496,190760,389080,579840
3/29/2024,Mithula Senanayake,Batticaloa,Kattankudy,Eastern,5533,9139,14672,221320,365560,586880
3/30/2024,Mithula Senanayake,Batticaloa,Kattankudy,Eastern,8909,2331,11240,356360,93240,449600
3/31/2024,Mithula Senanayake,Batticaloa,Kattankudy,Eastern,7982,7215,15197,319280,288600,607880
4/1/2024,Mithula Senanayake,Batticaloa,Kattankudy,Eastern,1637,7684,9321,65480,307360,372840
4/2/2024,Mithula Senanayake,Batticaloa,Kattankudy,Eastern,6252,1467,7719,250080,58680,308760
4/3/2024,Mithula Senanayake,Batticaloa,Kattankudy,Eastern,7516,6807,14323,300640,272280,572920
4/4/2024,Mithula Senanayake,Batticaloa,Kattankudy,Eastern,906,4931,5837,36240,197240,233480
4/5/2024,Mithula Senanayake,Batticaloa,Kattankudy,Eastern,7825,6602,14427,313000,264080,577080
4/6/2024,Mithula Senanayake,Batticaloa,Kattankudy,Eastern,8680,3287,11967,347200,131480,478680
4/7/2024,Mithula Senanayake,Batticaloa,Kattankudy,Eastern,7655,4916,12571,306200,196640,502840
4/8/2024,Mithula Senanayake,Batticaloa,Kattankudy,Eastern,205,7595,7800,8200,303800,312000
4/9/2024,Mithula Senanayake,Batticaloa,Kattankudy,Eastern,6471,6893,13364,258840,275720,534560
4/10/2024,Mithula Senanayake,Batticaloa,Kattankudy,Eastern,4753,8060,12813,190120,322400,512520
4/11/2024,Mithula Senanayake,Batticaloa,Kattankudy,Eastern,7063,1210,8273,282520,48400,330920
4/19/2024,Mithula Senanayake,Batticaloa,Kattankudy,Eastern,5798,3055,8853,231920,122200,354120
4/20/2024,Mithula Senanayake,Batticaloa,Kattankudy,Eastern,9649,6210,15859,385960,248400,634360
4/21/2024,Mithula Senanayake,Batticaloa,Kattankudy,Eastern,6904,5362,12266,276160,214480,490640
4/22/2024,Mithula Senanayake,Batticaloa,Kattankudy,Eastern,775,7940,8715,31000,317600,348600
4/23/2024,Mithula Senanayake,Batticaloa,Kattankudy,Eastern,2263,4634,6897,90520,185360,275880
4/24/2024,Mithula Senanayake,Batticaloa,Kattankudy,Eastern,7623,9149,16772,304920,365960,670880
4/25/2024,Mithula Senanayake,Batticaloa,Kattankudy,Eastern,4089,7509,11598,163560,300360,463920
4/26/2024,Mithula Senanayake,Batticaloa,Kattankudy,Eastern,815,4171,4986,32600,166840,199440
4/27/2024,Mithula Senanayake,Batticaloa,Kattankudy,Eastern,8686,2393,11079,347440,95720,443160
4/28/2024,Mithula Senanayake,Batticaloa,Kattankudy,Eastern,2643,6475,9118,105720,259000,364720
4/29/2024,Mithula Senanayake,Batticaloa,Kattankudy,Eastern,9730,3976,13706,389200,159040,548240
4/30/2024,Mithula Senanayake,Batticaloa,Kattankudy,Eastern,1087,479,1566,43480,19160,62640
5/1/2024,Mithula Senanayake,Batticaloa,Kattankudy,Eastern,9046,4740,13786,361840,189600,551440
5/2/2024,Mithula Senanayake,Batticaloa,Kattankudy,Eastern,9685,6908,16593,387400,276320,663720
5/3/2024,Mithula Senanayake,Batticaloa,Kattankudy,Eastern,1015,7130,8145,40600,285200,325800
5/4/2024,Mithula Senanayake,Batticaloa,Kattankudy,Eastern,2685,7212,9897,107400,288480,395880
5/5/2024,Mithula Senanayake,Batticaloa,Kattankudy,Eastern,9411,1858,11269,376440,74320,450760
5/6/2024,Mithula Senanayake,Batticaloa,Kattankudy,Eastern,9057,550,9607,362280,22000,384280
5/7/2024,Mithula Senanayake,Batticaloa,Kattankudy,Eastern,3015,7204,10219,120600,288160,408760
5/8/2024,Mithula Senanayake,Batticaloa,Kattankudy,Eastern,6500,3984,10484,260000,159360,419360
5/9/2024,Mithula Senanayake,Batticaloa,Kattankudy,Eastern,9898,9033,18931,395920,361320,757240
5/10/2024,Mithula Senanayake,Batticaloa,Kattankudy,Eastern,6977,2230,9207,279080,89200,368280
5/11/2024,Mithula Senanayake,Batticaloa,Kattankudy,Eastern,2450,8001,10451,98000,320040,418040
5/12/2024,Mithula Senanayake,Batticaloa,Kattankudy,Eastern,1578,4068,5646,63120,162720,225840
5/13/2024,Mithula Senanayake,Batticaloa,Kattankudy,Eastern,3504,5876,9380,140160,235040,375200
5/14/2024,Mithula Senanayake,Batticaloa,Kattankudy,Eastern,5942,4943,10885,237680,197720,435400
5/15/2024,Mithula Senanayake,Batticaloa,Kattankudy,Eastern,3815,7603,11418,152600,304120,456720
5/16/2024,Mithula Senanayake,Batticaloa,Kattankudy,Eastern,1484,5318,6802,59360,212720,272080
5/17/2024,Mithula Senanayake,Batticaloa,Kattankudy,Eastern,7248,3516,10764,289920,140640,430560
5/18/2024,Mithula Senanayake,Batticaloa,Kattankudy,Eastern,1198,3244,4442,47920,129760,177680
5/19/2024,Mithula Senanayake,Batticaloa,Kattankudy,Eastern,9342,7696,17038,373680,307840,681520
5/20/2024,Mithula Senanayake,Batticaloa,Kattankudy,Eastern,8721,3731,12452,348840,149240,498080
5/21/2024,Mithula Senanayake,Batticaloa,Kattankudy,Eastern,6513,4160,10673,260520,166400,426920
5/22/2024,Mithula Senanayake,Batticaloa,Kattankudy,Eastern,8729,7977,16706,349160,319080,668240
5/24/2024,Mithula Senanayake,Batticaloa,Kattankudy,Eastern,1536,9537,11073,61440,381480,442920
5/25/2024,Mithula Senanayake,Batticaloa,Kattankudy,Eastern,8004,5705,13709,320160,228200,548360
5/26/2024,Mithula Senanayake,Batticaloa,Kattankudy,Eastern,4586,7543,12129,183440,301720,485160
5/27/2024,Mithula Senanayake,Batticaloa,Kattankudy,Eastern,1921,3233,5154,76840,129320,206160
5/28/2024,Mithula Senanayake,Batticaloa,Kattankudy,Eastern,9888,8267,18155,395520,330680,726200
5/29/2024,Mithula Senanayake,Batticaloa,Kattankudy,Eastern,5095,9846,14941,203800,393840,597640
5/30/2024,Mithula Senanayake,Batticaloa,Kattankudy,Eastern,8377,949,9326,335080,37960,373040
5/31/2024,Mithula Senanayake,Batticaloa,Kattankudy,Eastern,6218,1244,7462,248720,49760,298480
6/1/2024,Mithula Senanayake,Batticaloa,Kattankudy,Eastern,8417,684,9101,336680,27360,364040
6/2/2024,Mithula Senanayake,Batticaloa,Kattankudy,Eastern,7057,1889,8946,282280,75560,357840
6/3/2024,Mithula Senanayake,Batticaloa,Kattankudy,Eastern,4942,7966,12908,197680,318640,516320
6/4/2024,Mithula Senanayake,Batticaloa,Kattankudy,Eastern,504,4774,5278,20160,190960,211120
6/5/2024,Mithula Senanayake,Batticaloa,Kattankudy,Eastern,4077,2963,7040,163080,118520,281600
6/6/2024,Mithula Senanayake,Batticaloa,Kattankudy,Eastern,1599,7706,9305,63960,308240,372200
6/7/2024,Mithula Senanayake,Batticaloa,Kattankudy,Eastern,2919,4302,7221,116760,172080,288840
6/8/2024,Mithula Senanayake,Batticaloa,Kattankudy,Eastern,6742,8797,15539,269680,351880,621560
6/9/2024,Mithula Senanayake,Batticaloa,Kattankudy,Eastern,7717,2548,10265,308680,101920,410600
6/10/2024,Mithula Senanayake,Batticaloa,Kattankudy,Eastern,5760,8125,13885,230400,325000,555400
6/11/2024,Mithula Senanayake,Batticaloa,Kattankudy,Eastern,2140,4881,7021,85600,195240,280840
6/12/2024,Mithula Senanayake,Batticaloa,Kattankudy,Eastern,5519,4981,10500,220760,199240,420000
6/13/2024,Mithula Senanayake,Batticaloa,Kattankudy,Eastern,7571,3280,10851,302840,131200,434040
6/14/2024,Mithula Senanayake,Batticaloa,Kattankudy,Eastern,4575,6487,11062,183000,259480,442480
6/15/2024,Mithula Senanayake,Batticaloa,Kattankudy,Eastern,7640,2143,9783,305600,85720,391320
6/16/2024,Mithula Senanayake,Batticaloa,Kattankudy,Eastern,5660,7307,12967,226400,292280,518680
6/17/2024,Mithula Senanayake,Batticaloa,Kattankudy,Eastern,1935,8935,10870,77400,357400,434800
6/18/2024,Mithula Senanayake,Batticaloa,Kattankudy,Eastern,1230,7193,8423,49200,287720,336920
6/19/2024,Mithula Senanayake,Batticaloa,Kattankudy,Eastern,8941,8845,17786,357640,353800,711440
6/20/2024,Mithula Senanayake,Batticaloa,Kattankudy,Eastern,7375,3575,10950,295000,143000,438000
6/21/2024,Mithula Senanayake,Batticaloa,Kattankudy,Eastern,9636,3842,13478,385440,153680,539120
6/22/2024,Mithula Senanayake,Batticaloa,Kattankudy,Eastern,3918,5538,9456,156720,221520,378240
6/23/2024,Mithula Senanayake,Batticaloa,Kattankudy,Eastern,8955,8297,17252,358200,331880,690080
6/24/2024,Mithula Senanayake,Batticaloa,Kattankudy,Eastern,9179,5754,14933,367160,230160,597320
6/25/2024,Mithula Senanayake,Batticaloa,Kattankudy,Eastern,6740,9713,16453,269600,388520,658120
6/26/2024,Mithula Senanayake,Batticaloa,Kattankudy,Eastern,9230,8417,17647,369200,336680,705880
6/27/2024,Mithula Senanayake,Batticaloa,Kattankudy,Eastern,5380,2981,8361,215200,119240,334440
6/28/2024,Mithula Senanayake,Batticaloa,Kattankudy,Eastern,828,228,1056,33120,9120,42240
6/29/2024,Mithula Senanayake,Batticaloa,Kattankudy,Eastern,4164,5643,9807,166560,225720,392280
6/30/2024,Mithula Senanayake,Batticaloa,Kattankudy,Eastern,2355,4809,7164,94200,192360,286560
7/1/2024,Mithula Senanayake,Batticaloa,Kattankudy,Eastern,2434,2538,4972,97360,101520,198880
7/2/2024,Mithula Senanayake,Batticaloa,Kattankudy,Eastern,3278,6602,9880,131120,264080,395200
7/3/2024,Mithula Senanayake,Batticaloa,Kattankudy,Eastern,383,7509,7892,15320,300360,315680
7/4/2024,Mithula Senanayake,Batticaloa,Kattankudy,Eastern,6244,3998,10242,249760,159920,409680
7/5/2024,Mithula Senanayake,Batticaloa,Kattankudy,Eastern,7163,2538,9701,286520,101520,388040
7/6/2024,Mithula Senanayake,Batticaloa,Kattankudy,Eastern,4404,8548,12952,176160,341920,518080
7/7/2024,Mithula Senanayake,Batticaloa,Kattankudy,Eastern,9743,2210,11953,389720,88400,478120
7/8/2024,Mithula Senanayake,Batticaloa,Kattankudy,Eastern,3362,5049,8411,134480,201960,336440
7/9/2024,Mithula Senanayake,Batticaloa,Kattankudy,Eastern,4892,9934,14826,195680,397360,593040
7/10/2024,Mithula Senanayake,Batticaloa,Kattankudy,Eastern,5099,5184,10283,203960,207360,411320
7/11/2024,Mithula Senanayake,Batticaloa,Kattankudy,Eastern,9722,5757,15479,388880,230280,619160
7/12/2024,Mithula Senanayake,Batticaloa,Kattankudy,Eastern,3645,3156,6801,145800,126240,272040
7/13/2024,Mithula Senanayake,Batticaloa,Kattankudy,Eastern,2281,3122,5403,91240,124880,216120
7/14/2024,Mithula Senanayake,Batticaloa,Kattankudy,Eastern,7900,6602,14502,316000,264080,580080
7/15/2024,Mithula Senanayake,Batticaloa,Kattankudy,Eastern,6900,9744,16644,276000,389760,665760
7/16/2024,Mithula Senanayake,Batticaloa,Kattankudy,Eastern,6506,8278,14784,260240,331120,591360
7/17/2024,Mithula Senanayake,Batticaloa,Kattankudy,Eastern,7495,2989,10484,299800,119560,419360
7/18/2024,Mithula Senanayake,Batticaloa,Kattankudy,Eastern,400,4025,4425,16000,161000,177000
7/19/2024,Mithula Senanayake,Batticaloa,Kattankudy,Eastern,6690,1332,8022,267600,53280,320880
7/20/2024,Mithula Senanayake,Batticaloa,Kattankudy,Eastern,7877,8063,15940,315080,322520,637600
7/21/2024,Mithula Senanayake,Batticaloa,Kattankudy,Eastern,7862,4840,12702,314480,193600,508080
7/22/2024,Mithula Senanayake,Batticaloa,Kattankudy,Eastern,3995,7465,11460,159800,298600,458400
7/23/2024,Mithula Senanayake,Batticaloa,Kattankudy,Eastern,8295,282,8577,331800,11280,343080
7/24/2024,Mithula Senanayake,Batticaloa,Kattankudy,Eastern,7146,1639,8785,285840,65560,351400
7/25/2024,Mithula Senanayake,Batticaloa,Kattankudy,Eastern,8457,8250,16707,338280,330000,668280
7/26/2024,Mithula Senanayake,Batticaloa,Kattankudy,Eastern,5445,6566,12011,217800,262640,480440
7/27/2024,Mithula Senanayake,Batticaloa,Kattankudy,Eastern,7930,5458,13388,317200,218320,535520
7/28/2024,Mithula Senanayake,Batticaloa,Kattankudy,Eastern,6549,8123,14672,261960,324920,586880
7/29/2024,Mithula Senanayake,Batticaloa,Kattankudy,Eastern,3523,9944,13467,140920,397760,538680
7/30/2024,Mithula Senanayake,Batticaloa,Kattankudy,Eastern,5511,5804,11315,220440,232160,452600
7/31/2024,Mithula Senanayake,Batticaloa,Kattankudy,Eastern,9190,1572,10762,367600,62880,430480
8/1/2024,Mithula Senanayake,Batticaloa,Kattankudy,Eastern,4852,365,5217,194080,14600,208680
8/2/2024,Mithula Senanayake,Batticaloa,Kattankudy,Eastern,1425,6732,8157,57000,269280,326280
8/3/2024,Mithula Senanayake,Batticaloa,Kattankudy,Eastern,2923,9676,12599,116920,387040,503960
8/4/2024,Mithula Senanayake,Batticaloa,Kattankudy,Eastern,666,468,1134,26640,18720,45360
8/5/2024,Mithula Senanayake,Batticaloa,Kattankudy,Eastern,8680,2758,11438,347200,110320,457520
8/6/2024,Mithula Senanayake,Batticaloa,Kattankudy,Eastern,8767,3656,12423,350680,146240,496920
8/7/2024,Mithula Senanayake,Batticaloa,Kattankudy,Eastern,4306,8145,12451,172240,325800,498040
8/8/2024,Mithula Senanayake,Batticaloa,Kattankudy,Eastern,7367,1419,8786,294680,56760,351440
8/9/2024,Mithula Senanayake,Batticaloa,Kattankudy,Eastern,6519,7533,14052,260760,301320,562080
8/10/2024,Mithula Senanayake,Batticaloa,Kattankudy,Eastern,3521,8342,11863,140840,333680,474520
8/11/2024,Mithula Senanayake,Batticaloa,Kattankudy,Eastern,9110,9895,19005,364400,395800,760200
8/12/2024,Mithula Senanayake,Batticaloa,Kattankudy,Eastern,1381,4645,6026,55240,185800,241040
8/13/2024,Mithula Senanayake,Batticaloa,Kattankudy,Eastern,5422,7031,12453,216880,281240,498120
8/14/2024,Mithula Senanayake,Batticaloa,Kattankudy,Eastern,9641,2117,11758,385640,84680,470320
8/15/2024,Mithula Senanayake,Batticaloa,Kattankudy,Eastern,5880,9845,15725,235200,393800,629000
8/16/2024,Mithula Senanayake,Batticaloa,Kattankudy,Eastern,7991,1673,9664,319640,66920,386560
8/17/2024,Mithula Senanayake,Batticaloa,Kattankudy,Eastern,7577,5326,12903,303080,213040,516120
8/18/2024,Mithula Senanayake,Batticaloa,Kattankudy,Eastern,4816,5334,10150,192640,213360,406000
8/19/2024,Mithula Senanayake,Batticaloa,Kattankudy,Eastern,4538,4105,8643,181520,164200,345720
8/20/2024,Mithula Senanayake,Batticaloa,Kattankudy,Eastern,5257,5361,10618,210280,214440,424720
8/21/2024,Mithula Senanayake,Batticaloa,Kattankudy,Eastern,856,520,1376,34240,20800,55040
8/22/2024,Mithula Senanayake,Batticaloa,Kattankudy,Eastern,8109,607,8716,324360,24280,348640
8/23/2024,Mithula Senanayake,Batticaloa,Kattankudy,Eastern,1866,9920,11786,74640,396800,471440
8/24/2024,Mithula Senanayake,Batticaloa,Kattankudy,Eastern,6897,8611,15508,275880,344440,620320
8/25/2024,Mithula Senanayake,Batticaloa,Kattankudy,Eastern,176,1253,1429,7040,50120,57160
8/26/2024,Mithula Senanayake,Batticaloa,Kattankudy,Eastern,5667,550,6217,226680,22000,248680
8/27/2024,Mithula Senanayake,Batticaloa,Kattankudy,Eastern,5625,8205,13830,225000,328200,553200
8/28/2024,Mithula Senanayake,Batticaloa,Kattankudy,Eastern,3900,2631,6531,156000,105240,261240
8/29/2024,Mithula Senanayake,Batticaloa,Kattankudy,Eastern,3972,7218,11190,158880,288720,447600
8/30/2024,Mithula Senanayake,Batticaloa,Kattankudy,Eastern,3479,7547,11026,139160,301880,441040
8/31/2024,Mithula Senanayake,Batticaloa,Kattankudy,Eastern,7943,1822,9765,317720,72880,390600
9/1/2024,Mithula Senanayake,Batticaloa,Kattankudy,Eastern,2504,554,3058,100160,22160,122320
9/2/2024,Mithula Senanayake,Batticaloa,Kattankudy,Eastern,7946,9571,17517,317840,382840,700680
9/3/2024,Mithula Senanayake,Batticaloa,Kattankudy,Eastern,6109,3671,9780,244360,146840,391200
9/4/2024,Mithula Senanayake,Batticaloa,Kattankudy,Eastern,69,9628,9697,2760,385120,387880
9/5/2024,Mithula Senanayake,Batticaloa,Kattankudy,Eastern,7569,7415,14984,302760,296600,599360
9/6/2024,Mithula Senanayake,Batticaloa,Kattankudy,Eastern,6314,6784,13098,252560,271360,523920
9/7/2024,Mithula Senanayake,Batticaloa,Kattankudy,Eastern,9010,8054,17064,360400,322160,682560
9/8/2024,Mithula Senanayake,Batticaloa,Kattankudy,Eastern,2164,3262,5426,86560,130480,217040
9/9/2024,Mithula Senanayake,Batticaloa,Kattankudy,Eastern,6805,4402,11207,272200,176080,448280
9/10/2024,Mithula Senanayake,Batticaloa,Kattankudy,Eastern,3794,9693,13487,151760,387720,539480
9/11/2024,Mithula Senanayake,Batticaloa,Kattankudy,Eastern,98,5529,5627,3920,221160,225080
9/12/2024,Mithula Senanayake,Batticaloa,Kattankudy,Eastern,5089,2052,7141,203560,82080,285640
9/13/2024,Mithula Senanayake,Batticaloa,Kattankudy,Eastern,537,1286,1823,21480,51440,72920
9/14/2024,Mithula Senanayake,Batticaloa,Kattankudy,Eastern,7506,4266,11772,300240,170640,470880
9/15/2024,Mithula Senanayake,Batticaloa,Kattankudy,Eastern,575,4590,5165,23000,183600,206600
9/16/2024,Mithula Senanayake,Batticaloa,Kattankudy,Eastern,8617,2231,10848,344680,89240,433920
9/17/2024,Mithula Senanayake,Batticaloa,Kattankudy,Eastern,6473,6871,13344,258920,274840,533760
9/18/2024,Mithula Senanayake,Batticaloa,Kattankudy,Eastern,1452,3478,4930,58080,139120,197200
9/19/2024,Mithula Senanayake,Batticaloa,Kattankudy,Eastern,1901,4209,6110,76040,168360,244400
9/20/2024,Mithula Senanayake,Batticaloa,Kattankudy,Eastern,1080,5822,6902,43200,232880,276080
9/21/2024,Mithula Senanayake,Batticaloa,Kattankudy,Eastern,2614,9086,11700,104560,363440,468000
9/22/2024,Mithula Senanayake,Batticaloa,Kattankudy,Eastern,2807,5849,8656,112280,233960,346240
9/23/2024,Mithula Senanayake,Batticaloa,Kattankudy,Eastern,8863,2037,10900,354520,81480,436000
9/24/2024,Mithula Senanayake,Batticaloa,Kattankudy,Eastern,6918,5591,12509,276720,223640,500360
9/25/2024,Mithula Senanayake,Batticaloa,Kattankudy,Eastern,5769,6795,12564,230760,271800,502560
9/26/2024,Mithula Senanayake,Batticaloa,Kattankudy,Eastern,5181,7807,12988,207240,312280,519520
9/27/2024,Mithula Senanayake,Batticaloa,Kattankudy,Eastern,3686,3737,7423,147440,149480,296920
9/28/2024,Mithula Senanayake,Batticaloa,Kattankudy,Eastern,6163,626,6789,246520,25040,271560
9/29/2024,Mithula Senanayake,Batticaloa,Kattankudy,Eastern,8500,5846,14346,340000,233840,573840
9/30/2024,Mithula Senanayake,Batticaloa,Kattankudy,Eastern,6104,2784,8888,244160,111360,355520
10/1/2024,Mithula Senanayake,Batticaloa,Kattankudy,Eastern,2215,5607,7822,88600,224280,312880
10/2/2024,Mithula Senanayake,Batticaloa,Kattankudy,Eastern,9884,4722,14606,395360,188880,584240
10/3/2024,Mithula Senanayake,Batticaloa,Kattankudy,Eastern,3584,3732,7316,143360,149280,292640
10/4/2024,Mithula Senanayake,Batticaloa,Kattankudy,Eastern,3797,8064,11861,151880,322560,474440
10/5/2024,Mithula Senanayake,Batticaloa,Kattankudy,Eastern,5082,1704,6786,203280,68160,271440
10/6/2024,Mithula Senanayake,Batticaloa,Kattankudy,Eastern,4196,996,5192,167840,39840,207680
10/7/2024,Mithula Senanayake,Batticaloa,Kattankudy,Eastern,696,3738,4434,27840,149520,177360
10/8/2024,Mithula Senanayake,Batticaloa,Kattankudy,Eastern,5160,4898,10058,206400,195920,402320
10/9/2024,Mithula Senanayake,Batticaloa,Kattankudy,Eastern,3348,5096,8444,133920,203840,337760
10/10/2024,Mithula Senanayake,Batticaloa,Kattankudy,Eastern,3080,4336,7416,123200,173440,296640
10/11/2024,Mithula Senanayake,Batticaloa,Kattankudy,Eastern,4052,96,4148,162080,3840,165920
10/12/2024,Mithula Senanayake,Batticaloa,Kattankudy,Eastern,7926,8788,16714,317040,351520,668560
10/13/2024,Mithula Senanayake,Batticaloa,Kattankudy,Eastern,8530,9627,18157,341200,385080,726280
10/14/2024,Mithula Senanayake,Batticaloa,Kattankudy,Eastern,2362,5931,8293,94480,237240,331720
10/15/2024,Mithula Senanayake,Batticaloa,Kattankudy,Eastern,405,7939,8344,16200,317560,333760
10/16/2024,Mithula Senanayake,Batticaloa,Kattankudy,Eastern,5975,1975,7950,239000,79000,318000
10/17/2024,Mithula Senanayake,Batticaloa,Kattankudy,Eastern,9799,8337,18136,391960,333480,725440
10/18/2024,Mithula Senanayake,Batticaloa,Kattankudy,Eastern,1112,3924,5036,44480,156960,201440
10/19/2024,Mithula Senanayake,Batticaloa,Kattankudy,Eastern,7606,1693,9299,304240,67720,371960
10/20/2024,Mithula Senanayake,Batticaloa,Kattankudy,Eastern,8346,4922,13268,333840,196880,530720
10/21/2024,Mithula Senanayake,Batticaloa,Kattankudy,Eastern,21,2976,2997,840,119040,119880
10/22/2024,Mithula Senanayake,Batticaloa,Kattankudy,Eastern,2533,2125,4658,101320,85000,186320
10/23/2024,Mithula Senanayake,Batticaloa,Kattankudy,Eastern,8410,7464,15874,336400,298560,634960
10/24/2024,Mithula Senanayake,Batticaloa,Kattankudy,Eastern,6297,5612,11909,251880,224480,476360
10/25/2024,Mithula Senanayake,Batticaloa,Kattankudy,Eastern,6030,8488,14518,241200,339520,580720
10/26/2024,Mithula Senanayake,Batticaloa,Kattankudy,Eastern,2252,6502,8754,90080,260080,350160
10/27/2024,Mithula Senanayake,Batticaloa,Kattankudy,Eastern,6388,9837,16225,255520,393480,649000
10/28/2024,Mithula Senanayake,Batticaloa,Kattankudy,Eastern,995,4754,5749,39800,190160,229960
10/29/2024,Mithula Senanayake,Batticaloa,Kattankudy,Eastern,7111,7420,14531,284440,296800,581240
10/30/2024,Mithula Senanayake,Batticaloa,Kattankudy,Eastern,7767,8787,16554,310680,351480,662160
10/31/2024,Mithula Senanayake,Batticaloa,Kattankudy,Eastern,1137,5028,6165,45480,201120,246600
11/1/2024,Mithula Senanayake,Batticaloa,Kattankudy,Eastern,5636,9881,15517,225440,395240,620680
11/2/2024,Mithula Senanayake,Batticaloa,Kattankudy,Eastern,2933,6480,9413,117320,259200,376520
11/3/2024,Mithula Senanayake,Batticaloa,Kattankudy,Eastern,9116,3693,12809,364640,147720,512360
11/4/2024,Mithula Senanayake,Batticaloa,Kattankudy,Eastern,3409,6915,10324,136360,276600,412960
11/5/2024,Mithula Senanayake,Batticaloa,Kattankudy,Eastern,2430,8323,10753,97200,332920,430120
11/6/2024,Mithula Senanayake,Batticaloa,Kattankudy,Eastern,8076,4512,12588,323040,180480,503520
11/7/2024,Mithula Senanayake,Batticaloa,Kattankudy,Eastern,813,4543,5356,32520,181720,214240
11/8/2024,Mithula Senanayake,Batticaloa,Kattankudy,Eastern,8574,9080,17654,342960,363200,706160
11/9/2024,Mithula Senanayake,Batticaloa,Kattankudy,Eastern,5193,4506,9699,207720,180240,387960
11/10/2024,Mithula Senanayake,Batticaloa,Kattankudy,Eastern,7425,9443,16868,297000,377720,674720
11/11/2024,Mithula Senanayake,Batticaloa,Kattankudy,Eastern,9380,9140,18520,375200,365600,740800
11/12/2024,Mithula Senanayake,Batticaloa,Kattankudy,Eastern,7377,9113,16490,295080,364520,659600
11/13/2024,Mithula Senanayake,Batticaloa,Kattankudy,Eastern,8914,8153,17067,356560,326120,682680
11/14/2024,Mithula Senanayake,Batticaloa,Kattankudy,Eastern,8790,3980,12770,351600,159200,510800
11/15/2024,Mithula Senanayake,Batticaloa,Kattankudy,Eastern,8885,4277,13162,355400,171080,526480
11/16/2024,Mithula Senanayake,Batticaloa,Kattankudy,Eastern,9627,619,10246,385080,24760,409840
11/17/2024,Mithula Senanayake,Batticaloa,Kattankudy,Eastern,7437,4494,11931,297480,179760,477240
11/18/2024,Mithula Senanayake,Batticaloa,Kattankudy,Eastern,1847,4017,5864,73880,160680,234560
11/19/2024,Mithula Senanayake,Batticaloa,Kattankudy,Eastern,4638,293,4931,185520,11720,197240
11/20/2024,Mithula Senanayake,Batticaloa,Kattankudy,Eastern,7042,5794,12836,281680,231760,513440
11/21/2024,Mithula Senanayake,Batticaloa,Kattankudy,Eastern,5090,5581,10671,203600,223240,426840
11/22/2024,Mithula Senanayake,Batticaloa,Kattankudy,Eastern,7814,4423,12237,312560,176920,489480
11/23/2024,Mithula Senanayake,Batticaloa,Kattankudy,Eastern,9887,2760,12647,395480,110400,505880
11/24/2024,Mithula Senanayake,Batticaloa,Kattankudy,Eastern,1929,8218,10147,77160,328720,405880
11/25/2024,Mithula Senanayake,Batticaloa,Kattankudy,Eastern,3340,8193,11533,133600,327720,461320
11/26/2024,Mithula Senanayake,Batticaloa,Kattankudy,Eastern,9036,1842,10878,361440,73680,435120
11/27/2024,Mithula Senanayake,Batticaloa,Kattankudy,Eastern,6040,816,6856,241600,32640,274240
11/28/2024,Mithula Senanayake,Batticaloa,Kattankudy,Eastern,3086,2729,5815,123440,109160,232600
11/29/2024,Mithula Senanayake,Batticaloa,Kattankudy,Eastern,9366,8472,17838,374640,338880,713520
11/30/2024,Mithula Senanayake,Batticaloa,Kattankudy,Eastern,788,6199,6987,31520,247960,279480
12/1/2024,Mithula Senanayake,Batticaloa,Kattankudy,Eastern,6746,1905,8651,269840,76200,346040
12/2/2024,Mithula Senanayake,Batticaloa,Kattankudy,Eastern,9215,6885,16100,368600,275400,644000
12/3/2024,Mithula Senanayake,Batticaloa,Kattankudy,Eastern,3660,8174,11834,146400,326960,473360
12/4/2024,Mithula Senanayake,Batticaloa,Kattankudy,Eastern,2203,3465,5668,88120,138600,226720
12/5/2024,Mithula Senanayake,Batticaloa,Kattankudy,Eastern,775,4316,5091,31000,172640,203640
12/6/2024,Mithula Senanayake,Batticaloa,Kattankudy,Eastern,890,8685,9575,35600,347400,383000
12/7/2024,Mithula Senanayake,Batticaloa,Kattankudy,Eastern,1969,4104,6073,78760,164160,242920
12/8/2024,Mithula Senanayake,Batticaloa,Kattankudy,Eastern,2317,2058,4375,92680,82320,175000
12/9/2024,Mithula Senanayake,Batticaloa,Kattankudy,Eastern,2939,1902,4841,117560,76080,193640
12/10/2024,Mithula Senanayake,Batticaloa,Kattankudy,Eastern,6193,9335,15528,247720,373400,621120
12/11/2024,Mithula Senanayake,Batticaloa,Kattankudy,Eastern,3836,6165,10001,153440,246600,400040
12/12/2024,Mithula Senanayake,Batticaloa,Kattankudy,Eastern,5453,167,5620,218120,6680,224800
12/13/2024,Mithula Senanayake,Batticaloa,Kattankudy,Eastern,4490,7115,11605,179600,284600,464200
12/14/2024,Mithula Senanayake,Batticaloa,Kattankudy,Eastern,7515,9889,17404,300600,395560,696160
12/15/2024,Mithula Senanayake,Batticaloa,Kattankudy,Eastern,4445,2430,6875,177800,97200,275000
12/16/2024,Mithula Senanayake,Batticaloa,Kattankudy,Eastern,945,4395,5340,37800,175800,213600
12/17/2024,Mithula Senanayake,Batticaloa,Kattankudy,Eastern,8613,100,8713,344520,4000,348520
12/18/2024,Mithula Senanayake,Batticaloa,Kattankudy,Eastern,7326,8851,16177,293040,354040,647080
12/19/2024,Mithula Senanayake,Batticaloa,Kattankudy,Eastern,2372,8833,11205,94880,353320,448200
12/20/2024,Mithula Senanayake,Batticaloa,Kattankudy,Eastern,7175,3112,10287,287000,124480,411480
12/21/2024,Mithula Senanayake,Batticaloa,Kattankudy,Eastern,5841,5042,10883,233640,201680,435320
12/22/2024,Mithula Senanayake,Batticaloa,Kattankudy,Eastern,9580,5352,14932,383200,214080,597280
12/23/2024,Mithula Senanayake,Batticaloa,Kattankudy,Eastern,4201,4810,9011,168040,192400,360440
12/24/2024,Mithula Senanayake,Batticaloa,Kattankudy,Eastern,2252,5637,7889,90080,225480,315560
12/25/2024,Mithula Senanayake,Batticaloa,Kattankudy,Eastern,9259,2238,11497,370360,89520,459880
12/26/2024,Mithula Senanayake,Batticaloa,Kattankudy,Eastern,9336,8658,17994,373440,346320,719760
12/27/2024,Mithula Senanayake,Batticaloa,Kattankudy,Eastern,670,3400,4070,26800,136000,162800
12/28/2024,Mithula Senanayake,Batticaloa,Kattankudy,Eastern,541,4189,4730,21640,167560,189200
12/29/2024,Mithula Senanayake,Batticaloa,Kattankudy,Eastern,676,4727,5403,27040,189080,216120
12/30/2024,Mithula Senanayake,Batticaloa,Kattankudy,Eastern,6997,3217,10214,279880,128680,408560
12/31/2024,Mithula Senanayake,Batticaloa,Kattankudy,Eastern,2484,3062,5546,99360,122480,221840
1/1/2025,Mithula Senanayake,Batticaloa,Kattankudy,Eastern,337,7064,7401,13480,282560,296040
1/2/2025,Mithula Senanayake,Batticaloa,Kattankudy,Eastern,6167,3893,10060,246680,155720,402400
1/3/2025,Mithula Senanayake,Batticaloa,Kattankudy,Eastern,9524,7328,16852,380960,293120,674080
1/4/2025,Mithula Senanayake,Batticaloa,Kattankudy,Eastern,1770,5478,7248,70800,219120,289920
1/5/2025,Mithula Senanayake,Batticaloa,Kattankudy,Eastern,4016,1604,5620,160640,64160,224800
1/6/2025,Mithula Senanayake,Batticaloa,Kattankudy,Eastern,4019,1541,5560,160760,61640,222400
1/7/2025,Mithula Senanayake,Batticaloa,Kattankudy,Eastern,2582,8342,10924,103280,333680,436960
1/8/2025,Mithula Senanayake,Batticaloa,Kattankudy,Eastern,584,2698,3282,23360,107920,131280
1/9/2025,Mithula Senanayake,Batticaloa,Kattankudy,Eastern,8020,126,8146,320800,5040,325840
1/10/2025,Mithula Senanayake,Batticaloa,Kattankudy,Eastern,7907,4186,12093,316280,167440,483720
1/11/2025,Mithula Senanayake,Batticaloa,Kattankudy,Eastern,7719,2581,10300,308760,103240,412000
1/12/2025,Mithula Senanayake,Batticaloa,Kattankudy,Eastern,4668,9931,14599,186720,397240,583960
1/13/2025,Mithula Senanayake,Batticaloa,Kattankudy,Eastern,8453,6872,15325,338120,274880,613000
1/14/2025,Mithula Senanayake,Batticaloa,Kattankudy,Eastern,8554,6202,14756,342160,248080,590240
1/15/2025,Mithula Senanayake,Batticaloa,Kattankudy,Eastern,3343,5962,9305,133720,238480,372200
1/16/2025,Mithula Senanayake,Batticaloa,Kattankudy,Eastern,3328,9517,12845,133120,380680,513800
1/17/2025,Mithula Senanayake,Batticaloa,Kattankudy,Eastern,8235,7552,15787,329400,302080,631480
1/18/2025,Mithula Senanayake,Batticaloa,Kattankudy,Eastern,6654,8234,14888,266160,329360,595520
1/19/2025,Mithula Senanayake,Batticaloa,Kattankudy,Eastern,9889,4523,14412,395560,180920,576480
1/20/2025,Mithula Senanayake,Batticaloa,Kattankudy,Eastern,3500,124,3624,140000,4960,144960
1/21/2025,Mithula Senanayake,Batticaloa,Kattankudy,Eastern,7938,4270,12208,317520,170800,488320
1/22/2025,Mithula Senanayake,Batticaloa,Kattankudy,Eastern,5921,4516,10437,236840,180640,417480
1/23/2025,Mithula Senanayake,Batticaloa,Kattankudy,Eastern,3599,7003,10602,143960,280120,424080
1/24/2025,Mithula Senanayake,Batticaloa,Kattankudy,Eastern,5284,2484,7768,211360,99360,310720
1/25/2025,Mithula Senanayake,Batticaloa,Kattankudy,Eastern,698,3647,4345,27920,145880,173800
1/26/2025,Mithula Senanayake,Batticaloa,Kattankudy,Eastern,4421,5505,9926,176840,220200,397040
1/27/2025,Mithula Senanayake,Batticaloa,Kattankudy,Eastern,4929,417,5346,197160,16680,213840
1/28/2025,Mithula Senanayake,Batticaloa,Kattankudy,Eastern,201,6816,7017,8040,272640,280680
1/29/2025,Mithula Senanayake,Batticaloa,Kattankudy,Eastern,7411,2131,9542,296440,85240,381680
1/30/2025,Mithula Senanayake,Batticaloa,Kattankudy,Eastern,5990,9894,15884,239600,395760,635360
1/31/2025,Mithula Senanayake,Batticaloa,Kattankudy,Eastern,9650,2997,12647,386000,119880,505880
2/1/2025,Mithula Senanayake,Batticaloa,Kattankudy,Eastern,6449,3611,10060,257960,144440,402400
2/2/2025,Mithula Senanayake,Batticaloa,Kattankudy,Eastern,5645,4494,10139,225800,179760,405560
2/3/2025,Mithula Senanayake,Batticaloa,Kattankudy,Eastern,2415,1090,3505,96600,43600,140200
2/4/2025,Mithula Senanayake,Batticaloa,Kattankudy,Eastern,6206,5694,11900,248240,227760,476000
2/5/2025,Mithula Senanayake,Batticaloa,Kattankudy,Eastern,2199,4581,6780,87960,183240,271200
2/6/2025,Mithula Senanayake,Batticaloa,Kattankudy,Eastern,6907,5217,12124,276280,208680,484960
2/7/2025,Mithula Senanayake,Batticaloa,Kattankudy,Eastern,8759,5143,13902,350360,205720,556080
2/8/2025,Mithula Senanayake,Batticaloa,Kattankudy,Eastern,5082,67,5149,203280,2680,205960
2/9/2025,Mithula Senanayake,Batticaloa,Kattankudy,Eastern,2037,6910,8947,81480,276400,357880
2/10/2025,Mithula Senanayake,Batticaloa,Kattankudy,Eastern,4629,841,5470,185160,33640,218800
2/11/2025,Mithula Senanayake,Batticaloa,Kattankudy,Eastern,3069,3614,6683,122760,144560,267320
2/12/2025,Mithula Senanayake,Batticaloa,Kattankudy,Eastern,5289,5831,11120,211560,233240,444800
2/13/2025,Mithula Senanayake,Batticaloa,Kattankudy,Eastern,8665,7020,15685,346600,280800,627400
2/14/2025,Mithula Senanayake,Batticaloa,Kattankudy,Eastern,4510,5590,10100,180400,223600,404000
2/15/2025,Mithula Senanayake,Batticaloa,Kattankudy,Eastern,591,3001,3592,23640,120040,143680
2/16/2025,Mithula Senanayake,Batticaloa,Kattankudy,Eastern,5395,3410,8805,215800,136400,352200
2/17/2025,Mithula Senanayake,Batticaloa,Kattankudy,Eastern,8710,981,9691,348400,39240,387640
2/18/2025,Mithula Senanayake,Batticaloa,Kattankudy,Eastern,5232,5768,11000,209280,230720,440000
2/19/2025,Mithula Senanayake,Batticaloa,Kattankudy,Eastern,156,8569,8725,6240,342760,349000
2/20/2025,Mithula Senanayake,Batticaloa,Kattankudy,Eastern,1143,5524,6667,45720,220960,266680
2/21/2025,Mithula Senanayake,Batticaloa,Kattankudy,Eastern,8767,17,8784,350680,680,351360
2/22/2025,Mithula Senanayake,Batticaloa,Kattankudy,Eastern,2748,4799,7547,109920,191960,301880
2/23/2025,Mithula Senanayake,Batticaloa,Kattankudy,Eastern,8033,9246,17279,321320,369840,691160
2/24/2025,Mithula Senanayake,Batticaloa,Kattankudy,Eastern,967,1309,2276,38680,52360,91040
2/25/2025,Mithula Senanayake,Batticaloa,Kattankudy,Eastern,8905,4212,13117,356200,168480,524680
2/26/2025,Mithula Senanayake,Batticaloa,Kattankudy,Eastern,1503,164,1667,60120,6560,66680
2/27/2025,Mithula Senanayake,Batticaloa,Kattankudy,Eastern,2533,9211,11744,101320,368440,469760
2/28/2025,Mithula Senanayake,Batticaloa,Kattankudy,Eastern,9926,8308,18234,397040,332320,729360
3/1/2025,Mithula Senanayake,Batticaloa,Kattankudy,Eastern,5843,8051,13894,233720,322040,555760
3/2/2025,Mithula Senanayake,Batticaloa,Kattankudy,Eastern,700,1900,2600,28000,76000,104000
3/3/2025,Mithula Senanayake,Batticaloa,Kattankudy,Eastern,5185,5582,10767,207400,223280,430680
3/4/2025,Mithula Senanayake,Batticaloa,Kattankudy,Eastern,467,5110,5577,18680,204400,223080
3/5/2025,Mithula Senanayake,Batticaloa,Kattankudy,Eastern,6203,7500,13703,248120,300000,548120
3/6/2025,Mithula Senanayake,Batticaloa,Kattankudy,Eastern,4560,4261,8821,182400,170440,352840
3/7/2025,Mithula Senanayake,Batticaloa,Kattankudy,Eastern,6421,4132,10553,256840,165280,422120
3/8/2025,Mithula Senanayake,Batticaloa,Kattankudy,Eastern,5408,8536,13944,216320,341440,557760
3/9/2025,Mithula Senanayake,Batticaloa,Kattankudy,Eastern,5339,6074,11413,213560,242960,456520
3/10/2025,Mithula Senanayake,Batticaloa,Kattankudy,Eastern,4382,2031,6413,175280,81240,256520
3/11/2025,Mithula Senanayake,Batticaloa,Kattankudy,Eastern,4461,7376,11837,178440,295040,473480
3/12/2025,Mithula Senanayake,Batticaloa,Kattankudy,Eastern,1249,2531,3780,49960,101240,151200
3/13/2025,Mithula Senanayake,Batticaloa,Kattankudy,Eastern,5667,5837,11504,226680,233480,460160
3/14/2025,Mithula Senanayake,Batticaloa,Kattankudy,Eastern,4522,391,4913,180880,15640,196520
3/15/2025,Mithula Senanayake,Batticaloa,Kattankudy,Eastern,3674,1317,4991,146960,52680,199640
3/16/2025,Mithula Senanayake,Batticaloa,Kattankudy,Eastern,918,9038,9956,36720,361520,398240
3/17/2025,Mithula Senanayake,Batticaloa,Kattankudy,Eastern,4968,7181,12149,198720,287240,485960
3/18/2025,Mithula Senanayake,Batticaloa,Kattankudy,Eastern,8212,4371,12583,328480,174840,503320
3/19/2025,Mithula Senanayake,Batticaloa,Kattankudy,Eastern,103,1295,1398,4120,51800,55920
3/20/2025,Mithula Senanayake,Batticaloa,Kattankudy,Eastern,9251,2336,11587,370040,93440,463480
3/21/2025,Mithula Senanayake,Batticaloa,Kattankudy,Eastern,7081,7006,14087,283240,280240,563480
3/22/2025,Mithula Senanayake,Batticaloa,Kattankudy,Eastern,7179,1261,8440,287160,50440,337600
3/23/2025,Mithula Senanayake,Batticaloa,Kattankudy,Eastern,977,1366,2343,39080,54640,93720
3/25/2024,Roshani Jayathilake,Puttalam,Chilaw,North Western,9292,9125,18417,371680,365000,736680
3/26/2024,Roshani Jayathilake,Puttalam,Chilaw,North Western,318,7290,7608,12720,291600,304320
3/27/2024,Roshani Jayathilake,Puttalam,Chilaw,North Western,4110,6206,10316,164400,248240,412640
3/28/2024,Roshani Jayathilake,Puttalam,Chilaw,North Western,9653,6538,16191,386120,261520,647640
3/29/2024,Roshani Jayathilake,Puttalam,Chilaw,North Western,683,8680,9363,27320,347200,374520
3/30/2024,Roshani Jayathilake,Puttalam,Chilaw,North Western,2113,8922,11035,84520,356880,441400
3/31/2024,Roshani Jayathilake,Puttalam,Chilaw,North Western,4926,590,5516,197040,23600,220640
4/1/2024,Roshani Jayathilake,Puttalam,Chilaw,North Western,6313,6863,13176,252520,274520,527040
4/2/2024,Roshani Jayathilake,Puttalam,Chilaw,North Western,7757,514,8271,310280,20560,330840
4/3/2024,Roshani Jayathilake,Puttalam,Chilaw,North Western,2567,5293,7860,102680,211720,314400
4/4/2024,Roshani Jayathilake,Puttalam,Chilaw,North Western,4899,9646,14545,195960,385840,581800
4/5/2024,Roshani Jayathilake,Puttalam,Chilaw,North Western,9033,5301,14334,361320,212040,573360
4/6/2024,Roshani Jayathilake,Puttalam,Chilaw,North Western,8661,4647,13308,346440,185880,532320
4/7/2024,Roshani Jayathilake,Puttalam,Chilaw,North Western,2508,3356,5864,100320,134240,234560
4/8/2024,Roshani Jayathilake,Puttalam,Chilaw,North Western,7228,2475,9703,289120,99000,388120
4/9/2024,Roshani Jayathilake,Puttalam,Chilaw,North Western,8622,6607,15229,344880,264280,609160
4/10/2024,Roshani Jayathilake,Puttalam,Chilaw,North Western,4227,6255,10482,169080,250200,419280
4/11/2024,Roshani Jayathilake,Puttalam,Chilaw,North Western,6943,1436,8379,277720,57440,335160
4/19/2024,Roshani Jayathilake,Puttalam,Chilaw,North Western,7619,3422,11041,304760,136880,441640
4/20/2024,Roshani Jayathilake,Puttalam,Chilaw,North Western,213,1995,2208,8520,79800,88320
4/21/2024,Roshani Jayathilake,Puttalam,Chilaw,North Western,2627,5353,7980,105080,214120,319200
4/22/2024,Roshani Jayathilake,Puttalam,Chilaw,North Western,1415,1085,2500,56600,43400,100000
4/23/2024,Roshani Jayathilake,Puttalam,Chilaw,North Western,2237,5891,8128,89480,235640,325120
4/24/2024,Roshani Jayathilake,Puttalam,Chilaw,North Western,2198,12,2210,87920,480,88400
4/25/2024,Roshani Jayathilake,Puttalam,Chilaw,North Western,3545,9288,12833,141800,371520,513320
4/26/2024,Roshani Jayathilake,Puttalam,Chilaw,North Western,4910,7227,12137,196400,289080,485480
4/27/2024,Roshani Jayathilake,Puttalam,Chilaw,North Western,9282,6685,15967,371280,267400,638680
4/28/2024,Roshani Jayathilake,Puttalam,Chilaw,North Western,867,1524,2391,34680,60960,95640
4/29/2024,Roshani Jayathilake,Puttalam,Chilaw,North Western,4182,7454,11636,167280,298160,465440
4/30/2024,Roshani Jayathilake,Puttalam,Chilaw,North Western,3297,3983,7280,131880,159320,291200
5/1/2024,Roshani Jayathilake,Puttalam,Chilaw,North Western,3288,5105,8393,131520,204200,335720
5/2/2024,Roshani Jayathilake,Puttalam,Chilaw,North Western,3398,531,3929,135920,21240,157160
5/3/2024,Roshani Jayathilake,Puttalam,Chilaw,North Western,6163,2120,8283,246520,84800,331320
5/4/2024,Roshani Jayathilake,Puttalam,Chilaw,North Western,1636,9856,11492,65440,394240,459680
5/5/2024,Roshani Jayathilake,Puttalam,Chilaw,North Western,8553,3593,12146,342120,143720,485840
5/6/2024,Roshani Jayathilake,Puttalam,Chilaw,North Western,1768,8304,10072,70720,332160,402880
5/7/2024,Roshani Jayathilake,Puttalam,Chilaw,North Western,3759,7885,11644,150360,315400,465760
5/8/2024,Roshani Jayathilake,Puttalam,Chilaw,North Western,3000,2871,5871,120000,114840,234840
5/9/2024,Roshani Jayathilake,Puttalam,Chilaw,North Western,9923,8827,18750,396920,353080,750000
5/10/2024,Roshani Jayathilake,Puttalam,Chilaw,North Western,5570,4330,9900,222800,173200,396000
5/11/2024,Roshani Jayathilake,Puttalam,Chilaw,North Western,6772,7030,13802,270880,281200,552080
5/12/2024,Roshani Jayathilake,Puttalam,Chilaw,North Western,1963,5613,7576,78520,224520,303040
5/13/2024,Roshani Jayathilake,Puttalam,Chilaw,North Western,2977,7102,10079,119080,284080,403160
5/14/2024,Roshani Jayathilake,Puttalam,Chilaw,North Western,6935,3896,10831,277400,155840,433240
5/15/2024,Roshani Jayathilake,Puttalam,Chilaw,North Western,6635,9493,16128,265400,379720,645120
5/16/2024,Roshani Jayathilake,Puttalam,Chilaw,North Western,4701,3284,7985,188040,131360,319400
5/17/2024,Roshani Jayathilake,Puttalam,Chilaw,North Western,3878,5819,9697,155120,232760,387880
5/18/2024,Roshani Jayathilake,Puttalam,Chilaw,North Western,7308,9082,16390,292320,363280,655600
5/19/2024,Roshani Jayathilake,Puttalam,Chilaw,North Western,396,5704,6100,15840,228160,244000
5/20/2024,Roshani Jayathilake,Puttalam,Chilaw,North Western,5104,5943,11047,204160,237720,441880
5/21/2024,Roshani Jayathilake,Puttalam,Chilaw,North Western,7281,1881,9162,291240,75240,366480
5/22/2024,Roshani Jayathilake,Puttalam,Chilaw,North Western,2609,9605,12214,104360,384200,488560
5/24/2024,Roshani Jayathilake,Puttalam,Chilaw,North Western,5170,9878,15048,206800,395120,601920
5/25/2024,Roshani Jayathilake,Puttalam,Chilaw,North Western,6313,3873,10186,252520,154920,407440
5/26/2024,Roshani Jayathilake,Puttalam,Chilaw,North Western,2408,8784,11192,96320,351360,447680
5/27/2024,Roshani Jayathilake,Puttalam,Chilaw,North Western,1556,3394,4950,62240,135760,198000
5/28/2024,Roshani Jayathilake,Puttalam,Chilaw,North Western,2260,5011,7271,90400,200440,290840
5/29/2024,Roshani Jayathilake,Puttalam,Chilaw,North Western,2655,98,2753,106200,3920,110120
5/30/2024,Roshani Jayathilake,Puttalam,Chilaw,North Western,8712,3897,12609,348480,155880,504360
5/31/2024,Roshani Jayathilake,Puttalam,Chilaw,North Western,5653,6994,12647,226120,279760,505880
6/1/2024,Roshani Jayathilake,Puttalam,Chilaw,North Western,7707,6460,14167,308280,258400,566680
6/2/2024,Roshani Jayathilake,Puttalam,Chilaw,North Western,4969,7991,12960,198760,319640,518400
6/3/2024,Roshani Jayathilake,Puttalam,Chilaw,North Western,6577,2536,9113,263080,101440,364520
6/4/2024,Roshani Jayathilake,Puttalam,Chilaw,North Western,8487,3388,11875,339480,135520,475000
6/5/2024,Roshani Jayathilake,Puttalam,Chilaw,North Western,1446,4473,5919,57840,178920,236760
6/6/2024,Roshani Jayathilake,Puttalam,Chilaw,North Western,5390,8409,13799,215600,336360,551960
6/7/2024,Roshani Jayathilake,Puttalam,Chilaw,North Western,6242,4165,10407,249680,166600,416280
6/8/2024,Roshani Jayathilake,Puttalam,Chilaw,North Western,4303,3176,7479,172120,127040,299160
6/9/2024,Roshani Jayathilake,Puttalam,Chilaw,North Western,8995,5629,14624,359800,225160,584960
6/10/2024,Roshani Jayathilake,Puttalam,Chilaw,North Western,5641,9689,15330,225640,387560,613200
6/11/2024,Roshani Jayathilake,Puttalam,Chilaw,North Western,2160,9466,11626,86400,378640,465040
6/12/2024,Roshani Jayathilake,Puttalam,Chilaw,North Western,4233,5112,9345,169320,204480,373800
6/13/2024,Roshani Jayathilake,Puttalam,Chilaw,North Western,8187,9119,17306,327480,364760,692240
6/14/2024,Roshani Jayathilake,Puttalam,Chilaw,North Western,3888,5503,9391,155520,220120,375640
6/15/2024,Roshani Jayathilake,Puttalam,Chilaw,North Western,767,8445,9212,30680,337800,368480
6/16/2024,Roshani Jayathilake,Puttalam,Chilaw,North Western,1474,6317,7791,58960,252680,311640
6/17/2024,Roshani Jayathilake,Puttalam,Chilaw,North Western,7784,4162,11946,311360,166480,477840
6/18/2024,Roshani Jayathilake,Puttalam,Chilaw,North Western,5501,7193,12694,220040,287720,507760
6/19/2024,Roshani Jayathilake,Puttalam,Chilaw,North Western,8557,1009,9566,342280,40360,382640
6/20/2024,Roshani Jayathilake,Puttalam,Chilaw,North Western,7207,3785,10992,288280,151400,439680
6/21/2024,Roshani Jayathilake,Puttalam,Chilaw,North Western,3035,4549,7584,121400,181960,303360
6/22/2024,Roshani Jayathilake,Puttalam,Chilaw,North Western,9523,5186,14709,380920,207440,588360
6/23/2024,Roshani Jayathilake,Puttalam,Chilaw,North Western,1206,3415,4621,48240,136600,184840
6/24/2024,Roshani Jayathilake,Puttalam,Chilaw,North Western,3921,489,4410,156840,19560,176400
6/25/2024,Roshani Jayathilake,Puttalam,Chilaw,North Western,746,6574,7320,29840,262960,292800
6/26/2024,Roshani Jayathilake,Puttalam,Chilaw,North Western,6186,7463,13649,247440,298520,545960
6/27/2024,Roshani Jayathilake,Puttalam,Chilaw,North Western,734,4545,5279,29360,181800,211160
6/28/2024,Roshani Jayathilake,Puttalam,Chilaw,North Western,3966,6561,10527,158640,262440,421080
6/29/2024,Roshani Jayathilake,Puttalam,Chilaw,North Western,1431,3544,4975,57240,141760,199000
6/30/2024,Roshani Jayathilake,Puttalam,Chilaw,North Western,5080,1328,6408,203200,53120,256320
7/1/2024,Roshani Jayathilake,Puttalam,Chilaw,North Western,1451,9226,10677,58040,369040,427080
7/2/2024,Roshani Jayathilake,Puttalam,Chilaw,North Western,5222,6062,11284,208880,242480,451360
7/3/2024,Roshani Jayathilake,Puttalam,Chilaw,North Western,6343,6752,13095,253720,270080,523800
7/4/2024,Roshani Jayathilake,Puttalam,Chilaw,North Western,9065,7026,16091,362600,281040,643640
7/5/2024,Roshani Jayathilake,Puttalam,Chilaw,North Western,6800,1493,8293,272000,59720,331720
7/6/2024,Roshani Jayathilake,Puttalam,Chilaw,North Western,1423,921,2344,56920,36840,93760
7/7/2024,Roshani Jayathilake,Puttalam,Chilaw,North Western,9263,8922,18185,370520,356880,727400
7/8/2024,Roshani Jayathilake,Puttalam,Chilaw,North Western,5128,8719,13847,205120,348760,553880
7/9/2024,Roshani Jayathilake,Puttalam,Chilaw,North Western,8723,2370,11093,348920,94800,443720
7/10/2024,Roshani Jayathilake,Puttalam,Chilaw,North Western,8903,1972,10875,356120,78880,435000
7/11/2024,Roshani Jayathilake,Puttalam,Chilaw,North Western,5821,2928,8749,232840,117120,349960
7/12/2024,Roshani Jayathilake,Puttalam,Chilaw,North Western,9741,4927,14668,389640,197080,586720
7/13/2024,Roshani Jayathilake,Puttalam,Chilaw,North Western,8829,9037,17866,353160,361480,714640
7/14/2024,Roshani Jayathilake,Puttalam,Chilaw,North Western,2345,2617,4962,93800,104680,198480
7/15/2024,Roshani Jayathilake,Puttalam,Chilaw,North Western,6350,823,7173,254000,32920,286920
7/16/2024,Roshani Jayathilake,Puttalam,Chilaw,North Western,8869,3851,12720,354760,154040,508800
7/17/2024,Roshani Jayathilake,Puttalam,Chilaw,North Western,3177,2140,5317,127080,85600,212680
7/18/2024,Roshani Jayathilake,Puttalam,Chilaw,North Western,9287,9583,18870,371480,383320,754800
7/19/2024,Roshani Jayathilake,Puttalam,Chilaw,North Western,2240,4936,7176,89600,197440,287040
7/20/2024,Roshani Jayathilake,Puttalam,Chilaw,North Western,7264,3415,10679,290560,136600,427160
7/21/2024,Roshani Jayathilake,Puttalam,Chilaw,North Western,9716,6981,16697,388640,279240,667880
7/22/2024,Roshani Jayathilake,Puttalam,Chilaw,North Western,1178,1497,2675,47120,59880,107000
7/23/2024,Roshani Jayathilake,Puttalam,Chilaw,North Western,192,8657,8849,7680,346280,353960
7/24/2024,Roshani Jayathilake,Puttalam,Chilaw,North Western,7107,891,7998,284280,35640,319920
7/25/2024,Roshani Jayathilake,Puttalam,Chilaw,North Western,4212,6463,10675,168480,258520,427000
7/26/2024,Roshani Jayathilake,Puttalam,Chilaw,North Western,2070,986,3056,82800,39440,122240
7/27/2024,Roshani Jayathilake,Puttalam,Chilaw,North Western,7179,202,7381,287160,8080,295240
7/28/2024,Roshani Jayathilake,Puttalam,Chilaw,North Western,9818,4412,14230,392720,176480,569200
7/29/2024,Roshani Jayathilake,Puttalam,Chilaw,North Western,1805,850,2655,72200,34000,106200
7/30/2024,Roshani Jayathilake,Puttalam,Chilaw,North Western,1857,939,2796,74280,37560,111840
7/31/2024,Roshani Jayathilake,Puttalam,Chilaw,North Western,7313,2813,10126,292520,112520,405040
8/1/2024,Roshani Jayathilake,Puttalam,Chilaw,North Western,3123,2086,5209,124920,83440,208360
8/2/2024,Roshani Jayathilake,Puttalam,Chilaw,North Western,2354,26,2380,94160,1040,95200
8/3/2024,Roshani Jayathilake,Puttalam,Chilaw,North Western,6696,1705,8401,267840,68200,336040
8/4/2024,Roshani Jayathilake,Puttalam,Chilaw,North Western,1469,9898,11367,58760,395920,454680
8/5/2024,Roshani Jayathilake,Puttalam,Chilaw,North Western,1429,9551,10980,57160,382040,439200
8/6/2024,Roshani Jayathilake,Puttalam,Chilaw,North Western,4207,9550,13757,168280,382000,550280
8/7/2024,Roshani Jayathilake,Puttalam,Chilaw,North Western,5650,1044,6694,226000,41760,267760
8/8/2024,Roshani Jayathilake,Puttalam,Chilaw,North Western,6514,3201,9715,260560,128040,388600
8/9/2024,Roshani Jayathilake,Puttalam,Chilaw,North Western,8849,886,9735,353960,35440,389400
8/10/2024,Roshani Jayathilake,Puttalam,Chilaw,North Western,8442,7965,16407,337680,318600,656280
8/11/2024,Roshani Jayathilake,Puttalam,Chilaw,North Western,2545,8343,10888,101800,333720,435520
8/12/2024,Roshani Jayathilake,Puttalam,Chilaw,North Western,3764,6011,9775,150560,240440,391000
8/13/2024,Roshani Jayathilake,Puttalam,Chilaw,North Western,8777,9060,17837,351080,362400,713480
8/14/2024,Roshani Jayathilake,Puttalam,Chilaw,North Western,5302,8230,13532,212080,329200,541280
8/15/2024,Roshani Jayathilake,Puttalam,Chilaw,North Western,1083,6848,7931,43320,273920,317240
8/16/2024,Roshani Jayathilake,Puttalam,Chilaw,North Western,9516,4379,13895,380640,175160,555800
8/17/2024,Roshani Jayathilake,Puttalam,Chilaw,North Western,6016,9259,15275,240640,370360,611000
8/18/2024,Roshani Jayathilake,Puttalam,Chilaw,North Western,4725,4806,9531,189000,192240,381240
8/19/2024,Roshani Jayathilake,Puttalam,Chilaw,North Western,3210,5639,8849,128400,225560,353960
8/20/2024,Roshani Jayathilake,Puttalam,Chilaw,North Western,2090,4649,6739,83600,185960,269560
8/21/2024,Roshani Jayathilake,Puttalam,Chilaw,North Western,6146,639,6785,245840,25560,271400
8/22/2024,Roshani Jayathilake,Puttalam,Chilaw,North Western,34,3649,3683,1360,145960,147320
8/23/2024,Roshani Jayathilake,Puttalam,Chilaw,North Western,4444,261,4705,177760,10440,188200
8/24/2024,Roshani Jayathilake,Puttalam,Chilaw,North Western,3167,63,3230,126680,2520,129200
8/25/2024,Roshani Jayathilake,Puttalam,Chilaw,North Western,8059,8209,16268,322360,328360,650720
8/26/2024,Roshani Jayathilake,Puttalam,Chilaw,North Western,4481,479,4960,179240,19160,198400
8/27/2024,Roshani Jayathilake,Puttalam,Chilaw,North Western,2459,5634,8093,98360,225360,323720
8/28/2024,Roshani Jayathilake,Puttalam,Chilaw,North Western,4759,6419,11178,190360,256760,447120
8/29/2024,Roshani Jayathilake,Puttalam,Chilaw,North Western,7772,3643,11415,310880,145720,456600
8/30/2024,Roshani Jayathilake,Puttalam,Chilaw,North Western,6808,7326,14134,272320,293040,565360
8/31/2024,Roshani Jayathilake,Puttalam,Chilaw,North Western,4767,3,4770,190680,120,190800
9/1/2024,Roshani Jayathilake,Puttalam,Chilaw,North Western,6295,6343,12638,251800,253720,505520
9/2/2024,Roshani Jayathilake,Puttalam,Chilaw,North Western,7065,7028,14093,282600,281120,563720
9/3/2024,Roshani Jayathilake,Puttalam,Chilaw,North Western,7561,8243,15804,302440,329720,632160
9/4/2024,Roshani Jayathilake,Puttalam,Chilaw,North Western,7663,8345,16008,306520,333800,640320
9/5/2024,Roshani Jayathilake,Puttalam,Chilaw,North Western,3593,1844,5437,143720,73760,217480
9/6/2024,Roshani Jayathilake,Puttalam,Chilaw,North Western,1690,1892,3582,67600,75680,143280
9/7/2024,Roshani Jayathilake,Puttalam,Chilaw,North Western,5391,6025,11416,215640,241000,456640
9/8/2024,Roshani Jayathilake,Puttalam,Chilaw,North Western,9276,82,9358,371040,3280,374320
9/9/2024,Roshani Jayathilake,Puttalam,Chilaw,North Western,4413,1374,5787,176520,54960,231480
9/10/2024,Roshani Jayathilake,Puttalam,Chilaw,North Western,9255,7038,16293,370200,281520,651720
9/11/2024,Roshani Jayathilake,Puttalam,Chilaw,North Western,4416,3062,7478,176640,122480,299120
9/12/2024,Roshani Jayathilake,Puttalam,Chilaw,North Western,186,591,777,7440,23640,31080
9/13/2024,Roshani Jayathilake,Puttalam,Chilaw,North Western,5750,158,5908,230000,6320,236320
9/14/2024,Roshani Jayathilake,Puttalam,Chilaw,North Western,5572,8955,14527,222880,358200,581080
9/15/2024,Roshani Jayathilake,Puttalam,Chilaw,North Western,5633,885,6518,225320,35400,260720
9/16/2024,Roshani Jayathilake,Puttalam,Chilaw,North Western,944,1013,1957,37760,40520,78280
9/17/2024,Roshani Jayathilake,Puttalam,Chilaw,North Western,833,376,1209,33320,15040,48360
9/18/2024,Roshani Jayathilake,Puttalam,Chilaw,North Western,4610,2359,6969,184400,94360,278760
9/19/2024,Roshani Jayathilake,Puttalam,Chilaw,North Western,9582,8225,17807,383280,329000,712280
9/20/2024,Roshani Jayathilake,Puttalam,Chilaw,North Western,4016,5861,9877,160640,234440,395080
9/21/2024,Roshani Jayathilake,Puttalam,Chilaw,North Western,7461,6844,14305,298440,273760,572200
9/22/2024,Roshani Jayathilake,Puttalam,Chilaw,North Western,8981,9450,18431,359240,378000,737240
9/23/2024,Roshani Jayathilake,Puttalam,Chilaw,North Western,834,5089,5923,33360,203560,236920
9/24/2024,Roshani Jayathilake,Puttalam,Chilaw,North Western,9505,4934,14439,380200,197360,577560
9/25/2024,Roshani Jayathilake,Puttalam,Chilaw,North Western,5673,9989,15662,226920,399560,626480
9/26/2024,Roshani Jayathilake,Puttalam,Chilaw,North Western,2214,9843,12057,88560,393720,482280
9/27/2024,Roshani Jayathilake,Puttalam,Chilaw,North Western,2139,6923,9062,85560,276920,362480
9/28/2024,Roshani Jayathilake,Puttalam,Chilaw,North Western,3797,4969,8766,151880,198760,350640
9/29/2024,Roshani Jayathilake,Puttalam,Chilaw,North Western,5046,9517,14563,201840,380680,582520
9/30/2024,Roshani Jayathilake,Puttalam,Chilaw,North Western,316,4037,4353,12640,161480,174120
10/1/2024,Roshani Jayathilake,Puttalam,Chilaw,North Western,9483,2376,11859,379320,95040,474360
10/2/2024,Roshani Jayathilake,Puttalam,Chilaw,North Western,733,7683,8416,29320,307320,336640
10/3/2024,Roshani Jayathilake,Puttalam,Chilaw,North Western,632,7325,7957,25280,293000,318280
10/4/2024,Roshani Jayathilake,Puttalam,Chilaw,North Western,1592,7425,9017,63680,297000,360680
10/5/2024,Roshani Jayathilake,Puttalam,Chilaw,North Western,5109,8465,13574,204360,338600,542960
10/6/2024,Roshani Jayathilake,Puttalam,Chilaw,North Western,8018,8446,16464,320720,337840,658560
10/7/2024,Roshani Jayathilake,Puttalam,Chilaw,North Western,9517,4759,14276,380680,190360,571040
10/8/2024,Roshani Jayathilake,Puttalam,Chilaw,North Western,8835,7586,16421,353400,303440,656840
10/9/2024,Roshani Jayathilake,Puttalam,Chilaw,North Western,8071,6943,15014,322840,277720,600560
10/10/2024,Roshani Jayathilake,Puttalam,Chilaw,North Western,9284,6689,15973,371360,267560,638920
10/11/2024,Roshani Jayathilake,Puttalam,Chilaw,North Western,6887,4547,11434,275480,181880,457360
10/12/2024,Roshani Jayathilake,Puttalam,Chilaw,North Western,3929,3166,7095,157160,126640,283800
10/13/2024,Roshani Jayathilake,Puttalam,Chilaw,North Western,4884,4209,9093,195360,168360,363720
10/14/2024,Roshani Jayathilake,Puttalam,Chilaw,North Western,2866,6422,9288,114640,256880,371520
10/15/2024,Roshani Jayathilake,Puttalam,Chilaw,North Western,7093,3785,10878,283720,151400,435120
10/16/2024,Roshani Jayathilake,Puttalam,Chilaw,North Western,7152,8814,15966,286080,352560,638640
10/17/2024,Roshani Jayathilake,Puttalam,Chilaw,North Western,6163,2645,8808,246520,105800,352320
10/18/2024,Roshani Jayathilake,Puttalam,Chilaw,North Western,6165,8049,14214,246600,321960,568560
10/19/2024,Roshani Jayathilake,Puttalam,Chilaw,North Western,3464,8664,12128,138560,346560,485120
10/20/2024,Roshani Jayathilake,Puttalam,Chilaw,North Western,991,2475,3466,39640,99000,138640
10/21/2024,Roshani Jayathilake,Puttalam,Chilaw,North Western,7038,7390,14428,281520,295600,577120
10/22/2024,Roshani Jayathilake,Puttalam,Chilaw,North Western,4885,4931,9816,195400,197240,392640
10/23/2024,Roshani Jayathilake,Puttalam,Chilaw,North Western,8387,6172,14559,335480,246880,582360
10/24/2024,Roshani Jayathilake,Puttalam,Chilaw,North Western,9746,6946,16692,389840,277840,667680
10/25/2024,Roshani Jayathilake,Puttalam,Chilaw,North Western,8349,9227,17576,333960,369080,703040
10/26/2024,Roshani Jayathilake,Puttalam,Chilaw,North Western,3639,1842,5481,145560,73680,219240
10/27/2024,Roshani Jayathilake,Puttalam,Chilaw,North Western,3111,5863,8974,124440,234520,358960
10/28/2024,Roshani Jayathilake,Puttalam,Chilaw,North Western,3657,8251,11908,146280,330040,476320
10/29/2024,Roshani Jayathilake,Puttalam,Chilaw,North Western,6301,3122,9423,252040,124880,376920
10/30/2024,Roshani Jayathilake,Puttalam,Chilaw,North Western,6590,459,7049,263600,18360,281960
10/31/2024,Roshani Jayathilake,Puttalam,Chilaw,North Western,6569,9210,15779,262760,368400,631160
11/1/2024,Roshani Jayathilake,Puttalam,Chilaw,North Western,1972,3473,5445,78880,138920,217800
11/2/2024,Roshani Jayathilake,Puttalam,Chilaw,North Western,7038,3891,10929,281520,155640,437160
11/3/2024,Roshani Jayathilake,Puttalam,Chilaw,North Western,7801,2168,9969,312040,86720,398760
11/4/2024,Roshani Jayathilake,Puttalam,Chilaw,North Western,400,2934,3334,16000,117360,133360
11/5/2024,Roshani Jayathilake,Puttalam,Chilaw,North Western,8053,4863,12916,322120,194520,516640
11/6/2024,Roshani Jayathilake,Puttalam,Chilaw,North Western,4717,9520,14237,188680,380800,569480
11/7/2024,Roshani Jayathilake,Puttalam,Chilaw,North Western,2841,1022,3863,113640,40880,154520
11/8/2024,Roshani Jayathilake,Puttalam,Chilaw,North Western,114,3703,3817,4560,148120,152680
11/9/2024,Roshani Jayathilake,Puttalam,Chilaw,North Western,1809,5399,7208,72360,215960,288320
11/10/2024,Roshani Jayathilake,Puttalam,Chilaw,North Western,579,9455,10034,23160,378200,401360
11/11/2024,Roshani Jayathilake,Puttalam,Chilaw,North Western,7854,8327,16181,314160,333080,647240
11/12/2024,Roshani Jayathilake,Puttalam,Chilaw,North Western,4583,132,4715,183320,5280,188600
11/13/2024,Roshani Jayathilake,Puttalam,Chilaw,North Western,7868,1516,9384,314720,60640,375360
11/14/2024,Roshani Jayathilake,Puttalam,Chilaw,North Western,4257,2950,7207,170280,118000,288280
11/15/2024,Roshani Jayathilake,Puttalam,Chilaw,North Western,2551,2034,4585,102040,81360,183400
11/16/2024,Roshani Jayathilake,Puttalam,Chilaw,North Western,4307,3079,7386,172280,123160,295440
11/17/2024,Roshani Jayathilake,Puttalam,Chilaw,North Western,530,2804,3334,21200,112160,133360
11/18/2024,Roshani Jayathilake,Puttalam,Chilaw,North Western,6492,9085,15577,259680,363400,623080
11/19/2024,Roshani Jayathilake,Puttalam,Chilaw,North Western,3323,6753,10076,132920,270120,403040
11/20/2024,Roshani Jayathilake,Puttalam,Chilaw,North Western,6422,3348,9770,256880,133920,390800
11/21/2024,Roshani Jayathilake,Puttalam,Chilaw,North Western,5973,4531,10504,238920,181240,420160
11/22/2024,Roshani Jayathilake,Puttalam,Chilaw,North Western,7560,8936,16496,302400,357440,659840
11/23/2024,Roshani Jayathilake,Puttalam,Chilaw,North Western,946,6846,7792,37840,273840,311680
11/24/2024,Roshani Jayathilake,Puttalam,Chilaw,North Western,7690,3382,11072,307600,135280,442880
11/25/2024,Roshani Jayathilake,Puttalam,Chilaw,North Western,9973,3879,13852,398920,155160,554080
11/26/2024,Roshani Jayathilake,Puttalam,Chilaw,North Western,2756,741,3497,110240,29640,139880
11/27/2024,Roshani Jayathilake,Puttalam,Chilaw,North Western,3661,8123,11784,146440,324920,471360
11/28/2024,Roshani Jayathilake,Puttalam,Chilaw,North Western,449,8572,9021,17960,342880,360840
11/29/2024,Roshani Jayathilake,Puttalam,Chilaw,North Western,4657,3922,8579,186280,156880,343160
11/30/2024,Roshani Jayathilake,Puttalam,Chilaw,North Western,8827,580,9407,353080,23200,376280
12/1/2024,Roshani Jayathilake,Puttalam,Chilaw,North Western,833,440,1273,33320,17600,50920
12/2/2024,Roshani Jayathilake,Puttalam,Chilaw,North Western,5164,3337,8501,206560,133480,340040
12/3/2024,Roshani Jayathilake,Puttalam,Chilaw,North Western,6879,646,7525,275160,25840,301000
12/4/2024,Roshani Jayathilake,Puttalam,Chilaw,North Western,4835,3702,8537,193400,148080,341480
12/5/2024,Roshani Jayathilake,Puttalam,Chilaw,North Western,8807,7768,16575,352280,310720,663000
12/6/2024,Roshani Jayathilake,Puttalam,Chilaw,North Western,4657,9107,13764,186280,364280,550560
12/7/2024,Roshani Jayathilake,Puttalam,Chilaw,North Western,2547,7732,10279,101880,309280,411160
12/8/2024,Roshani Jayathilake,Puttalam,Chilaw,North Western,1259,4287,5546,50360,171480,221840
12/9/2024,Roshani Jayathilake,Puttalam,Chilaw,North Western,42,3573,3615,1680,142920,144600
12/10/2024,Roshani Jayathilake,Puttalam,Chilaw,North Western,5122,4669,9791,204880,186760,391640
12/11/2024,Roshani Jayathilake,Puttalam,Chilaw,North Western,7124,5142,12266,284960,205680,490640
12/12/2024,Roshani Jayathilake,Puttalam,Chilaw,North Western,2887,3722,6609,115480,148880,264360
12/13/2024,Roshani Jayathilake,Puttalam,Chilaw,North Western,1015,3830,4845,40600,153200,193800
12/14/2024,Roshani Jayathilake,Puttalam,Chilaw,North Western,1436,5426,6862,57440,217040,274480
12/15/2024,Roshani Jayathilake,Puttalam,Chilaw,North Western,1249,821,2070,49960,32840,82800
12/16/2024,Roshani Jayathilake,Puttalam,Chilaw,North Western,4890,4620,9510,195600,184800,380400
12/17/2024,Roshani Jayathilake,Puttalam,Chilaw,North Western,2960,8074,11034,118400,322960,441360
12/18/2024,Roshani Jayathilake,Puttalam,Chilaw,North Western,492,2694,3186,19680,107760,127440
12/19/2024,Roshani Jayathilake,Puttalam,Chilaw,North Western,8429,5801,14230,337160,232040,569200
12/20/2024,Roshani Jayathilake,Puttalam,Chilaw,North Western,4278,3913,8191,171120,156520,327640
12/21/2024,Roshani Jayathilake,Puttalam,Chilaw,North Western,9398,4181,13579,375920,167240,543160
12/22/2024,Roshani Jayathilake,Puttalam,Chilaw,North Western,6193,9740,15933,247720,389600,637320
12/23/2024,Roshani Jayathilake,Puttalam,Chilaw,North Western,8013,3821,11834,320520,152840,473360
12/24/2024,Roshani Jayathilake,Puttalam,Chilaw,North Western,3112,683,3795,124480,27320,151800
12/25/2024,Roshani Jayathilake,Puttalam,Chilaw,North Western,6842,4957,11799,273680,198280,471960
12/26/2024,Roshani Jayathilake,Puttalam,Chilaw,North Western,7427,7809,15236,297080,312360,609440
12/27/2024,Roshani Jayathilake,Puttalam,Chilaw,North Western,3879,8285,12164,155160,331400,486560
12/28/2024,Roshani Jayathilake,Puttalam,Chilaw,North Western,7571,3896,11467,302840,155840,458680
12/29/2024,Roshani Jayathilake,Puttalam,Chilaw,North Western,4040,1491,5531,161600,59640,221240
12/30/2024,Roshani Jayathilake,Puttalam,Chilaw,North Western,6451,3785,10236,258040,151400,409440
12/31/2024,Roshani Jayathilake,Puttalam,Chilaw,North Western,746,4029,4775,29840,161160,191000
1/1/2025,Roshani Jayathilake,Puttalam,Chilaw,North Western,9878,8488,18366,395120,339520,734640
1/2/2025,Roshani Jayathilake,Puttalam,Chilaw,North Western,2360,31,2391,94400,1240,95640
1/3/2025,Roshani Jayathilake,Puttalam,Chilaw,North Western,932,1822,2754,37280,72880,110160
1/4/2025,Roshani Jayathilake,Puttalam,Chilaw,North Western,3257,5370,8627,130280,214800,345080
1/5/2025,Roshani Jayathilake,Puttalam,Chilaw,North Western,9786,4643,14429,391440,185720,577160
1/6/2025,Roshani Jayathilake,Puttalam,Chilaw,North Western,8993,7314,16307,359720,292560,652280
1/7/2025,Roshani Jayathilake,Puttalam,Chilaw,North Western,860,1933,2793,34400,77320,111720
1/8/2025,Roshani Jayathilake,Puttalam,Chilaw,North Western,6557,4804,11361,262280,192160,454440
1/9/2025,Roshani Jayathilake,Puttalam,Chilaw,North Western,1267,5324,6591,50680,212960,263640
1/10/2025,Roshani Jayathilake,Puttalam,Chilaw,North Western,8961,5910,14871,358440,236400,594840
1/11/2025,Roshani Jayathilake,Puttalam,Chilaw,North Western,4619,9502,14121,184760,380080,564840
1/12/2025,Roshani Jayathilake,Puttalam,Chilaw,North Western,3293,6625,9918,131720,265000,396720
1/13/2025,Roshani Jayathilake,Puttalam,Chilaw,North Western,2683,997,3680,107320,39880,147200
1/14/2025,Roshani Jayathilake,Puttalam,Chilaw,North Western,1381,1036,2417,55240,41440,96680
1/15/2025,Roshani Jayathilake,Puttalam,Chilaw,North Western,9353,5292,14645,374120,211680,585800
1/16/2025,Roshani Jayathilake,Puttalam,Chilaw,North Western,6025,7541,13566,241000,301640,542640
1/17/2025,Roshani Jayathilake,Puttalam,Chilaw,North Western,8722,3633,12355,348880,145320,494200
1/18/2025,Roshani Jayathilake,Puttalam,Chilaw,North Western,501,1369,1870,20040,54760,74800
1/19/2025,Roshani Jayathilake,Puttalam,Chilaw,North Western,406,9759,10165,16240,390360,406600
1/20/2025,Roshani Jayathilake,Puttalam,Chilaw,North Western,8945,2790,11735,357800,111600,469400
1/21/2025,Roshani Jayathilake,Puttalam,Chilaw,North Western,6312,4323,10635,252480,172920,425400
1/22/2025,Roshani Jayathilake,Puttalam,Chilaw,North Western,7008,6417,13425,280320,256680,537000
1/23/2025,Roshani Jayathilake,Puttalam,Chilaw,North Western,4345,9110,13455,173800,364400,538200
1/24/2025,Roshani Jayathilake,Puttalam,Chilaw,North Western,2426,7413,9839,97040,296520,393560
1/25/2025,Roshani Jayathilake,Puttalam,Chilaw,North Western,6403,5714,12117,256120,228560,484680
1/26/2025,Roshani Jayathilake,Puttalam,Chilaw,North Western,2078,872,2950,83120,34880,118000
1/27/2025,Roshani Jayathilake,Puttalam,Chilaw,North Western,8160,5999,14159,326400,239960,566360
1/28/2025,Roshani Jayathilake,Puttalam,Chilaw,North Western,3239,1790,5029,129560,71600,201160
1/29/2025,Roshani Jayathilake,Puttalam,Chilaw,North Western,6023,7642,13665,240920,305680,546600
1/30/2025,Roshani Jayathilake,Puttalam,Chilaw,North Western,4853,8123,12976,194120,324920,519040
1/31/2025,Roshani Jayathilake,Puttalam,Chilaw,North Western,6151,7468,13619,246040,298720,544760
2/1/2025,Roshani Jayathilake,Puttalam,Chilaw,North Western,1669,2230,3899,66760,89200,155960
2/2/2025,Roshani Jayathilake,Puttalam,Chilaw,North Western,9771,6857,16628,390840,274280,665120
2/3/2025,Roshani Jayathilake,Puttalam,Chilaw,North Western,7980,470,8450,319200,18800,338000
2/4/2025,Roshani Jayathilake,Puttalam,Chilaw,North Western,7076,839,7915,283040,33560,316600
2/5/2025,Roshani Jayathilake,Puttalam,Chilaw,North Western,5968,6917,12885,238720,276680,515400
2/6/2025,Roshani Jayathilake,Puttalam,Chilaw,North Western,2663,448,3111,106520,17920,124440
2/7/2025,Roshani Jayathilake,Puttalam,Chilaw,North Western,8622,1090,9712,344880,43600,388480
2/8/2025,Roshani Jayathilake,Puttalam,Chilaw,North Western,8914,1678,10592,356560,67120,423680
2/9/2025,Roshani Jayathilake,Puttalam,Chilaw,North Western,9872,806,10678,394880,32240,427120
2/10/2025,Roshani Jayathilake,Puttalam,Chilaw,North Western,1039,5031,6070,41560,201240,242800
2/11/2025,Roshani Jayathilake,Puttalam,Chilaw,North Western,405,3848,4253,16200,153920,170120
2/12/2025,Roshani Jayathilake,Puttalam,Chilaw,North Western,473,4675,5148,18920,187000,205920
2/13/2025,Roshani Jayathilake,Puttalam,Chilaw,North Western,3748,5528,9276,149920,221120,371040
2/14/2025,Roshani Jayathilake,Puttalam,Chilaw,North Western,9999,116,10115,399960,4640,404600
2/15/2025,Roshani Jayathilake,Puttalam,Chilaw,North Western,3971,7274,11245,158840,290960,449800
2/16/2025,Roshani Jayathilake,Puttalam,Chilaw,North Western,9375,4903,14278,375000,196120,571120
2/17/2025,Roshani Jayathilake,Puttalam,Chilaw,North Western,6864,3152,10016,274560,126080,400640
2/18/2025,Roshani Jayathilake,Puttalam,Chilaw,North Western,6814,7025,13839,272560,281000,553560
2/19/2025,Roshani Jayathilake,Puttalam,Chilaw,North Western,991,3996,4987,39640,159840,199480
2/20/2025,Roshani Jayathilake,Puttalam,Chilaw,North Western,2481,6561,9042,99240,262440,361680
2/21/2025,Roshani Jayathilake,Puttalam,Chilaw,North Western,836,2496,3332,33440,99840,133280
2/22/2025,Roshani Jayathilake,Puttalam,Chilaw,North Western,3167,2360,5527,126680,94400,221080
2/23/2025,Roshani Jayathilake,Puttalam,Chilaw,North Western,3401,8903,12304,136040,356120,492160
2/24/2025,Roshani Jayathilake,Puttalam,Chilaw,North Western,9905,8615,18520,396200,344600,740800
2/25/2025,Roshani Jayathilake,Puttalam,Chilaw,North Western,5035,9669,14704,201400,386760,588160
2/26/2025,Roshani Jayathilake,Puttalam,Chilaw,North Western,5975,1158,7133,239000,46320,285320
2/27/2025,Roshani Jayathilake,Puttalam,Chilaw,North Western,5876,4682,10558,235040,187280,422320
2/28/2025,Roshani Jayathilake,Puttalam,Chilaw,North Western,2806,648,3454,112240,25920,138160
3/1/2025,Roshani Jayathilake,Puttalam,Chilaw,North Western,3667,2037,5704,146680,81480,228160
3/2/2025,Roshani Jayathilake,Puttalam,Chilaw,North Western,7115,2216,9331,284600,88640,373240
3/3/2025,Roshani Jayathilake,Puttalam,Chilaw,North Western,1435,3186,4621,57400,127440,184840
3/4/2025,Roshani Jayathilake,Puttalam,Chilaw,North Western,722,4978,5700,28880,199120,228000
3/5/2025,Roshani Jayathilake,Puttalam,Chilaw,North Western,6881,8847,15728,275240,353880,629120
3/6/2025,Roshani Jayathilake,Puttalam,Chilaw,North Western,5055,7651,12706,202200,306040,508240
3/7/2025,Roshani Jayathilake,Puttalam,Chilaw,North Western,7824,3355,11179,312960,134200,447160
3/8/2025,Roshani Jayathilake,Puttalam,Chilaw,North Western,9247,687,9934,369880,27480,397360
3/9/2025,Roshani Jayathilake,Puttalam,Chilaw,North Western,8459,1829,10288,338360,73160,411520
3/10/2025,Roshani Jayathilake,Puttalam,Chilaw,North Western,7388,6795,14183,295520,271800,567320
3/11/2025,Roshani Jayathilake,Puttalam,Chilaw,North Western,3741,3303,7044,149640,132120,281760
3/12/2025,Roshani Jayathilake,Puttalam,Chilaw,North Western,2967,791,3758,118680,31640,150320
3/13/2025,Roshani Jayathilake,Puttalam,Chilaw,North Western,1229,2682,3911,49160,107280,156440
3/14/2025,Roshani Jayathilake,Puttalam,Chilaw,North Western,4950,2479,7429,198000,99160,297160
3/15/2025,Roshani Jayathilake,Puttalam,Chilaw,North Western,277,123,400,11080,4920,16000
3/16/2025,Roshani Jayathilake,Puttalam,Chilaw,North Western,4315,5153,9468,172600,206120,378720
3/17/2025,Roshani Jayathilake,Puttalam,Chilaw,North Western,5552,4074,9626,222080,162960,385040
3/18/2025,Roshani Jayathilake,Puttalam,Chilaw,North Western,9080,4887,13967,363200,195480,558680
3/19/2025,Roshani Jayathilake,Puttalam,Chilaw,North Western,1398,2476,3874,55920,99040,154960
3/20/2025,Roshani Jayathilake,Puttalam,Chilaw,North Western,3937,3128,7065,157480,125120,282600
3/21/2025,Roshani Jayathilake,Puttalam,Chilaw,North Western,1650,5083,6733,66000,203320,269320
3/22/2025,Roshani Jayathilake,Puttalam,Chilaw,North Western,7099,7251,14350,283960,290040,574000
3/23/2025,Roshani Jayathilake,Puttalam,Chilaw,North Western,6706,3247,9953,268240,129880,398120
3/25/2024,Saman Rajaratne,Badulla,Badulla,Uva,3104,8036,11140,124160,321440,445600
3/26/2024,Saman Rajaratne,Badulla,Badulla,Uva,6270,645,6915,250800,25800,276600
3/27/2024,Saman Rajaratne,Badulla,Badulla,Uva,2378,1446,3824,95120,57840,152960
3/28/2024,Saman Rajaratne,Badulla,Badulla,Uva,7024,7822,14846,280960,312880,593840
3/29/2024,Saman Rajaratne,Badulla,Badulla,Uva,779,3855,4634,31160,154200,185360
3/30/2024,Saman Rajaratne,Badulla,Badulla,Uva,9047,1286,10333,361880,51440,413320
3/31/2024,Saman Rajaratne,Badulla,Badulla,Uva,2830,5404,8234,113200,216160,329360
4/1/2024,Saman Rajaratne,Badulla,Badulla,Uva,9972,6008,15980,398880,240320,639200
4/2/2024,Saman Rajaratne,Badulla,Badulla,Uva,9131,7926,17057,365240,317040,682280
4/3/2024,Saman Rajaratne,Badulla,Badulla,Uva,2615,6435,9050,104600,257400,362000
4/4/2024,Saman Rajaratne,Badulla,Badulla,Uva,174,4637,4811,6960,185480,192440
4/5/2024,Saman Rajaratne,Badulla,Badulla,Uva,6981,8602,15583,279240,344080,623320
4/6/2024,Saman Rajaratne,Badulla,Badulla,Uva,1991,3394,5385,79640,135760,215400
4/7/2024,Saman Rajaratne,Badulla,Badulla,Uva,2277,8417,10694,91080,336680,427760
4/8/2024,Saman Rajaratne,Badulla,Badulla,Uva,5766,487,6253,230640,19480,250120
4/9/2024,Saman Rajaratne,Badulla,Badulla,Uva,4022,288,4310,160880,11520,172400
4/10/2024,Saman Rajaratne,Badulla,Badulla,Uva,953,2626,3579,38120,105040,143160
4/11/2024,Saman Rajaratne,Badulla,Badulla,Uva,651,5182,5833,26040,207280,233320
4/19/2024,Saman Rajaratne,Badulla,Badulla,Uva,495,4080,4575,19800,163200,183000
4/20/2024,Saman Rajaratne,Badulla,Badulla,Uva,8853,3842,12695,354120,153680,507800
4/21/2024,Saman Rajaratne,Badulla,Badulla,Uva,541,2069,2610,21640,82760,104400
4/22/2024,Saman Rajaratne,Badulla,Badulla,Uva,4089,3988,8077,163560,159520,323080
4/23/2024,Saman Rajaratne,Badulla,Badulla,Uva,4691,7907,12598,187640,316280,503920
4/24/2024,Saman Rajaratne,Badulla,Badulla,Uva,1474,9934,11408,58960,397360,456320
4/25/2024,Saman Rajaratne,Badulla,Badulla,Uva,9874,4422,14296,394960,176880,571840
4/26/2024,Saman Rajaratne,Badulla,Badulla,Uva,7100,9812,16912,284000,392480,676480
4/27/2024,Saman Rajaratne,Badulla,Badulla,Uva,2658,3396,6054,106320,135840,242160
4/28/2024,Saman Rajaratne,Badulla,Badulla,Uva,9882,2052,11934,395280,82080,477360
4/29/2024,Saman Rajaratne,Badulla,Badulla,Uva,9005,9821,18826,360200,392840,753040
4/30/2024,Saman Rajaratne,Badulla,Badulla,Uva,1901,5978,7879,76040,239120,315160
5/1/2024,Saman Rajaratne,Badulla,Badulla,Uva,790,6112,6902,31600,244480,276080
5/2/2024,Saman Rajaratne,Badulla,Badulla,Uva,2563,5871,8434,102520,234840,337360
5/3/2024,Saman Rajaratne,Badulla,Badulla,Uva,6827,895,7722,273080,35800,308880
5/4/2024,Saman Rajaratne,Badulla,Badulla,Uva,4159,3767,7926,166360,150680,317040
5/5/2024,Saman Rajaratne,Badulla,Badulla,Uva,1331,2210,3541,53240,88400,141640
5/6/2024,Saman Rajaratne,Badulla,Badulla,Uva,9183,2080,11263,367320,83200,450520
5/7/2024,Saman Rajaratne,Badulla,Badulla,Uva,338,3096,3434,13520,123840,137360
5/8/2024,Saman Rajaratne,Badulla,Badulla,Uva,3908,8265,12173,156320,330600,486920
5/9/2024,Saman Rajaratne,Badulla,Badulla,Uva,432,1633,2065,17280,65320,82600
5/10/2024,Saman Rajaratne,Badulla,Badulla,Uva,6947,7289,14236,277880,291560,569440
5/11/2024,Saman Rajaratne,Badulla,Badulla,Uva,3795,5032,8827,151800,201280,353080
5/12/2024,Saman Rajaratne,Badulla,Badulla,Uva,5893,7485,13378,235720,299400,535120
5/13/2024,Saman Rajaratne,Badulla,Badulla,Uva,8049,2419,10468,321960,96760,418720
5/14/2024,Saman Rajaratne,Badulla,Badulla,Uva,7642,1568,9210,305680,62720,368400
5/15/2024,Saman Rajaratne,Badulla,Badulla,Uva,2568,487,3055,102720,19480,122200
5/16/2024,Saman Rajaratne,Badulla,Badulla,Uva,9051,7803,16854,362040,312120,674160
5/17/2024,Saman Rajaratne,Badulla,Badulla,Uva,1625,8421,10046,65000,336840,401840
5/18/2024,Saman Rajaratne,Badulla,Badulla,Uva,1597,7350,8947,63880,294000,357880
5/19/2024,Saman Rajaratne,Badulla,Badulla,Uva,8473,1978,10451,338920,79120,418040
5/20/2024,Saman Rajaratne,Badulla,Badulla,Uva,762,2731,3493,30480,109240,139720
5/21/2024,Saman Rajaratne,Badulla,Badulla,Uva,8780,1170,9950,351200,46800,398000
5/22/2024,Saman Rajaratne,Badulla,Badulla,Uva,2397,600,2997,95880,24000,119880
5/24/2024,Saman Rajaratne,Badulla,Badulla,Uva,438,2121,2559,17520,84840,102360
5/25/2024,Saman Rajaratne,Badulla,Badulla,Uva,9925,1762,11687,397000,70480,467480
5/26/2024,Saman Rajaratne,Badulla,Badulla,Uva,1205,6345,7550,48200,253800,302000
5/27/2024,Saman Rajaratne,Badulla,Badulla,Uva,5675,4995,10670,227000,199800,426800
5/28/2024,Saman Rajaratne,Badulla,Badulla,Uva,6815,4113,10928,272600,164520,437120
5/29/2024,Saman Rajaratne,Badulla,Badulla,Uva,6365,9009,15374,254600,360360,614960
5/30/2024,Saman Rajaratne,Badulla,Badulla,Uva,972,8703,9675,38880,348120,387000
5/31/2024,Saman Rajaratne,Badulla,Badulla,Uva,5,3848,3853,200,153920,154120
6/1/2024,Saman Rajaratne,Badulla,Badulla,Uva,1910,8194,10104,76400,327760,404160
6/2/2024,Saman Rajaratne,Badulla,Badulla,Uva,9843,9449,19292,393720,377960,771680
6/3/2024,Saman Rajaratne,Badulla,Badulla,Uva,8380,8477,16857,335200,339080,674280
6/4/2024,Saman Rajaratne,Badulla,Badulla,Uva,1902,6388,8290,76080,255520,331600
6/5/2024,Saman Rajaratne,Badulla,Badulla,Uva,8172,3051,11223,326880,122040,448920
6/6/2024,Saman Rajaratne,Badulla,Badulla,Uva,2228,9731,11959,89120,389240,478360
6/7/2024,Saman Rajaratne,Badulla,Badulla,Uva,1437,5020,6457,57480,200800,258280
6/8/2024,Saman Rajaratne,Badulla,Badulla,Uva,4719,632,5351,188760,25280,214040
6/9/2024,Saman Rajaratne,Badulla,Badulla,Uva,2011,5861,7872,80440,234440,314880
6/10/2024,Saman Rajaratne,Badulla,Badulla,Uva,6860,5245,12105,274400,209800,484200
6/11/2024,Saman Rajaratne,Badulla,Badulla,Uva,9116,4479,13595,364640,179160,543800
6/12/2024,Saman Rajaratne,Badulla,Badulla,Uva,1522,3551,5073,60880,142040,202920
6/13/2024,Saman Rajaratne,Badulla,Badulla,Uva,3250,9205,12455,130000,368200,498200
6/14/2024,Saman Rajaratne,Badulla,Badulla,Uva,9578,5365,14943,383120,214600,597720
6/15/2024,Saman Rajaratne,Badulla,Badulla,Uva,7902,9146,17048,316080,365840,681920
6/16/2024,Saman Rajaratne,Badulla,Badulla,Uva,7364,3800,11164,294560,152000,446560
6/17/2024,Saman Rajaratne,Badulla,Badulla,Uva,8675,5194,13869,347000,207760,554760
6/18/2024,Saman Rajaratne,Badulla,Badulla,Uva,229,668,897,9160,26720,35880
6/19/2024,Saman Rajaratne,Badulla,Badulla,Uva,8537,5084,13621,341480,203360,544840
6/20/2024,Saman Rajaratne,Badulla,Badulla,Uva,5463,6697,12160,218520,267880,486400
6/21/2024,Saman Rajaratne,Badulla,Badulla,Uva,8902,498,9400,356080,19920,376000
6/22/2024,Saman Rajaratne,Badulla,Badulla,Uva,9949,8311,18260,397960,332440,730400
6/23/2024,Saman Rajaratne,Badulla,Badulla,Uva,4385,7235,11620,175400,289400,464800
6/24/2024,Saman Rajaratne,Badulla,Badulla,Uva,1391,1767,3158,55640,70680,126320
6/25/2024,Saman Rajaratne,Badulla,Badulla,Uva,7282,9541,16823,291280,381640,672920
6/26/2024,Saman Rajaratne,Badulla,Badulla,Uva,511,7635,8146,20440,305400,325840
6/27/2024,Saman Rajaratne,Badulla,Badulla,Uva,5925,8071,13996,237000,322840,559840
6/28/2024,Saman Rajaratne,Badulla,Badulla,Uva,6218,1199,7417,248720,47960,296680
6/29/2024,Saman Rajaratne,Badulla,Badulla,Uva,8650,9063,17713,346000,362520,708520
6/30/2024,Saman Rajaratne,Badulla,Badulla,Uva,8223,9304,17527,328920,372160,701080
7/1/2024,Saman Rajaratne,Badulla,Badulla,Uva,8832,3097,11929,353280,123880,477160
7/2/2024,Saman Rajaratne,Badulla,Badulla,Uva,2321,6471,8792,92840,258840,351680
7/3/2024,Saman Rajaratne,Badulla,Badulla,Uva,155,5793,5948,6200,231720,237920
7/4/2024,Saman Rajaratne,Badulla,Badulla,Uva,4885,5543,10428,195400,221720,417120
7/5/2024,Saman Rajaratne,Badulla,Badulla,Uva,1501,9499,11000,60040,379960,440000
7/6/2024,Saman Rajaratne,Badulla,Badulla,Uva,8213,1329,9542,328520,53160,381680
7/7/2024,Saman Rajaratne,Badulla,Badulla,Uva,500,823,1323,20000,32920,52920
7/8/2024,Saman Rajaratne,Badulla,Badulla,Uva,5627,3001,8628,225080,120040,345120
7/9/2024,Saman Rajaratne,Badulla,Badulla,Uva,2647,6449,9096,105880,257960,363840
7/10/2024,Saman Rajaratne,Badulla,Badulla,Uva,5943,8107,14050,237720,324280,562000
7/11/2024,Saman Rajaratne,Badulla,Badulla,Uva,7365,8683,16048,294600,347320,641920
7/12/2024,Saman Rajaratne,Badulla,Badulla,Uva,4102,8490,12592,164080,339600,503680
7/13/2024,Saman Rajaratne,Badulla,Badulla,Uva,588,4066,4654,23520,162640,186160
7/14/2024,Saman Rajaratne,Badulla,Badulla,Uva,3131,9782,12913,125240,391280,516520
7/15/2024,Saman Rajaratne,Badulla,Badulla,Uva,4916,682,5598,196640,27280,223920
7/16/2024,Saman Rajaratne,Badulla,Badulla,Uva,9074,2435,11509,362960,97400,460360
7/17/2024,Saman Rajaratne,Badulla,Badulla,Uva,6369,1210,7579,254760,48400,303160
7/18/2024,Saman Rajaratne,Badulla,Badulla,Uva,4101,6840,10941,164040,273600,437640
7/19/2024,Saman Rajaratne,Badulla,Badulla,Uva,8399,625,9024,335960,25000,360960
7/20/2024,Saman Rajaratne,Badulla,Badulla,Uva,1589,7282,8871,63560,291280,354840
7/21/2024,Saman Rajaratne,Badulla,Badulla,Uva,1957,9425,11382,78280,377000,455280
7/22/2024,Saman Rajaratne,Badulla,Badulla,Uva,9988,7034,17022,399520,281360,680880
7/23/2024,Saman Rajaratne,Badulla,Badulla,Uva,1317,8436,9753,52680,337440,390120
7/24/2024,Saman Rajaratne,Badulla,Badulla,Uva,6693,7845,14538,267720,313800,581520
7/25/2024,Saman Rajaratne,Badulla,Badulla,Uva,7716,5797,13513,308640,231880,540520
7/26/2024,Saman Rajaratne,Badulla,Badulla,Uva,2606,7568,10174,104240,302720,406960
7/27/2024,Saman Rajaratne,Badulla,Badulla,Uva,400,2683,3083,16000,107320,123320
7/28/2024,Saman Rajaratne,Badulla,Badulla,Uva,3411,1042,4453,136440,41680,178120
7/29/2024,Saman Rajaratne,Badulla,Badulla,Uva,1299,7345,8644,51960,293800,345760
7/30/2024,Saman Rajaratne,Badulla,Badulla,Uva,8447,3679,12126,337880,147160,485040
7/31/2024,Saman Rajaratne,Badulla,Badulla,Uva,1868,2223,4091,74720,88920,163640
8/1/2024,Saman Rajaratne,Badulla,Badulla,Uva,3233,5415,8648,129320,216600,345920
8/2/2024,Saman Rajaratne,Badulla,Badulla,Uva,5385,6682,12067,215400,267280,482680
8/3/2024,Saman Rajaratne,Badulla,Badulla,Uva,6245,6221,12466,249800,248840,498640
8/4/2024,Saman Rajaratne,Badulla,Badulla,Uva,4991,9790,14781,199640,391600,591240
8/5/2024,Saman Rajaratne,Badulla,Badulla,Uva,7124,2580,9704,284960,103200,388160
8/6/2024,Saman Rajaratne,Badulla,Badulla,Uva,7391,7995,15386,295640,319800,615440
8/7/2024,Saman Rajaratne,Badulla,Badulla,Uva,6968,7572,14540,278720,302880,581600
8/8/2024,Saman Rajaratne,Badulla,Badulla,Uva,8212,2156,10368,328480,86240,414720
8/9/2024,Saman Rajaratne,Badulla,Badulla,Uva,3458,692,4150,138320,27680,166000
8/10/2024,Saman Rajaratne,Badulla,Badulla,Uva,3103,5128,8231,124120,205120,329240
8/11/2024,Saman Rajaratne,Badulla,Badulla,Uva,991,8644,9635,39640,345760,385400
8/12/2024,Saman Rajaratne,Badulla,Badulla,Uva,3569,9257,12826,142760,370280,513040
8/13/2024,Saman Rajaratne,Badulla,Badulla,Uva,4051,6473,10524,162040,258920,420960
8/14/2024,Saman Rajaratne,Badulla,Badulla,Uva,769,2541,3310,30760,101640,132400
8/15/2024,Saman Rajaratne,Badulla,Badulla,Uva,7998,6524,14522,319920,260960,580880
8/16/2024,Saman Rajaratne,Badulla,Badulla,Uva,7959,9591,17550,318360,383640,702000
8/17/2024,Saman Rajaratne,Badulla,Badulla,Uva,9981,6107,16088,399240,244280,643520
8/18/2024,Saman Rajaratne,Badulla,Badulla,Uva,7845,3136,10981,313800,125440,439240
8/19/2024,Saman Rajaratne,Badulla,Badulla,Uva,74,2349,2423,2960,93960,96920
8/20/2024,Saman Rajaratne,Badulla,Badulla,Uva,5972,9796,15768,238880,391840,630720
8/21/2024,Saman Rajaratne,Badulla,Badulla,Uva,1532,8952,10484,61280,358080,419360
8/22/2024,Saman Rajaratne,Badulla,Badulla,Uva,5786,2901,8687,231440,116040,347480
8/23/2024,Saman Rajaratne,Badulla,Badulla,Uva,1305,1248,2553,52200,49920,102120
8/24/2024,Saman Rajaratne,Badulla,Badulla,Uva,5597,4600,10197,223880,184000,407880
8/25/2024,Saman Rajaratne,Badulla,Badulla,Uva,5951,5679,11630,238040,227160,465200
8/26/2024,Saman Rajaratne,Badulla,Badulla,Uva,4027,141,4168,161080,5640,166720
8/27/2024,Saman Rajaratne,Badulla,Badulla,Uva,8957,9334,18291,358280,373360,731640
8/28/2024,Saman Rajaratne,Badulla,Badulla,Uva,5044,2463,7507,201760,98520,300280
8/29/2024,Saman Rajaratne,Badulla,Badulla,Uva,8590,2059,10649,343600,82360,425960
8/30/2024,Saman Rajaratne,Badulla,Badulla,Uva,364,6265,6629,14560,250600,265160
8/31/2024,Saman Rajaratne,Badulla,Badulla,Uva,7219,687,7906,288760,27480,316240
9/1/2024,Saman Rajaratne,Badulla,Badulla,Uva,1778,806,2584,71120,32240,103360
9/2/2024,Saman Rajaratne,Badulla,Badulla,Uva,9501,6250,15751,380040,250000,630040
9/3/2024,Saman Rajaratne,Badulla,Badulla,Uva,7643,4270,11913,305720,170800,476520
9/4/2024,Saman Rajaratne,Badulla,Badulla,Uva,9509,5072,14581,380360,202880,583240
9/5/2024,Saman Rajaratne,Badulla,Badulla,Uva,2,7512,7514,80,300480,300560
9/6/2024,Saman Rajaratne,Badulla,Badulla,Uva,3916,7711,11627,156640,308440,465080
9/7/2024,Saman Rajaratne,Badulla,Badulla,Uva,202,2221,2423,8080,88840,96920
9/8/2024,Saman Rajaratne,Badulla,Badulla,Uva,4307,3008,7315,172280,120320,292600
9/9/2024,Saman Rajaratne,Badulla,Badulla,Uva,3622,3432,7054,144880,137280,282160
9/10/2024,Saman Rajaratne,Badulla,Badulla,Uva,7412,1827,9239,296480,73080,369560
9/11/2024,Saman Rajaratne,Badulla,Badulla,Uva,6825,3978,10803,273000,159120,432120
9/12/2024,Saman Rajaratne,Badulla,Badulla,Uva,4425,1436,5861,177000,57440,234440
9/13/2024,Saman Rajaratne,Badulla,Badulla,Uva,8350,1631,9981,334000,65240,399240
9/14/2024,Saman Rajaratne,Badulla,Badulla,Uva,5807,7325,13132,232280,293000,525280
9/15/2024,Saman Rajaratne,Badulla,Badulla,Uva,8378,929,9307,335120,37160,372280
9/16/2024,Saman Rajaratne,Badulla,Badulla,Uva,3191,4985,8176,127640,199400,327040
9/17/2024,Saman Rajaratne,Badulla,Badulla,Uva,9462,9267,18729,378480,370680,749160
9/18/2024,Saman Rajaratne,Badulla,Badulla,Uva,5818,7094,12912,232720,283760,516480
9/19/2024,Saman Rajaratne,Badulla,Badulla,Uva,4310,2919,7229,172400,116760,289160
9/20/2024,Saman Rajaratne,Badulla,Badulla,Uva,1066,8096,9162,42640,323840,366480
9/21/2024,Saman Rajaratne,Badulla,Badulla,Uva,7301,6792,14093,292040,271680,563720
9/22/2024,Saman Rajaratne,Badulla,Badulla,Uva,6240,934,7174,249600,37360,286960
9/23/2024,Saman Rajaratne,Badulla,Badulla,Uva,1974,1787,3761,78960,71480,150440
9/24/2024,Saman Rajaratne,Badulla,Badulla,Uva,1632,3728,5360,65280,149120,214400
9/25/2024,Saman Rajaratne,Badulla,Badulla,Uva,8876,8383,17259,355040,335320,690360
9/26/2024,Saman Rajaratne,Badulla,Badulla,Uva,6563,2693,9256,262520,107720,370240
9/27/2024,Saman Rajaratne,Badulla,Badulla,Uva,8198,9648,17846,327920,385920,713840
9/28/2024,Saman Rajaratne,Badulla,Badulla,Uva,5359,9636,14995,214360,385440,599800
9/29/2024,Saman Rajaratne,Badulla,Badulla,Uva,9973,9126,19099,398920,365040,763960
9/30/2024,Saman Rajaratne,Badulla,Badulla,Uva,5238,4592,9830,209520,183680,393200
10/1/2024,Saman Rajaratne,Badulla,Badulla,Uva,9103,228,9331,364120,9120,373240
10/2/2024,Saman Rajaratne,Badulla,Badulla,Uva,4018,6939,10957,160720,277560,438280
10/3/2024,Saman Rajaratne,Badulla,Badulla,Uva,3557,7880,11437,142280,315200,457480
10/4/2024,Saman Rajaratne,Badulla,Badulla,Uva,3213,1923,5136,128520,76920,205440
10/5/2024,Saman Rajaratne,Badulla,Badulla,Uva,1480,3142,4622,59200,125680,184880
10/6/2024,Saman Rajaratne,Badulla,Badulla,Uva,490,9653,10143,19600,386120,405720
10/7/2024,Saman Rajaratne,Badulla,Badulla,Uva,6543,4519,11062,261720,180760,442480
10/8/2024,Saman Rajaratne,Badulla,Badulla,Uva,6024,7612,13636,240960,304480,545440
10/9/2024,Saman Rajaratne,Badulla,Badulla,Uva,3415,1216,4631,136600,48640,185240
10/10/2024,Saman Rajaratne,Badulla,Badulla,Uva,959,8228,9187,38360,329120,367480
10/11/2024,Saman Rajaratne,Badulla,Badulla,Uva,9299,9236,18535,371960,369440,741400
10/12/2024,Saman Rajaratne,Badulla,Badulla,Uva,4587,2804,7391,183480,112160,295640
10/13/2024,Saman Rajaratne,Badulla,Badulla,Uva,6265,2919,9184,250600,116760,367360
10/14/2024,Saman Rajaratne,Badulla,Badulla,Uva,3344,8557,11901,133760,342280,476040
10/15/2024,Saman Rajaratne,Badulla,Badulla,Uva,1832,7328,9160,73280,293120,366400
10/16/2024,Saman Rajaratne,Badulla,Badulla,Uva,8960,6922,15882,358400,276880,635280
10/17/2024,Saman Rajaratne,Badulla,Badulla,Uva,5906,7195,13101,236240,287800,524040
10/18/2024,Saman Rajaratne,Badulla,Badulla,Uva,7059,437,7496,282360,17480,299840
10/19/2024,Saman Rajaratne,Badulla,Badulla,Uva,8604,4261,12865,344160,170440,514600
10/20/2024,Saman Rajaratne,Badulla,Badulla,Uva,4244,7666,11910,169760,306640,476400
10/21/2024,Saman Rajaratne,Badulla,Badulla,Uva,46,1146,1192,1840,45840,47680
10/22/2024,Saman Rajaratne,Badulla,Badulla,Uva,8371,1993,10364,334840,79720,414560
10/23/2024,Saman Rajaratne,Badulla,Badulla,Uva,2963,3451,6414,118520,138040,256560
10/24/2024,Saman Rajaratne,Badulla,Badulla,Uva,7254,4377,11631,290160,175080,465240
10/25/2024,Saman Rajaratne,Badulla,Badulla,Uva,8524,800,9324,340960,32000,372960
10/26/2024,Saman Rajaratne,Badulla,Badulla,Uva,8580,2341,10921,343200,93640,436840
10/27/2024,Saman Rajaratne,Badulla,Badulla,Uva,5713,219,5932,228520,8760,237280
10/28/2024,Saman Rajaratne,Badulla,Badulla,Uva,7010,2101,9111,280400,84040,364440
10/29/2024,Saman Rajaratne,Badulla,Badulla,Uva,5064,6607,11671,202560,264280,466840
10/30/2024,Saman Rajaratne,Badulla,Badulla,Uva,5571,3996,9567,222840,159840,382680
10/31/2024,Saman Rajaratne,Badulla,Badulla,Uva,257,6566,6823,10280,262640,272920
11/1/2024,Saman Rajaratne,Badulla,Badulla,Uva,5569,4099,9668,222760,163960,386720
11/2/2024,Saman Rajaratne,Badulla,Badulla,Uva,4264,7229,11493,170560,289160,459720
11/3/2024,Saman Rajaratne,Badulla,Badulla,Uva,1386,4474,5860,55440,178960,234400
11/4/2024,Saman Rajaratne,Badulla,Badulla,Uva,4542,962,5504,181680,38480,220160
11/5/2024,Saman Rajaratne,Badulla,Badulla,Uva,7105,2136,9241,284200,85440,369640
11/6/2024,Saman Rajaratne,Badulla,Badulla,Uva,5203,732,5935,208120,29280,237400
11/7/2024,Saman Rajaratne,Badulla,Badulla,Uva,1639,2446,4085,65560,97840,163400
11/8/2024,Saman Rajaratne,Badulla,Badulla,Uva,6384,2991,9375,255360,119640,375000
11/9/2024,Saman Rajaratne,Badulla,Badulla,Uva,8053,8220,16273,322120,328800,650920
11/10/2024,Saman Rajaratne,Badulla,Badulla,Uva,7435,303,7738,297400,12120,309520
11/11/2024,Saman Rajaratne,Badulla,Badulla,Uva,4304,4774,9078,172160,190960,363120
11/12/2024,Saman Rajaratne,Badulla,Badulla,Uva,6777,1237,8014,271080,49480,320560
11/13/2024,Saman Rajaratne,Badulla,Badulla,Uva,6164,7465,13629,246560,298600,545160
11/14/2024,Saman Rajaratne,Badulla,Badulla,Uva,2729,3623,6352,109160,144920,254080
11/15/2024,Saman Rajaratne,Badulla,Badulla,Uva,8584,7673,16257,343360,306920,650280
11/16/2024,Saman Rajaratne,Badulla,Badulla,Uva,3563,885,4448,142520,35400,177920
11/17/2024,Saman Rajaratne,Badulla,Badulla,Uva,841,5875,6716,33640,235000,268640
11/18/2024,Saman Rajaratne,Badulla,Badulla,Uva,7985,5823,13808,319400,232920,552320
11/19/2024,Saman Rajaratne,Badulla,Badulla,Uva,4254,4960,9214,170160,198400,368560
11/20/2024,Saman Rajaratne,Badulla,Badulla,Uva,9821,2548,12369,392840,101920,494760
11/21/2024,Saman Rajaratne,Badulla,Badulla,Uva,7147,1015,8162,285880,40600,326480
11/22/2024,Saman Rajaratne,Badulla,Badulla,Uva,3580,1787,5367,143200,71480,214680
11/23/2024,Saman Rajaratne,Badulla,Badulla,Uva,4393,9086,13479,175720,363440,539160
11/24/2024,Saman Rajaratne,Badulla,Badulla,Uva,1217,9859,11076,48680,394360,443040
11/25/2024,Saman Rajaratne,Badulla,Badulla,Uva,97,248,345,3880,9920,13800
11/26/2024,Saman Rajaratne,Badulla,Badulla,Uva,1835,6079,7914,73400,243160,316560
11/27/2024,Saman Rajaratne,Badulla,Badulla,Uva,7114,3322,10436,284560,132880,417440
11/28/2024,Saman Rajaratne,Badulla,Badulla,Uva,2223,2026,4249,88920,81040,169960
11/29/2024,Saman Rajaratne,Badulla,Badulla,Uva,2373,4677,7050,94920,187080,282000
11/30/2024,Saman Rajaratne,Badulla,Badulla,Uva,873,5598,6471,34920,223920,258840
12/1/2024,Saman Rajaratne,Badulla,Badulla,Uva,4576,9226,13802,183040,369040,552080
12/2/2024,Saman Rajaratne,Badulla,Badulla,Uva,5264,3609,8873,210560,144360,354920
12/3/2024,Saman Rajaratne,Badulla,Badulla,Uva,6415,3816,10231,256600,152640,409240
12/4/2024,Saman Rajaratne,Badulla,Badulla,Uva,5210,4561,9771,208400,182440,390840
12/5/2024,Saman Rajaratne,Badulla,Badulla,Uva,1146,1202,2348,45840,48080,93920
12/6/2024,Saman Rajaratne,Badulla,Badulla,Uva,4939,7964,12903,197560,318560,516120
12/7/2024,Saman Rajaratne,Badulla,Badulla,Uva,7631,9414,17045,305240,376560,681800
12/8/2024,Saman Rajaratne,Badulla,Badulla,Uva,9239,6403,15642,369560,256120,625680
12/9/2024,Saman Rajaratne,Badulla,Badulla,Uva,7270,1621,8891,290800,64840,355640
12/10/2024,Saman Rajaratne,Badulla,Badulla,Uva,1744,4471,6215,69760,178840,248600
12/11/2024,Saman Rajaratne,Badulla,Badulla,Uva,8833,1518,10351,353320,60720,414040
12/12/2024,Saman Rajaratne,Badulla,Badulla,Uva,8606,964,9570,344240,38560,382800
12/13/2024,Saman Rajaratne,Badulla,Badulla,Uva,2601,4907,7508,104040,196280,300320
12/14/2024,Saman Rajaratne,Badulla,Badulla,Uva,5793,8926,14719,231720,357040,588760
12/15/2024,Saman Rajaratne,Badulla,Badulla,Uva,9396,2250,11646,375840,90000,465840
12/16/2024,Saman Rajaratne,Badulla,Badulla,Uva,942,1778,2720,37680,71120,108800
12/17/2024,Saman Rajaratne,Badulla,Badulla,Uva,7355,5138,12493,294200,205520,499720
12/18/2024,Saman Rajaratne,Badulla,Badulla,Uva,3416,3713,7129,136640,148520,285160
12/19/2024,Saman Rajaratne,Badulla,Badulla,Uva,5938,4559,10497,237520,182360,419880
12/20/2024,Saman Rajaratne,Badulla,Badulla,Uva,4276,9962,14238,171040,398480,569520
12/21/2024,Saman Rajaratne,Badulla,Badulla,Uva,6390,980,7370,255600,39200,294800
12/22/2024,Saman Rajaratne,Badulla,Badulla,Uva,8135,748,8883,325400,29920,355320
12/23/2024,Saman Rajaratne,Badulla,Badulla,Uva,273,1283,1556,10920,51320,62240
12/24/2024,Saman Rajaratne,Badulla,Badulla,Uva,253,1108,1361,10120,44320,54440
12/25/2024,Saman Rajaratne,Badulla,Badulla,Uva,2955,6371,9326,118200,254840,373040
12/26/2024,Saman Rajaratne,Badulla,Badulla,Uva,2479,4794,7273,99160,191760,290920
12/27/2024,Saman Rajaratne,Badulla,Badulla,Uva,7277,999,8276,291080,39960,331040
12/28/2024,Saman Rajaratne,Badulla,Badulla,Uva,1747,8278,10025,69880,331120,401000
12/29/2024,Saman Rajaratne,Badulla,Badulla,Uva,5671,812,6483,226840,32480,259320
12/30/2024,Saman Rajaratne,Badulla,Badulla,Uva,4560,5039,9599,182400,201560,383960
12/31/2024,Saman Rajaratne,Badulla,Badulla,Uva,8531,5394,13925,341240,215760,557000
1/1/2025,Saman Rajaratne,Badulla,Badulla,Uva,4702,9748,14450,188080,389920,578000
1/2/2025,Saman Rajaratne,Badulla,Badulla,Uva,1145,3037,4182,45800,121480,167280
1/3/2025,Saman Rajaratne,Badulla,Badulla,Uva,939,9859,10798,37560,394360,431920
1/4/2025,Saman Rajaratne,Badulla,Badulla,Uva,7849,7500,15349,313960,300000,613960
1/5/2025,Saman Rajaratne,Badulla,Badulla,Uva,2395,3042,5437,95800,121680,217480
1/6/2025,Saman Rajaratne,Badulla,Badulla,Uva,8929,2111,11040,357160,84440,441600
1/7/2025,Saman Rajaratne,Badulla,Badulla,Uva,4804,2861,7665,192160,114440,306600
1/8/2025,Saman Rajaratne,Badulla,Badulla,Uva,6943,3736,10679,277720,149440,427160
1/9/2025,Saman Rajaratne,Badulla,Badulla,Uva,4402,3777,8179,176080,151080,327160
1/10/2025,Saman Rajaratne,Badulla,Badulla,Uva,2784,9663,12447,111360,386520,497880
1/11/2025,Saman Rajaratne,Badulla,Badulla,Uva,8434,7443,15877,337360,297720,635080
1/12/2025,Saman Rajaratne,Badulla,Badulla,Uva,9152,6138,15290,366080,245520,611600
1/13/2025,Saman Rajaratne,Badulla,Badulla,Uva,3854,8136,11990,154160,325440,479600
1/14/2025,Saman Rajaratne,Badulla,Badulla,Uva,8539,1918,10457,341560,76720,418280
1/15/2025,Saman Rajaratne,Badulla,Badulla,Uva,9818,6282,16100,392720,251280,644000
1/16/2025,Saman Rajaratne,Badulla,Badulla,Uva,3289,8064,11353,131560,322560,454120
1/17/2025,Saman Rajaratne,Badulla,Badulla,Uva,9129,2368,11497,365160,94720,459880
1/18/2025,Saman Rajaratne,Badulla,Badulla,Uva,358,786,1144,14320,31440,45760
1/19/2025,Saman Rajaratne,Badulla,Badulla,Uva,7719,3219,10938,308760,128760,437520
1/20/2025,Saman Rajaratne,Badulla,Badulla,Uva,5047,1323,6370,201880,52920,254800
1/21/2025,Saman Rajaratne,Badulla,Badulla,Uva,143,2909,3052,5720,116360,122080
1/22/2025,Saman Rajaratne,Badulla,Badulla,Uva,5628,775,6403,225120,31000,256120
1/23/2025,Saman Rajaratne,Badulla,Badulla,Uva,6847,7749,14596,273880,309960,583840
1/24/2025,Saman Rajaratne,Badulla,Badulla,Uva,277,3128,3405,11080,125120,136200
1/25/2025,Saman Rajaratne,Badulla,Badulla,Uva,4310,3857,8167,172400,154280,326680
1/26/2025,Saman Rajaratne,Badulla,Badulla,Uva,9975,7092,17067,399000,283680,682680
1/27/2025,Saman Rajaratne,Badulla,Badulla,Uva,110,431,541,4400,17240,21640
1/28/2025,Saman Rajaratne,Badulla,Badulla,Uva,1657,7536,9193,66280,301440,367720
1/29/2025,Saman Rajaratne,Badulla,Badulla,Uva,2122,6968,9090,84880,278720,363600
1/30/2025,Saman Rajaratne,Badulla,Badulla,Uva,4585,9753,14338,183400,390120,573520
1/31/2025,Saman Rajaratne,Badulla,Badulla,Uva,6437,3511,9948,257480,140440,397920
2/1/2025,Saman Rajaratne,Badulla,Badulla,Uva,3468,4529,7997,138720,181160,319880
2/2/2025,Saman Rajaratne,Badulla,Badulla,Uva,477,6414,6891,19080,256560,275640
2/3/2025,Saman Rajaratne,Badulla,Badulla,Uva,4186,4216,8402,167440,168640,336080
2/4/2025,Saman Rajaratne,Badulla,Badulla,Uva,4376,3425,7801,175040,137000,312040
2/5/2025,Saman Rajaratne,Badulla,Badulla,Uva,845,7994,8839,33800,319760,353560
2/6/2025,Saman Rajaratne,Badulla,Badulla,Uva,8140,4007,12147,325600,160280,485880
2/7/2025,Saman Rajaratne,Badulla,Badulla,Uva,8072,4906,12978,322880,196240,519120
2/8/2025,Saman Rajaratne,Badulla,Badulla,Uva,1997,7127,9124,79880,285080,364960
2/9/2025,Saman Rajaratne,Badulla,Badulla,Uva,9026,921,9947,361040,36840,397880
2/10/2025,Saman Rajaratne,Badulla,Badulla,Uva,6512,2639,9151,260480,105560,366040
2/11/2025,Saman Rajaratne,Badulla,Badulla,Uva,7565,1148,8713,302600,45920,348520
2/12/2025,Saman Rajaratne,Badulla,Badulla,Uva,5475,6594,12069,219000,263760,482760
2/13/2025,Saman Rajaratne,Badulla,Badulla,Uva,9881,8998,18879,395240,359920,755160
2/14/2025,Saman Rajaratne,Badulla,Badulla,Uva,5086,3726,8812,203440,149040,352480
2/15/2025,Saman Rajaratne,Badulla,Badulla,Uva,2981,5028,8009,119240,201120,320360
2/16/2025,Saman Rajaratne,Badulla,Badulla,Uva,8726,7481,16207,349040,299240,648280
2/17/2025,Saman Rajaratne,Badulla,Badulla,Uva,4457,7281,11738,178280,291240,469520
2/18/2025,Saman Rajaratne,Badulla,Badulla,Uva,3446,5072,8518,137840,202880,340720
2/19/2025,Saman Rajaratne,Badulla,Badulla,Uva,3113,3180,6293,124520,127200,251720
2/20/2025,Saman Rajaratne,Badulla,Badulla,Uva,8611,1411,10022,344440,56440,400880
2/21/2025,Saman Rajaratne,Badulla,Badulla,Uva,6751,9198,15949,270040,367920,637960
2/22/2025,Saman Rajaratne,Badulla,Badulla,Uva,9627,1392,11019,385080,55680,440760
2/23/2025,Saman Rajaratne,Badulla,Badulla,Uva,7168,3949,11117,286720,157960,444680
2/24/2025,Saman Rajaratne,Badulla,Badulla,Uva,4227,6242,10469,169080,249680,418760
2/25/2025,Saman Rajaratne,Badulla,Badulla,Uva,921,5560,6481,36840,222400,259240
2/26/2025,Saman Rajaratne,Badulla,Badulla,Uva,8394,5155,13549,335760,206200,541960
2/27/2025,Saman Rajaratne,Badulla,Badulla,Uva,4010,3899,7909,160400,155960,316360
2/28/2025,Saman Rajaratne,Badulla,Badulla,Uva,610,4901,5511,24400,196040,220440
3/1/2025,Saman Rajaratne,Badulla,Badulla,Uva,9480,8800,18280,379200,352000,731200
3/2/2025,Saman Rajaratne,Badulla,Badulla,Uva,8997,4718,13715,359880,188720,548600
3/3/2025,Saman Rajaratne,Badulla,Badulla,Uva,1642,2728,4370,65680,109120,174800
3/4/2025,Saman Rajaratne,Badulla,Badulla,Uva,7009,857,7866,280360,34280,314640
3/5/2025,Saman Rajaratne,Badulla,Badulla,Uva,7275,4148,11423,291000,165920,456920
3/6/2025,Saman Rajaratne,Badulla,Badulla,Uva,6816,9105,15921,272640,364200,636840
3/7/2025,Saman Rajaratne,Badulla,Badulla,Uva,5222,2673,7895,208880,106920,315800
3/8/2025,Saman Rajaratne,Badulla,Badulla,Uva,1224,136,1360,48960,5440,54400
3/9/2025,Saman Rajaratne,Badulla,Badulla,Uva,680,3313,3993,27200,132520,159720
3/10/2025,Saman Rajaratne,Badulla,Badulla,Uva,3166,8743,11909,126640,349720,476360
3/11/2025,Saman Rajaratne,Badulla,Badulla,Uva,5867,8305,14172,234680,332200,566880
3/12/2025,Saman Rajaratne,Badulla,Badulla,Uva,7241,9038,16279,289640,361520,651160
3/13/2025,Saman Rajaratne,Badulla,Badulla,Uva,5808,4751,10559,232320,190040,422360
3/14/2025,Saman Rajaratne,Badulla,Badulla,Uva,9585,9983,19568,383400,399320,782720
3/15/2025,Saman Rajaratne,Badulla,Badulla,Uva,6144,5834,11978,245760,233360,479120
3/16/2025,Saman Rajaratne,Badulla,Badulla,Uva,1475,7395,8870,59000,295800,354800
3/17/2025,Saman Rajaratne,Badulla,Badulla,Uva,6568,8652,15220,262720,346080,608800
3/18/2025,Saman Rajaratne,Badulla,Badulla,Uva,9760,5068,14828,390400,202720,593120
3/19/2025,Saman Rajaratne,Badulla,Badulla,Uva,2416,9230,11646,96640,369200,465840
3/20/2025,Saman Rajaratne,Badulla,Badulla,Uva,6186,2652,8838,247440,106080,353520
3/21/2025,Saman Rajaratne,Badulla,Badulla,Uva,7179,3737,10916,287160,149480,436640
3/22/2025,Saman Rajaratne,Badulla,Badulla,Uva,5194,4919,10113,207760,196760,404520
3/23/2025,Saman Rajaratne,Badulla,Badulla,Uva,9590,3758,13348,383600,150320,533920
3/25/2024,Yashoda Kumari,Ratnapura,Elapatha,Sabaragamuwa,4884,7573,12457,195360,302920,498280
3/26/2024,Yashoda Kumari,Ratnapura,Elapatha,Sabaragamuwa,8610,4492,13102,344400,179680,524080
3/27/2024,Yashoda Kumari,Ratnapura,Elapatha,Sabaragamuwa,8953,9050,18003,358120,362000,720120
3/28/2024,Yashoda Kumari,Ratnapura,Elapatha,Sabaragamuwa,9604,9222,18826,384160,368880,753040
3/29/2024,Yashoda Kumari,Ratnapura,Elapatha,Sabaragamuwa,9151,6456,15607,366040,258240,624280
3/30/2024,Yashoda Kumari,Ratnapura,Elapatha,Sabaragamuwa,4889,7452,12341,195560,298080,493640
3/31/2024,Yashoda Kumari,Ratnapura,Elapatha,Sabaragamuwa,1302,9039,10341,52080,361560,413640
4/1/2024,Yashoda Kumari,Ratnapura,Elapatha,Sabaragamuwa,4352,3212,7564,174080,128480,302560
4/2/2024,Yashoda Kumari,Ratnapura,Elapatha,Sabaragamuwa,8174,6212,14386,326960,248480,575440
4/3/2024,Yashoda Kumari,Ratnapura,Elapatha,Sabaragamuwa,4124,1650,5774,164960,66000,230960
4/4/2024,Yashoda Kumari,Ratnapura,Elapatha,Sabaragamuwa,8698,5323,14021,347920,212920,560840
4/5/2024,Yashoda Kumari,Ratnapura,Elapatha,Sabaragamuwa,903,1056,1959,36120,42240,78360
4/6/2024,Yashoda Kumari,Ratnapura,Elapatha,Sabaragamuwa,9284,9334,18618,371360,373360,744720
4/7/2024,Yashoda Kumari,Ratnapura,Elapatha,Sabaragamuwa,3123,8933,12056,124920,357320,482240
4/8/2024,Yashoda Kumari,Ratnapura,Elapatha,Sabaragamuwa,9787,4716,14503,391480,188640,580120
4/9/2024,Yashoda Kumari,Ratnapura,Elapatha,Sabaragamuwa,8556,8427,16983,342240,337080,679320
4/10/2024,Yashoda Kumari,Ratnapura,Elapatha,Sabaragamuwa,1189,6038,7227,47560,241520,289080
4/11/2024,Yashoda Kumari,Ratnapura,Elapatha,Sabaragamuwa,635,7600,8235,25400,304000,329400
4/19/2024,Yashoda Kumari,Ratnapura,Elapatha,Sabaragamuwa,564,1368,1932,22560,54720,77280
4/20/2024,Yashoda Kumari,Ratnapura,Elapatha,Sabaragamuwa,1605,2083,3688,64200,83320,147520
4/21/2024,Yashoda Kumari,Ratnapura,Elapatha,Sabaragamuwa,2767,5761,8528,110680,230440,341120
4/22/2024,Yashoda Kumari,Ratnapura,Elapatha,Sabaragamuwa,8549,4753,13302,341960,190120,532080
4/23/2024,Yashoda Kumari,Ratnapura,Elapatha,Sabaragamuwa,3604,7072,10676,144160,282880,427040
4/24/2024,Yashoda Kumari,Ratnapura,Elapatha,Sabaragamuwa,5307,2908,8215,212280,116320,328600
4/25/2024,Yashoda Kumari,Ratnapura,Elapatha,Sabaragamuwa,4840,8098,12938,193600,323920,517520
4/26/2024,Yashoda Kumari,Ratnapura,Elapatha,Sabaragamuwa,5854,1152,7006,234160,46080,280240
4/27/2024,Yashoda Kumari,Ratnapura,Elapatha,Sabaragamuwa,5750,3088,8838,230000,123520,353520
4/28/2024,Yashoda Kumari,Ratnapura,Elapatha,Sabaragamuwa,671,9217,9888,26840,368680,395520
4/29/2024,Yashoda Kumari,Ratnapura,Elapatha,Sabaragamuwa,5540,5942,11482,221600,237680,459280
4/30/2024,Yashoda Kumari,Ratnapura,Elapatha,Sabaragamuwa,2787,1029,3816,111480,41160,152640
5/1/2024,Yashoda Kumari,Ratnapura,Elapatha,Sabaragamuwa,3162,1829,4991,126480,73160,199640
5/2/2024,Yashoda Kumari,Ratnapura,Elapatha,Sabaragamuwa,8119,9672,17791,324760,386880,711640
5/3/2024,Yashoda Kumari,Ratnapura,Elapatha,Sabaragamuwa,5599,9434,15033,223960,377360,601320
5/4/2024,Yashoda Kumari,Ratnapura,Elapatha,Sabaragamuwa,2371,760,3131,94840,30400,125240
5/5/2024,Yashoda Kumari,Ratnapura,Elapatha,Sabaragamuwa,2841,8391,11232,113640,335640,449280
5/6/2024,Yashoda Kumari,Ratnapura,Elapatha,Sabaragamuwa,5138,2270,7408,205520,90800,296320
5/7/2024,Yashoda Kumari,Ratnapura,Elapatha,Sabaragamuwa,4970,5173,10143,198800,206920,405720
5/8/2024,Yashoda Kumari,Ratnapura,Elapatha,Sabaragamuwa,2744,3498,6242,109760,139920,249680
5/9/2024,Yashoda Kumari,Ratnapura,Elapatha,Sabaragamuwa,5703,2553,8256,228120,102120,330240
5/10/2024,Yashoda Kumari,Ratnapura,Elapatha,Sabaragamuwa,1674,2098,3772,66960,83920,150880
5/11/2024,Yashoda Kumari,Ratnapura,Elapatha,Sabaragamuwa,4380,6127,10507,175200,245080,420280
5/12/2024,Yashoda Kumari,Ratnapura,Elapatha,Sabaragamuwa,5443,8127,13570,217720,325080,542800
5/13/2024,Yashoda Kumari,Ratnapura,Elapatha,Sabaragamuwa,4289,1883,6172,171560,75320,246880
5/14/2024,Yashoda Kumari,Ratnapura,Elapatha,Sabaragamuwa,2752,4243,6995,110080,169720,279800
5/15/2024,Yashoda Kumari,Ratnapura,Elapatha,Sabaragamuwa,2114,9471,11585,84560,378840,463400
5/16/2024,Yashoda Kumari,Ratnapura,Elapatha,Sabaragamuwa,8458,2775,11233,338320,111000,449320
5/17/2024,Yashoda Kumari,Ratnapura,Elapatha,Sabaragamuwa,5957,898,6855,238280,35920,274200
5/18/2024,Yashoda Kumari,Ratnapura,Elapatha,Sabaragamuwa,6160,5649,11809,246400,225960,472360
5/19/2024,Yashoda Kumari,Ratnapura,Elapatha,Sabaragamuwa,8949,3437,12386,357960,137480,495440
5/20/2024,Yashoda Kumari,Ratnapura,Elapatha,Sabaragamuwa,8979,7849,16828,359160,313960,673120
5/21/2024,Yashoda Kumari,Ratnapura,Elapatha,Sabaragamuwa,5786,2091,7877,231440,83640,315080
5/22/2024,Yashoda Kumari,Ratnapura,Elapatha,Sabaragamuwa,1201,3462,4663,48040,138480,186520
5/24/2024,Yashoda Kumari,Ratnapura,Elapatha,Sabaragamuwa,2949,3814,6763,117960,152560,270520
5/25/2024,Yashoda Kumari,Ratnapura,Elapatha,Sabaragamuwa,3065,9432,12497,122600,377280,499880
5/26/2024,Yashoda Kumari,Ratnapura,Elapatha,Sabaragamuwa,5105,6738,11843,204200,269520,473720
5/27/2024,Yashoda Kumari,Ratnapura,Elapatha,Sabaragamuwa,9624,3425,13049,384960,137000,521960
5/28/2024,Yashoda Kumari,Ratnapura,Elapatha,Sabaragamuwa,6870,1425,8295,274800,57000,331800
5/29/2024,Yashoda Kumari,Ratnapura,Elapatha,Sabaragamuwa,2043,576,2619,81720,23040,104760
5/30/2024,Yashoda Kumari,Ratnapura,Elapatha,Sabaragamuwa,2068,3659,5727,82720,146360,229080
5/31/2024,Yashoda Kumari,Ratnapura,Elapatha,Sabaragamuwa,4019,904,4923,160760,36160,196920
6/1/2024,Yashoda Kumari,Ratnapura,Elapatha,Sabaragamuwa,4145,1952,6097,165800,78080,243880
6/2/2024,Yashoda Kumari,Ratnapura,Elapatha,Sabaragamuwa,6545,9226,15771,261800,369040,630840
6/3/2024,Yashoda Kumari,Ratnapura,Elapatha,Sabaragamuwa,292,7075,7367,11680,283000,294680
6/4/2024,Yashoda Kumari,Ratnapura,Elapatha,Sabaragamuwa,752,7314,8066,30080,292560,322640
6/5/2024,Yashoda Kumari,Ratnapura,Elapatha,Sabaragamuwa,9058,9617,18675,362320,384680,747000
6/6/2024,Yashoda Kumari,Ratnapura,Elapatha,Sabaragamuwa,4631,2066,6697,185240,82640,267880
6/7/2024,Yashoda Kumari,Ratnapura,Elapatha,Sabaragamuwa,8435,1077,9512,337400,43080,380480
6/8/2024,Yashoda Kumari,Ratnapura,Elapatha,Sabaragamuwa,5262,4876,10138,210480,195040,405520
6/9/2024,Yashoda Kumari,Ratnapura,Elapatha,Sabaragamuwa,8180,738,8918,327200,29520,356720
6/10/2024,Yashoda Kumari,Ratnapura,Elapatha,Sabaragamuwa,5038,6528,11566,201520,261120,462640
6/11/2024,Yashoda Kumari,Ratnapura,Elapatha,Sabaragamuwa,5910,7333,13243,236400,293320,529720
6/12/2024,Yashoda Kumari,Ratnapura,Elapatha,Sabaragamuwa,1334,3931,5265,53360,157240,210600
6/13/2024,Yashoda Kumari,Ratnapura,Elapatha,Sabaragamuwa,9500,4325,13825,380000,173000,553000
6/14/2024,Yashoda Kumari,Ratnapura,Elapatha,Sabaragamuwa,1686,5291,6977,67440,211640,279080
6/15/2024,Yashoda Kumari,Ratnapura,Elapatha,Sabaragamuwa,6003,2490,8493,240120,99600,339720
6/16/2024,Yashoda Kumari,Ratnapura,Elapatha,Sabaragamuwa,3527,9116,12643,141080,364640,505720
6/17/2024,Yashoda Kumari,Ratnapura,Elapatha,Sabaragamuwa,7869,8946,16815,314760,357840,672600
6/18/2024,Yashoda Kumari,Ratnapura,Elapatha,Sabaragamuwa,2031,3587,5618,81240,143480,224720
6/19/2024,Yashoda Kumari,Ratnapura,Elapatha,Sabaragamuwa,83,6407,6490,3320,256280,259600
6/20/2024,Yashoda Kumari,Ratnapura,Elapatha,Sabaragamuwa,2434,4364,6798,97360,174560,271920
6/21/2024,Yashoda Kumari,Ratnapura,Elapatha,Sabaragamuwa,7061,9087,16148,282440,363480,645920
6/22/2024,Yashoda Kumari,Ratnapura,Elapatha,Sabaragamuwa,9833,8302,18135,393320,332080,725400
6/23/2024,Yashoda Kumari,Ratnapura,Elapatha,Sabaragamuwa,8738,1297,10035,349520,51880,401400
6/24/2024,Yashoda Kumari,Ratnapura,Elapatha,Sabaragamuwa,6357,6064,12421,254280,242560,496840
6/25/2024,Yashoda Kumari,Ratnapura,Elapatha,Sabaragamuwa,3934,456,4390,157360,18240,175600
6/26/2024,Yashoda Kumari,Ratnapura,Elapatha,Sabaragamuwa,7500,5384,12884,300000,215360,515360
6/27/2024,Yashoda Kumari,Ratnapura,Elapatha,Sabaragamuwa,3130,1816,4946,125200,72640,197840
6/28/2024,Yashoda Kumari,Ratnapura,Elapatha,Sabaragamuwa,5101,6669,11770,204040,266760,470800
6/29/2024,Yashoda Kumari,Ratnapura,Elapatha,Sabaragamuwa,4231,6756,10987,169240,270240,439480
6/30/2024,Yashoda Kumari,Ratnapura,Elapatha,Sabaragamuwa,2537,4046,6583,101480,161840,263320
7/1/2024,Yashoda Kumari,Ratnapura,Elapatha,Sabaragamuwa,4316,7536,11852,172640,301440,474080
7/2/2024,Yashoda Kumari,Ratnapura,Elapatha,Sabaragamuwa,1999,8815,10814,79960,352600,432560
7/3/2024,Yashoda Kumari,Ratnapura,Elapatha,Sabaragamuwa,6975,7802,14777,279000,312080,591080
7/4/2024,Yashoda Kumari,Ratnapura,Elapatha,Sabaragamuwa,5406,1943,7349,216240,77720,293960
7/5/2024,Yashoda Kumari,Ratnapura,Elapatha,Sabaragamuwa,7843,271,8114,313720,10840,324560
7/6/2024,Yashoda Kumari,Ratnapura,Elapatha,Sabaragamuwa,2291,7781,10072,91640,311240,402880
7/7/2024,Yashoda Kumari,Ratnapura,Elapatha,Sabaragamuwa,4510,6768,11278,180400,270720,451120
7/8/2024,Yashoda Kumari,Ratnapura,Elapatha,Sabaragamuwa,7420,6327,13747,296800,253080,549880
7/9/2024,Yashoda Kumari,Ratnapura,Elapatha,Sabaragamuwa,7822,7963,15785,312880,318520,631400
7/10/2024,Yashoda Kumari,Ratnapura,Elapatha,Sabaragamuwa,1526,6246,7772,61040,249840,310880
7/11/2024,Yashoda Kumari,Ratnapura,Elapatha,Sabaragamuwa,9223,3075,12298,368920,123000,491920
7/12/2024,Yashoda Kumari,Ratnapura,Elapatha,Sabaragamuwa,9649,5909,15558,385960,236360,622320
7/13/2024,Yashoda Kumari,Ratnapura,Elapatha,Sabaragamuwa,1901,6275,8176,76040,251000,327040
7/14/2024,Yashoda Kumari,Ratnapura,Elapatha,Sabaragamuwa,7246,3933,11179,289840,157320,447160
7/15/2024,Yashoda Kumari,Ratnapura,Elapatha,Sabaragamuwa,5556,2215,7771,222240,88600,310840
7/16/2024,Yashoda Kumari,Ratnapura,Elapatha,Sabaragamuwa,9407,6424,15831,376280,256960,633240
7/17/2024,Yashoda Kumari,Ratnapura,Elapatha,Sabaragamuwa,687,6420,7107,27480,256800,284280
7/18/2024,Yashoda Kumari,Ratnapura,Elapatha,Sabaragamuwa,6776,5337,12113,271040,213480,484520
7/19/2024,Yashoda Kumari,Ratnapura,Elapatha,Sabaragamuwa,9644,9049,18693,385760,361960,747720
7/20/2024,Yashoda Kumari,Ratnapura,Elapatha,Sabaragamuwa,8017,8781,16798,320680,351240,671920
7/21/2024,Yashoda Kumari,Ratnapura,Elapatha,Sabaragamuwa,720,9285,10005,28800,371400,400200
7/22/2024,Yashoda Kumari,Ratnapura,Elapatha,Sabaragamuwa,7137,2608,9745,285480,104320,389800
7/23/2024,Yashoda Kumari,Ratnapura,Elapatha,Sabaragamuwa,3036,9761,12797,121440,390440,511880
7/24/2024,Yashoda Kumari,Ratnapura,Elapatha,Sabaragamuwa,8629,1449,10078,345160,57960,403120
7/25/2024,Yashoda Kumari,Ratnapura,Elapatha,Sabaragamuwa,6830,6900,13730,273200,276000,549200
7/26/2024,Yashoda Kumari,Ratnapura,Elapatha,Sabaragamuwa,6683,8970,15653,267320,358800,626120
7/27/2024,Yashoda Kumari,Ratnapura,Elapatha,Sabaragamuwa,6096,268,6364,243840,10720,254560
7/28/2024,Yashoda Kumari,Ratnapura,Elapatha,Sabaragamuwa,8829,7249,16078,353160,289960,643120
7/29/2024,Yashoda Kumari,Ratnapura,Elapatha,Sabaragamuwa,1541,2433,3974,61640,97320,158960
7/30/2024,Yashoda Kumari,Ratnapura,Elapatha,Sabaragamuwa,8703,3572,12275,348120,142880,491000
7/31/2024,Yashoda Kumari,Ratnapura,Elapatha,Sabaragamuwa,140,9864,10004,5600,394560,400160
8/1/2024,Yashoda Kumari,Ratnapura,Elapatha,Sabaragamuwa,4421,2952,7373,176840,118080,294920
8/2/2024,Yashoda Kumari,Ratnapura,Elapatha,Sabaragamuwa,6966,5850,12816,278640,234000,512640
8/3/2024,Yashoda Kumari,Ratnapura,Elapatha,Sabaragamuwa,3812,2132,5944,152480,85280,237760
8/4/2024,Yashoda Kumari,Ratnapura,Elapatha,Sabaragamuwa,9604,4342,13946,384160,173680,557840
8/5/2024,Yashoda Kumari,Ratnapura,Elapatha,Sabaragamuwa,4380,787,5167,175200,31480,206680
8/6/2024,Yashoda Kumari,Ratnapura,Elapatha,Sabaragamuwa,3701,8339,12040,148040,333560,481600
8/7/2024,Yashoda Kumari,Ratnapura,Elapatha,Sabaragamuwa,6524,1707,8231,260960,68280,329240
8/8/2024,Yashoda Kumari,Ratnapura,Elapatha,Sabaragamuwa,6768,5109,11877,270720,204360,475080
8/9/2024,Yashoda Kumari,Ratnapura,Elapatha,Sabaragamuwa,8620,929,9549,344800,37160,381960
8/10/2024,Yashoda Kumari,Ratnapura,Elapatha,Sabaragamuwa,1058,934,1992,42320,37360,79680
8/11/2024,Yashoda Kumari,Ratnapura,Elapatha,Sabaragamuwa,3975,4142,8117,159000,165680,324680
8/12/2024,Yashoda Kumari,Ratnapura,Elapatha,Sabaragamuwa,8108,2369,10477,324320,94760,419080
8/13/2024,Yashoda Kumari,Ratnapura,Elapatha,Sabaragamuwa,1008,901,1909,40320,36040,76360
8/14/2024,Yashoda Kumari,Ratnapura,Elapatha,Sabaragamuwa,3753,8319,12072,150120,332760,482880
8/15/2024,Yashoda Kumari,Ratnapura,Elapatha,Sabaragamuwa,371,8972,9343,14840,358880,373720
8/16/2024,Yashoda Kumari,Ratnapura,Elapatha,Sabaragamuwa,4272,9550,13822,170880,382000,552880
8/17/2024,Yashoda Kumari,Ratnapura,Elapatha,Sabaragamuwa,9228,938,10166,369120,37520,406640
8/18/2024,Yashoda Kumari,Ratnapura,Elapatha,Sabaragamuwa,3234,923,4157,129360,36920,166280
8/19/2024,Yashoda Kumari,Ratnapura,Elapatha,Sabaragamuwa,6379,2698,9077,255160,107920,363080
8/20/2024,Yashoda Kumari,Ratnapura,Elapatha,Sabaragamuwa,1963,3954,5917,78520,158160,236680
8/21/2024,Yashoda Kumari,Ratnapura,Elapatha,Sabaragamuwa,2947,3118,6065,117880,124720,242600
8/22/2024,Yashoda Kumari,Ratnapura,Elapatha,Sabaragamuwa,8723,7625,16348,348920,305000,653920
8/23/2024,Yashoda Kumari,Ratnapura,Elapatha,Sabaragamuwa,1796,6652,8448,71840,266080,337920
8/24/2024,Yashoda Kumari,Ratnapura,Elapatha,Sabaragamuwa,8943,4756,13699,357720,190240,547960
8/25/2024,Yashoda Kumari,Ratnapura,Elapatha,Sabaragamuwa,861,4002,4863,34440,160080,194520
8/26/2024,Yashoda Kumari,Ratnapura,Elapatha,Sabaragamuwa,8078,4772,12850,323120,190880,514000
8/27/2024,Yashoda Kumari,Ratnapura,Elapatha,Sabaragamuwa,1025,5676,6701,41000,227040,268040
8/28/2024,Yashoda Kumari,Ratnapura,Elapatha,Sabaragamuwa,6329,6804,13133,253160,272160,525320
8/29/2024,Yashoda Kumari,Ratnapura,Elapatha,Sabaragamuwa,4533,9514,14047,181320,380560,561880
8/30/2024,Yashoda Kumari,Ratnapura,Elapatha,Sabaragamuwa,3999,6293,10292,159960,251720,411680
8/31/2024,Yashoda Kumari,Ratnapura,Elapatha,Sabaragamuwa,4621,5645,10266,184840,225800,410640
9/1/2024,Yashoda Kumari,Ratnapura,Elapatha,Sabaragamuwa,5609,3254,8863,224360,130160,354520
9/2/2024,Yashoda Kumari,Ratnapura,Elapatha,Sabaragamuwa,7763,7308,15071,310520,292320,602840
9/3/2024,Yashoda Kumari,Ratnapura,Elapatha,Sabaragamuwa,178,5735,5913,7120,229400,236520
9/4/2024,Yashoda Kumari,Ratnapura,Elapatha,Sabaragamuwa,4534,8474,13008,181360,338960,520320
9/5/2024,Yashoda Kumari,Ratnapura,Elapatha,Sabaragamuwa,7626,5089,12715,305040,203560,508600
9/6/2024,Yashoda Kumari,Ratnapura,Elapatha,Sabaragamuwa,8347,1443,9790,333880,57720,391600
9/7/2024,Yashoda Kumari,Ratnapura,Elapatha,Sabaragamuwa,477,7185,7662,19080,287400,306480
9/8/2024,Yashoda Kumari,Ratnapura,Elapatha,Sabaragamuwa,2034,3288,5322,81360,131520,212880
9/9/2024,Yashoda Kumari,Ratnapura,Elapatha,Sabaragamuwa,2904,5231,8135,116160,209240,325400
9/10/2024,Yashoda Kumari,Ratnapura,Elapatha,Sabaragamuwa,5497,6215,11712,219880,248600,468480
9/11/2024,Yashoda Kumari,Ratnapura,Elapatha,Sabaragamuwa,7549,5347,12896,301960,213880,515840
9/12/2024,Yashoda Kumari,Ratnapura,Elapatha,Sabaragamuwa,9085,9142,18227,363400,365680,729080
9/13/2024,Yashoda Kumari,Ratnapura,Elapatha,Sabaragamuwa,2704,2787,5491,108160,111480,219640
9/14/2024,Yashoda Kumari,Ratnapura,Elapatha,Sabaragamuwa,3120,9275,12395,124800,371000,495800
9/15/2024,Yashoda Kumari,Ratnapura,Elapatha,Sabaragamuwa,7902,2621,10523,316080,104840,420920
9/16/2024,Yashoda Kumari,Ratnapura,Elapatha,Sabaragamuwa,8493,8397,16890,339720,335880,675600
9/17/2024,Yashoda Kumari,Ratnapura,Elapatha,Sabaragamuwa,6332,7388,13720,253280,295520,548800
9/18/2024,Yashoda Kumari,Ratnapura,Elapatha,Sabaragamuwa,112,7698,7810,4480,307920,312400
9/19/2024,Yashoda Kumari,Ratnapura,Elapatha,Sabaragamuwa,1797,7774,9571,71880,310960,382840
9/20/2024,Yashoda Kumari,Ratnapura,Elapatha,Sabaragamuwa,7767,2546,10313,310680,101840,412520
9/21/2024,Yashoda Kumari,Ratnapura,Elapatha,Sabaragamuwa,827,2286,3113,33080,91440,124520
9/22/2024,Yashoda Kumari,Ratnapura,Elapatha,Sabaragamuwa,5019,5530,10549,200760,221200,421960
9/23/2024,Yashoda Kumari,Ratnapura,Elapatha,Sabaragamuwa,8258,3820,12078,330320,152800,483120
9/24/2024,Yashoda Kumari,Ratnapura,Elapatha,Sabaragamuwa,9240,7658,16898,369600,306320,675920
9/25/2024,Yashoda Kumari,Ratnapura,Elapatha,Sabaragamuwa,5923,7591,13514,236920,303640,540560
9/26/2024,Yashoda Kumari,Ratnapura,Elapatha,Sabaragamuwa,3449,221,3670,137960,8840,146800
9/27/2024,Yashoda Kumari,Ratnapura,Elapatha,Sabaragamuwa,7685,5081,12766,307400,203240,510640
9/28/2024,Yashoda Kumari,Ratnapura,Elapatha,Sabaragamuwa,7642,1044,8686,305680,41760,347440
9/29/2024,Yashoda Kumari,Ratnapura,Elapatha,Sabaragamuwa,2422,4890,7312,96880,195600,292480
9/30/2024,Yashoda Kumari,Ratnapura,Elapatha,Sabaragamuwa,1937,1364,3301,77480,54560,132040
10/1/2024,Yashoda Kumari,Ratnapura,Elapatha,Sabaragamuwa,4510,4267,8777,180400,170680,351080
10/2/2024,Yashoda Kumari,Ratnapura,Elapatha,Sabaragamuwa,7842,3382,11224,313680,135280,448960
10/3/2024,Yashoda Kumari,Ratnapura,Elapatha,Sabaragamuwa,5480,7657,13137,219200,306280,525480
10/4/2024,Yashoda Kumari,Ratnapura,Elapatha,Sabaragamuwa,295,1332,1627,11800,53280,65080
10/5/2024,Yashoda Kumari,Ratnapura,Elapatha,Sabaragamuwa,7958,4595,12553,318320,183800,502120
10/6/2024,Yashoda Kumari,Ratnapura,Elapatha,Sabaragamuwa,3583,5662,9245,143320,226480,369800
10/7/2024,Yashoda Kumari,Ratnapura,Elapatha,Sabaragamuwa,4703,2160,6863,188120,86400,274520
10/8/2024,Yashoda Kumari,Ratnapura,Elapatha,Sabaragamuwa,2194,1316,3510,87760,52640,140400
10/9/2024,Yashoda Kumari,Ratnapura,Elapatha,Sabaragamuwa,1222,2690,3912,48880,107600,156480
10/10/2024,Yashoda Kumari,Ratnapura,Elapatha,Sabaragamuwa,7068,7693,14761,282720,307720,590440
10/11/2024,Yashoda Kumari,Ratnapura,Elapatha,Sabaragamuwa,7612,5722,13334,304480,228880,533360
10/12/2024,Yashoda Kumari,Ratnapura,Elapatha,Sabaragamuwa,2918,2524,5442,116720,100960,217680
10/13/2024,Yashoda Kumari,Ratnapura,Elapatha,Sabaragamuwa,7554,1195,8749,302160,47800,349960
10/14/2024,Yashoda Kumari,Ratnapura,Elapatha,Sabaragamuwa,4919,5100,10019,196760,204000,400760
10/15/2024,Yashoda Kumari,Ratnapura,Elapatha,Sabaragamuwa,1654,2269,3923,66160,90760,156920
10/16/2024,Yashoda Kumari,Ratnapura,Elapatha,Sabaragamuwa,1591,9545,11136,63640,381800,445440
10/17/2024,Yashoda Kumari,Ratnapura,Elapatha,Sabaragamuwa,4062,9727,13789,162480,389080,551560
10/18/2024,Yashoda Kumari,Ratnapura,Elapatha,Sabaragamuwa,5440,6300,11740,217600,252000,469600
10/19/2024,Yashoda Kumari,Ratnapura,Elapatha,Sabaragamuwa,1476,9623,11099,59040,384920,443960
10/20/2024,Yashoda Kumari,Ratnapura,Elapatha,Sabaragamuwa,9476,112,9588,379040,4480,383520
10/21/2024,Yashoda Kumari,Ratnapura,Elapatha,Sabaragamuwa,3185,4255,7440,127400,170200,297600
10/22/2024,Yashoda Kumari,Ratnapura,Elapatha,Sabaragamuwa,2935,1548,4483,117400,61920,179320
10/23/2024,Yashoda Kumari,Ratnapura,Elapatha,Sabaragamuwa,5698,5104,10802,227920,204160,432080
10/24/2024,Yashoda Kumari,Ratnapura,Elapatha,Sabaragamuwa,6301,5385,11686,252040,215400,467440
10/25/2024,Yashoda Kumari,Ratnapura,Elapatha,Sabaragamuwa,4918,3355,8273,196720,134200,330920
10/26/2024,Yashoda Kumari,Ratnapura,Elapatha,Sabaragamuwa,5609,1494,7103,224360,59760,284120
10/27/2024,Yashoda Kumari,Ratnapura,Elapatha,Sabaragamuwa,2854,6496,9350,114160,259840,374000
10/28/2024,Yashoda Kumari,Ratnapura,Elapatha,Sabaragamuwa,8675,305,8980,347000,12200,359200
10/29/2024,Yashoda Kumari,Ratnapura,Elapatha,Sabaragamuwa,7529,9362,16891,301160,374480,675640
10/30/2024,Yashoda Kumari,Ratnapura,Elapatha,Sabaragamuwa,1582,9805,11387,63280,392200,455480
10/31/2024,Yashoda Kumari,Ratnapura,Elapatha,Sabaragamuwa,7747,3958,11705,309880,158320,468200
11/1/2024,Yashoda Kumari,Ratnapura,Elapatha,Sabaragamuwa,6508,783,7291,260320,31320,291640
11/2/2024,Yashoda Kumari,Ratnapura,Elapatha,Sabaragamuwa,5107,2430,7537,204280,97200,301480
11/3/2024,Yashoda Kumari,Ratnapura,Elapatha,Sabaragamuwa,6112,6019,12131,244480,240760,485240
11/4/2024,Yashoda Kumari,Ratnapura,Elapatha,Sabaragamuwa,1134,2063,3197,45360,82520,127880
11/5/2024,Yashoda Kumari,Ratnapura,Elapatha,Sabaragamuwa,6460,901,7361,258400,36040,294440
11/6/2024,Yashoda Kumari,Ratnapura,Elapatha,Sabaragamuwa,6644,8480,15124,265760,339200,604960
11/7/2024,Yashoda Kumari,Ratnapura,Elapatha,Sabaragamuwa,4054,9534,13588,162160,381360,543520
11/8/2024,Yashoda Kumari,Ratnapura,Elapatha,Sabaragamuwa,2103,6910,9013,84120,276400,360520
11/9/2024,Yashoda Kumari,Ratnapura,Elapatha,Sabaragamuwa,4833,5422,10255,193320,216880,410200
11/10/2024,Yashoda Kumari,Ratnapura,Elapatha,Sabaragamuwa,6346,7017,13363,253840,280680,534520
11/11/2024,Yashoda Kumari,Ratnapura,Elapatha,Sabaragamuwa,8987,7845,16832,359480,313800,673280
11/12/2024,Yashoda Kumari,Ratnapura,Elapatha,Sabaragamuwa,2518,6014,8532,100720,240560,341280
11/13/2024,Yashoda Kumari,Ratnapura,Elapatha,Sabaragamuwa,118,398,516,4720,15920,20640
11/14/2024,Yashoda Kumari,Ratnapura,Elapatha,Sabaragamuwa,6758,6180,12938,270320,247200,517520
11/15/2024,Yashoda Kumari,Ratnapura,Elapatha,Sabaragamuwa,175,3309,3484,7000,132360,139360
11/16/2024,Yashoda Kumari,Ratnapura,Elapatha,Sabaragamuwa,5616,8810,14426,224640,352400,577040
11/17/2024,Yashoda Kumari,Ratnapura,Elapatha,Sabaragamuwa,3026,9656,12682,121040,386240,507280
11/18/2024,Yashoda Kumari,Ratnapura,Elapatha,Sabaragamuwa,8839,6305,15144,353560,252200,605760
11/19/2024,Yashoda Kumari,Ratnapura,Elapatha,Sabaragamuwa,5895,2304,8199,235800,92160,327960
11/20/2024,Yashoda Kumari,Ratnapura,Elapatha,Sabaragamuwa,6691,4921,11612,267640,196840,464480
11/21/2024,Yashoda Kumari,Ratnapura,Elapatha,Sabaragamuwa,160,7987,8147,6400,319480,325880
11/22/2024,Yashoda Kumari,Ratnapura,Elapatha,Sabaragamuwa,3051,1600,4651,122040,64000,186040
11/23/2024,Yashoda Kumari,Ratnapura,Elapatha,Sabaragamuwa,9124,9148,18272,364960,365920,730880
11/24/2024,Yashoda Kumari,Ratnapura,Elapatha,Sabaragamuwa,9536,8593,18129,381440,343720,725160
11/25/2024,Yashoda Kumari,Ratnapura,Elapatha,Sabaragamuwa,6684,3893,10577,267360,155720,423080
11/26/2024,Yashoda Kumari,Ratnapura,Elapatha,Sabaragamuwa,5606,4098,9704,224240,163920,388160
11/27/2024,Yashoda Kumari,Ratnapura,Elapatha,Sabaragamuwa,7312,7019,14331,292480,280760,573240
11/28/2024,Yashoda Kumari,Ratnapura,Elapatha,Sabaragamuwa,5343,9524,14867,213720,380960,594680
11/29/2024,Yashoda Kumari,Ratnapura,Elapatha,Sabaragamuwa,7175,8762,15937,287000,350480,637480
11/30/2024,Yashoda Kumari,Ratnapura,Elapatha,Sabaragamuwa,5203,6985,12188,208120,279400,487520
12/1/2024,Yashoda Kumari,Ratnapura,Elapatha,Sabaragamuwa,510,4777,5287,20400,191080,211480
12/2/2024,Yashoda Kumari,Ratnapura,Elapatha,Sabaragamuwa,6071,1248,7319,242840,49920,292760
12/3/2024,Yashoda Kumari,Ratnapura,Elapatha,Sabaragamuwa,2813,8739,11552,112520,349560,462080
12/4/2024,Yashoda Kumari,Ratnapura,Elapatha,Sabaragamuwa,7261,9681,16942,290440,387240,677680
12/5/2024,Yashoda Kumari,Ratnapura,Elapatha,Sabaragamuwa,5823,2341,8164,232920,93640,326560
12/6/2024,Yashoda Kumari,Ratnapura,Elapatha,Sabaragamuwa,7728,6775,14503,309120,271000,580120
12/7/2024,Yashoda Kumari,Ratnapura,Elapatha,Sabaragamuwa,7906,7759,15665,316240,310360,626600
12/8/2024,Yashoda Kumari,Ratnapura,Elapatha,Sabaragamuwa,8041,4424,12465,321640,176960,498600
12/9/2024,Yashoda Kumari,Ratnapura,Elapatha,Sabaragamuwa,8516,822,9338,340640,32880,373520
12/10/2024,Yashoda Kumari,Ratnapura,Elapatha,Sabaragamuwa,221,7678,7899,8840,307120,315960
12/11/2024,Yashoda Kumari,Ratnapura,Elapatha,Sabaragamuwa,3193,2671,5864,127720,106840,234560
12/12/2024,Yashoda Kumari,Ratnapura,Elapatha,Sabaragamuwa,5943,2054,7997,237720,82160,319880
12/13/2024,Yashoda Kumari,Ratnapura,Elapatha,Sabaragamuwa,2611,8137,10748,104440,325480,429920
12/14/2024,Yashoda Kumari,Ratnapura,Elapatha,Sabaragamuwa,5819,8494,14313,232760,339760,572520
12/15/2024,Yashoda Kumari,Ratnapura,Elapatha,Sabaragamuwa,8548,3839,12387,341920,153560,495480
12/16/2024,Yashoda Kumari,Ratnapura,Elapatha,Sabaragamuwa,9670,524,10194,386800,20960,407760
12/17/2024,Yashoda Kumari,Ratnapura,Elapatha,Sabaragamuwa,9404,4897,14301,376160,195880,572040
12/18/2024,Yashoda Kumari,Ratnapura,Elapatha,Sabaragamuwa,4423,4223,8646,176920,168920,345840
12/19/2024,Yashoda Kumari,Ratnapura,Elapatha,Sabaragamuwa,7201,7250,14451,288040,290000,578040
12/20/2024,Yashoda Kumari,Ratnapura,Elapatha,Sabaragamuwa,8044,9837,17881,321760,393480,715240
12/21/2024,Yashoda Kumari,Ratnapura,Elapatha,Sabaragamuwa,7563,4722,12285,302520,188880,491400
12/22/2024,Yashoda Kumari,Ratnapura,Elapatha,Sabaragamuwa,1294,3975,5269,51760,159000,210760
12/23/2024,Yashoda Kumari,Ratnapura,Elapatha,Sabaragamuwa,1545,1146,2691,61800,45840,107640
12/24/2024,Yashoda Kumari,Ratnapura,Elapatha,Sabaragamuwa,6378,1559,7937,255120,62360,317480
12/25/2024,Yashoda Kumari,Ratnapura,Elapatha,Sabaragamuwa,7054,3994,11048,282160,159760,441920
12/26/2024,Yashoda Kumari,Ratnapura,Elapatha,Sabaragamuwa,8049,3709,11758,321960,148360,470320
12/27/2024,Yashoda Kumari,Ratnapura,Elapatha,Sabaragamuwa,263,353,616,10520,14120,24640
12/28/2024,Yashoda Kumari,Ratnapura,Elapatha,Sabaragamuwa,7432,1742,9174,297280,69680,366960
12/29/2024,Yashoda Kumari,Ratnapura,Elapatha,Sabaragamuwa,3426,3862,7288,137040,154480,291520
12/30/2024,Yashoda Kumari,Ratnapura,Elapatha,Sabaragamuwa,3795,7336,11131,151800,293440,445240
12/31/2024,Yashoda Kumari,Ratnapura,Elapatha,Sabaragamuwa,8777,3414,12191,351080,136560,487640
1/1/2025,Yashoda Kumari,Ratnapura,Elapatha,Sabaragamuwa,6829,9054,15883,273160,362160,635320
1/2/2025,Yashoda Kumari,Ratnapura,Elapatha,Sabaragamuwa,7986,8352,16338,319440,334080,653520
1/3/2025,Yashoda Kumari,Ratnapura,Elapatha,Sabaragamuwa,1480,4423,5903,59200,176920,236120
1/4/2025,Yashoda Kumari,Ratnapura,Elapatha,Sabaragamuwa,5423,1400,6823,216920,56000,272920
1/5/2025,Yashoda Kumari,Ratnapura,Elapatha,Sabaragamuwa,7308,3260,10568,292320,130400,422720
1/6/2025,Yashoda Kumari,Ratnapura,Elapatha,Sabaragamuwa,4149,6969,11118,165960,278760,444720
1/7/2025,Yashoda Kumari,Ratnapura,Elapatha,Sabaragamuwa,8359,4796,13155,334360,191840,526200
1/8/2025,Yashoda Kumari,Ratnapura,Elapatha,Sabaragamuwa,549,6245,6794,21960,249800,271760
1/9/2025,Yashoda Kumari,Ratnapura,Elapatha,Sabaragamuwa,3649,4952,8601,145960,198080,344040
1/10/2025,Yashoda Kumari,Ratnapura,Elapatha,Sabaragamuwa,3695,8644,12339,147800,345760,493560
1/11/2025,Yashoda Kumari,Ratnapura,Elapatha,Sabaragamuwa,9526,3108,12634,381040,124320,505360
1/12/2025,Yashoda Kumari,Ratnapura,Elapatha,Sabaragamuwa,1141,2228,3369,45640,89120,134760
1/13/2025,Yashoda Kumari,Ratnapura,Elapatha,Sabaragamuwa,3729,8170,11899,149160,326800,475960
1/14/2025,Yashoda Kumari,Ratnapura,Elapatha,Sabaragamuwa,4326,7434,11760,173040,297360,470400
1/15/2025,Yashoda Kumari,Ratnapura,Elapatha,Sabaragamuwa,98,8662,8760,3920,346480,350400
1/16/2025,Yashoda Kumari,Ratnapura,Elapatha,Sabaragamuwa,419,652,1071,16760,26080,42840
1/17/2025,Yashoda Kumari,Ratnapura,Elapatha,Sabaragamuwa,3764,3682,7446,150560,147280,297840
1/18/2025,Yashoda Kumari,Ratnapura,Elapatha,Sabaragamuwa,394,7047,7441,15760,281880,297640
1/19/2025,Yashoda Kumari,Ratnapura,Elapatha,Sabaragamuwa,7668,7229,14897,306720,289160,595880
1/20/2025,Yashoda Kumari,Ratnapura,Elapatha,Sabaragamuwa,8860,534,9394,354400,21360,375760
1/21/2025,Yashoda Kumari,Ratnapura,Elapatha,Sabaragamuwa,84,887,971,3360,35480,38840
1/22/2025,Yashoda Kumari,Ratnapura,Elapatha,Sabaragamuwa,771,3231,4002,30840,129240,160080
1/23/2025,Yashoda Kumari,Ratnapura,Elapatha,Sabaragamuwa,9173,108,9281,366920,4320,371240
1/24/2025,Yashoda Kumari,Ratnapura,Elapatha,Sabaragamuwa,9310,7911,17221,372400,316440,688840
1/25/2025,Yashoda Kumari,Ratnapura,Elapatha,Sabaragamuwa,3385,68,3453,135400,2720,138120
1/26/2025,Yashoda Kumari,Ratnapura,Elapatha,Sabaragamuwa,2573,6956,9529,102920,278240,381160
1/27/2025,Yashoda Kumari,Ratnapura,Elapatha,Sabaragamuwa,3532,2172,5704,141280,86880,228160
1/28/2025,Yashoda Kumari,Ratnapura,Elapatha,Sabaragamuwa,975,5107,6082,39000,204280,243280
1/29/2025,Yashoda Kumari,Ratnapura,Elapatha,Sabaragamuwa,6587,5169,11756,263480,206760,470240
1/30/2025,Yashoda Kumari,Ratnapura,Elapatha,Sabaragamuwa,927,7919,8846,37080,316760,353840
1/31/2025,Yashoda Kumari,Ratnapura,Elapatha,Sabaragamuwa,8940,2157,11097,357600,86280,443880
2/1/2025,Yashoda Kumari,Ratnapura,Elapatha,Sabaragamuwa,4298,1421,5719,171920,56840,228760
2/2/2025,Yashoda Kumari,Ratnapura,Elapatha,Sabaragamuwa,9823,7723,17546,392920,308920,701840
2/3/2025,Yashoda Kumari,Ratnapura,Elapatha,Sabaragamuwa,1918,1241,3159,76720,49640,126360
2/4/2025,Yashoda Kumari,Ratnapura,Elapatha,Sabaragamuwa,2287,8943,11230,91480,357720,449200
2/5/2025,Yashoda Kumari,Ratnapura,Elapatha,Sabaragamuwa,220,8426,8646,8800,337040,345840
2/6/2025,Yashoda Kumari,Ratnapura,Elapatha,Sabaragamuwa,5616,2223,7839,224640,88920,313560
2/7/2025,Yashoda Kumari,Ratnapura,Elapatha,Sabaragamuwa,1494,8324,9818,59760,332960,392720
2/8/2025,Yashoda Kumari,Ratnapura,Elapatha,Sabaragamuwa,6234,8434,14668,249360,337360,586720
2/9/2025,Yashoda Kumari,Ratnapura,Elapatha,Sabaragamuwa,2362,9847,12209,94480,393880,488360
2/10/2025,Yashoda Kumari,Ratnapura,Elapatha,Sabaragamuwa,129,4385,4514,5160,175400,180560
2/11/2025,Yashoda Kumari,Ratnapura,Elapatha,Sabaragamuwa,13,993,1006,520,39720,40240
2/12/2025,Yashoda Kumari,Ratnapura,Elapatha,Sabaragamuwa,651,7282,7933,26040,291280,317320
2/13/2025,Yashoda Kumari,Ratnapura,Elapatha,Sabaragamuwa,8569,1214,9783,342760,48560,391320
2/14/2025,Yashoda Kumari,Ratnapura,Elapatha,Sabaragamuwa,7506,3135,10641,300240,125400,425640
2/15/2025,Yashoda Kumari,Ratnapura,Elapatha,Sabaragamuwa,9470,7015,16485,378800,280600,659400
2/16/2025,Yashoda Kumari,Ratnapura,Elapatha,Sabaragamuwa,9081,6723,15804,363240,268920,632160
2/17/2025,Yashoda Kumari,Ratnapura,Elapatha,Sabaragamuwa,7872,8908,16780,314880,356320,671200
2/18/2025,Yashoda Kumari,Ratnapura,Elapatha,Sabaragamuwa,3078,9520,12598,123120,380800,503920
2/19/2025,Yashoda Kumari,Ratnapura,Elapatha,Sabaragamuwa,4537,8046,12583,181480,321840,503320
2/20/2025,Yashoda Kumari,Ratnapura,Elapatha,Sabaragamuwa,5873,9252,15125,234920,370080,605000
2/21/2025,Yashoda Kumari,Ratnapura,Elapatha,Sabaragamuwa,8191,3255,11446,327640,130200,457840
2/22/2025,Yashoda Kumari,Ratnapura,Elapatha,Sabaragamuwa,7100,6539,13639,284000,261560,545560
2/23/2025,Yashoda Kumari,Ratnapura,Elapatha,Sabaragamuwa,6656,8884,15540,266240,355360,621600
2/24/2025,Yashoda Kumari,Ratnapura,Elapatha,Sabaragamuwa,1027,4972,5999,41080,198880,239960
2/25/2025,Yashoda Kumari,Ratnapura,Elapatha,Sabaragamuwa,5302,8130,13432,212080,325200,537280
2/26/2025,Yashoda Kumari,Ratnapura,Elapatha,Sabaragamuwa,1558,4027,5585,62320,161080,223400
2/27/2025,Yashoda Kumari,Ratnapura,Elapatha,Sabaragamuwa,9502,7406,16908,380080,296240,676320
2/28/2025,Yashoda Kumari,Ratnapura,Elapatha,Sabaragamuwa,9636,5030,14666,385440,201200,586640
3/1/2025,Yashoda Kumari,Ratnapura,Elapatha,Sabaragamuwa,2214,7951,10165,88560,318040,406600
3/2/2025,Yashoda Kumari,Ratnapura,Elapatha,Sabaragamuwa,8753,6482,15235,350120,259280,609400
3/3/2025,Yashoda Kumari,Ratnapura,Elapatha,Sabaragamuwa,661,6889,7550,26440,275560,302000
3/4/2025,Yashoda Kumari,Ratnapura,Elapatha,Sabaragamuwa,9970,7866,17836,398800,314640,713440
3/5/2025,Yashoda Kumari,Ratnapura,Elapatha,Sabaragamuwa,7609,7585,15194,304360,303400,607760
3/6/2025,Yashoda Kumari,Ratnapura,Elapatha,Sabaragamuwa,3604,1478,5082,144160,59120,203280
3/7/2025,Yashoda Kumari,Ratnapura,Elapatha,Sabaragamuwa,8647,1740,10387,345880,69600,415480
3/8/2025,Yashoda Kumari,Ratnapura,Elapatha,Sabaragamuwa,8345,7811,16156,333800,312440,646240
3/9/2025,Yashoda Kumari,Ratnapura,Elapatha,Sabaragamuwa,5238,8619,13857,209520,344760,554280
3/10/2025,Yashoda Kumari,Ratnapura,Elapatha,Sabaragamuwa,3951,9213,13164,158040,368520,526560
3/11/2025,Yashoda Kumari,Ratnapura,Elapatha,Sabaragamuwa,8821,3278,12099,352840,131120,483960
3/12/2025,Yashoda Kumari,Ratnapura,Elapatha,Sabaragamuwa,9454,7912,17366,378160,316480,694640
3/13/2025,Yashoda Kumari,Ratnapura,Elapatha,Sabaragamuwa,2053,1871,3924,82120,74840,156960
3/14/2025,Yashoda Kumari,Ratnapura,Elapatha,Sabaragamuwa,2961,4562,7523,118440,182480,300920
3/15/2025,Yashoda Kumari,Ratnapura,Elapatha,Sabaragamuwa,1211,8967,10178,48440,358680,407120
3/16/2025,Yashoda Kumari,Ratnapura,Elapatha,Sabaragamuwa,3558,8800,12358,142320,352000,494320
3/17/2025,Yashoda Kumari,Ratnapura,Elapatha,Sabaragamuwa,8384,1462,9846,335360,58480,393840
3/18/2025,Yashoda Kumari,Ratnapura,Elapatha,Sabaragamuwa,8382,2006,10388,335280,80240,415520
3/19/2025,Yashoda Kumari,Ratnapura,Elapatha,Sabaragamuwa,587,282,869,23480,11280,34760
3/20/2025,Yashoda Kumari,Ratnapura,Elapatha,Sabaragamuwa,7754,5760,13514,310160,230400,540560
3/21/2025,Yashoda Kumari,Ratnapura,Elapatha,Sabaragamuwa,5911,7619,13530,236440,304760,541200
3/22/2025,Yashoda Kumari,Ratnapura,Elapatha,Sabaragamuwa,7395,604,7999,295800,24160,319960
3/23/2025,Yashoda Kumari,Ratnapura,Elapatha,Sabaragamuwa,9548,7971,17519,381920,318840,700760
3/25/2024,Sahan Kumara,Anuradhapura,Thissamaharama,North Central,3167,2989,6156,126680,119560,246240
3/26/2024,Sahan Kumara,Anuradhapura,Thissamaharama,North Central,7860,3950,11810,314400,158000,472400
3/27/2024,Sahan Kumara,Anuradhapura,Thissamaharama,North Central,5977,3337,9314,239080,133480,372560
3/28/2024,Sahan Kumara,Anuradhapura,Thissamaharama,North Central,973,917,1890,38920,36680,75600
3/29/2024,Sahan Kumara,Anuradhapura,Thissamaharama,North Central,8535,5671,14206,341400,226840,568240
3/30/2024,Sahan Kumara,Anuradhapura,Thissamaharama,North Central,2282,5327,7609,91280,213080,304360
3/31/2024,Sahan Kumara,Anuradhapura,Thissamaharama,North Central,7764,6255,14019,310560,250200,560760
4/1/2024,Sahan Kumara,Anuradhapura,Thissamaharama,North Central,2710,1453,4163,108400,58120,166520
4/2/2024,Sahan Kumara,Anuradhapura,Thissamaharama,North Central,4080,8994,13074,163200,359760,522960
4/3/2024,Sahan Kumara,Anuradhapura,Thissamaharama,North Central,3247,3728,6975,129880,149120,279000
4/4/2024,Sahan Kumara,Anuradhapura,Thissamaharama,North Central,1062,3063,4125,42480,122520,165000
4/5/2024,Sahan Kumara,Anuradhapura,Thissamaharama,North Central,6696,3594,10290,267840,143760,411600
4/6/2024,Sahan Kumara,Anuradhapura,Thissamaharama,North Central,5090,3173,8263,203600,126920,330520
4/7/2024,Sahan Kumara,Anuradhapura,Thissamaharama,North Central,5134,7162,12296,205360,286480,491840
4/8/2024,Sahan Kumara,Anuradhapura,Thissamaharama,North Central,7630,3775,11405,305200,151000,456200
4/9/2024,Sahan Kumara,Anuradhapura,Thissamaharama,North Central,1695,279,1974,67800,11160,78960
4/10/2024,Sahan Kumara,Anuradhapura,Thissamaharama,North Central,9631,7804,17435,385240,312160,697400
4/11/2024,Sahan Kumara,Anuradhapura,Thissamaharama,North Central,8590,4744,13334,343600,189760,533360
4/19/2024,Sahan Kumara,Anuradhapura,Thissamaharama,North Central,2381,8372,10753,95240,334880,430120
4/20/2024,Sahan Kumara,Anuradhapura,Thissamaharama,North Central,9446,5793,15239,377840,231720,609560
4/21/2024,Sahan Kumara,Anuradhapura,Thissamaharama,North Central,9101,9780,18881,364040,391200,755240
4/22/2024,Sahan Kumara,Anuradhapura,Thissamaharama,North Central,9204,9069,18273,368160,362760,730920
4/23/2024,Sahan Kumara,Anuradhapura,Thissamaharama,North Central,587,213,800,23480,8520,32000
4/24/2024,Sahan Kumara,Anuradhapura,Thissamaharama,North Central,7203,4082,11285,288120,163280,451400
4/25/2024,Sahan Kumara,Anuradhapura,Thissamaharama,North Central,3078,9570,12648,123120,382800,505920
4/26/2024,Sahan Kumara,Anuradhapura,Thissamaharama,North Central,5335,5423,10758,213400,216920,430320
4/27/2024,Sahan Kumara,Anuradhapura,Thissamaharama,North Central,3758,1283,5041,150320,51320,201640
4/28/2024,Sahan Kumara,Anuradhapura,Thissamaharama,North Central,9663,9236,18899,386520,369440,755960
4/29/2024,Sahan Kumara,Anuradhapura,Thissamaharama,North Central,8326,2171,10497,333040,86840,419880
4/30/2024,Sahan Kumara,Anuradhapura,Thissamaharama,North Central,5689,5230,10919,227560,209200,436760
5/1/2024,Sahan Kumara,Anuradhapura,Thissamaharama,North Central,2656,6707,9363,106240,268280,374520
5/2/2024,Sahan Kumara,Anuradhapura,Thissamaharama,North Central,687,6057,6744,27480,242280,269760
5/3/2024,Sahan Kumara,Anuradhapura,Thissamaharama,North Central,9276,5571,14847,371040,222840,593880
5/4/2024,Sahan Kumara,Anuradhapura,Thissamaharama,North Central,8085,2524,10609,323400,100960,424360
5/5/2024,Sahan Kumara,Anuradhapura,Thissamaharama,North Central,7292,9652,16944,291680,386080,677760
5/6/2024,Sahan Kumara,Anuradhapura,Thissamaharama,North Central,6820,5019,11839,272800,200760,473560
5/7/2024,Sahan Kumara,Anuradhapura,Thissamaharama,North Central,5352,4057,9409,214080,162280,376360
5/8/2024,Sahan Kumara,Anuradhapura,Thissamaharama,North Central,6440,4653,11093,257600,186120,443720
5/9/2024,Sahan Kumara,Anuradhapura,Thissamaharama,North Central,5260,9648,14908,210400,385920,596320
5/10/2024,Sahan Kumara,Anuradhapura,Thissamaharama,North Central,2291,4336,6627,91640,173440,265080
5/11/2024,Sahan Kumara,Anuradhapura,Thissamaharama,North Central,2709,7387,10096,108360,295480,403840
5/12/2024,Sahan Kumara,Anuradhapura,Thissamaharama,North Central,6796,8995,15791,271840,359800,631640
5/13/2024,Sahan Kumara,Anuradhapura,Thissamaharama,North Central,4207,1228,5435,168280,49120,217400
5/14/2024,Sahan Kumara,Anuradhapura,Thissamaharama,North Central,6878,880,7758,275120,35200,310320
5/15/2024,Sahan Kumara,Anuradhapura,Thissamaharama,North Central,2075,3409,5484,83000,136360,219360
5/16/2024,Sahan Kumara,Anuradhapura,Thissamaharama,North Central,9483,1028,10511,379320,41120,420440
5/17/2024,Sahan Kumara,Anuradhapura,Thissamaharama,North Central,3055,8333,11388,122200,333320,455520
5/18/2024,Sahan Kumara,Anuradhapura,Thissamaharama,North Central,6779,6377,13156,271160,255080,526240
5/19/2024,Sahan Kumara,Anuradhapura,Thissamaharama,North Central,5918,5826,11744,236720,233040,469760
5/20/2024,Sahan Kumara,Anuradhapura,Thissamaharama,North Central,5569,8856,14425,222760,354240,577000
5/21/2024,Sahan Kumara,Anuradhapura,Thissamaharama,North Central,7106,2758,9864,284240,110320,394560
5/22/2024,Sahan Kumara,Anuradhapura,Thissamaharama,North Central,4757,7760,12517,190280,310400,500680
5/24/2024,Sahan Kumara,Anuradhapura,Thissamaharama,North Central,9971,1960,11931,398840,78400,477240
5/25/2024,Sahan Kumara,Anuradhapura,Thissamaharama,North Central,5039,9039,14078,201560,361560,563120
5/26/2024,Sahan Kumara,Anuradhapura,Thissamaharama,North Central,4192,7650,11842,167680,306000,473680
5/27/2024,Sahan Kumara,Anuradhapura,Thissamaharama,North Central,3843,8854,12697,153720,354160,507880
5/28/2024,Sahan Kumara,Anuradhapura,Thissamaharama,North Central,8556,402,8958,342240,16080,358320
5/29/2024,Sahan Kumara,Anuradhapura,Thissamaharama,North Central,9236,1075,10311,369440,43000,412440
5/30/2024,Sahan Kumara,Anuradhapura,Thissamaharama,North Central,491,7085,7576,19640,283400,303040
5/31/2024,Sahan Kumara,Anuradhapura,Thissamaharama,North Central,1784,1343,3127,71360,53720,125080
6/1/2024,Sahan Kumara,Anuradhapura,Thissamaharama,North Central,2479,6936,9415,99160,277440,376600
6/2/2024,Sahan Kumara,Anuradhapura,Thissamaharama,North Central,7676,9218,16894,307040,368720,675760
6/3/2024,Sahan Kumara,Anuradhapura,Thissamaharama,North Central,2181,9727,11908,87240,389080,476320
6/4/2024,Sahan Kumara,Anuradhapura,Thissamaharama,North Central,8735,8263,16998,349400,330520,679920
6/5/2024,Sahan Kumara,Anuradhapura,Thissamaharama,North Central,5105,5242,10347,204200,209680,413880
6/6/2024,Sahan Kumara,Anuradhapura,Thissamaharama,North Central,6378,9200,15578,255120,368000,623120
6/7/2024,Sahan Kumara,Anuradhapura,Thissamaharama,North Central,4814,6402,11216,192560,256080,448640
6/8/2024,Sahan Kumara,Anuradhapura,Thissamaharama,North Central,1846,1178,3024,73840,47120,120960
6/9/2024,Sahan Kumara,Anuradhapura,Thissamaharama,North Central,5265,2896,8161,210600,115840,326440
6/10/2024,Sahan Kumara,Anuradhapura,Thissamaharama,North Central,5510,9340,14850,220400,373600,594000
6/11/2024,Sahan Kumara,Anuradhapura,Thissamaharama,North Central,4201,1466,5667,168040,58640,226680
6/12/2024,Sahan Kumara,Anuradhapura,Thissamaharama,North Central,4295,7591,11886,171800,303640,475440
6/13/2024,Sahan Kumara,Anuradhapura,Thissamaharama,North Central,5980,9873,15853,239200,394920,634120
6/14/2024,Sahan Kumara,Anuradhapura,Thissamaharama,North Central,8537,6640,15177,341480,265600,607080
6/15/2024,Sahan Kumara,Anuradhapura,Thissamaharama,North Central,7559,5096,12655,302360,203840,506200
6/16/2024,Sahan Kumara,Anuradhapura,Thissamaharama,North Central,6308,5760,12068,252320,230400,482720
6/17/2024,Sahan Kumara,Anuradhapura,Thissamaharama,North Central,1245,669,1914,49800,26760,76560
6/18/2024,Sahan Kumara,Anuradhapura,Thissamaharama,North Central,8320,7356,15676,332800,294240,627040
6/19/2024,Sahan Kumara,Anuradhapura,Thissamaharama,North Central,5015,2020,7035,200600,80800,281400
6/20/2024,Sahan Kumara,Anuradhapura,Thissamaharama,North Central,6127,2301,8428,245080,92040,337120
6/21/2024,Sahan Kumara,Anuradhapura,Thissamaharama,North Central,9577,3326,12903,383080,133040,516120
6/22/2024,Sahan Kumara,Anuradhapura,Thissamaharama,North Central,23,1030,1053,920,41200,42120
6/23/2024,Sahan Kumara,Anuradhapura,Thissamaharama,North Central,542,7985,8527,21680,319400,341080
6/24/2024,Sahan Kumara,Anuradhapura,Thissamaharama,North Central,6979,403,7382,279160,16120,295280
6/25/2024,Sahan Kumara,Anuradhapura,Thissamaharama,North Central,3231,9688,12919,129240,387520,516760
6/26/2024,Sahan Kumara,Anuradhapura,Thissamaharama,North Central,5542,235,5777,221680,9400,231080
6/27/2024,Sahan Kumara,Anuradhapura,Thissamaharama,North Central,8711,450,9161,348440,18000,366440
6/28/2024,Sahan Kumara,Anuradhapura,Thissamaharama,North Central,1269,5261,6530,50760,210440,261200
6/29/2024,Sahan Kumara,Anuradhapura,Thissamaharama,North Central,3806,1243,5049,152240,49720,201960
6/30/2024,Sahan Kumara,Anuradhapura,Thissamaharama,North Central,5758,8443,14201,230320,337720,568040
7/1/2024,Sahan Kumara,Anuradhapura,Thissamaharama,North Central,7213,2629,9842,288520,105160,393680
7/2/2024,Sahan Kumara,Anuradhapura,Thissamaharama,North Central,2244,8135,10379,89760,325400,415160
7/3/2024,Sahan Kumara,Anuradhapura,Thissamaharama,North Central,9719,5534,15253,388760,221360,610120
7/4/2024,Sahan Kumara,Anuradhapura,Thissamaharama,North Central,8566,611,9177,342640,24440,367080
7/5/2024,Sahan Kumara,Anuradhapura,Thissamaharama,North Central,3242,3699,6941,129680,147960,277640
7/6/2024,Sahan Kumara,Anuradhapura,Thissamaharama,North Central,3348,6462,9810,133920,258480,392400
7/7/2024,Sahan Kumara,Anuradhapura,Thissamaharama,North Central,3048,8185,11233,121920,327400,449320
7/8/2024,Sahan Kumara,Anuradhapura,Thissamaharama,North Central,6220,6180,12400,248800,247200,496000
7/9/2024,Sahan Kumara,Anuradhapura,Thissamaharama,North Central,3673,9910,13583,146920,396400,543320
7/10/2024,Sahan Kumara,Anuradhapura,Thissamaharama,North Central,2443,2671,5114,97720,106840,204560
7/11/2024,Sahan Kumara,Anuradhapura,Thissamaharama,North Central,4407,1349,5756,176280,53960,230240
7/12/2024,Sahan Kumara,Anuradhapura,Thissamaharama,North Central,4631,9997,14628,185240,399880,585120
7/13/2024,Sahan Kumara,Anuradhapura,Thissamaharama,North Central,4716,2629,7345,188640,105160,293800
7/14/2024,Sahan Kumara,Anuradhapura,Thissamaharama,North Central,2019,5721,7740,80760,228840,309600
7/15/2024,Sahan Kumara,Anuradhapura,Thissamaharama,North Central,2961,8814,11775,118440,352560,471000
7/16/2024,Sahan Kumara,Anuradhapura,Thissamaharama,North Central,9073,881,9954,362920,35240,398160
7/17/2024,Sahan Kumara,Anuradhapura,Thissamaharama,North Central,9463,1323,10786,378520,52920,431440
7/18/2024,Sahan Kumara,Anuradhapura,Thissamaharama,North Central,5856,9047,14903,234240,361880,596120
7/19/2024,Sahan Kumara,Anuradhapura,Thissamaharama,North Central,8689,5803,14492,347560,232120,579680
7/20/2024,Sahan Kumara,Anuradhapura,Thissamaharama,North Central,4479,7849,12328,179160,313960,493120
7/21/2024,Sahan Kumara,Anuradhapura,Thissamaharama,North Central,9772,3374,13146,390880,134960,525840
7/22/2024,Sahan Kumara,Anuradhapura,Thissamaharama,North Central,2290,3319,5609,91600,132760,224360
7/23/2024,Sahan Kumara,Anuradhapura,Thissamaharama,North Central,2216,5492,7708,88640,219680,308320
7/24/2024,Sahan Kumara,Anuradhapura,Thissamaharama,North Central,395,7908,8303,15800,316320,332120
7/25/2024,Sahan Kumara,Anuradhapura,Thissamaharama,North Central,1214,4442,5656,48560,177680,226240
7/26/2024,Sahan Kumara,Anuradhapura,Thissamaharama,North Central,6804,3933,10737,272160,157320,429480
7/27/2024,Sahan Kumara,Anuradhapura,Thissamaharama,North Central,2731,7382,10113,109240,295280,404520
7/28/2024,Sahan Kumara,Anuradhapura,Thissamaharama,North Central,694,4253,4947,27760,170120,197880
7/29/2024,Sahan Kumara,Anuradhapura,Thissamaharama,North Central,3155,1714,4869,126200,68560,194760
7/30/2024,Sahan Kumara,Anuradhapura,Thissamaharama,North Central,6813,680,7493,272520,27200,299720
7/31/2024,Sahan Kumara,Anuradhapura,Thissamaharama,North Central,6023,8347,14370,240920,333880,574800
8/1/2024,Sahan Kumara,Anuradhapura,Thissamaharama,North Central,4312,2000,6312,172480,80000,252480
8/2/2024,Sahan Kumara,Anuradhapura,Thissamaharama,North Central,4097,1802,5899,163880,72080,235960
8/3/2024,Sahan Kumara,Anuradhapura,Thissamaharama,North Central,4904,2095,6999,196160,83800,279960
8/4/2024,Sahan Kumara,Anuradhapura,Thissamaharama,North Central,4239,3180,7419,169560,127200,296760
8/5/2024,Sahan Kumara,Anuradhapura,Thissamaharama,North Central,6758,2867,9625,270320,114680,385000
8/6/2024,Sahan Kumara,Anuradhapura,Thissamaharama,North Central,5560,9886,15446,222400,395440,617840
8/7/2024,Sahan Kumara,Anuradhapura,Thissamaharama,North Central,9450,2820,12270,378000,112800,490800
8/8/2024,Sahan Kumara,Anuradhapura,Thissamaharama,North Central,7701,5127,12828,308040,205080,513120
8/9/2024,Sahan Kumara,Anuradhapura,Thissamaharama,North Central,4006,4476,8482,160240,179040,339280
8/10/2024,Sahan Kumara,Anuradhapura,Thissamaharama,North Central,4660,2856,7516,186400,114240,300640
8/11/2024,Sahan Kumara,Anuradhapura,Thissamaharama,North Central,9027,9810,18837,361080,392400,753480
8/12/2024,Sahan Kumara,Anuradhapura,Thissamaharama,North Central,311,4800,5111,12440,192000,204440
8/13/2024,Sahan Kumara,Anuradhapura,Thissamaharama,North Central,2599,9236,11835,103960,369440,473400
8/14/2024,Sahan Kumara,Anuradhapura,Thissamaharama,North Central,5073,4984,10057,202920,199360,402280
8/15/2024,Sahan Kumara,Anuradhapura,Thissamaharama,North Central,1491,7517,9008,59640,300680,360320
8/16/2024,Sahan Kumara,Anuradhapura,Thissamaharama,North Central,3813,9786,13599,152520,391440,543960
8/17/2024,Sahan Kumara,Anuradhapura,Thissamaharama,North Central,5877,174,6051,235080,6960,242040
8/18/2024,Sahan Kumara,Anuradhapura,Thissamaharama,North Central,8344,8581,16925,333760,343240,677000
8/19/2024,Sahan Kumara,Anuradhapura,Thissamaharama,North Central,404,9066,9470,16160,362640,378800
8/20/2024,Sahan Kumara,Anuradhapura,Thissamaharama,North Central,9307,1303,10610,372280,52120,424400
8/21/2024,Sahan Kumara,Anuradhapura,Thissamaharama,North Central,2606,4816,7422,104240,192640,296880
8/22/2024,Sahan Kumara,Anuradhapura,Thissamaharama,North Central,5560,9129,14689,222400,365160,587560
8/23/2024,Sahan Kumara,Anuradhapura,Thissamaharama,North Central,6003,852,6855,240120,34080,274200
8/24/2024,Sahan Kumara,Anuradhapura,Thissamaharama,North Central,7945,1979,9924,317800,79160,396960
8/25/2024,Sahan Kumara,Anuradhapura,Thissamaharama,North Central,4984,4133,9117,199360,165320,364680
8/26/2024,Sahan Kumara,Anuradhapura,Thissamaharama,North Central,6824,6438,13262,272960,257520,530480
8/27/2024,Sahan Kumara,Anuradhapura,Thissamaharama,North Central,7313,6695,14008,292520,267800,560320
8/28/2024,Sahan Kumara,Anuradhapura,Thissamaharama,North Central,1374,878,2252,54960,35120,90080
8/29/2024,Sahan Kumara,Anuradhapura,Thissamaharama,North Central,6500,4315,10815,260000,172600,432600
8/30/2024,Sahan Kumara,Anuradhapura,Thissamaharama,North Central,7127,9865,16992,285080,394600,679680
8/31/2024,Sahan Kumara,Anuradhapura,Thissamaharama,North Central,8709,4845,13554,348360,193800,542160
9/1/2024,Sahan Kumara,Anuradhapura,Thissamaharama,North Central,7589,857,8446,303560,34280,337840
9/2/2024,Sahan Kumara,Anuradhapura,Thissamaharama,North Central,3020,2926,5946,120800,117040,237840
9/3/2024,Sahan Kumara,Anuradhapura,Thissamaharama,North Central,1915,6706,8621,76600,268240,344840
9/4/2024,Sahan Kumara,Anuradhapura,Thissamaharama,North Central,8421,8874,17295,336840,354960,691800
9/5/2024,Sahan Kumara,Anuradhapura,Thissamaharama,North Central,3391,1924,5315,135640,76960,212600
9/6/2024,Sahan Kumara,Anuradhapura,Thissamaharama,North Central,3020,2193,5213,120800,87720,208520
9/7/2024,Sahan Kumara,Anuradhapura,Thissamaharama,North Central,5462,1457,6919,218480,58280,276760
9/8/2024,Sahan Kumara,Anuradhapura,Thissamaharama,North Central,1957,4872,6829,78280,194880,273160
9/9/2024,Sahan Kumara,Anuradhapura,Thissamaharama,North Central,3088,9287,12375,123520,371480,495000
9/10/2024,Sahan Kumara,Anuradhapura,Thissamaharama,North Central,6286,4698,10984,251440,187920,439360
9/11/2024,Sahan Kumara,Anuradhapura,Thissamaharama,North Central,9689,6143,15832,387560,245720,633280
9/12/2024,Sahan Kumara,Anuradhapura,Thissamaharama,North Central,4321,3273,7594,172840,130920,303760
9/13/2024,Sahan Kumara,Anuradhapura,Thissamaharama,North Central,9277,4455,13732,371080,178200,549280
9/14/2024,Sahan Kumara,Anuradhapura,Thissamaharama,North Central,1470,5563,7033,58800,222520,281320
9/15/2024,Sahan Kumara,Anuradhapura,Thissamaharama,North Central,4422,7132,11554,176880,285280,462160
9/16/2024,Sahan Kumara,Anuradhapura,Thissamaharama,North Central,2382,1089,3471,95280,43560,138840
9/17/2024,Sahan Kumara,Anuradhapura,Thissamaharama,North Central,9222,3768,12990,368880,150720,519600
9/18/2024,Sahan Kumara,Anuradhapura,Thissamaharama,North Central,7376,7228,14604,295040,289120,584160
9/19/2024,Sahan Kumara,Anuradhapura,Thissamaharama,North Central,3360,1530,4890,134400,61200,195600
9/20/2024,Sahan Kumara,Anuradhapura,Thissamaharama,North Central,6482,1051,7533,259280,42040,301320
9/21/2024,Sahan Kumara,Anuradhapura,Thissamaharama,North Central,5836,5419,11255,233440,216760,450200
9/22/2024,Sahan Kumara,Anuradhapura,Thissamaharama,North Central,7135,9157,16292,285400,366280,651680
9/23/2024,Sahan Kumara,Anuradhapura,Thissamaharama,North Central,9146,7709,16855,365840,308360,674200
9/24/2024,Sahan Kumara,Anuradhapura,Thissamaharama,North Central,4592,6049,10641,183680,241960,425640
9/25/2024,Sahan Kumara,Anuradhapura,Thissamaharama,North Central,7275,6999,14274,291000,279960,570960
9/26/2024,Sahan Kumara,Anuradhapura,Thissamaharama,North Central,8703,8164,16867,348120,326560,674680
9/27/2024,Sahan Kumara,Anuradhapura,Thissamaharama,North Central,8278,3161,11439,331120,126440,457560
9/28/2024,Sahan Kumara,Anuradhapura,Thissamaharama,North Central,1605,2443,4048,64200,97720,161920
9/29/2024,Sahan Kumara,Anuradhapura,Thissamaharama,North Central,1612,4982,6594,64480,199280,263760
9/30/2024,Sahan Kumara,Anuradhapura,Thissamaharama,North Central,4442,6568,11010,177680,262720,440400
10/1/2024,Sahan Kumara,Anuradhapura,Thissamaharama,North Central,9471,1581,11052,378840,63240,442080
10/2/2024,Sahan Kumara,Anuradhapura,Thissamaharama,North Central,8444,5454,13898,337760,218160,555920
10/3/2024,Sahan Kumara,Anuradhapura,Thissamaharama,North Central,403,1741,2144,16120,69640,85760
10/4/2024,Sahan Kumara,Anuradhapura,Thissamaharama,North Central,3169,7925,11094,126760,317000,443760
10/5/2024,Sahan Kumara,Anuradhapura,Thissamaharama,North Central,9806,9439,19245,392240,377560,769800
10/6/2024,Sahan Kumara,Anuradhapura,Thissamaharama,North Central,5814,6877,12691,232560,275080,507640
10/7/2024,Sahan Kumara,Anuradhapura,Thissamaharama,North Central,8662,8896,17558,346480,355840,702320
10/8/2024,Sahan Kumara,Anuradhapura,Thissamaharama,North Central,5858,9788,15646,234320,391520,625840
10/9/2024,Sahan Kumara,Anuradhapura,Thissamaharama,North Central,2570,1990,4560,102800,79600,182400
10/10/2024,Sahan Kumara,Anuradhapura,Thissamaharama,North Central,8232,8606,16838,329280,344240,673520
10/11/2024,Sahan Kumara,Anuradhapura,Thissamaharama,North Central,1137,424,1561,45480,16960,62440
10/12/2024,Sahan Kumara,Anuradhapura,Thissamaharama,North Central,2365,5085,7450,94600,203400,298000
10/13/2024,Sahan Kumara,Anuradhapura,Thissamaharama,North Central,9822,2454,12276,392880,98160,491040
10/14/2024,Sahan Kumara,Anuradhapura,Thissamaharama,North Central,262,592,854,10480,23680,34160
10/15/2024,Sahan Kumara,Anuradhapura,Thissamaharama,North Central,6162,1706,7868,246480,68240,314720
10/16/2024,Sahan Kumara,Anuradhapura,Thissamaharama,North Central,6209,6186,12395,248360,247440,495800
10/17/2024,Sahan Kumara,Anuradhapura,Thissamaharama,North Central,3104,3550,6654,124160,142000,266160
10/18/2024,Sahan Kumara,Anuradhapura,Thissamaharama,North Central,6239,8005,14244,249560,320200,569760
10/19/2024,Sahan Kumara,Anuradhapura,Thissamaharama,North Central,9279,4689,13968,371160,187560,558720
10/20/2024,Sahan Kumara,Anuradhapura,Thissamaharama,North Central,9019,9678,18697,360760,387120,747880
10/21/2024,Sahan Kumara,Anuradhapura,Thissamaharama,North Central,4964,3833,8797,198560,153320,351880
10/22/2024,Sahan Kumara,Anuradhapura,Thissamaharama,North Central,319,7001,7320,12760,280040,292800
10/23/2024,Sahan Kumara,Anuradhapura,Thissamaharama,North Central,4495,5978,10473,179800,239120,418920
10/24/2024,Sahan Kumara,Anuradhapura,Thissamaharama,North Central,3098,8374,11472,123920,334960,458880
10/25/2024,Sahan Kumara,Anuradhapura,Thissamaharama,North Central,995,2408,3403,39800,96320,136120
10/26/2024,Sahan Kumara,Anuradhapura,Thissamaharama,North Central,7808,6560,14368,312320,262400,574720
10/27/2024,Sahan Kumara,Anuradhapura,Thissamaharama,North Central,9215,3008,12223,368600,120320,488920
10/28/2024,Sahan Kumara,Anuradhapura,Thissamaharama,North Central,360,8250,8610,14400,330000,344400
10/29/2024,Sahan Kumara,Anuradhapura,Thissamaharama,North Central,1232,5051,6283,49280,202040,251320
10/30/2024,Sahan Kumara,Anuradhapura,Thissamaharama,North Central,1464,6628,8092,58560,265120,323680
10/31/2024,Sahan Kumara,Anuradhapura,Thissamaharama,North Central,6084,2284,8368,243360,91360,334720
11/1/2024,Sahan Kumara,Anuradhapura,Thissamaharama,North Central,6663,144,6807,266520,5760,272280
11/2/2024,Sahan Kumara,Anuradhapura,Thissamaharama,North Central,5817,9978,15795,232680,399120,631800
11/3/2024,Sahan Kumara,Anuradhapura,Thissamaharama,North Central,6326,2028,8354,253040,81120,334160
11/4/2024,Sahan Kumara,Anuradhapura,Thissamaharama,North Central,6299,9357,15656,251960,374280,626240
11/5/2024,Sahan Kumara,Anuradhapura,Thissamaharama,North Central,6316,6469,12785,252640,258760,511400
11/6/2024,Sahan Kumara,Anuradhapura,Thissamaharama,North Central,2103,1861,3964,84120,74440,158560
11/7/2024,Sahan Kumara,Anuradhapura,Thissamaharama,North Central,4092,718,4810,163680,28720,192400
11/8/2024,Sahan Kumara,Anuradhapura,Thissamaharama,North Central,9780,6167,15947,391200,246680,637880
11/9/2024,Sahan Kumara,Anuradhapura,Thissamaharama,North Central,2655,7913,10568,106200,316520,422720
11/10/2024,Sahan Kumara,Anuradhapura,Thissamaharama,North Central,3263,3726,6989,130520,149040,279560
11/11/2024,Sahan Kumara,Anuradhapura,Thissamaharama,North Central,6532,5130,11662,261280,205200,466480
11/12/2024,Sahan Kumara,Anuradhapura,Thissamaharama,North Central,3830,8676,12506,153200,347040,500240
11/13/2024,Sahan Kumara,Anuradhapura,Thissamaharama,North Central,4324,1988,6312,172960,79520,252480
11/14/2024,Sahan Kumara,Anuradhapura,Thissamaharama,North Central,1868,7328,9196,74720,293120,367840
11/15/2024,Sahan Kumara,Anuradhapura,Thissamaharama,North Central,5912,6413,12325,236480,256520,493000
11/16/2024,Sahan Kumara,Anuradhapura,Thissamaharama,North Central,2689,7097,9786,107560,283880,391440
11/17/2024,Sahan Kumara,Anuradhapura,Thissamaharama,North Central,9022,2189,11211,360880,87560,448440
11/18/2024,Sahan Kumara,Anuradhapura,Thissamaharama,North Central,519,7385,7904,20760,295400,316160
11/19/2024,Sahan Kumara,Anuradhapura,Thissamaharama,North Central,582,5315,5897,23280,212600,235880
11/20/2024,Sahan Kumara,Anuradhapura,Thissamaharama,North Central,9111,1133,10244,364440,45320,409760
11/21/2024,Sahan Kumara,Anuradhapura,Thissamaharama,North Central,3448,8862,12310,137920,354480,492400
11/22/2024,Sahan Kumara,Anuradhapura,Thissamaharama,North Central,7708,2689,10397,308320,107560,415880
11/23/2024,Sahan Kumara,Anuradhapura,Thissamaharama,North Central,5078,6155,11233,203120,246200,449320
11/24/2024,Sahan Kumara,Anuradhapura,Thissamaharama,North Central,9519,6402,15921,380760,256080,636840
11/25/2024,Sahan Kumara,Anuradhapura,Thissamaharama,North Central,8520,3892,12412,340800,155680,496480
11/26/2024,Sahan Kumara,Anuradhapura,Thissamaharama,North Central,2843,5852,8695,113720,234080,347800
11/27/2024,Sahan Kumara,Anuradhapura,Thissamaharama,North Central,5006,9110,14116,200240,364400,564640
11/28/2024,Sahan Kumara,Anuradhapura,Thissamaharama,North Central,8093,6770,14863,323720,270800,594520
11/29/2024,Sahan Kumara,Anuradhapura,Thissamaharama,North Central,9290,2254,11544,371600,90160,461760
11/30/2024,Sahan Kumara,Anuradhapura,Thissamaharama,North Central,6183,4569,10752,247320,182760,430080
12/1/2024,Sahan Kumara,Anuradhapura,Thissamaharama,North Central,929,6153,7082,37160,246120,283280
12/2/2024,Sahan Kumara,Anuradhapura,Thissamaharama,North Central,9247,5313,14560,369880,212520,582400
12/3/2024,Sahan Kumara,Anuradhapura,Thissamaharama,North Central,5949,3832,9781,237960,153280,391240
12/4/2024,Sahan Kumara,Anuradhapura,Thissamaharama,North Central,1340,564,1904,53600,22560,76160
12/5/2024,Sahan Kumara,Anuradhapura,Thissamaharama,North Central,5931,5675,11606,237240,227000,464240
12/6/2024,Sahan Kumara,Anuradhapura,Thissamaharama,North Central,1771,2896,4667,70840,115840,186680
12/7/2024,Sahan Kumara,Anuradhapura,Thissamaharama,North Central,4788,2523,7311,191520,100920,292440
12/8/2024,Sahan Kumara,Anuradhapura,Thissamaharama,North Central,2267,8052,10319,90680,322080,412760
12/9/2024,Sahan Kumara,Anuradhapura,Thissamaharama,North Central,7012,4329,11341,280480,173160,453640
12/10/2024,Sahan Kumara,Anuradhapura,Thissamaharama,North Central,9978,2918,12896,399120,116720,515840
12/11/2024,Sahan Kumara,Anuradhapura,Thissamaharama,North Central,7978,1326,9304,319120,53040,372160
12/12/2024,Sahan Kumara,Anuradhapura,Thissamaharama,North Central,1292,8282,9574,51680,331280,382960
12/13/2024,Sahan Kumara,Anuradhapura,Thissamaharama,North Central,9022,3104,12126,360880,124160,485040
12/14/2024,Sahan Kumara,Anuradhapura,Thissamaharama,North Central,1682,6201,7883,67280,248040,315320
12/15/2024,Sahan Kumara,Anuradhapura,Thissamaharama,North Central,8166,7209,15375,326640,288360,615000
12/16/2024,Sahan Kumara,Anuradhapura,Thissamaharama,North Central,2200,5157,7357,88000,206280,294280
12/17/2024,Sahan Kumara,Anuradhapura,Thissamaharama,North Central,8045,2439,10484,321800,97560,419360
12/18/2024,Sahan Kumara,Anuradhapura,Thissamaharama,North Central,9287,3419,12706,371480,136760,508240
12/19/2024,Sahan Kumara,Anuradhapura,Thissamaharama,North Central,4382,700,5082,175280,28000,203280
12/20/2024,Sahan Kumara,Anuradhapura,Thissamaharama,North Central,2,6239,6241,80,249560,249640
12/21/2024,Sahan Kumara,Anuradhapura,Thissamaharama,North Central,173,5053,5226,6920,202120,209040
12/22/2024,Sahan Kumara,Anuradhapura,Thissamaharama,North Central,8401,4619,13020,336040,184760,520800
12/23/2024,Sahan Kumara,Anuradhapura,Thissamaharama,North Central,4096,6245,10341,163840,249800,413640
12/24/2024,Sahan Kumara,Anuradhapura,Thissamaharama,North Central,933,8718,9651,37320,348720,386040
12/25/2024,Sahan Kumara,Anuradhapura,Thissamaharama,North Central,4426,292,4718,177040,11680,188720
12/26/2024,Sahan Kumara,Anuradhapura,Thissamaharama,North Central,632,4348,4980,25280,173920,199200
12/27/2024,Sahan Kumara,Anuradhapura,Thissamaharama,North Central,7252,1717,8969,290080,68680,358760
12/28/2024,Sahan Kumara,Anuradhapura,Thissamaharama,North Central,6769,1472,8241,270760,58880,329640
12/29/2024,Sahan Kumara,Anuradhapura,Thissamaharama,North Central,9322,5453,14775,372880,218120,591000
12/30/2024,Sahan Kumara,Anuradhapura,Thissamaharama,North Central,1906,1756,3662,76240,70240,146480
12/31/2024,Sahan Kumara,Anuradhapura,Thissamaharama,North Central,15,4198,4213,600,167920,168520
1/1/2025,Sahan Kumara,Anuradhapura,Thissamaharama,North Central,3927,1122,5049,157080,44880,201960
1/2/2025,Sahan Kumara,Anuradhapura,Thissamaharama,North Central,484,7439,7923,19360,297560,316920
1/3/2025,Sahan Kumara,Anuradhapura,Thissamaharama,North Central,9422,458,9880,376880,18320,395200
1/4/2025,Sahan Kumara,Anuradhapura,Thissamaharama,North Central,5876,6600,12476,235040,264000,499040
1/5/2025,Sahan Kumara,Anuradhapura,Thissamaharama,North Central,9384,371,9755,375360,14840,390200
1/6/2025,Sahan Kumara,Anuradhapura,Thissamaharama,North Central,9510,5988,15498,380400,239520,619920
1/7/2025,Sahan Kumara,Anuradhapura,Thissamaharama,North Central,5004,5630,10634,200160,225200,425360
1/8/2025,Sahan Kumara,Anuradhapura,Thissamaharama,North Central,8399,3752,12151,335960,150080,486040
1/9/2025,Sahan Kumara,Anuradhapura,Thissamaharama,North Central,4337,9738,14075,173480,389520,563000
1/10/2025,Sahan Kumara,Anuradhapura,Thissamaharama,North Central,3876,4428,8304,155040,177120,332160
1/11/2025,Sahan Kumara,Anuradhapura,Thissamaharama,North Central,4429,857,5286,177160,34280,211440
1/12/2025,Sahan Kumara,Anuradhapura,Thissamaharama,North Central,9462,8387,17849,378480,335480,713960
1/13/2025,Sahan Kumara,Anuradhapura,Thissamaharama,North Central,8919,7298,16217,356760,291920,648680
1/14/2025,Sahan Kumara,Anuradhapura,Thissamaharama,North Central,1769,6908,8677,70760,276320,347080
1/15/2025,Sahan Kumara,Anuradhapura,Thissamaharama,North Central,5024,720,5744,200960,28800,229760
1/16/2025,Sahan Kumara,Anuradhapura,Thissamaharama,North Central,6258,1015,7273,250320,40600,290920
1/17/2025,Sahan Kumara,Anuradhapura,Thissamaharama,North Central,1223,4443,5666,48920,177720,226640
1/18/2025,Sahan Kumara,Anuradhapura,Thissamaharama,North Central,9545,18,9563,381800,720,382520
1/19/2025,Sahan Kumara,Anuradhapura,Thissamaharama,North Central,6997,4612,11609,279880,184480,464360
1/20/2025,Sahan Kumara,Anuradhapura,Thissamaharama,North Central,305,1356,1661,12200,54240,66440
1/21/2025,Sahan Kumara,Anuradhapura,Thissamaharama,North Central,3489,1690,5179,139560,67600,207160
1/22/2025,Sahan Kumara,Anuradhapura,Thissamaharama,North Central,5357,7375,12732,214280,295000,509280
1/23/2025,Sahan Kumara,Anuradhapura,Thissamaharama,North Central,8364,5120,13484,334560,204800,539360
1/24/2025,Sahan Kumara,Anuradhapura,Thissamaharama,North Central,8,965,973,320,38600,38920
1/25/2025,Sahan Kumara,Anuradhapura,Thissamaharama,North Central,9001,3676,12677,360040,147040,507080
1/26/2025,Sahan Kumara,Anuradhapura,Thissamaharama,North Central,7088,1809,8897,283520,72360,355880
1/27/2025,Sahan Kumara,Anuradhapura,Thissamaharama,North Central,2788,7652,10440,111520,306080,417600
1/28/2025,Sahan Kumara,Anuradhapura,Thissamaharama,North Central,8981,4451,13432,359240,178040,537280
1/29/2025,Sahan Kumara,Anuradhapura,Thissamaharama,North Central,3388,9180,12568,135520,367200,502720
1/30/2025,Sahan Kumara,Anuradhapura,Thissamaharama,North Central,1115,1329,2444,44600,53160,97760
1/31/2025,Sahan Kumara,Anuradhapura,Thissamaharama,North Central,5389,6357,11746,215560,254280,469840
2/1/2025,Sahan Kumara,Anuradhapura,Thissamaharama,North Central,9712,1121,10833,388480,44840,433320
2/2/2025,Sahan Kumara,Anuradhapura,Thissamaharama,North Central,4640,7325,11965,185600,293000,478600
2/3/2025,Sahan Kumara,Anuradhapura,Thissamaharama,North Central,6650,2293,8943,266000,91720,357720
2/4/2025,Sahan Kumara,Anuradhapura,Thissamaharama,North Central,1945,3663,5608,77800,146520,224320
2/5/2025,Sahan Kumara,Anuradhapura,Thissamaharama,North Central,4224,2613,6837,168960,104520,273480
2/6/2025,Sahan Kumara,Anuradhapura,Thissamaharama,North Central,6497,1836,8333,259880,73440,333320
2/7/2025,Sahan Kumara,Anuradhapura,Thissamaharama,North Central,7329,3738,11067,293160,149520,442680
2/8/2025,Sahan Kumara,Anuradhapura,Thissamaharama,North Central,350,8611,8961,14000,344440,358440
2/9/2025,Sahan Kumara,Anuradhapura,Thissamaharama,North Central,3559,9468,13027,142360,378720,521080
2/10/2025,Sahan Kumara,Anuradhapura,Thissamaharama,North Central,8769,9367,18136,350760,374680,725440
2/11/2025,Sahan Kumara,Anuradhapura,Thissamaharama,North Central,7912,1863,9775,316480,74520,391000
2/12/2025,Sahan Kumara,Anuradhapura,Thissamaharama,North Central,3030,5811,8841,121200,232440,353640
2/13/2025,Sahan Kumara,Anuradhapura,Thissamaharama,North Central,1114,5770,6884,44560,230800,275360
2/14/2025,Sahan Kumara,Anuradhapura,Thissamaharama,North Central,2132,3412,5544,85280,136480,221760
2/15/2025,Sahan Kumara,Anuradhapura,Thissamaharama,North Central,1089,2562,3651,43560,102480,146040
2/16/2025,Sahan Kumara,Anuradhapura,Thissamaharama,North Central,3814,9099,12913,152560,363960,516520
2/17/2025,Sahan Kumara,Anuradhapura,Thissamaharama,North Central,4840,9980,14820,193600,399200,592800
2/18/2025,Sahan Kumara,Anuradhapura,Thissamaharama,North Central,9767,1961,11728,390680,78440,469120
2/19/2025,Sahan Kumara,Anuradhapura,Thissamaharama,North Central,8770,7976,16746,350800,319040,669840
2/20/2025,Sahan Kumara,Anuradhapura,Thissamaharama,North Central,1455,4881,6336,58200,195240,253440
2/21/2025,Sahan Kumara,Anuradhapura,Thissamaharama,North Central,7518,3427,10945,300720,137080,437800
2/22/2025,Sahan Kumara,Anuradhapura,Thissamaharama,North Central,3242,6284,9526,129680,251360,381040
2/23/2025,Sahan Kumara,Anuradhapura,Thissamaharama,North Central,1676,1099,2775,67040,43960,111000
2/24/2025,Sahan Kumara,Anuradhapura,Thissamaharama,North Central,3530,9676,13206,141200,387040,528240
2/25/2025,Sahan Kumara,Anuradhapura,Thissamaharama,North Central,1958,5431,7389,78320,217240,295560
2/26/2025,Sahan Kumara,Anuradhapura,Thissamaharama,North Central,1977,7482,9459,79080,299280,378360
2/27/2025,Sahan Kumara,Anuradhapura,Thissamaharama,North Central,2281,644,2925,91240,25760,117000
2/28/2025,Sahan Kumara,Anuradhapura,Thissamaharama,North Central,467,5800,6267,18680,232000,250680
3/1/2025,Sahan Kumara,Anuradhapura,Thissamaharama,North Central,6683,1973,8656,267320,78920,346240
3/2/2025,Sahan Kumara,Anuradhapura,Thissamaharama,North Central,6993,4992,11985,279720,199680,479400
3/3/2025,Sahan Kumara,Anuradhapura,Thissamaharama,North Central,6267,599,6866,250680,23960,274640
3/4/2025,Sahan Kumara,Anuradhapura,Thissamaharama,North Central,4527,6140,10667,181080,245600,426680
3/5/2025,Sahan Kumara,Anuradhapura,Thissamaharama,North Central,4591,9164,13755,183640,366560,550200
3/6/2025,Sahan Kumara,Anuradhapura,Thissamaharama,North Central,9122,1763,10885,364880,70520,435400
3/7/2025,Sahan Kumara,Anuradhapura,Thissamaharama,North Central,1662,1090,2752,66480,43600,110080
3/8/2025,Sahan Kumara,Anuradhapura,Thissamaharama,North Central,4824,4643,9467,192960,185720,378680
3/9/2025,Sahan Kumara,Anuradhapura,Thissamaharama,North Central,1383,2315,3698,55320,92600,147920
3/10/2025,Sahan Kumara,Anuradhapura,Thissamaharama,North Central,5616,3456,9072,224640,138240,362880
3/11/2025,Sahan Kumara,Anuradhapura,Thissamaharama,North Central,964,7611,8575,38560,304440,343000
3/12/2025,Sahan Kumara,Anuradhapura,Thissamaharama,North Central,1451,5519,6970,58040,220760,278800
3/13/2025,Sahan Kumara,Anuradhapura,Thissamaharama,North Central,7369,7430,14799,294760,297200,591960
3/14/2025,Sahan Kumara,Anuradhapura,Thissamaharama,North Central,4598,3734,8332,183920,149360,333280
3/15/2025,Sahan Kumara,Anuradhapura,Thissamaharama,North Central,3467,766,4233,138680,30640,169320
3/16/2025,Sahan Kumara,Anuradhapura,Thissamaharama,North Central,5270,9270,14540,210800,370800,581600
3/17/2025,Sahan Kumara,Anuradhapura,Thissamaharama,North Central,7341,4340,11681,293640,173600,467240
3/18/2025,Sahan Kumara,Anuradhapura,Thissamaharama,North Central,30,3508,3538,1200,140320,141520
3/19/2025,Sahan Kumara,Anuradhapura,Thissamaharama,North Central,6158,4395,10553,246320,175800,422120
3/20/2025,Sahan Kumara,Anuradhapura,Thissamaharama,North Central,2339,8384,10723,93560,335360,428920
3/21/2025,Sahan Kumara,Anuradhapura,Thissamaharama,North Central,2297,3016,5313,91880,120640,212520
3/22/2025,Sahan Kumara,Anuradhapura,Thissamaharama,North Central,7605,6620,14225,304200,264800,569000
3/23/2025,Sahan Kumara,Anuradhapura,Thissamaharama,North Central,2998,94,3092,119920,3760,123680
3/25/2024,Suwandika Udugama,Colombo,Sri Jayawardenepura Kotte,Western,3675,4111,7786,147000,164440,311440
3/26/2024,Suwandika Udugama,Colombo,Sri Jayawardenepura Kotte,Western,3817,7643,11460,152680,305720,458400
3/27/2024,Suwandika Udugama,Colombo,Sri Jayawardenepura Kotte,Western,8820,8976,17796,352800,359040,711840
3/28/2024,Suwandika Udugama,Colombo,Sri Jayawardenepura Kotte,Western,6793,8620,15413,271720,344800,616520
3/29/2024,Suwandika Udugama,Colombo,Sri Jayawardenepura Kotte,Western,7810,3219,11029,312400,128760,441160
3/30/2024,Suwandika Udugama,Colombo,Sri Jayawardenepura Kotte,Western,2851,4198,7049,114040,167920,281960
3/31/2024,Suwandika Udugama,Colombo,Sri Jayawardenepura Kotte,Western,4151,942,5093,166040,37680,203720
4/1/2024,Suwandika Udugama,Colombo,Sri Jayawardenepura Kotte,Western,5309,8192,13501,212360,327680,540040
4/2/2024,Suwandika Udugama,Colombo,Sri Jayawardenepura Kotte,Western,2002,9354,11356,80080,374160,454240
4/3/2024,Suwandika Udugama,Colombo,Sri Jayawardenepura Kotte,Western,6457,1417,7874,258280,56680,314960
4/4/2024,Suwandika Udugama,Colombo,Sri Jayawardenepura Kotte,Western,6510,3918,10428,260400,156720,417120
4/5/2024,Suwandika Udugama,Colombo,Sri Jayawardenepura Kotte,Western,9755,9374,19129,390200,374960,765160
4/6/2024,Suwandika Udugama,Colombo,Sri Jayawardenepura Kotte,Western,1727,8043,9770,69080,321720,390800
4/7/2024,Suwandika Udugama,Colombo,Sri Jayawardenepura Kotte,Western,9848,4286,14134,393920,171440,565360
4/8/2024,Suwandika Udugama,Colombo,Sri Jayawardenepura Kotte,Western,435,6014,6449,17400,240560,257960
4/9/2024,Suwandika Udugama,Colombo,Sri Jayawardenepura Kotte,Western,636,5272,5908,25440,210880,236320
4/10/2024,Suwandika Udugama,Colombo,Sri Jayawardenepura Kotte,Western,5178,2501,7679,207120,100040,307160
4/11/2024,Suwandika Udugama,Colombo,Sri Jayawardenepura Kotte,Western,7911,437,8348,316440,17480,333920
4/19/2024,Suwandika Udugama,Colombo,Sri Jayawardenepura Kotte,Western,6361,86,6447,254440,3440,257880
4/20/2024,Suwandika Udugama,Colombo,Sri Jayawardenepura Kotte,Western,6676,7301,13977,267040,292040,559080
4/21/2024,Suwandika Udugama,Colombo,Sri Jayawardenepura Kotte,Western,9751,5323,15074,390040,212920,602960
4/22/2024,Suwandika Udugama,Colombo,Sri Jayawardenepura Kotte,Western,1525,9354,10879,61000,374160,435160
4/23/2024,Suwandika Udugama,Colombo,Sri Jayawardenepura Kotte,Western,3871,2311,6182,154840,92440,247280
4/24/2024,Suwandika Udugama,Colombo,Sri Jayawardenepura Kotte,Western,1050,3746,4796,42000,149840,191840
4/25/2024,Suwandika Udugama,Colombo,Sri Jayawardenepura Kotte,Western,6203,4866,11069,248120,194640,442760
4/26/2024,Suwandika Udugama,Colombo,Sri Jayawardenepura Kotte,Western,9224,9558,18782,368960,382320,751280
4/27/2024,Suwandika Udugama,Colombo,Sri Jayawardenepura Kotte,Western,5137,3394,8531,205480,135760,341240
4/28/2024,Suwandika Udugama,Colombo,Sri Jayawardenepura Kotte,Western,1487,1238,2725,59480,49520,109000
4/29/2024,Suwandika Udugama,Colombo,Sri Jayawardenepura Kotte,Western,8588,8977,17565,343520,359080,702600
4/30/2024,Suwandika Udugama,Colombo,Sri Jayawardenepura Kotte,Western,2262,6947,9209,90480,277880,368360
5/1/2024,Suwandika Udugama,Colombo,Sri Jayawardenepura Kotte,Western,8088,6983,15071,323520,279320,602840
5/2/2024,Suwandika Udugama,Colombo,Sri Jayawardenepura Kotte,Western,9407,7992,17399,376280,319680,695960
5/3/2024,Suwandika Udugama,Colombo,Sri Jayawardenepura Kotte,Western,6903,998,7901,276120,39920,316040
5/4/2024,Suwandika Udugama,Colombo,Sri Jayawardenepura Kotte,Western,4383,2083,6466,175320,83320,258640
5/5/2024,Suwandika Udugama,Colombo,Sri Jayawardenepura Kotte,Western,5497,6397,11894,219880,255880,475760
5/6/2024,Suwandika Udugama,Colombo,Sri Jayawardenepura Kotte,Western,4158,9049,13207,166320,361960,528280
5/7/2024,Suwandika Udugama,Colombo,Sri Jayawardenepura Kotte,Western,1650,5898,7548,66000,235920,301920
5/8/2024,Suwandika Udugama,Colombo,Sri Jayawardenepura Kotte,Western,4483,3908,8391,179320,156320,335640
5/9/2024,Suwandika Udugama,Colombo,Sri Jayawardenepura Kotte,Western,764,4319,5083,30560,172760,203320
5/10/2024,Suwandika Udugama,Colombo,Sri Jayawardenepura Kotte,Western,6641,8962,15603,265640,358480,624120
5/11/2024,Suwandika Udugama,Colombo,Sri Jayawardenepura Kotte,Western,324,1274,1598,12960,50960,63920
5/12/2024,Suwandika Udugama,Colombo,Sri Jayawardenepura Kotte,Western,1360,8702,10062,54400,348080,402480
5/13/2024,Suwandika Udugama,Colombo,Sri Jayawardenepura Kotte,Western,4733,8259,12992,189320,330360,519680
5/14/2024,Suwandika Udugama,Colombo,Sri Jayawardenepura Kotte,Western,6414,9905,16319,256560,396200,652760
5/15/2024,Suwandika Udugama,Colombo,Sri Jayawardenepura Kotte,Western,5,6422,6427,200,256880,257080
5/16/2024,Suwandika Udugama,Colombo,Sri Jayawardenepura Kotte,Western,5522,7141,12663,220880,285640,506520
5/17/2024,Suwandika Udugama,Colombo,Sri Jayawardenepura Kotte,Western,7159,276,7435,286360,11040,297400
5/18/2024,Suwandika Udugama,Colombo,Sri Jayawardenepura Kotte,Western,7662,1354,9016,306480,54160,360640
5/19/2024,Suwandika Udugama,Colombo,Sri Jayawardenepura Kotte,Western,122,5379,5501,4880,215160,220040
5/20/2024,Suwandika Udugama,Colombo,Sri Jayawardenepura Kotte,Western,7647,8896,16543,305880,355840,661720
5/21/2024,Suwandika Udugama,Colombo,Sri Jayawardenepura Kotte,Western,7984,5387,13371,319360,215480,534840
5/22/2024,Suwandika Udugama,Colombo,Sri Jayawardenepura Kotte,Western,8123,1718,9841,324920,68720,393640
5/24/2024,Suwandika Udugama,Colombo,Sri Jayawardenepura Kotte,Western,9446,933,10379,377840,37320,415160
5/25/2024,Suwandika Udugama,Colombo,Sri Jayawardenepura Kotte,Western,2503,7082,9585,100120,283280,383400
5/26/2024,Suwandika Udugama,Colombo,Sri Jayawardenepura Kotte,Western,7072,1341,8413,282880,53640,336520
5/27/2024,Suwandika Udugama,Colombo,Sri Jayawardenepura Kotte,Western,6927,2220,9147,277080,88800,365880
5/28/2024,Suwandika Udugama,Colombo,Sri Jayawardenepura Kotte,Western,2961,9424,12385,118440,376960,495400
5/29/2024,Suwandika Udugama,Colombo,Sri Jayawardenepura Kotte,Western,2264,2537,4801,90560,101480,192040
5/30/2024,Suwandika Udugama,Colombo,Sri Jayawardenepura Kotte,Western,8990,9348,18338,359600,373920,733520
5/31/2024,Suwandika Udugama,Colombo,Sri Jayawardenepura Kotte,Western,4291,1202,5493,171640,48080,219720
6/1/2024,Suwandika Udugama,Colombo,Sri Jayawardenepura Kotte,Western,602,5382,5984,24080,215280,239360
6/2/2024,Suwandika Udugama,Colombo,Sri Jayawardenepura Kotte,Western,5188,4859,10047,207520,194360,401880
6/3/2024,Suwandika Udugama,Colombo,Sri Jayawardenepura Kotte,Western,4584,2972,7556,183360,118880,302240
6/4/2024,Suwandika Udugama,Colombo,Sri Jayawardenepura Kotte,Western,1269,3048,4317,50760,121920,172680
6/5/2024,Suwandika Udugama,Colombo,Sri Jayawardenepura Kotte,Western,4047,1895,5942,161880,75800,237680
6/6/2024,Suwandika Udugama,Colombo,Sri Jayawardenepura Kotte,Western,9407,2896,12303,376280,115840,492120
6/7/2024,Suwandika Udugama,Colombo,Sri Jayawardenepura Kotte,Western,7497,2888,10385,299880,115520,415400
6/8/2024,Suwandika Udugama,Colombo,Sri Jayawardenepura Kotte,Western,635,6007,6642,25400,240280,265680
6/9/2024,Suwandika Udugama,Colombo,Sri Jayawardenepura Kotte,Western,795,8377,9172,31800,335080,366880
6/10/2024,Suwandika Udugama,Colombo,Sri Jayawardenepura Kotte,Western,7678,9129,16807,307120,365160,672280
6/11/2024,Suwandika Udugama,Colombo,Sri Jayawardenepura Kotte,Western,5286,7397,12683,211440,295880,507320
6/12/2024,Suwandika Udugama,Colombo,Sri Jayawardenepura Kotte,Western,4252,5505,9757,170080,220200,390280
6/13/2024,Suwandika Udugama,Colombo,Sri Jayawardenepura Kotte,Western,3795,2351,6146,151800,94040,245840
6/14/2024,Suwandika Udugama,Colombo,Sri Jayawardenepura Kotte,Western,3667,805,4472,146680,32200,178880
6/15/2024,Suwandika Udugama,Colombo,Sri Jayawardenepura Kotte,Western,5149,9482,14631,205960,379280,585240
6/16/2024,Suwandika Udugama,Colombo,Sri Jayawardenepura Kotte,Western,3818,5514,9332,152720,220560,373280
6/17/2024,Suwandika Udugama,Colombo,Sri Jayawardenepura Kotte,Western,2946,3517,6463,117840,140680,258520
6/18/2024,Suwandika Udugama,Colombo,Sri Jayawardenepura Kotte,Western,9903,2761,12664,396120,110440,506560
6/19/2024,Suwandika Udugama,Colombo,Sri Jayawardenepura Kotte,Western,281,7140,7421,11240,285600,296840
6/20/2024,Suwandika Udugama,Colombo,Sri Jayawardenepura Kotte,Western,8218,6564,14782,328720,262560,591280
6/21/2024,Suwandika Udugama,Colombo,Sri Jayawardenepura Kotte,Western,1028,4220,5248,41120,168800,209920
6/22/2024,Suwandika Udugama,Colombo,Sri Jayawardenepura Kotte,Western,7253,3061,10314,290120,122440,412560
6/23/2024,Suwandika Udugama,Colombo,Sri Jayawardenepura Kotte,Western,1801,5456,7257,72040,218240,290280
6/24/2024,Suwandika Udugama,Colombo,Sri Jayawardenepura Kotte,Western,3757,9596,13353,150280,383840,534120
6/25/2024,Suwandika Udugama,Colombo,Sri Jayawardenepura Kotte,Western,5358,9866,15224,214320,394640,608960
6/26/2024,Suwandika Udugama,Colombo,Sri Jayawardenepura Kotte,Western,5467,9210,14677,218680,368400,587080
6/27/2024,Suwandika Udugama,Colombo,Sri Jayawardenepura Kotte,Western,1095,8244,9339,43800,329760,373560
6/28/2024,Suwandika Udugama,Colombo,Sri Jayawardenepura Kotte,Western,7665,1431,9096,306600,57240,363840
6/29/2024,Suwandika Udugama,Colombo,Sri Jayawardenepura Kotte,Western,6248,3808,10056,249920,152320,402240
6/30/2024,Suwandika Udugama,Colombo,Sri Jayawardenepura Kotte,Western,4325,7410,11735,173000,296400,469400
7/1/2024,Suwandika Udugama,Colombo,Sri Jayawardenepura Kotte,Western,9798,6521,16319,391920,260840,652760
7/2/2024,Suwandika Udugama,Colombo,Sri Jayawardenepura Kotte,Western,8083,4371,12454,323320,174840,498160
7/3/2024,Suwandika Udugama,Colombo,Sri Jayawardenepura Kotte,Western,1065,2230,3295,42600,89200,131800
7/4/2024,Suwandika Udugama,Colombo,Sri Jayawardenepura Kotte,Western,5354,7569,12923,214160,302760,516920
7/5/2024,Suwandika Udugama,Colombo,Sri Jayawardenepura Kotte,Western,902,1459,2361,36080,58360,94440
7/6/2024,Suwandika Udugama,Colombo,Sri Jayawardenepura Kotte,Western,64,1121,1185,2560,44840,47400
7/7/2024,Suwandika Udugama,Colombo,Sri Jayawardenepura Kotte,Western,3965,3763,7728,158600,150520,309120
7/8/2024,Suwandika Udugama,Colombo,Sri Jayawardenepura Kotte,Western,7227,2965,10192,289080,118600,407680
7/9/2024,Suwandika Udugama,Colombo,Sri Jayawardenepura Kotte,Western,7050,8877,15927,282000,355080,637080
7/10/2024,Suwandika Udugama,Colombo,Sri Jayawardenepura Kotte,Western,1022,4047,5069,40880,161880,202760
7/11/2024,Suwandika Udugama,Colombo,Sri Jayawardenepura Kotte,Western,2202,4680,6882,88080,187200,275280
7/12/2024,Suwandika Udugama,Colombo,Sri Jayawardenepura Kotte,Western,8725,5445,14170,349000,217800,566800
7/13/2024,Suwandika Udugama,Colombo,Sri Jayawardenepura Kotte,Western,982,6898,7880,39280,275920,315200
7/14/2024,Suwandika Udugama,Colombo,Sri Jayawardenepura Kotte,Western,8412,4538,12950,336480,181520,518000
7/15/2024,Suwandika Udugama,Colombo,Sri Jayawardenepura Kotte,Western,676,7738,8414,27040,309520,336560
7/16/2024,Suwandika Udugama,Colombo,Sri Jayawardenepura Kotte,Western,5608,4915,10523,224320,196600,420920
7/17/2024,Suwandika Udugama,Colombo,Sri Jayawardenepura Kotte,Western,7254,6223,13477,290160,248920,539080
7/18/2024,Suwandika Udugama,Colombo,Sri Jayawardenepura Kotte,Western,1422,97,1519,56880,3880,60760
7/19/2024,Suwandika Udugama,Colombo,Sri Jayawardenepura Kotte,Western,6190,8147,14337,247600,325880,573480
7/20/2024,Suwandika Udugama,Colombo,Sri Jayawardenepura Kotte,Western,4593,5761,10354,183720,230440,414160
7/21/2024,Suwandika Udugama,Colombo,Sri Jayawardenepura Kotte,Western,1105,5103,6208,44200,204120,248320
7/22/2024,Suwandika Udugama,Colombo,Sri Jayawardenepura Kotte,Western,3621,8209,11830,144840,328360,473200
7/23/2024,Suwandika Udugama,Colombo,Sri Jayawardenepura Kotte,Western,3292,6936,10228,131680,277440,409120
7/24/2024,Suwandika Udugama,Colombo,Sri Jayawardenepura Kotte,Western,768,9893,10661,30720,395720,426440
7/25/2024,Suwandika Udugama,Colombo,Sri Jayawardenepura Kotte,Western,8926,5841,14767,357040,233640,590680
7/26/2024,Suwandika Udugama,Colombo,Sri Jayawardenepura Kotte,Western,4327,4767,9094,173080,190680,363760
7/27/2024,Suwandika Udugama,Colombo,Sri Jayawardenepura Kotte,Western,1805,422,2227,72200,16880,89080
7/28/2024,Suwandika Udugama,Colombo,Sri Jayawardenepura Kotte,Western,1437,6847,8284,57480,273880,331360
7/29/2024,Suwandika Udugama,Colombo,Sri Jayawardenepura Kotte,Western,3527,1266,4793,141080,50640,191720
7/30/2024,Suwandika Udugama,Colombo,Sri Jayawardenepura Kotte,Western,7244,8827,16071,289760,353080,642840
7/31/2024,Suwandika Udugama,Colombo,Sri Jayawardenepura Kotte,Western,4223,8304,12527,168920,332160,501080
8/1/2024,Suwandika Udugama,Colombo,Sri Jayawardenepura Kotte,Western,3540,8921,12461,141600,356840,498440
8/2/2024,Suwandika Udugama,Colombo,Sri Jayawardenepura Kotte,Western,1501,6988,8489,60040,279520,339560
8/3/2024,Suwandika Udugama,Colombo,Sri Jayawardenepura Kotte,Western,3488,4071,7559,139520,162840,302360
8/4/2024,Suwandika Udugama,Colombo,Sri Jayawardenepura Kotte,Western,1831,9831,11662,73240,393240,466480
8/5/2024,Suwandika Udugama,Colombo,Sri Jayawardenepura Kotte,Western,4909,8065,12974,196360,322600,518960
8/6/2024,Suwandika Udugama,Colombo,Sri Jayawardenepura Kotte,Western,9211,3751,12962,368440,150040,518480
8/7/2024,Suwandika Udugama,Colombo,Sri Jayawardenepura Kotte,Western,7004,5658,12662,280160,226320,506480
8/8/2024,Suwandika Udugama,Colombo,Sri Jayawardenepura Kotte,Western,1395,7346,8741,55800,293840,349640
8/9/2024,Suwandika Udugama,Colombo,Sri Jayawardenepura Kotte,Western,8507,3276,11783,340280,131040,471320
8/10/2024,Suwandika Udugama,Colombo,Sri Jayawardenepura Kotte,Western,4000,2465,6465,160000,98600,258600
8/11/2024,Suwandika Udugama,Colombo,Sri Jayawardenepura Kotte,Western,3143,1888,5031,125720,75520,201240
8/12/2024,Suwandika Udugama,Colombo,Sri Jayawardenepura Kotte,Western,5350,8161,13511,214000,326440,540440
8/13/2024,Suwandika Udugama,Colombo,Sri Jayawardenepura Kotte,Western,4654,7330,11984,186160,293200,479360
8/14/2024,Suwandika Udugama,Colombo,Sri Jayawardenepura Kotte,Western,7163,7203,14366,286520,288120,574640
8/15/2024,Suwandika Udugama,Colombo,Sri Jayawardenepura Kotte,Western,5440,7782,13222,217600,311280,528880
8/16/2024,Suwandika Udugama,Colombo,Sri Jayawardenepura Kotte,Western,8738,92,8830,349520,3680,353200
8/17/2024,Suwandika Udugama,Colombo,Sri Jayawardenepura Kotte,Western,5115,4340,9455,204600,173600,378200
8/18/2024,Suwandika Udugama,Colombo,Sri Jayawardenepura Kotte,Western,2729,9274,12003,109160,370960,480120
8/19/2024,Suwandika Udugama,Colombo,Sri Jayawardenepura Kotte,Western,8951,868,9819,358040,34720,392760
8/20/2024,Suwandika Udugama,Colombo,Sri Jayawardenepura Kotte,Western,4354,2566,6920,174160,102640,276800
8/21/2024,Suwandika Udugama,Colombo,Sri Jayawardenepura Kotte,Western,2734,9711,12445,109360,388440,497800
8/22/2024,Suwandika Udugama,Colombo,Sri Jayawardenepura Kotte,Western,9366,4352,13718,374640,174080,548720
8/23/2024,Suwandika Udugama,Colombo,Sri Jayawardenepura Kotte,Western,313,2247,2560,12520,89880,102400
8/24/2024,Suwandika Udugama,Colombo,Sri Jayawardenepura Kotte,Western,8595,8445,17040,343800,337800,681600
8/25/2024,Suwandika Udugama,Colombo,Sri Jayawardenepura Kotte,Western,3090,2878,5968,123600,115120,238720
8/26/2024,Suwandika Udugama,Colombo,Sri Jayawardenepura Kotte,Western,1912,3276,5188,76480,131040,207520
8/27/2024,Suwandika Udugama,Colombo,Sri Jayawardenepura Kotte,Western,4966,4904,9870,198640,196160,394800
8/28/2024,Suwandika Udugama,Colombo,Sri Jayawardenepura Kotte,Western,9179,5027,14206,367160,201080,568240
8/29/2024,Suwandika Udugama,Colombo,Sri Jayawardenepura Kotte,Western,4410,6659,11069,176400,266360,442760
8/30/2024,Suwandika Udugama,Colombo,Sri Jayawardenepura Kotte,Western,8782,429,9211,351280,17160,368440
8/31/2024,Suwandika Udugama,Colombo,Sri Jayawardenepura Kotte,Western,7067,827,7894,282680,33080,315760
9/1/2024,Suwandika Udugama,Colombo,Sri Jayawardenepura Kotte,Western,9731,4586,14317,389240,183440,572680
9/2/2024,Suwandika Udugama,Colombo,Sri Jayawardenepura Kotte,Western,1793,887,2680,71720,35480,107200
9/3/2024,Suwandika Udugama,Colombo,Sri Jayawardenepura Kotte,Western,494,7975,8469,19760,319000,338760
9/4/2024,Suwandika Udugama,Colombo,Sri Jayawardenepura Kotte,Western,5466,6501,11967,218640,260040,478680
9/5/2024,Suwandika Udugama,Colombo,Sri Jayawardenepura Kotte,Western,3973,3833,7806,158920,153320,312240
9/6/2024,Suwandika Udugama,Colombo,Sri Jayawardenepura Kotte,Western,2946,2062,5008,117840,82480,200320
9/7/2024,Suwandika Udugama,Colombo,Sri Jayawardenepura Kotte,Western,5195,1132,6327,207800,45280,253080
9/8/2024,Suwandika Udugama,Colombo,Sri Jayawardenepura Kotte,Western,842,4469,5311,33680,178760,212440
9/9/2024,Suwandika Udugama,Colombo,Sri Jayawardenepura Kotte,Western,6504,3627,10131,260160,145080,405240
9/10/2024,Suwandika Udugama,Colombo,Sri Jayawardenepura Kotte,Western,5094,6107,11201,203760,244280,448040
9/11/2024,Suwandika Udugama,Colombo,Sri Jayawardenepura Kotte,Western,6391,8791,15182,255640,351640,607280
9/12/2024,Suwandika Udugama,Colombo,Sri Jayawardenepura Kotte,Western,7142,2987,10129,285680,119480,405160
9/13/2024,Suwandika Udugama,Colombo,Sri Jayawardenepura Kotte,Western,5609,7811,13420,224360,312440,536800
9/14/2024,Suwandika Udugama,Colombo,Sri Jayawardenepura Kotte,Western,8929,3291,12220,357160,131640,488800
9/15/2024,Suwandika Udugama,Colombo,Sri Jayawardenepura Kotte,Western,7988,2197,10185,319520,87880,407400
9/16/2024,Suwandika Udugama,Colombo,Sri Jayawardenepura Kotte,Western,8241,6615,14856,329640,264600,594240
9/17/2024,Suwandika Udugama,Colombo,Sri Jayawardenepura Kotte,Western,205,3147,3352,8200,125880,134080
9/18/2024,Suwandika Udugama,Colombo,Sri Jayawardenepura Kotte,Western,2631,8853,11484,105240,354120,459360
9/19/2024,Suwandika Udugama,Colombo,Sri Jayawardenepura Kotte,Western,6796,8887,15683,271840,355480,627320
9/20/2024,Suwandika Udugama,Colombo,Sri Jayawardenepura Kotte,Western,5299,2826,8125,211960,113040,325000
9/21/2024,Suwandika Udugama,Colombo,Sri Jayawardenepura Kotte,Western,9129,9629,18758,365160,385160,750320
9/22/2024,Suwandika Udugama,Colombo,Sri Jayawardenepura Kotte,Western,5868,6838,12706,234720,273520,508240
9/23/2024,Suwandika Udugama,Colombo,Sri Jayawardenepura Kotte,Western,8200,4947,13147,328000,197880,525880
9/24/2024,Suwandika Udugama,Colombo,Sri Jayawardenepura Kotte,Western,1505,6842,8347,60200,273680,333880
9/25/2024,Suwandika Udugama,Colombo,Sri Jayawardenepura Kotte,Western,644,8734,9378,25760,349360,375120
9/26/2024,Suwandika Udugama,Colombo,Sri Jayawardenepura Kotte,Western,8198,7664,15862,327920,306560,634480
9/27/2024,Suwandika Udugama,Colombo,Sri Jayawardenepura Kotte,Western,3504,3317,6821,140160,132680,272840
9/28/2024,Suwandika Udugama,Colombo,Sri Jayawardenepura Kotte,Western,9979,5430,15409,399160,217200,616360
9/29/2024,Suwandika Udugama,Colombo,Sri Jayawardenepura Kotte,Western,5327,1790,7117,213080,71600,284680
9/30/2024,Suwandika Udugama,Colombo,Sri Jayawardenepura Kotte,Western,1645,2054,3699,65800,82160,147960
10/1/2024,Suwandika Udugama,Colombo,Sri Jayawardenepura Kotte,Western,6108,7716,13824,244320,308640,552960
10/2/2024,Suwandika Udugama,Colombo,Sri Jayawardenepura Kotte,Western,2848,3173,6021,113920,126920,240840
10/3/2024,Suwandika Udugama,Colombo,Sri Jayawardenepura Kotte,Western,5654,8049,13703,226160,321960,548120
10/4/2024,Suwandika Udugama,Colombo,Sri Jayawardenepura Kotte,Western,5170,79,5249,206800,3160,209960
10/5/2024,Suwandika Udugama,Colombo,Sri Jayawardenepura Kotte,Western,6141,2707,8848,245640,108280,353920
10/6/2024,Suwandika Udugama,Colombo,Sri Jayawardenepura Kotte,Western,8062,2745,10807,322480,109800,432280
10/7/2024,Suwandika Udugama,Colombo,Sri Jayawardenepura Kotte,Western,6658,9260,15918,266320,370400,636720
10/8/2024,Suwandika Udugama,Colombo,Sri Jayawardenepura Kotte,Western,5185,9789,14974,207400,391560,598960
10/9/2024,Suwandika Udugama,Colombo,Sri Jayawardenepura Kotte,Western,8386,2595,10981,335440,103800,439240
10/10/2024,Suwandika Udugama,Colombo,Sri Jayawardenepura Kotte,Western,4615,2885,7500,184600,115400,300000
10/11/2024,Suwandika Udugama,Colombo,Sri Jayawardenepura Kotte,Western,6082,9118,15200,243280,364720,608000
10/12/2024,Suwandika Udugama,Colombo,Sri Jayawardenepura Kotte,Western,7012,1166,8178,280480,46640,327120
10/13/2024,Suwandika Udugama,Colombo,Sri Jayawardenepura Kotte,Western,4078,4216,8294,163120,168640,331760
10/14/2024,Suwandika Udugama,Colombo,Sri Jayawardenepura Kotte,Western,5552,921,6473,222080,36840,258920
10/15/2024,Suwandika Udugama,Colombo,Sri Jayawardenepura Kotte,Western,8001,9390,17391,320040,375600,695640
10/16/2024,Suwandika Udugama,Colombo,Sri Jayawardenepura Kotte,Western,5917,6041,11958,236680,241640,478320
10/17/2024,Suwandika Udugama,Colombo,Sri Jayawardenepura Kotte,Western,7151,8838,15989,286040,353520,639560
10/18/2024,Suwandika Udugama,Colombo,Sri Jayawardenepura Kotte,Western,7259,6202,13461,290360,248080,538440
10/19/2024,Suwandika Udugama,Colombo,Sri Jayawardenepura Kotte,Western,2471,8827,11298,98840,353080,451920
10/20/2024,Suwandika Udugama,Colombo,Sri Jayawardenepura Kotte,Western,2215,6424,8639,88600,256960,345560
10/21/2024,Suwandika Udugama,Colombo,Sri Jayawardenepura Kotte,Western,3899,1096,4995,155960,43840,199800
10/22/2024,Suwandika Udugama,Colombo,Sri Jayawardenepura Kotte,Western,9432,2339,11771,377280,93560,470840
10/23/2024,Suwandika Udugama,Colombo,Sri Jayawardenepura Kotte,Western,2245,9814,12059,89800,392560,482360
10/24/2024,Suwandika Udugama,Colombo,Sri Jayawardenepura Kotte,Western,1673,8550,10223,66920,342000,408920
10/25/2024,Suwandika Udugama,Colombo,Sri Jayawardenepura Kotte,Western,306,8018,8324,12240,320720,332960
10/26/2024,Suwandika Udugama,Colombo,Sri Jayawardenepura Kotte,Western,2604,3985,6589,104160,159400,263560
10/27/2024,Suwandika Udugama,Colombo,Sri Jayawardenepura Kotte,Western,536,6663,7199,21440,266520,287960
10/28/2024,Suwandika Udugama,Colombo,Sri Jayawardenepura Kotte,Western,4864,2357,7221,194560,94280,288840
10/29/2024,Suwandika Udugama,Colombo,Sri Jayawardenepura Kotte,Western,9311,7282,16593,372440,291280,663720
10/30/2024,Suwandika Udugama,Colombo,Sri Jayawardenepura Kotte,Western,5292,1387,6679,211680,55480,267160
10/31/2024,Suwandika Udugama,Colombo,Sri Jayawardenepura Kotte,Western,4607,1406,6013,184280,56240,240520
11/1/2024,Suwandika Udugama,Colombo,Sri Jayawardenepura Kotte,Western,8153,7878,16031,326120,315120,641240
11/2/2024,Suwandika Udugama,Colombo,Sri Jayawardenepura Kotte,Western,5143,4749,9892,205720,189960,395680
11/3/2024,Suwandika Udugama,Colombo,Sri Jayawardenepura Kotte,Western,620,6989,7609,24800,279560,304360
11/4/2024,Suwandika Udugama,Colombo,Sri Jayawardenepura Kotte,Western,6616,2062,8678,264640,82480,347120
11/5/2024,Suwandika Udugama,Colombo,Sri Jayawardenepura Kotte,Western,9381,4428,13809,375240,177120,552360
11/6/2024,Suwandika Udugama,Colombo,Sri Jayawardenepura Kotte,Western,7648,7436,15084,305920,297440,603360
11/7/2024,Suwandika Udugama,Colombo,Sri Jayawardenepura Kotte,Western,5361,906,6267,214440,36240,250680
11/8/2024,Suwandika Udugama,Colombo,Sri Jayawardenepura Kotte,Western,3684,804,4488,147360,32160,179520
11/9/2024,Suwandika Udugama,Colombo,Sri Jayawardenepura Kotte,Western,5105,8888,13993,204200,355520,559720
11/10/2024,Suwandika Udugama,Colombo,Sri Jayawardenepura Kotte,Western,1749,2318,4067,69960,92720,162680
11/11/2024,Suwandika Udugama,Colombo,Sri Jayawardenepura Kotte,Western,4967,9488,14455,198680,379520,578200
11/12/2024,Suwandika Udugama,Colombo,Sri Jayawardenepura Kotte,Western,6321,4216,10537,252840,168640,421480
11/13/2024,Suwandika Udugama,Colombo,Sri Jayawardenepura Kotte,Western,9758,3117,12875,390320,124680,515000
11/14/2024,Suwandika Udugama,Colombo,Sri Jayawardenepura Kotte,Western,1418,3602,5020,56720,144080,200800
11/15/2024,Suwandika Udugama,Colombo,Sri Jayawardenepura Kotte,Western,2512,9895,12407,100480,395800,496280
11/16/2024,Suwandika Udugama,Colombo,Sri Jayawardenepura Kotte,Western,7336,4409,11745,293440,176360,469800
11/17/2024,Suwandika Udugama,Colombo,Sri Jayawardenepura Kotte,Western,3951,4959,8910,158040,198360,356400
11/18/2024,Suwandika Udugama,Colombo,Sri Jayawardenepura Kotte,Western,5948,4894,10842,237920,195760,433680
11/19/2024,Suwandika Udugama,Colombo,Sri Jayawardenepura Kotte,Western,802,6031,6833,32080,241240,273320
11/20/2024,Suwandika Udugama,Colombo,Sri Jayawardenepura Kotte,Western,1740,667,2407,69600,26680,96280
11/21/2024,Suwandika Udugama,Colombo,Sri Jayawardenepura Kotte,Western,8064,1479,9543,322560,59160,381720
11/22/2024,Suwandika Udugama,Colombo,Sri Jayawardenepura Kotte,Western,3632,2889,6521,145280,115560,260840
11/23/2024,Suwandika Udugama,Colombo,Sri Jayawardenepura Kotte,Western,888,2910,3798,35520,116400,151920
11/24/2024,Suwandika Udugama,Colombo,Sri Jayawardenepura Kotte,Western,8519,5370,13889,340760,214800,555560
11/25/2024,Suwandika Udugama,Colombo,Sri Jayawardenepura Kotte,Western,3921,6924,10845,156840,276960,433800
11/26/2024,Suwandika Udugama,Colombo,Sri Jayawardenepura Kotte,Western,6811,3815,10626,272440,152600,425040
11/27/2024,Suwandika Udugama,Colombo,Sri Jayawardenepura Kotte,Western,6677,2995,9672,267080,119800,386880
11/28/2024,Suwandika Udugama,Colombo,Sri Jayawardenepura Kotte,Western,9660,1025,10685,386400,41000,427400
11/29/2024,Suwandika Udugama,Colombo,Sri Jayawardenepura Kotte,Western,4970,1381,6351,198800,55240,254040
11/30/2024,Suwandika Udugama,Colombo,Sri Jayawardenepura Kotte,Western,668,1139,1807,26720,45560,72280
12/1/2024,Suwandika Udugama,Colombo,Sri Jayawardenepura Kotte,Western,4933,8528,13461,197320,341120,538440
12/2/2024,Suwandika Udugama,Colombo,Sri Jayawardenepura Kotte,Western,6942,2259,9201,277680,90360,368040
12/3/2024,Suwandika Udugama,Colombo,Sri Jayawardenepura Kotte,Western,6673,7396,14069,266920,295840,562760
12/4/2024,Suwandika Udugama,Colombo,Sri Jayawardenepura Kotte,Western,5534,6369,11903,221360,254760,476120
12/5/2024,Suwandika Udugama,Colombo,Sri Jayawardenepura Kotte,Western,248,546,794,9920,21840,31760
12/6/2024,Suwandika Udugama,Colombo,Sri Jayawardenepura Kotte,Western,6846,7605,14451,273840,304200,578040
12/7/2024,Suwandika Udugama,Colombo,Sri Jayawardenepura Kotte,Western,5447,6005,11452,217880,240200,458080
12/8/2024,Suwandika Udugama,Colombo,Sri Jayawardenepura Kotte,Western,9383,4529,13912,375320,181160,556480
12/9/2024,Suwandika Udugama,Colombo,Sri Jayawardenepura Kotte,Western,387,3450,3837,15480,138000,153480
12/10/2024,Suwandika Udugama,Colombo,Sri Jayawardenepura Kotte,Western,5739,6059,11798,229560,242360,471920
12/11/2024,Suwandika Udugama,Colombo,Sri Jayawardenepura Kotte,Western,6625,4804,11429,265000,192160,457160
12/12/2024,Suwandika Udugama,Colombo,Sri Jayawardenepura Kotte,Western,850,7036,7886,34000,281440,315440
12/13/2024,Suwandika Udugama,Colombo,Sri Jayawardenepura Kotte,Western,1498,7953,9451,59920,318120,378040
12/14/2024,Suwandika Udugama,Colombo,Sri Jayawardenepura Kotte,Western,6098,8861,14959,243920,354440,598360
12/15/2024,Suwandika Udugama,Colombo,Sri Jayawardenepura Kotte,Western,9098,9607,18705,363920,384280,748200
12/16/2024,Suwandika Udugama,Colombo,Sri Jayawardenepura Kotte,Western,440,4483,4923,17600,179320,196920
12/17/2024,Suwandika Udugama,Colombo,Sri Jayawardenepura Kotte,Western,6252,7219,13471,250080,288760,538840
12/18/2024,Suwandika Udugama,Colombo,Sri Jayawardenepura Kotte,Western,3075,3419,6494,123000,136760,259760
12/19/2024,Suwandika Udugama,Colombo,Sri Jayawardenepura Kotte,Western,8045,6142,14187,321800,245680,567480
12/20/2024,Suwandika Udugama,Colombo,Sri Jayawardenepura Kotte,Western,2540,2554,5094,101600,102160,203760
12/21/2024,Suwandika Udugama,Colombo,Sri Jayawardenepura Kotte,Western,6185,5635,11820,247400,225400,472800
12/22/2024,Suwandika Udugama,Colombo,Sri Jayawardenepura Kotte,Western,8540,7144,15684,341600,285760,627360
12/23/2024,Suwandika Udugama,Colombo,Sri Jayawardenepura Kotte,Western,8380,4205,12585,335200,168200,503400
12/24/2024,Suwandika Udugama,Colombo,Sri Jayawardenepura Kotte,Western,88,6241,6329,3520,249640,253160
12/25/2024,Suwandika Udugama,Colombo,Sri Jayawardenepura Kotte,Western,6722,2399,9121,268880,95960,364840
12/26/2024,Suwandika Udugama,Colombo,Sri Jayawardenepura Kotte,Western,4190,7847,12037,167600,313880,481480
12/27/2024,Suwandika Udugama,Colombo,Sri Jayawardenepura Kotte,Western,9816,8421,18237,392640,336840,729480
12/28/2024,Suwandika Udugama,Colombo,Sri Jayawardenepura Kotte,Western,929,2834,3763,37160,113360,150520
12/29/2024,Suwandika Udugama,Colombo,Sri Jayawardenepura Kotte,Western,6821,2062,8883,272840,82480,355320
12/30/2024,Suwandika Udugama,Colombo,Sri Jayawardenepura Kotte,Western,2436,4467,6903,97440,178680,276120
12/31/2024,Suwandika Udugama,Colombo,Sri Jayawardenepura Kotte,Western,7406,507,7913,296240,20280,316520
1/1/2025,Suwandika Udugama,Colombo,Sri Jayawardenepura Kotte,Western,5067,4707,9774,202680,188280,390960
1/2/2025,Suwandika Udugama,Colombo,Sri Jayawardenepura Kotte,Western,4137,9709,13846,165480,388360,553840
1/3/2025,Suwandika Udugama,Colombo,Sri Jayawardenepura Kotte,Western,8949,7109,16058,357960,284360,642320
1/4/2025,Suwandika Udugama,Colombo,Sri Jayawardenepura Kotte,Western,4779,129,4908,191160,5160,196320
1/5/2025,Suwandika Udugama,Colombo,Sri Jayawardenepura Kotte,Western,9012,6441,15453,360480,257640,618120
1/6/2025,Suwandika Udugama,Colombo,Sri Jayawardenepura Kotte,Western,1460,3432,4892,58400,137280,195680
1/7/2025,Suwandika Udugama,Colombo,Sri Jayawardenepura Kotte,Western,4522,8729,13251,180880,349160,530040
1/8/2025,Suwandika Udugama,Colombo,Sri Jayawardenepura Kotte,Western,1524,1967,3491,60960,78680,139640
1/9/2025,Suwandika Udugama,Colombo,Sri Jayawardenepura Kotte,Western,6674,4160,10834,266960,166400,433360
1/10/2025,Suwandika Udugama,Colombo,Sri Jayawardenepura Kotte,Western,6914,9743,16657,276560,389720,666280
1/11/2025,Suwandika Udugama,Colombo,Sri Jayawardenepura Kotte,Western,9427,362,9789,377080,14480,391560
1/12/2025,Suwandika Udugama,Colombo,Sri Jayawardenepura Kotte,Western,3877,2530,6407,155080,101200,256280
1/13/2025,Suwandika Udugama,Colombo,Sri Jayawardenepura Kotte,Western,1558,2398,3956,62320,95920,158240
1/14/2025,Suwandika Udugama,Colombo,Sri Jayawardenepura Kotte,Western,1914,412,2326,76560,16480,93040
1/15/2025,Suwandika Udugama,Colombo,Sri Jayawardenepura Kotte,Western,4363,2587,6950,174520,103480,278000
1/16/2025,Suwandika Udugama,Colombo,Sri Jayawardenepura Kotte,Western,6342,2977,9319,253680,119080,372760
1/17/2025,Suwandika Udugama,Colombo,Sri Jayawardenepura Kotte,Western,7586,9374,16960,303440,374960,678400
1/18/2025,Suwandika Udugama,Colombo,Sri Jayawardenepura Kotte,Western,8149,4693,12842,325960,187720,513680
1/19/2025,Suwandika Udugama,Colombo,Sri Jayawardenepura Kotte,Western,2084,9452,11536,83360,378080,461440
1/20/2025,Suwandika Udugama,Colombo,Sri Jayawardenepura Kotte,Western,2971,4324,7295,118840,172960,291800
1/21/2025,Suwandika Udugama,Colombo,Sri Jayawardenepura Kotte,Western,1384,8628,10012,55360,345120,400480
1/22/2025,Suwandika Udugama,Colombo,Sri Jayawardenepura Kotte,Western,5973,7722,13695,238920,308880,547800
1/23/2025,Suwandika Udugama,Colombo,Sri Jayawardenepura Kotte,Western,1637,4232,5869,65480,169280,234760
1/24/2025,Suwandika Udugama,Colombo,Sri Jayawardenepura Kotte,Western,3133,8766,11899,125320,350640,475960
1/25/2025,Suwandika Udugama,Colombo,Sri Jayawardenepura Kotte,Western,4370,7323,11693,174800,292920,467720
1/26/2025,Suwandika Udugama,Colombo,Sri Jayawardenepura Kotte,Western,5628,1265,6893,225120,50600,275720
1/27/2025,Suwandika Udugama,Colombo,Sri Jayawardenepura Kotte,Western,9379,5314,14693,375160,212560,587720
1/28/2025,Suwandika Udugama,Colombo,Sri Jayawardenepura Kotte,Western,7412,8639,16051,296480,345560,642040
1/29/2025,Suwandika Udugama,Colombo,Sri Jayawardenepura Kotte,Western,4600,5397,9997,184000,215880,399880
1/30/2025,Suwandika Udugama,Colombo,Sri Jayawardenepura Kotte,Western,4437,9841,14278,177480,393640,571120
1/31/2025,Suwandika Udugama,Colombo,Sri Jayawardenepura Kotte,Western,6505,1546,8051,260200,61840,322040
2/1/2025,Suwandika Udugama,Colombo,Sri Jayawardenepura Kotte,Western,9952,4175,14127,398080,167000,565080
2/2/2025,Suwandika Udugama,Colombo,Sri Jayawardenepura Kotte,Western,5898,8757,14655,235920,350280,586200
2/3/2025,Suwandika Udugama,Colombo,Sri Jayawardenepura Kotte,Western,1633,899,2532,65320,35960,101280
2/4/2025,Suwandika Udugama,Colombo,Sri Jayawardenepura Kotte,Western,6106,4946,11052,244240,197840,442080
2/5/2025,Suwandika Udugama,Colombo,Sri Jayawardenepura Kotte,Western,3553,4688,8241,142120,187520,329640
2/6/2025,Suwandika Udugama,Colombo,Sri Jayawardenepura Kotte,Western,802,5910,6712,32080,236400,268480
2/7/2025,Suwandika Udugama,Colombo,Sri Jayawardenepura Kotte,Western,8965,5967,14932,358600,238680,597280
2/8/2025,Suwandika Udugama,Colombo,Sri Jayawardenepura Kotte,Western,8926,1879,10805,357040,75160,432200
2/9/2025,Suwandika Udugama,Colombo,Sri Jayawardenepura Kotte,Western,1055,5007,6062,42200,200280,242480
2/10/2025,Suwandika Udugama,Colombo,Sri Jayawardenepura Kotte,Western,2731,5697,8428,109240,227880,337120
2/11/2025,Suwandika Udugama,Colombo,Sri Jayawardenepura Kotte,Western,9761,4012,13773,390440,160480,550920
2/12/2025,Suwandika Udugama,Colombo,Sri Jayawardenepura Kotte,Western,5786,301,6087,231440,12040,243480
2/13/2025,Suwandika Udugama,Colombo,Sri Jayawardenepura Kotte,Western,1196,5475,6671,47840,219000,266840
2/14/2025,Suwandika Udugama,Colombo,Sri Jayawardenepura Kotte,Western,2039,9721,11760,81560,388840,470400
2/15/2025,Suwandika Udugama,Colombo,Sri Jayawardenepura Kotte,Western,2772,8361,11133,110880,334440,445320
2/16/2025,Suwandika Udugama,Colombo,Sri Jayawardenepura Kotte,Western,8433,3512,11945,337320,140480,477800
2/17/2025,Suwandika Udugama,Colombo,Sri Jayawardenepura Kotte,Western,2609,5036,7645,104360,201440,305800
2/18/2025,Suwandika Udugama,Colombo,Sri Jayawardenepura Kotte,Western,4707,7747,12454,188280,309880,498160
2/19/2025,Suwandika Udugama,Colombo,Sri Jayawardenepura Kotte,Western,1231,7050,8281,49240,282000,331240
2/20/2025,Suwandika Udugama,Colombo,Sri Jayawardenepura Kotte,Western,5388,6991,12379,215520,279640,495160
2/21/2025,Suwandika Udugama,Colombo,Sri Jayawardenepura Kotte,Western,4794,4180,8974,191760,167200,358960
2/22/2025,Suwandika Udugama,Colombo,Sri Jayawardenepura Kotte,Western,1036,5396,6432,41440,215840,257280
2/23/2025,Suwandika Udugama,Colombo,Sri Jayawardenepura Kotte,Western,8669,1910,10579,346760,76400,423160
2/24/2025,Suwandika Udugama,Colombo,Sri Jayawardenepura Kotte,Western,5753,6034,11787,230120,241360,471480
2/25/2025,Suwandika Udugama,Colombo,Sri Jayawardenepura Kotte,Western,9129,8874,18003,365160,354960,720120
2/26/2025,Suwandika Udugama,Colombo,Sri Jayawardenepura Kotte,Western,3658,3042,6700,146320,121680,268000
2/27/2025,Suwandika Udugama,Colombo,Sri Jayawardenepura Kotte,Western,5300,7710,13010,212000,308400,520400
2/28/2025,Suwandika Udugama,Colombo,Sri Jayawardenepura Kotte,Western,9930,7821,17751,397200,312840,710040
3/1/2025,Suwandika Udugama,Colombo,Sri Jayawardenepura Kotte,Western,4354,3769,8123,174160,150760,324920
3/2/2025,Suwandika Udugama,Colombo,Sri Jayawardenepura Kotte,Western,6278,5714,11992,251120,228560,479680
3/3/2025,Suwandika Udugama,Colombo,Sri Jayawardenepura Kotte,Western,5099,7594,12693,203960,303760,507720
3/4/2025,Suwandika Udugama,Colombo,Sri Jayawardenepura Kotte,Western,7887,8810,16697,315480,352400,667880
3/5/2025,Suwandika Udugama,Colombo,Sri Jayawardenepura Kotte,Western,2961,3117,6078,118440,124680,243120
3/6/2025,Suwandika Udugama,Colombo,Sri Jayawardenepura Kotte,Western,3299,6038,9337,131960,241520,373480
3/7/2025,Suwandika Udugama,Colombo,Sri Jayawardenepura Kotte,Western,8397,3062,11459,335880,122480,458360
3/8/2025,Suwandika Udugama,Colombo,Sri Jayawardenepura Kotte,Western,1576,4373,5949,63040,174920,237960
3/9/2025,Suwandika Udugama,Colombo,Sri Jayawardenepura Kotte,Western,3458,1336,4794,138320,53440,191760
3/10/2025,Suwandika Udugama,Colombo,Sri Jayawardenepura Kotte,Western,6424,8789,15213,256960,351560,608520
3/11/2025,Suwandika Udugama,Colombo,Sri Jayawardenepura Kotte,Western,683,4325,5008,27320,173000,200320
3/12/2025,Suwandika Udugama,Colombo,Sri Jayawardenepura Kotte,Western,4361,5667,10028,174440,226680,401120
3/13/2025,Suwandika Udugama,Colombo,Sri Jayawardenepura Kotte,Western,4135,1867,6002,165400,74680,240080
3/14/2025,Suwandika Udugama,Colombo,Sri Jayawardenepura Kotte,Western,5715,8378,14093,228600,335120,563720
3/15/2025,Suwandika Udugama,Colombo,Sri Jayawardenepura Kotte,Western,8211,497,8708,328440,19880,348320
3/16/2025,Suwandika Udugama,Colombo,Sri Jayawardenepura Kotte,Western,2807,6194,9001,112280,247760,360040
3/17/2025,Suwandika Udugama,Colombo,Sri Jayawardenepura Kotte,Western,7493,7761,15254,299720,310440,610160
3/18/2025,Suwandika Udugama,Colombo,Sri Jayawardenepura Kotte,Western,8498,3761,12259,339920,150440,490360
3/19/2025,Suwandika Udugama,Colombo,Sri Jayawardenepura Kotte,Western,3163,6826,9989,126520,273040,399560
3/20/2025,Suwandika Udugama,Colombo,Sri Jayawardenepura Kotte,Western,7742,5135,12877,309680,205400,515080
3/21/2025,Suwandika Udugama,Colombo,Sri Jayawardenepura Kotte,Western,4541,7976,12517,181640,319040,500680
3/22/2025,Suwandika Udugama,Colombo,Sri Jayawardenepura Kotte,Western,4634,2652,7286,185360,106080,291440
3/23/2025,Suwandika Udugama,Colombo,Sri Jayawardenepura Kotte,Western,5664,2760,8424,226560,110400,336960
3/25/2024,Vihanga Maduranga,Moneragala,Moneragala,Uva,6645,3173,9818,265800,126920,392720
3/26/2024,Vihanga Maduranga,Moneragala,Moneragala,Uva,4700,8003,12703,188000,320120,508120
3/27/2024,Vihanga Maduranga,Moneragala,Moneragala,Uva,7005,6678,13683,280200,267120,547320
3/28/2024,Vihanga Maduranga,Moneragala,Moneragala,Uva,3257,5901,9158,130280,236040,366320
3/29/2024,Vihanga Maduranga,Moneragala,Moneragala,Uva,130,2223,2353,5200,88920,94120
3/30/2024,Vihanga Maduranga,Moneragala,Moneragala,Uva,339,3538,3877,13560,141520,155080
3/31/2024,Vihanga Maduranga,Moneragala,Moneragala,Uva,5382,2658,8040,215280,106320,321600
4/1/2024,Vihanga Maduranga,Moneragala,Moneragala,Uva,8872,8156,17028,354880,326240,681120
4/2/2024,Vihanga Maduranga,Moneragala,Moneragala,Uva,8207,7429,15636,328280,297160,625440
4/3/2024,Vihanga Maduranga,Moneragala,Moneragala,Uva,7969,6681,14650,318760,267240,586000
4/4/2024,Vihanga Maduranga,Moneragala,Moneragala,Uva,947,8660,9607,37880,346400,384280
4/5/2024,Vihanga Maduranga,Moneragala,Moneragala,Uva,7051,4627,11678,282040,185080,467120
4/6/2024,Vihanga Maduranga,Moneragala,Moneragala,Uva,589,5594,6183,23560,223760,247320
4/7/2024,Vihanga Maduranga,Moneragala,Moneragala,Uva,2250,7577,9827,90000,303080,393080
4/8/2024,Vihanga Maduranga,Moneragala,Moneragala,Uva,4924,9902,14826,196960,396080,593040
4/9/2024,Vihanga Maduranga,Moneragala,Moneragala,Uva,9836,5389,15225,393440,215560,609000
4/10/2024,Vihanga Maduranga,Moneragala,Moneragala,Uva,6551,7157,13708,262040,286280,548320
4/11/2024,Vihanga Maduranga,Moneragala,Moneragala,Uva,3790,6629,10419,151600,265160,416760
4/19/2024,Vihanga Maduranga,Moneragala,Moneragala,Uva,697,3461,4158,27880,138440,166320
4/20/2024,Vihanga Maduranga,Moneragala,Moneragala,Uva,7836,6218,14054,313440,248720,562160
4/21/2024,Vihanga Maduranga,Moneragala,Moneragala,Uva,2573,9807,12380,102920,392280,495200
4/22/2024,Vihanga Maduranga,Moneragala,Moneragala,Uva,515,4598,5113,20600,183920,204520
4/23/2024,Vihanga Maduranga,Moneragala,Moneragala,Uva,1754,4809,6563,70160,192360,262520
4/24/2024,Vihanga Maduranga,Moneragala,Moneragala,Uva,3511,7785,11296,140440,311400,451840
4/25/2024,Vihanga Maduranga,Moneragala,Moneragala,Uva,9389,5237,14626,375560,209480,585040
4/26/2024,Vihanga Maduranga,Moneragala,Moneragala,Uva,8376,8320,16696,335040,332800,667840
4/27/2024,Vihanga Maduranga,Moneragala,Moneragala,Uva,4610,4051,8661,184400,162040,346440
4/28/2024,Vihanga Maduranga,Moneragala,Moneragala,Uva,3098,1045,4143,123920,41800,165720
4/29/2024,Vihanga Maduranga,Moneragala,Moneragala,Uva,3462,5713,9175,138480,228520,367000
4/30/2024,Vihanga Maduranga,Moneragala,Moneragala,Uva,2920,5310,8230,116800,212400,329200
5/1/2024,Vihanga Maduranga,Moneragala,Moneragala,Uva,9748,8568,18316,389920,342720,732640
5/2/2024,Vihanga Maduranga,Moneragala,Moneragala,Uva,2329,2312,4641,93160,92480,185640
5/3/2024,Vihanga Maduranga,Moneragala,Moneragala,Uva,1857,4829,6686,74280,193160,267440
5/4/2024,Vihanga Maduranga,Moneragala,Moneragala,Uva,5450,779,6229,218000,31160,249160
5/5/2024,Vihanga Maduranga,Moneragala,Moneragala,Uva,9435,2070,11505,377400,82800,460200
5/6/2024,Vihanga Maduranga,Moneragala,Moneragala,Uva,955,3088,4043,38200,123520,161720
5/7/2024,Vihanga Maduranga,Moneragala,Moneragala,Uva,6851,5666,12517,274040,226640,500680
5/8/2024,Vihanga Maduranga,Moneragala,Moneragala,Uva,2997,4796,7793,119880,191840,311720
5/9/2024,Vihanga Maduranga,Moneragala,Moneragala,Uva,222,4711,4933,8880,188440,197320
5/10/2024,Vihanga Maduranga,Moneragala,Moneragala,Uva,9632,1863,11495,385280,74520,459800
5/11/2024,Vihanga Maduranga,Moneragala,Moneragala,Uva,6371,3889,10260,254840,155560,410400
5/12/2024,Vihanga Maduranga,Moneragala,Moneragala,Uva,8004,4784,12788,320160,191360,511520
5/13/2024,Vihanga Maduranga,Moneragala,Moneragala,Uva,5669,5399,11068,226760,215960,442720
5/14/2024,Vihanga Maduranga,Moneragala,Moneragala,Uva,3523,6966,10489,140920,278640,419560
5/15/2024,Vihanga Maduranga,Moneragala,Moneragala,Uva,5261,8297,13558,210440,331880,542320
5/16/2024,Vihanga Maduranga,Moneragala,Moneragala,Uva,8809,7193,16002,352360,287720,640080
5/17/2024,Vihanga Maduranga,Moneragala,Moneragala,Uva,9785,449,10234,391400,17960,409360
5/18/2024,Vihanga Maduranga,Moneragala,Moneragala,Uva,704,470,1174,28160,18800,46960
5/19/2024,Vihanga Maduranga,Moneragala,Moneragala,Uva,1913,2719,4632,76520,108760,185280
5/20/2024,Vihanga Maduranga,Moneragala,Moneragala,Uva,2191,1962,4153,87640,78480,166120
5/21/2024,Vihanga Maduranga,Moneragala,Moneragala,Uva,4321,7276,11597,172840,291040,463880
5/22/2024,Vihanga Maduranga,Moneragala,Moneragala,Uva,4289,9046,13335,171560,361840,533400
5/24/2024,Vihanga Maduranga,Moneragala,Moneragala,Uva,3380,2075,5455,135200,83000,218200
5/25/2024,Vihanga Maduranga,Moneragala,Moneragala,Uva,7013,8263,15276,280520,330520,611040
5/26/2024,Vihanga Maduranga,Moneragala,Moneragala,Uva,372,6680,7052,14880,267200,282080
5/27/2024,Vihanga Maduranga,Moneragala,Moneragala,Uva,4036,9289,13325,161440,371560,533000
5/28/2024,Vihanga Maduranga,Moneragala,Moneragala,Uva,3463,5269,8732,138520,210760,349280
5/29/2024,Vihanga Maduranga,Moneragala,Moneragala,Uva,6573,7027,13600,262920,281080,544000
5/30/2024,Vihanga Maduranga,Moneragala,Moneragala,Uva,4216,672,4888,168640,26880,195520
5/31/2024,Vihanga Maduranga,Moneragala,Moneragala,Uva,6295,4465,10760,251800,178600,430400
6/1/2024,Vihanga Maduranga,Moneragala,Moneragala,Uva,5469,6618,12087,218760,264720,483480
6/2/2024,Vihanga Maduranga,Moneragala,Moneragala,Uva,7561,3736,11297,302440,149440,451880
6/3/2024,Vihanga Maduranga,Moneragala,Moneragala,Uva,1359,1883,3242,54360,75320,129680
6/4/2024,Vihanga Maduranga,Moneragala,Moneragala,Uva,1902,3744,5646,76080,149760,225840
6/5/2024,Vihanga Maduranga,Moneragala,Moneragala,Uva,5736,1913,7649,229440,76520,305960
6/6/2024,Vihanga Maduranga,Moneragala,Moneragala,Uva,6419,769,7188,256760,30760,287520
6/7/2024,Vihanga Maduranga,Moneragala,Moneragala,Uva,7981,8861,16842,319240,354440,673680
6/8/2024,Vihanga Maduranga,Moneragala,Moneragala,Uva,2479,6492,8971,99160,259680,358840
6/9/2024,Vihanga Maduranga,Moneragala,Moneragala,Uva,2271,7899,10170,90840,315960,406800
6/10/2024,Vihanga Maduranga,Moneragala,Moneragala,Uva,2860,8780,11640,114400,351200,465600
6/11/2024,Vihanga Maduranga,Moneragala,Moneragala,Uva,7457,5982,13439,298280,239280,537560
6/12/2024,Vihanga Maduranga,Moneragala,Moneragala,Uva,9915,9958,19873,396600,398320,794920
6/13/2024,Vihanga Maduranga,Moneragala,Moneragala,Uva,345,6472,6817,13800,258880,272680
6/14/2024,Vihanga Maduranga,Moneragala,Moneragala,Uva,6756,9791,16547,270240,391640,661880
6/15/2024,Vihanga Maduranga,Moneragala,Moneragala,Uva,9883,8094,17977,395320,323760,719080
6/16/2024,Vihanga Maduranga,Moneragala,Moneragala,Uva,2015,7975,9990,80600,319000,399600
6/17/2024,Vihanga Maduranga,Moneragala,Moneragala,Uva,7108,4527,11635,284320,181080,465400
6/18/2024,Vihanga Maduranga,Moneragala,Moneragala,Uva,5185,8156,13341,207400,326240,533640
6/19/2024,Vihanga Maduranga,Moneragala,Moneragala,Uva,4193,4274,8467,167720,170960,338680
6/20/2024,Vihanga Maduranga,Moneragala,Moneragala,Uva,8554,3339,11893,342160,133560,475720
6/21/2024,Vihanga Maduranga,Moneragala,Moneragala,Uva,1998,9729,11727,79920,389160,469080
6/22/2024,Vihanga Maduranga,Moneragala,Moneragala,Uva,132,4663,4795,5280,186520,191800
6/23/2024,Vihanga Maduranga,Moneragala,Moneragala,Uva,8368,2404,10772,334720,96160,430880
6/24/2024,Vihanga Maduranga,Moneragala,Moneragala,Uva,9136,9999,19135,365440,399960,765400
6/25/2024,Vihanga Maduranga,Moneragala,Moneragala,Uva,2850,4418,7268,114000,176720,290720
6/26/2024,Vihanga Maduranga,Moneragala,Moneragala,Uva,6935,4060,10995,277400,162400,439800
6/27/2024,Vihanga Maduranga,Moneragala,Moneragala,Uva,2249,6414,8663,89960,256560,346520
6/28/2024,Vihanga Maduranga,Moneragala,Moneragala,Uva,9232,2744,11976,369280,109760,479040
6/29/2024,Vihanga Maduranga,Moneragala,Moneragala,Uva,8269,59,8328,330760,2360,333120
6/30/2024,Vihanga Maduranga,Moneragala,Moneragala,Uva,9322,3989,13311,372880,159560,532440
7/1/2024,Vihanga Maduranga,Moneragala,Moneragala,Uva,8243,8483,16726,329720,339320,669040
7/2/2024,Vihanga Maduranga,Moneragala,Moneragala,Uva,3053,4162,7215,122120,166480,288600
7/3/2024,Vihanga Maduranga,Moneragala,Moneragala,Uva,3380,8004,11384,135200,320160,455360
7/4/2024,Vihanga Maduranga,Moneragala,Moneragala,Uva,3021,5103,8124,120840,204120,324960
7/5/2024,Vihanga Maduranga,Moneragala,Moneragala,Uva,9305,7122,16427,372200,284880,657080
7/6/2024,Vihanga Maduranga,Moneragala,Moneragala,Uva,5139,8862,14001,205560,354480,560040
7/7/2024,Vihanga Maduranga,Moneragala,Moneragala,Uva,1424,2411,3835,56960,96440,153400
7/8/2024,Vihanga Maduranga,Moneragala,Moneragala,Uva,3233,7883,11116,129320,315320,444640
7/9/2024,Vihanga Maduranga,Moneragala,Moneragala,Uva,4281,2007,6288,171240,80280,251520
7/10/2024,Vihanga Maduranga,Moneragala,Moneragala,Uva,4809,6521,11330,192360,260840,453200
7/11/2024,Vihanga Maduranga,Moneragala,Moneragala,Uva,410,1914,2324,16400,76560,92960
7/12/2024,Vihanga Maduranga,Moneragala,Moneragala,Uva,9799,8157,17956,391960,326280,718240
7/13/2024,Vihanga Maduranga,Moneragala,Moneragala,Uva,4245,6352,10597,169800,254080,423880
7/14/2024,Vihanga Maduranga,Moneragala,Moneragala,Uva,861,1048,1909,34440,41920,76360
7/15/2024,Vihanga Maduranga,Moneragala,Moneragala,Uva,7226,9195,16421,289040,367800,656840
7/16/2024,Vihanga Maduranga,Moneragala,Moneragala,Uva,6955,1500,8455,278200,60000,338200
7/17/2024,Vihanga Maduranga,Moneragala,Moneragala,Uva,6428,4947,11375,257120,197880,455000
7/18/2024,Vihanga Maduranga,Moneragala,Moneragala,Uva,3735,1254,4989,149400,50160,199560
7/19/2024,Vihanga Maduranga,Moneragala,Moneragala,Uva,5383,1693,7076,215320,67720,283040
7/20/2024,Vihanga Maduranga,Moneragala,Moneragala,Uva,4138,4171,8309,165520,166840,332360
7/21/2024,Vihanga Maduranga,Moneragala,Moneragala,Uva,188,2721,2909,7520,108840,116360
7/22/2024,Vihanga Maduranga,Moneragala,Moneragala,Uva,6045,169,6214,241800,6760,248560
7/23/2024,Vihanga Maduranga,Moneragala,Moneragala,Uva,9275,1685,10960,371000,67400,438400
7/24/2024,Vihanga Maduranga,Moneragala,Moneragala,Uva,1425,2432,3857,57000,97280,154280
7/25/2024,Vihanga Maduranga,Moneragala,Moneragala,Uva,6442,2370,8812,257680,94800,352480
7/26/2024,Vihanga Maduranga,Moneragala,Moneragala,Uva,2660,3961,6621,106400,158440,264840
7/27/2024,Vihanga Maduranga,Moneragala,Moneragala,Uva,3035,4778,7813,121400,191120,312520
7/28/2024,Vihanga Maduranga,Moneragala,Moneragala,Uva,3013,5428,8441,120520,217120,337640
7/29/2024,Vihanga Maduranga,Moneragala,Moneragala,Uva,2368,9040,11408,94720,361600,456320
7/30/2024,Vihanga Maduranga,Moneragala,Moneragala,Uva,1313,9137,10450,52520,365480,418000
7/31/2024,Vihanga Maduranga,Moneragala,Moneragala,Uva,2049,5954,8003,81960,238160,320120
8/1/2024,Vihanga Maduranga,Moneragala,Moneragala,Uva,4722,9354,14076,188880,374160,563040
8/2/2024,Vihanga Maduranga,Moneragala,Moneragala,Uva,2224,3175,5399,88960,127000,215960
8/3/2024,Vihanga Maduranga,Moneragala,Moneragala,Uva,1113,7460,8573,44520,298400,342920
8/4/2024,Vihanga Maduranga,Moneragala,Moneragala,Uva,9445,5432,14877,377800,217280,595080
8/5/2024,Vihanga Maduranga,Moneragala,Moneragala,Uva,492,8174,8666,19680,326960,346640
8/6/2024,Vihanga Maduranga,Moneragala,Moneragala,Uva,5066,2454,7520,202640,98160,300800
8/7/2024,Vihanga Maduranga,Moneragala,Moneragala,Uva,3537,4172,7709,141480,166880,308360
8/8/2024,Vihanga Maduranga,Moneragala,Moneragala,Uva,3036,3723,6759,121440,148920,270360
8/9/2024,Vihanga Maduranga,Moneragala,Moneragala,Uva,3125,3020,6145,125000,120800,245800
8/10/2024,Vihanga Maduranga,Moneragala,Moneragala,Uva,6261,7874,14135,250440,314960,565400
8/11/2024,Vihanga Maduranga,Moneragala,Moneragala,Uva,3313,4593,7906,132520,183720,316240
8/12/2024,Vihanga Maduranga,Moneragala,Moneragala,Uva,7674,7782,15456,306960,311280,618240
8/13/2024,Vihanga Maduranga,Moneragala,Moneragala,Uva,7577,1074,8651,303080,42960,346040
8/14/2024,Vihanga Maduranga,Moneragala,Moneragala,Uva,8792,5316,14108,351680,212640,564320
8/15/2024,Vihanga Maduranga,Moneragala,Moneragala,Uva,1255,4983,6238,50200,199320,249520
8/16/2024,Vihanga Maduranga,Moneragala,Moneragala,Uva,3474,3361,6835,138960,134440,273400
8/17/2024,Vihanga Maduranga,Moneragala,Moneragala,Uva,5027,5189,10216,201080,207560,408640
8/18/2024,Vihanga Maduranga,Moneragala,Moneragala,Uva,8310,307,8617,332400,12280,344680
8/19/2024,Vihanga Maduranga,Moneragala,Moneragala,Uva,9624,34,9658,384960,1360,386320
8/20/2024,Vihanga Maduranga,Moneragala,Moneragala,Uva,4646,9493,14139,185840,379720,565560
8/21/2024,Vihanga Maduranga,Moneragala,Moneragala,Uva,3842,8139,11981,153680,325560,479240
8/22/2024,Vihanga Maduranga,Moneragala,Moneragala,Uva,5172,7037,12209,206880,281480,488360
8/23/2024,Vihanga Maduranga,Moneragala,Moneragala,Uva,4103,9411,13514,164120,376440,540560
8/24/2024,Vihanga Maduranga,Moneragala,Moneragala,Uva,149,5443,5592,5960,217720,223680
8/25/2024,Vihanga Maduranga,Moneragala,Moneragala,Uva,2088,3019,5107,83520,120760,204280
8/26/2024,Vihanga Maduranga,Moneragala,Moneragala,Uva,1287,5538,6825,51480,221520,273000
8/27/2024,Vihanga Maduranga,Moneragala,Moneragala,Uva,254,3112,3366,10160,124480,134640
8/28/2024,Vihanga Maduranga,Moneragala,Moneragala,Uva,3174,6735,9909,126960,269400,396360
8/29/2024,Vihanga Maduranga,Moneragala,Moneragala,Uva,2556,4996,7552,102240,199840,302080
8/30/2024,Vihanga Maduranga,Moneragala,Moneragala,Uva,4690,6715,11405,187600,268600,456200
8/31/2024,Vihanga Maduranga,Moneragala,Moneragala,Uva,9951,6089,16040,398040,243560,641600
9/1/2024,Vihanga Maduranga,Moneragala,Moneragala,Uva,879,7361,8240,35160,294440,329600
9/2/2024,Vihanga Maduranga,Moneragala,Moneragala,Uva,5933,4664,10597,237320,186560,423880
9/3/2024,Vihanga Maduranga,Moneragala,Moneragala,Uva,3426,9348,12774,137040,373920,510960
9/4/2024,Vihanga Maduranga,Moneragala,Moneragala,Uva,4602,5799,10401,184080,231960,416040
9/5/2024,Vihanga Maduranga,Moneragala,Moneragala,Uva,9262,3405,12667,370480,136200,506680
9/6/2024,Vihanga Maduranga,Moneragala,Moneragala,Uva,3696,7587,11283,147840,303480,451320
9/7/2024,Vihanga Maduranga,Moneragala,Moneragala,Uva,1686,6569,8255,67440,262760,330200
9/8/2024,Vihanga Maduranga,Moneragala,Moneragala,Uva,9067,6107,15174,362680,244280,606960
9/9/2024,Vihanga Maduranga,Moneragala,Moneragala,Uva,4748,2595,7343,189920,103800,293720
9/10/2024,Vihanga Maduranga,Moneragala,Moneragala,Uva,1526,9069,10595,61040,362760,423800
9/11/2024,Vihanga Maduranga,Moneragala,Moneragala,Uva,3110,8629,11739,124400,345160,469560
9/12/2024,Vihanga Maduranga,Moneragala,Moneragala,Uva,9068,8472,17540,362720,338880,701600
9/13/2024,Vihanga Maduranga,Moneragala,Moneragala,Uva,8361,4255,12616,334440,170200,504640
9/14/2024,Vihanga Maduranga,Moneragala,Moneragala,Uva,9775,5114,14889,391000,204560,595560
9/15/2024,Vihanga Maduranga,Moneragala,Moneragala,Uva,382,5426,5808,15280,217040,232320
9/16/2024,Vihanga Maduranga,Moneragala,Moneragala,Uva,9935,3138,13073,397400,125520,522920
9/17/2024,Vihanga Maduranga,Moneragala,Moneragala,Uva,2954,3042,5996,118160,121680,239840
9/18/2024,Vihanga Maduranga,Moneragala,Moneragala,Uva,4295,8732,13027,171800,349280,521080
9/19/2024,Vihanga Maduranga,Moneragala,Moneragala,Uva,8659,5329,13988,346360,213160,559520
9/20/2024,Vihanga Maduranga,Moneragala,Moneragala,Uva,8586,606,9192,343440,24240,367680
9/21/2024,Vihanga Maduranga,Moneragala,Moneragala,Uva,2593,8645,11238,103720,345800,449520
9/22/2024,Vihanga Maduranga,Moneragala,Moneragala,Uva,7083,8718,15801,283320,348720,632040
9/23/2024,Vihanga Maduranga,Moneragala,Moneragala,Uva,1681,633,2314,67240,25320,92560
9/24/2024,Vihanga Maduranga,Moneragala,Moneragala,Uva,329,5362,5691,13160,214480,227640
9/25/2024,Vihanga Maduranga,Moneragala,Moneragala,Uva,6953,1570,8523,278120,62800,340920
9/26/2024,Vihanga Maduranga,Moneragala,Moneragala,Uva,5249,8613,13862,209960,344520,554480
9/27/2024,Vihanga Maduranga,Moneragala,Moneragala,Uva,6531,4608,11139,261240,184320,445560
9/28/2024,Vihanga Maduranga,Moneragala,Moneragala,Uva,5964,8090,14054,238560,323600,562160
9/29/2024,Vihanga Maduranga,Moneragala,Moneragala,Uva,1980,9691,11671,79200,387640,466840
9/30/2024,Vihanga Maduranga,Moneragala,Moneragala,Uva,2356,2558,4914,94240,102320,196560
10/1/2024,Vihanga Maduranga,Moneragala,Moneragala,Uva,7728,5672,13400,309120,226880,536000
10/2/2024,Vihanga Maduranga,Moneragala,Moneragala,Uva,4596,2764,7360,183840,110560,294400
10/3/2024,Vihanga Maduranga,Moneragala,Moneragala,Uva,5312,906,6218,212480,36240,248720
10/4/2024,Vihanga Maduranga,Moneragala,Moneragala,Uva,9531,259,9790,381240,10360,391600
10/5/2024,Vihanga Maduranga,Moneragala,Moneragala,Uva,4654,2949,7603,186160,117960,304120
10/6/2024,Vihanga Maduranga,Moneragala,Moneragala,Uva,5322,5078,10400,212880,203120,416000
10/7/2024,Vihanga Maduranga,Moneragala,Moneragala,Uva,2249,2238,4487,89960,89520,179480
10/8/2024,Vihanga Maduranga,Moneragala,Moneragala,Uva,5097,8884,13981,203880,355360,559240
10/9/2024,Vihanga Maduranga,Moneragala,Moneragala,Uva,4015,9730,13745,160600,389200,549800
10/10/2024,Vihanga Maduranga,Moneragala,Moneragala,Uva,7425,1001,8426,297000,40040,337040
10/11/2024,Vihanga Maduranga,Moneragala,Moneragala,Uva,7092,3789,10881,283680,151560,435240
10/12/2024,Vihanga Maduranga,Moneragala,Moneragala,Uva,7402,6605,14007,296080,264200,560280
10/13/2024,Vihanga Maduranga,Moneragala,Moneragala,Uva,3668,2670,6338,146720,106800,253520
10/14/2024,Vihanga Maduranga,Moneragala,Moneragala,Uva,6541,8324,14865,261640,332960,594600
10/15/2024,Vihanga Maduranga,Moneragala,Moneragala,Uva,5780,9514,15294,231200,380560,611760
10/16/2024,Vihanga Maduranga,Moneragala,Moneragala,Uva,9387,6231,15618,375480,249240,624720
10/17/2024,Vihanga Maduranga,Moneragala,Moneragala,Uva,5650,789,6439,226000,31560,257560
10/18/2024,Vihanga Maduranga,Moneragala,Moneragala,Uva,2896,1258,4154,115840,50320,166160
10/19/2024,Vihanga Maduranga,Moneragala,Moneragala,Uva,8041,1901,9942,321640,76040,397680
10/20/2024,Vihanga Maduranga,Moneragala,Moneragala,Uva,348,282,630,13920,11280,25200
10/21/2024,Vihanga Maduranga,Moneragala,Moneragala,Uva,8136,4325,12461,325440,173000,498440
10/22/2024,Vihanga Maduranga,Moneragala,Moneragala,Uva,6324,8944,15268,252960,357760,610720
10/23/2024,Vihanga Maduranga,Moneragala,Moneragala,Uva,4677,9113,13790,187080,364520,551600
10/24/2024,Vihanga Maduranga,Moneragala,Moneragala,Uva,7905,6725,14630,316200,269000,585200
10/25/2024,Vihanga Maduranga,Moneragala,Moneragala,Uva,1615,9473,11088,64600,378920,443520
10/26/2024,Vihanga Maduranga,Moneragala,Moneragala,Uva,1989,6555,8544,79560,262200,341760
10/27/2024,Vihanga Maduranga,Moneragala,Moneragala,Uva,4501,7215,11716,180040,288600,468640
10/28/2024,Vihanga Maduranga,Moneragala,Moneragala,Uva,6763,9510,16273,270520,380400,650920
10/29/2024,Vihanga Maduranga,Moneragala,Moneragala,Uva,407,4547,4954,16280,181880,198160
10/30/2024,Vihanga Maduranga,Moneragala,Moneragala,Uva,3010,6606,9616,120400,264240,384640
10/31/2024,Vihanga Maduranga,Moneragala,Moneragala,Uva,502,8679,9181,20080,347160,367240
11/1/2024,Vihanga Maduranga,Moneragala,Moneragala,Uva,3493,2138,5631,139720,85520,225240
11/2/2024,Vihanga Maduranga,Moneragala,Moneragala,Uva,6687,4932,11619,267480,197280,464760
11/3/2024,Vihanga Maduranga,Moneragala,Moneragala,Uva,4184,1141,5325,167360,45640,213000
11/4/2024,Vihanga Maduranga,Moneragala,Moneragala,Uva,2057,4690,6747,82280,187600,269880
11/5/2024,Vihanga Maduranga,Moneragala,Moneragala,Uva,6490,6784,13274,259600,271360,530960
11/6/2024,Vihanga Maduranga,Moneragala,Moneragala,Uva,903,8617,9520,36120,344680,380800
11/7/2024,Vihanga Maduranga,Moneragala,Moneragala,Uva,187,8117,8304,7480,324680,332160
11/8/2024,Vihanga Maduranga,Moneragala,Moneragala,Uva,8033,1711,9744,321320,68440,389760
11/9/2024,Vihanga Maduranga,Moneragala,Moneragala,Uva,6126,5707,11833,245040,228280,473320
11/10/2024,Vihanga Maduranga,Moneragala,Moneragala,Uva,8603,7403,16006,344120,296120,640240
11/11/2024,Vihanga Maduranga,Moneragala,Moneragala,Uva,4078,2615,6693,163120,104600,267720
11/12/2024,Vihanga Maduranga,Moneragala,Moneragala,Uva,9008,2109,11117,360320,84360,444680
11/13/2024,Vihanga Maduranga,Moneragala,Moneragala,Uva,8217,4903,13120,328680,196120,524800
11/14/2024,Vihanga Maduranga,Moneragala,Moneragala,Uva,1813,3835,5648,72520,153400,225920
11/15/2024,Vihanga Maduranga,Moneragala,Moneragala,Uva,9724,4837,14561,388960,193480,582440
11/16/2024,Vihanga Maduranga,Moneragala,Moneragala,Uva,7416,7271,14687,296640,290840,587480
11/17/2024,Vihanga Maduranga,Moneragala,Moneragala,Uva,6307,4521,10828,252280,180840,433120
11/18/2024,Vihanga Maduranga,Moneragala,Moneragala,Uva,7873,8149,16022,314920,325960,640880
11/19/2024,Vihanga Maduranga,Moneragala,Moneragala,Uva,9185,509,9694,367400,20360,387760
11/20/2024,Vihanga Maduranga,Moneragala,Moneragala,Uva,6805,6034,12839,272200,241360,513560
11/21/2024,Vihanga Maduranga,Moneragala,Moneragala,Uva,1974,9244,11218,78960,369760,448720
11/22/2024,Vihanga Maduranga,Moneragala,Moneragala,Uva,5968,3473,9441,238720,138920,377640
11/23/2024,Vihanga Maduranga,Moneragala,Moneragala,Uva,3122,9746,12868,124880,389840,514720
11/24/2024,Vihanga Maduranga,Moneragala,Moneragala,Uva,9423,6614,16037,376920,264560,641480
11/25/2024,Vihanga Maduranga,Moneragala,Moneragala,Uva,2237,7603,9840,89480,304120,393600
11/26/2024,Vihanga Maduranga,Moneragala,Moneragala,Uva,7867,1895,9762,314680,75800,390480
11/27/2024,Vihanga Maduranga,Moneragala,Moneragala,Uva,1477,1067,2544,59080,42680,101760
11/28/2024,Vihanga Maduranga,Moneragala,Moneragala,Uva,3761,6938,10699,150440,277520,427960
11/29/2024,Vihanga Maduranga,Moneragala,Moneragala,Uva,7860,1588,9448,314400,63520,377920
11/30/2024,Vihanga Maduranga,Moneragala,Moneragala,Uva,5468,1692,7160,218720,67680,286400
12/1/2024,Vihanga Maduranga,Moneragala,Moneragala,Uva,3431,8918,12349,137240,356720,493960
12/2/2024,Vihanga Maduranga,Moneragala,Moneragala,Uva,5538,6054,11592,221520,242160,463680
12/3/2024,Vihanga Maduranga,Moneragala,Moneragala,Uva,975,805,1780,39000,32200,71200
12/4/2024,Vihanga Maduranga,Moneragala,Moneragala,Uva,7766,2918,10684,310640,116720,427360
12/5/2024,Vihanga Maduranga,Moneragala,Moneragala,Uva,7860,2093,9953,314400,83720,398120
12/6/2024,Vihanga Maduranga,Moneragala,Moneragala,Uva,8181,6975,15156,327240,279000,606240
12/7/2024,Vihanga Maduranga,Moneragala,Moneragala,Uva,4989,1706,6695,199560,68240,267800
12/8/2024,Vihanga Maduranga,Moneragala,Moneragala,Uva,9605,2957,12562,384200,118280,502480
12/9/2024,Vihanga Maduranga,Moneragala,Moneragala,Uva,4120,713,4833,164800,28520,193320
12/10/2024,Vihanga Maduranga,Moneragala,Moneragala,Uva,4333,3930,8263,173320,157200,330520
12/11/2024,Vihanga Maduranga,Moneragala,Moneragala,Uva,7513,2564,10077,300520,102560,403080
12/12/2024,Vihanga Maduranga,Moneragala,Moneragala,Uva,2559,5845,8404,102360,233800,336160
12/13/2024,Vihanga Maduranga,Moneragala,Moneragala,Uva,4783,3534,8317,191320,141360,332680
12/14/2024,Vihanga Maduranga,Moneragala,Moneragala,Uva,9779,3467,13246,391160,138680,529840
12/15/2024,Vihanga Maduranga,Moneragala,Moneragala,Uva,6330,2595,8925,253200,103800,357000
12/16/2024,Vihanga Maduranga,Moneragala,Moneragala,Uva,9097,3394,12491,363880,135760,499640
12/17/2024,Vihanga Maduranga,Moneragala,Moneragala,Uva,9194,5950,15144,367760,238000,605760
12/18/2024,Vihanga Maduranga,Moneragala,Moneragala,Uva,9747,9004,18751,389880,360160,750040
12/19/2024,Vihanga Maduranga,Moneragala,Moneragala,Uva,1104,6363,7467,44160,254520,298680
12/20/2024,Vihanga Maduranga,Moneragala,Moneragala,Uva,2376,6654,9030,95040,266160,361200
12/21/2024,Vihanga Maduranga,Moneragala,Moneragala,Uva,1013,5359,6372,40520,214360,254880
12/22/2024,Vihanga Maduranga,Moneragala,Moneragala,Uva,6254,2841,9095,250160,113640,363800
12/23/2024,Vihanga Maduranga,Moneragala,Moneragala,Uva,9619,5768,15387,384760,230720,615480
12/24/2024,Vihanga Maduranga,Moneragala,Moneragala,Uva,296,3496,3792,11840,139840,151680
12/25/2024,Vihanga Maduranga,Moneragala,Moneragala,Uva,5783,4809,10592,231320,192360,423680
12/26/2024,Vihanga Maduranga,Moneragala,Moneragala,Uva,4638,2861,7499,185520,114440,299960
12/27/2024,Vihanga Maduranga,Moneragala,Moneragala,Uva,5647,7919,13566,225880,316760,542640
12/28/2024,Vihanga Maduranga,Moneragala,Moneragala,Uva,3484,7830,11314,139360,313200,452560
12/29/2024,Vihanga Maduranga,Moneragala,Moneragala,Uva,1727,2623,4350,69080,104920,174000
12/30/2024,Vihanga Maduranga,Moneragala,Moneragala,Uva,9483,7604,17087,379320,304160,683480
12/31/2024,Vihanga Maduranga,Moneragala,Moneragala,Uva,3627,664,4291,145080,26560,171640
1/1/2025,Vihanga Maduranga,Moneragala,Moneragala,Uva,6770,6673,13443,270800,266920,537720
1/2/2025,Vihanga Maduranga,Moneragala,Moneragala,Uva,9823,1728,11551,392920,69120,462040
1/3/2025,Vihanga Maduranga,Moneragala,Moneragala,Uva,2118,187,2305,84720,7480,92200
1/4/2025,Vihanga Maduranga,Moneragala,Moneragala,Uva,1923,1339,3262,76920,53560,130480
1/5/2025,Vihanga Maduranga,Moneragala,Moneragala,Uva,7063,6088,13151,282520,243520,526040
1/6/2025,Vihanga Maduranga,Moneragala,Moneragala,Uva,2131,4681,6812,85240,187240,272480
1/7/2025,Vihanga Maduranga,Moneragala,Moneragala,Uva,8526,9251,17777,341040,370040,711080
1/8/2025,Vihanga Maduranga,Moneragala,Moneragala,Uva,4278,562,4840,171120,22480,193600
1/9/2025,Vihanga Maduranga,Moneragala,Moneragala,Uva,5663,3883,9546,226520,155320,381840
1/10/2025,Vihanga Maduranga,Moneragala,Moneragala,Uva,2496,7291,9787,99840,291640,391480
1/11/2025,Vihanga Maduranga,Moneragala,Moneragala,Uva,1408,6158,7566,56320,246320,302640
1/12/2025,Vihanga Maduranga,Moneragala,Moneragala,Uva,9180,4466,13646,367200,178640,545840
1/13/2025,Vihanga Maduranga,Moneragala,Moneragala,Uva,2675,4029,6704,107000,161160,268160
1/14/2025,Vihanga Maduranga,Moneragala,Moneragala,Uva,3564,4029,7593,142560,161160,303720
1/15/2025,Vihanga Maduranga,Moneragala,Moneragala,Uva,3690,3636,7326,147600,145440,293040
1/16/2025,Vihanga Maduranga,Moneragala,Moneragala,Uva,8365,2700,11065,334600,108000,442600
1/17/2025,Vihanga Maduranga,Moneragala,Moneragala,Uva,1925,4852,6777,77000,194080,271080
1/18/2025,Vihanga Maduranga,Moneragala,Moneragala,Uva,1524,7695,9219,60960,307800,368760
1/19/2025,Vihanga Maduranga,Moneragala,Moneragala,Uva,9907,9000,18907,396280,360000,756280
1/20/2025,Vihanga Maduranga,Moneragala,Moneragala,Uva,9127,1340,10467,365080,53600,418680
1/21/2025,Vihanga Maduranga,Moneragala,Moneragala,Uva,5545,3199,8744,221800,127960,349760
1/22/2025,Vihanga Maduranga,Moneragala,Moneragala,Uva,3406,4642,8048,136240,185680,321920
1/23/2025,Vihanga Maduranga,Moneragala,Moneragala,Uva,225,8338,8563,9000,333520,342520
1/24/2025,Vihanga Maduranga,Moneragala,Moneragala,Uva,3408,3465,6873,136320,138600,274920
1/25/2025,Vihanga Maduranga,Moneragala,Moneragala,Uva,4885,414,5299,195400,16560,211960
1/26/2025,Vihanga Maduranga,Moneragala,Moneragala,Uva,1772,7020,8792,70880,280800,351680
1/27/2025,Vihanga Maduranga,Moneragala,Moneragala,Uva,7873,2094,9967,314920,83760,398680
1/28/2025,Vihanga Maduranga,Moneragala,Moneragala,Uva,6524,3184,9708,260960,127360,388320
1/29/2025,Vihanga Maduranga,Moneragala,Moneragala,Uva,7676,7058,14734,307040,282320,589360
1/30/2025,Vihanga Maduranga,Moneragala,Moneragala,Uva,8374,9325,17699,334960,373000,707960
1/31/2025,Vihanga Maduranga,Moneragala,Moneragala,Uva,4102,2987,7089,164080,119480,283560
2/1/2025,Vihanga Maduranga,Moneragala,Moneragala,Uva,1866,3835,5701,74640,153400,228040
2/2/2025,Vihanga Maduranga,Moneragala,Moneragala,Uva,9857,9004,18861,394280,360160,754440
2/3/2025,Vihanga Maduranga,Moneragala,Moneragala,Uva,395,7917,8312,15800,316680,332480
2/4/2025,Vihanga Maduranga,Moneragala,Moneragala,Uva,35,7690,7725,1400,307600,309000
2/5/2025,Vihanga Maduranga,Moneragala,Moneragala,Uva,5240,2008,7248,209600,80320,289920
2/6/2025,Vihanga Maduranga,Moneragala,Moneragala,Uva,3801,7645,11446,152040,305800,457840
2/7/2025,Vihanga Maduranga,Moneragala,Moneragala,Uva,6761,5627,12388,270440,225080,495520
2/8/2025,Vihanga Maduranga,Moneragala,Moneragala,Uva,9855,8248,18103,394200,329920,724120
2/9/2025,Vihanga Maduranga,Moneragala,Moneragala,Uva,3148,2047,5195,125920,81880,207800
2/10/2025,Vihanga Maduranga,Moneragala,Moneragala,Uva,2533,2060,4593,101320,82400,183720
2/11/2025,Vihanga Maduranga,Moneragala,Moneragala,Uva,4276,385,4661,171040,15400,186440
2/12/2025,Vihanga Maduranga,Moneragala,Moneragala,Uva,466,8101,8567,18640,324040,342680
2/13/2025,Vihanga Maduranga,Moneragala,Moneragala,Uva,8807,8714,17521,352280,348560,700840
2/14/2025,Vihanga Maduranga,Moneragala,Moneragala,Uva,3808,1728,5536,152320,69120,221440
2/15/2025,Vihanga Maduranga,Moneragala,Moneragala,Uva,7460,5185,12645,298400,207400,505800
2/16/2025,Vihanga Maduranga,Moneragala,Moneragala,Uva,7423,511,7934,296920,20440,317360
2/17/2025,Vihanga Maduranga,Moneragala,Moneragala,Uva,4637,7389,12026,185480,295560,481040
2/18/2025,Vihanga Maduranga,Moneragala,Moneragala,Uva,7645,8715,16360,305800,348600,654400
2/19/2025,Vihanga Maduranga,Moneragala,Moneragala,Uva,8012,3137,11149,320480,125480,445960
2/20/2025,Vihanga Maduranga,Moneragala,Moneragala,Uva,3296,1585,4881,131840,63400,195240
2/21/2025,Vihanga Maduranga,Moneragala,Moneragala,Uva,524,2455,2979,20960,98200,119160
2/22/2025,Vihanga Maduranga,Moneragala,Moneragala,Uva,7246,1742,8988,289840,69680,359520
2/23/2025,Vihanga Maduranga,Moneragala,Moneragala,Uva,2021,6526,8547,80840,261040,341880
2/24/2025,Vihanga Maduranga,Moneragala,Moneragala,Uva,3471,9389,12860,138840,375560,514400
2/25/2025,Vihanga Maduranga,Moneragala,Moneragala,Uva,5318,8822,14140,212720,352880,565600
2/26/2025,Vihanga Maduranga,Moneragala,Moneragala,Uva,9186,6578,15764,367440,263120,630560
2/27/2025,Vihanga Maduranga,Moneragala,Moneragala,Uva,4245,8666,12911,169800,346640,516440
2/28/2025,Vihanga Maduranga,Moneragala,Moneragala,Uva,8603,9396,17999,344120,375840,719960
3/1/2025,Vihanga Maduranga,Moneragala,Moneragala,Uva,5386,5489,10875,215440,219560,435000
3/2/2025,Vihanga Maduranga,Moneragala,Moneragala,Uva,8344,8854,17198,333760,354160,687920
3/3/2025,Vihanga Maduranga,Moneragala,Moneragala,Uva,9665,4036,13701,386600,161440,548040
3/4/2025,Vihanga Maduranga,Moneragala,Moneragala,Uva,719,1321,2040,28760,52840,81600
3/5/2025,Vihanga Maduranga,Moneragala,Moneragala,Uva,586,7554,8140,23440,302160,325600
3/6/2025,Vihanga Maduranga,Moneragala,Moneragala,Uva,7933,5306,13239,317320,212240,529560
3/7/2025,Vihanga Maduranga,Moneragala,Moneragala,Uva,6333,6150,12483,253320,246000,499320
3/8/2025,Vihanga Maduranga,Moneragala,Moneragala,Uva,5482,3849,9331,219280,153960,373240
3/9/2025,Vihanga Maduranga,Moneragala,Moneragala,Uva,2924,6337,9261,116960,253480,370440
3/10/2025,Vihanga Maduranga,Moneragala,Moneragala,Uva,5955,5106,11061,238200,204240,442440
3/11/2025,Vihanga Maduranga,Moneragala,Moneragala,Uva,6366,8336,14702,254640,333440,588080
3/12/2025,Vihanga Maduranga,Moneragala,Moneragala,Uva,656,2784,3440,26240,111360,137600
3/13/2025,Vihanga Maduranga,Moneragala,Moneragala,Uva,7955,9407,17362,318200,376280,694480
3/14/2025,Vihanga Maduranga,Moneragala,Moneragala,Uva,7704,8560,16264,308160,342400,650560
3/15/2025,Vihanga Maduranga,Moneragala,Moneragala,Uva,6551,7080,13631,262040,283200,545240
3/16/2025,Vihanga Maduranga,Moneragala,Moneragala,Uva,4868,9671,14539,194720,386840,581560
3/17/2025,Vihanga Maduranga,Moneragala,Moneragala,Uva,1766,7597,9363,70640,303880,374520
3/18/2025,Vihanga Maduranga,Moneragala,Moneragala,Uva,8325,9873,18198,333000,394920,727920
3/19/2025,Vihanga Maduranga,Moneragala,Moneragala,Uva,2444,859,3303,97760,34360,132120
3/20/2025,Vihanga Maduranga,Moneragala,Moneragala,Uva,4629,1439,6068,185160,57560,242720
3/21/2025,Vihanga Maduranga,Moneragala,Moneragala,Uva,634,694,1328,25360,27760,53120
3/22/2025,Vihanga Maduranga,Moneragala,Moneragala,Uva,1138,2105,3243,45520,84200,129720
3/23/2025,Vihanga Maduranga,Moneragala,Moneragala,Uva,597,8120,8717,23880,324800,348680
3/25/2024,Madhushika Chandrasiri,Kurunegala,Melsiripura,North Western,4337,2701,7038,173480,108040,281520
3/26/2024,Madhushika Chandrasiri,Kurunegala,Melsiripura,North Western,5958,5875,11833,238320,235000,473320
3/27/2024,Madhushika Chandrasiri,Kurunegala,Melsiripura,North Western,9239,2700,11939,369560,108000,477560
3/28/2024,Madhushika Chandrasiri,Kurunegala,Melsiripura,North Western,232,882,1114,9280,35280,44560
3/29/2024,Madhushika Chandrasiri,Kurunegala,Melsiripura,North Western,9942,9192,19134,397680,367680,765360
3/30/2024,Madhushika Chandrasiri,Kurunegala,Melsiripura,North Western,6908,6684,13592,276320,267360,543680
3/31/2024,Madhushika Chandrasiri,Kurunegala,Melsiripura,North Western,5485,5719,11204,219400,228760,448160
4/1/2024,Madhushika Chandrasiri,Kurunegala,Melsiripura,North Western,3488,4525,8013,139520,181000,320520
4/2/2024,Madhushika Chandrasiri,Kurunegala,Melsiripura,North Western,9129,9794,18923,365160,391760,756920
4/3/2024,Madhushika Chandrasiri,Kurunegala,Melsiripura,North Western,4563,6051,10614,182520,242040,424560
4/4/2024,Madhushika Chandrasiri,Kurunegala,Melsiripura,North Western,361,4568,4929,14440,182720,197160
4/5/2024,Madhushika Chandrasiri,Kurunegala,Melsiripura,North Western,5644,7739,13383,225760,309560,535320
4/6/2024,Madhushika Chandrasiri,Kurunegala,Melsiripura,North Western,6329,3815,10144,253160,152600,405760
4/7/2024,Madhushika Chandrasiri,Kurunegala,Melsiripura,North Western,7751,9488,17239,310040,379520,689560
4/8/2024,Madhushika Chandrasiri,Kurunegala,Melsiripura,North Western,8946,6265,15211,357840,250600,608440
4/9/2024,Madhushika Chandrasiri,Kurunegala,Melsiripura,North Western,2680,1100,3780,107200,44000,151200
4/10/2024,Madhushika Chandrasiri,Kurunegala,Melsiripura,North Western,9017,4186,13203,360680,167440,528120
4/11/2024,Madhushika Chandrasiri,Kurunegala,Melsiripura,North Western,7638,616,8254,305520,24640,330160
4/19/2024,Madhushika Chandrasiri,Kurunegala,Melsiripura,North Western,8760,5023,13783,350400,200920,551320
4/20/2024,Madhushika Chandrasiri,Kurunegala,Melsiripura,North Western,4301,8617,12918,172040,344680,516720
4/21/2024,Madhushika Chandrasiri,Kurunegala,Melsiripura,North Western,6621,9659,16280,264840,386360,651200
4/22/2024,Madhushika Chandrasiri,Kurunegala,Melsiripura,North Western,7014,1211,8225,280560,48440,329000
4/23/2024,Madhushika Chandrasiri,Kurunegala,Melsiripura,North Western,1269,7906,9175,50760,316240,367000
4/24/2024,Madhushika Chandrasiri,Kurunegala,Melsiripura,North Western,2239,8046,10285,89560,321840,411400
4/25/2024,Madhushika Chandrasiri,Kurunegala,Melsiripura,North Western,3511,149,3660,140440,5960,146400
4/26/2024,Madhushika Chandrasiri,Kurunegala,Melsiripura,North Western,5530,9260,14790,221200,370400,591600
4/27/2024,Madhushika Chandrasiri,Kurunegala,Melsiripura,North Western,3241,7014,10255,129640,280560,410200
4/28/2024,Madhushika Chandrasiri,Kurunegala,Melsiripura,North Western,8672,2791,11463,346880,111640,458520
4/29/2024,Madhushika Chandrasiri,Kurunegala,Melsiripura,North Western,6685,8035,14720,267400,321400,588800
4/30/2024,Madhushika Chandrasiri,Kurunegala,Melsiripura,North Western,6733,7083,13816,269320,283320,552640
5/1/2024,Madhushika Chandrasiri,Kurunegala,Melsiripura,North Western,3504,2828,6332,140160,113120,253280
5/2/2024,Madhushika Chandrasiri,Kurunegala,Melsiripura,North Western,3603,2671,6274,144120,106840,250960
5/3/2024,Madhushika Chandrasiri,Kurunegala,Melsiripura,North Western,3244,6526,9770,129760,261040,390800
5/4/2024,Madhushika Chandrasiri,Kurunegala,Melsiripura,North Western,7893,293,8186,315720,11720,327440
5/5/2024,Madhushika Chandrasiri,Kurunegala,Melsiripura,North Western,2949,4866,7815,117960,194640,312600
5/6/2024,Madhushika Chandrasiri,Kurunegala,Melsiripura,North Western,6816,3453,10269,272640,138120,410760
5/7/2024,Madhushika Chandrasiri,Kurunegala,Melsiripura,North Western,234,9604,9838,9360,384160,393520
5/8/2024,Madhushika Chandrasiri,Kurunegala,Melsiripura,North Western,2680,4509,7189,107200,180360,287560
5/9/2024,Madhushika Chandrasiri,Kurunegala,Melsiripura,North Western,5983,4377,10360,239320,175080,414400
5/10/2024,Madhushika Chandrasiri,Kurunegala,Melsiripura,North Western,4974,786,5760,198960,31440,230400
5/11/2024,Madhushika Chandrasiri,Kurunegala,Melsiripura,North Western,3852,333,4185,154080,13320,167400
5/12/2024,Madhushika Chandrasiri,Kurunegala,Melsiripura,North Western,6898,7976,14874,275920,319040,594960
5/13/2024,Madhushika Chandrasiri,Kurunegala,Melsiripura,North Western,8700,5721,14421,348000,228840,576840
5/14/2024,Madhushika Chandrasiri,Kurunegala,Melsiripura,North Western,2214,2975,5189,88560,119000,207560
5/15/2024,Madhushika Chandrasiri,Kurunegala,Melsiripura,North Western,1518,4939,6457,60720,197560,258280
5/16/2024,Madhushika Chandrasiri,Kurunegala,Melsiripura,North Western,5729,8944,14673,229160,357760,586920
5/17/2024,Madhushika Chandrasiri,Kurunegala,Melsiripura,North Western,9579,3490,13069,383160,139600,522760
5/18/2024,Madhushika Chandrasiri,Kurunegala,Melsiripura,North Western,5620,9049,14669,224800,361960,586760
5/19/2024,Madhushika Chandrasiri,Kurunegala,Melsiripura,North Western,2257,1476,3733,90280,59040,149320
5/20/2024,Madhushika Chandrasiri,Kurunegala,Melsiripura,North Western,1841,5133,6974,73640,205320,278960
5/21/2024,Madhushika Chandrasiri,Kurunegala,Melsiripura,North Western,52,6603,6655,2080,264120,266200
5/22/2024,Madhushika Chandrasiri,Kurunegala,Melsiripura,North Western,1247,3037,4284,49880,121480,171360
5/24/2024,Madhushika Chandrasiri,Kurunegala,Melsiripura,North Western,6177,9403,15580,247080,376120,623200
5/25/2024,Madhushika Chandrasiri,Kurunegala,Melsiripura,North Western,6830,6413,13243,273200,256520,529720
5/26/2024,Madhushika Chandrasiri,Kurunegala,Melsiripura,North Western,8307,761,9068,332280,30440,362720
5/27/2024,Madhushika Chandrasiri,Kurunegala,Melsiripura,North Western,5999,7982,13981,239960,319280,559240
5/28/2024,Madhushika Chandrasiri,Kurunegala,Melsiripura,North Western,2818,4660,7478,112720,186400,299120
5/29/2024,Madhushika Chandrasiri,Kurunegala,Melsiripura,North Western,3954,8319,12273,158160,332760,490920
5/30/2024,Madhushika Chandrasiri,Kurunegala,Melsiripura,North Western,6279,6965,13244,251160,278600,529760
5/31/2024,Madhushika Chandrasiri,Kurunegala,Melsiripura,North Western,8545,3636,12181,341800,145440,487240
6/1/2024,Madhushika Chandrasiri,Kurunegala,Melsiripura,North Western,2184,6305,8489,87360,252200,339560
6/2/2024,Madhushika Chandrasiri,Kurunegala,Melsiripura,North Western,5187,8119,13306,207480,324760,532240
6/3/2024,Madhushika Chandrasiri,Kurunegala,Melsiripura,North Western,8354,6358,14712,334160,254320,588480
6/4/2024,Madhushika Chandrasiri,Kurunegala,Melsiripura,North Western,8086,7027,15113,323440,281080,604520
6/5/2024,Madhushika Chandrasiri,Kurunegala,Melsiripura,North Western,184,9568,9752,7360,382720,390080
6/6/2024,Madhushika Chandrasiri,Kurunegala,Melsiripura,North Western,6721,4650,11371,268840,186000,454840
6/7/2024,Madhushika Chandrasiri,Kurunegala,Melsiripura,North Western,3635,9224,12859,145400,368960,514360
6/8/2024,Madhushika Chandrasiri,Kurunegala,Melsiripura,North Western,5799,6349,12148,231960,253960,485920
6/9/2024,Madhushika Chandrasiri,Kurunegala,Melsiripura,North Western,2703,7265,9968,108120,290600,398720
6/10/2024,Madhushika Chandrasiri,Kurunegala,Melsiripura,North Western,5862,4638,10500,234480,185520,420000
6/11/2024,Madhushika Chandrasiri,Kurunegala,Melsiripura,North Western,3350,3671,7021,134000,146840,280840
6/12/2024,Madhushika Chandrasiri,Kurunegala,Melsiripura,North Western,3803,3304,7107,152120,132160,284280
6/13/2024,Madhushika Chandrasiri,Kurunegala,Melsiripura,North Western,3159,1692,4851,126360,67680,194040
6/14/2024,Madhushika Chandrasiri,Kurunegala,Melsiripura,North Western,9975,1103,11078,399000,44120,443120
6/15/2024,Madhushika Chandrasiri,Kurunegala,Melsiripura,North Western,5935,6781,12716,237400,271240,508640
6/16/2024,Madhushika Chandrasiri,Kurunegala,Melsiripura,North Western,847,7257,8104,33880,290280,324160
6/17/2024,Madhushika Chandrasiri,Kurunegala,Melsiripura,North Western,252,5289,5541,10080,211560,221640
6/18/2024,Madhushika Chandrasiri,Kurunegala,Melsiripura,North Western,3794,5151,8945,151760,206040,357800
6/19/2024,Madhushika Chandrasiri,Kurunegala,Melsiripura,North Western,2462,4417,6879,98480,176680,275160
6/20/2024,Madhushika Chandrasiri,Kurunegala,Melsiripura,North Western,5153,3885,9038,206120,155400,361520
6/21/2024,Madhushika Chandrasiri,Kurunegala,Melsiripura,North Western,110,3626,3736,4400,145040,149440
6/22/2024,Madhushika Chandrasiri,Kurunegala,Melsiripura,North Western,5013,4194,9207,200520,167760,368280
6/23/2024,Madhushika Chandrasiri,Kurunegala,Melsiripura,North Western,8893,3457,12350,355720,138280,494000
6/24/2024,Madhushika Chandrasiri,Kurunegala,Melsiripura,North Western,1417,1736,3153,56680,69440,126120
6/25/2024,Madhushika Chandrasiri,Kurunegala,Melsiripura,North Western,397,7484,7881,15880,299360,315240
6/26/2024,Madhushika Chandrasiri,Kurunegala,Melsiripura,North Western,2752,5129,7881,110080,205160,315240
6/27/2024,Madhushika Chandrasiri,Kurunegala,Melsiripura,North Western,1086,1998,3084,43440,79920,123360
6/28/2024,Madhushika Chandrasiri,Kurunegala,Melsiripura,North Western,3053,8057,11110,122120,322280,444400
6/29/2024,Madhushika Chandrasiri,Kurunegala,Melsiripura,North Western,3971,5260,9231,158840,210400,369240
6/30/2024,Madhushika Chandrasiri,Kurunegala,Melsiripura,North Western,319,8423,8742,12760,336920,349680
7/1/2024,Madhushika Chandrasiri,Kurunegala,Melsiripura,North Western,8864,6901,15765,354560,276040,630600
7/2/2024,Madhushika Chandrasiri,Kurunegala,Melsiripura,North Western,4814,6220,11034,192560,248800,441360
7/3/2024,Madhushika Chandrasiri,Kurunegala,Melsiripura,North Western,6451,7738,14189,258040,309520,567560
7/4/2024,Madhushika Chandrasiri,Kurunegala,Melsiripura,North Western,5736,4774,10510,229440,190960,420400
7/5/2024,Madhushika Chandrasiri,Kurunegala,Melsiripura,North Western,2482,3641,6123,99280,145640,244920
7/6/2024,Madhushika Chandrasiri,Kurunegala,Melsiripura,North Western,2934,5563,8497,117360,222520,339880
7/7/2024,Madhushika Chandrasiri,Kurunegala,Melsiripura,North Western,332,7299,7631,13280,291960,305240
7/8/2024,Madhushika Chandrasiri,Kurunegala,Melsiripura,North Western,7414,2851,10265,296560,114040,410600
7/9/2024,Madhushika Chandrasiri,Kurunegala,Melsiripura,North Western,7395,8054,15449,295800,322160,617960
7/10/2024,Madhushika Chandrasiri,Kurunegala,Melsiripura,North Western,1784,6124,7908,71360,244960,316320
7/11/2024,Madhushika Chandrasiri,Kurunegala,Melsiripura,North Western,3616,763,4379,144640,30520,175160
7/12/2024,Madhushika Chandrasiri,Kurunegala,Melsiripura,North Western,4286,3227,7513,171440,129080,300520
7/13/2024,Madhushika Chandrasiri,Kurunegala,Melsiripura,North Western,2855,7515,10370,114200,300600,414800
7/14/2024,Madhushika Chandrasiri,Kurunegala,Melsiripura,North Western,1555,5761,7316,62200,230440,292640
7/15/2024,Madhushika Chandrasiri,Kurunegala,Melsiripura,North Western,7651,694,8345,306040,27760,333800
7/16/2024,Madhushika Chandrasiri,Kurunegala,Melsiripura,North Western,9508,4756,14264,380320,190240,570560
7/17/2024,Madhushika Chandrasiri,Kurunegala,Melsiripura,North Western,5508,4188,9696,220320,167520,387840
7/18/2024,Madhushika Chandrasiri,Kurunegala,Melsiripura,North Western,5148,2767,7915,205920,110680,316600
7/19/2024,Madhushika Chandrasiri,Kurunegala,Melsiripura,North Western,7171,6493,13664,286840,259720,546560
7/20/2024,Madhushika Chandrasiri,Kurunegala,Melsiripura,North Western,4810,3085,7895,192400,123400,315800
7/21/2024,Madhushika Chandrasiri,Kurunegala,Melsiripura,North Western,4488,4663,9151,179520,186520,366040
7/22/2024,Madhushika Chandrasiri,Kurunegala,Melsiripura,North Western,1593,9869,11462,63720,394760,458480
7/23/2024,Madhushika Chandrasiri,Kurunegala,Melsiripura,North Western,6099,6687,12786,243960,267480,511440
7/24/2024,Madhushika Chandrasiri,Kurunegala,Melsiripura,North Western,7950,6115,14065,318000,244600,562600
7/25/2024,Madhushika Chandrasiri,Kurunegala,Melsiripura,North Western,5226,3179,8405,209040,127160,336200
7/26/2024,Madhushika Chandrasiri,Kurunegala,Melsiripura,North Western,5079,4965,10044,203160,198600,401760
7/27/2024,Madhushika Chandrasiri,Kurunegala,Melsiripura,North Western,9214,3350,12564,368560,134000,502560
7/28/2024,Madhushika Chandrasiri,Kurunegala,Melsiripura,North Western,6364,4749,11113,254560,189960,444520
7/29/2024,Madhushika Chandrasiri,Kurunegala,Melsiripura,North Western,5361,1527,6888,214440,61080,275520
7/30/2024,Madhushika Chandrasiri,Kurunegala,Melsiripura,North Western,7021,746,7767,280840,29840,310680
7/31/2024,Madhushika Chandrasiri,Kurunegala,Melsiripura,North Western,959,3807,4766,38360,152280,190640
8/1/2024,Madhushika Chandrasiri,Kurunegala,Melsiripura,North Western,4699,2378,7077,187960,95120,283080
8/2/2024,Madhushika Chandrasiri,Kurunegala,Melsiripura,North Western,7839,5338,13177,313560,213520,527080
8/3/2024,Madhushika Chandrasiri,Kurunegala,Melsiripura,North Western,9206,5316,14522,368240,212640,580880
8/4/2024,Madhushika Chandrasiri,Kurunegala,Melsiripura,North Western,1450,522,1972,58000,20880,78880
8/5/2024,Madhushika Chandrasiri,Kurunegala,Melsiripura,North Western,2375,3864,6239,95000,154560,249560
8/6/2024,Madhushika Chandrasiri,Kurunegala,Melsiripura,North Western,4919,9943,14862,196760,397720,594480
8/7/2024,Madhushika Chandrasiri,Kurunegala,Melsiripura,North Western,8709,1696,10405,348360,67840,416200
8/8/2024,Madhushika Chandrasiri,Kurunegala,Melsiripura,North Western,3886,1909,5795,155440,76360,231800
8/9/2024,Madhushika Chandrasiri,Kurunegala,Melsiripura,North Western,9289,9978,19267,371560,399120,770680
8/10/2024,Madhushika Chandrasiri,Kurunegala,Melsiripura,North Western,8471,34,8505,338840,1360,340200
8/11/2024,Madhushika Chandrasiri,Kurunegala,Melsiripura,North Western,8623,2935,11558,344920,117400,462320
8/12/2024,Madhushika Chandrasiri,Kurunegala,Melsiripura,North Western,9831,9458,19289,393240,378320,771560
8/13/2024,Madhushika Chandrasiri,Kurunegala,Melsiripura,North Western,1359,3845,5204,54360,153800,208160
8/14/2024,Madhushika Chandrasiri,Kurunegala,Melsiripura,North Western,7564,8150,15714,302560,326000,628560
8/15/2024,Madhushika Chandrasiri,Kurunegala,Melsiripura,North Western,8237,1313,9550,329480,52520,382000
8/16/2024,Madhushika Chandrasiri,Kurunegala,Melsiripura,North Western,8996,978,9974,359840,39120,398960
8/17/2024,Madhushika Chandrasiri,Kurunegala,Melsiripura,North Western,8659,4719,13378,346360,188760,535120
8/18/2024,Madhushika Chandrasiri,Kurunegala,Melsiripura,North Western,6008,8578,14586,240320,343120,583440
8/19/2024,Madhushika Chandrasiri,Kurunegala,Melsiripura,North Western,2265,2845,5110,90600,113800,204400
8/20/2024,Madhushika Chandrasiri,Kurunegala,Melsiripura,North Western,1381,7388,8769,55240,295520,350760
8/21/2024,Madhushika Chandrasiri,Kurunegala,Melsiripura,North Western,1195,917,2112,47800,36680,84480
8/22/2024,Madhushika Chandrasiri,Kurunegala,Melsiripura,North Western,6347,1883,8230,253880,75320,329200
8/23/2024,Madhushika Chandrasiri,Kurunegala,Melsiripura,North Western,3777,1584,5361,151080,63360,214440
8/24/2024,Madhushika Chandrasiri,Kurunegala,Melsiripura,North Western,3440,2029,5469,137600,81160,218760
8/25/2024,Madhushika Chandrasiri,Kurunegala,Melsiripura,North Western,8666,865,9531,346640,34600,381240
8/26/2024,Madhushika Chandrasiri,Kurunegala,Melsiripura,North Western,3379,1928,5307,135160,77120,212280
8/27/2024,Madhushika Chandrasiri,Kurunegala,Melsiripura,North Western,8107,5534,13641,324280,221360,545640
8/28/2024,Madhushika Chandrasiri,Kurunegala,Melsiripura,North Western,2947,7810,10757,117880,312400,430280
8/29/2024,Madhushika Chandrasiri,Kurunegala,Melsiripura,North Western,2791,9716,12507,111640,388640,500280
8/30/2024,Madhushika Chandrasiri,Kurunegala,Melsiripura,North Western,2475,1004,3479,99000,40160,139160
8/31/2024,Madhushika Chandrasiri,Kurunegala,Melsiripura,North Western,1316,9681,10997,52640,387240,439880
9/1/2024,Madhushika Chandrasiri,Kurunegala,Melsiripura,North Western,4777,2921,7698,191080,116840,307920
9/2/2024,Madhushika Chandrasiri,Kurunegala,Melsiripura,North Western,989,7003,7992,39560,280120,319680
9/3/2024,Madhushika Chandrasiri,Kurunegala,Melsiripura,North Western,1150,2335,3485,46000,93400,139400
9/4/2024,Madhushika Chandrasiri,Kurunegala,Melsiripura,North Western,1273,5489,6762,50920,219560,270480
9/5/2024,Madhushika Chandrasiri,Kurunegala,Melsiripura,North Western,7757,5057,12814,310280,202280,512560
9/6/2024,Madhushika Chandrasiri,Kurunegala,Melsiripura,North Western,8782,2374,11156,351280,94960,446240
9/7/2024,Madhushika Chandrasiri,Kurunegala,Melsiripura,North Western,6006,9491,15497,240240,379640,619880
9/8/2024,Madhushika Chandrasiri,Kurunegala,Melsiripura,North Western,1372,943,2315,54880,37720,92600
9/9/2024,Madhushika Chandrasiri,Kurunegala,Melsiripura,North Western,8837,4031,12868,353480,161240,514720
9/10/2024,Madhushika Chandrasiri,Kurunegala,Melsiripura,North Western,4138,2300,6438,165520,92000,257520
9/11/2024,Madhushika Chandrasiri,Kurunegala,Melsiripura,North Western,4208,1268,5476,168320,50720,219040
9/12/2024,Madhushika Chandrasiri,Kurunegala,Melsiripura,North Western,5011,3363,8374,200440,134520,334960
9/13/2024,Madhushika Chandrasiri,Kurunegala,Melsiripura,North Western,9336,8341,17677,373440,333640,707080
9/14/2024,Madhushika Chandrasiri,Kurunegala,Melsiripura,North Western,5951,6903,12854,238040,276120,514160
9/15/2024,Madhushika Chandrasiri,Kurunegala,Melsiripura,North Western,2491,8586,11077,99640,343440,443080
9/16/2024,Madhushika Chandrasiri,Kurunegala,Melsiripura,North Western,3235,1281,4516,129400,51240,180640
9/17/2024,Madhushika Chandrasiri,Kurunegala,Melsiripura,North Western,8050,5990,14040,322000,239600,561600
9/18/2024,Madhushika Chandrasiri,Kurunegala,Melsiripura,North Western,8178,3067,11245,327120,122680,449800
9/19/2024,Madhushika Chandrasiri,Kurunegala,Melsiripura,North Western,4380,9902,14282,175200,396080,571280
9/20/2024,Madhushika Chandrasiri,Kurunegala,Melsiripura,North Western,7301,1215,8516,292040,48600,340640
9/21/2024,Madhushika Chandrasiri,Kurunegala,Melsiripura,North Western,896,8610,9506,35840,344400,380240
9/22/2024,Madhushika Chandrasiri,Kurunegala,Melsiripura,North Western,4596,7648,12244,183840,305920,489760
9/23/2024,Madhushika Chandrasiri,Kurunegala,Melsiripura,North Western,3277,2138,5415,131080,85520,216600
9/24/2024,Madhushika Chandrasiri,Kurunegala,Melsiripura,North Western,1022,7665,8687,40880,306600,347480
9/25/2024,Madhushika Chandrasiri,Kurunegala,Melsiripura,North Western,68,1831,1899,2720,73240,75960
9/26/2024,Madhushika Chandrasiri,Kurunegala,Melsiripura,North Western,7553,3308,10861,302120,132320,434440
9/27/2024,Madhushika Chandrasiri,Kurunegala,Melsiripura,North Western,2271,58,2329,90840,2320,93160
9/28/2024,Madhushika Chandrasiri,Kurunegala,Melsiripura,North Western,5521,1657,7178,220840,66280,287120
9/29/2024,Madhushika Chandrasiri,Kurunegala,Melsiripura,North Western,489,6640,7129,19560,265600,285160
9/30/2024,Madhushika Chandrasiri,Kurunegala,Melsiripura,North Western,1397,6454,7851,55880,258160,314040
10/1/2024,Madhushika Chandrasiri,Kurunegala,Melsiripura,North Western,9093,4720,13813,363720,188800,552520
10/2/2024,Madhushika Chandrasiri,Kurunegala,Melsiripura,North Western,4698,6585,11283,187920,263400,451320
10/3/2024,Madhushika Chandrasiri,Kurunegala,Melsiripura,North Western,1486,2189,3675,59440,87560,147000
10/4/2024,Madhushika Chandrasiri,Kurunegala,Melsiripura,North Western,1923,9934,11857,76920,397360,474280
10/5/2024,Madhushika Chandrasiri,Kurunegala,Melsiripura,North Western,5236,1538,6774,209440,61520,270960
10/6/2024,Madhushika Chandrasiri,Kurunegala,Melsiripura,North Western,6778,4554,11332,271120,182160,453280
10/7/2024,Madhushika Chandrasiri,Kurunegala,Melsiripura,North Western,108,4163,4271,4320,166520,170840
10/8/2024,Madhushika Chandrasiri,Kurunegala,Melsiripura,North Western,7970,1025,8995,318800,41000,359800
10/9/2024,Madhushika Chandrasiri,Kurunegala,Melsiripura,North Western,6530,3090,9620,261200,123600,384800
10/10/2024,Madhushika Chandrasiri,Kurunegala,Melsiripura,North Western,3962,8605,12567,158480,344200,502680
10/11/2024,Madhushika Chandrasiri,Kurunegala,Melsiripura,North Western,7356,6374,13730,294240,254960,549200
10/12/2024,Madhushika Chandrasiri,Kurunegala,Melsiripura,North Western,6863,7352,14215,274520,294080,568600
10/13/2024,Madhushika Chandrasiri,Kurunegala,Melsiripura,North Western,9751,9733,19484,390040,389320,779360
10/14/2024,Madhushika Chandrasiri,Kurunegala,Melsiripura,North Western,4827,1879,6706,193080,75160,268240
10/15/2024,Madhushika Chandrasiri,Kurunegala,Melsiripura,North Western,5977,1974,7951,239080,78960,318040
10/16/2024,Madhushika Chandrasiri,Kurunegala,Melsiripura,North Western,8961,2239,11200,358440,89560,448000
10/17/2024,Madhushika Chandrasiri,Kurunegala,Melsiripura,North Western,1857,391,2248,74280,15640,89920
10/18/2024,Madhushika Chandrasiri,Kurunegala,Melsiripura,North Western,1712,8302,10014,68480,332080,400560
10/19/2024,Madhushika Chandrasiri,Kurunegala,Melsiripura,North Western,2656,4567,7223,106240,182680,288920
10/20/2024,Madhushika Chandrasiri,Kurunegala,Melsiripura,North Western,3981,4787,8768,159240,191480,350720
10/21/2024,Madhushika Chandrasiri,Kurunegala,Melsiripura,North Western,3398,2518,5916,135920,100720,236640
10/22/2024,Madhushika Chandrasiri,Kurunegala,Melsiripura,North Western,283,673,956,11320,26920,38240
10/23/2024,Madhushika Chandrasiri,Kurunegala,Melsiripura,North Western,3752,2322,6074,150080,92880,242960
10/24/2024,Madhushika Chandrasiri,Kurunegala,Melsiripura,North Western,2269,3026,5295,90760,121040,211800
10/25/2024,Madhushika Chandrasiri,Kurunegala,Melsiripura,North Western,6238,3928,10166,249520,157120,406640
10/26/2024,Madhushika Chandrasiri,Kurunegala,Melsiripura,North Western,9559,3659,13218,382360,146360,528720
10/27/2024,Madhushika Chandrasiri,Kurunegala,Melsiripura,North Western,143,4122,4265,5720,164880,170600
10/28/2024,Madhushika Chandrasiri,Kurunegala,Melsiripura,North Western,9062,2966,12028,362480,118640,481120
10/29/2024,Madhushika Chandrasiri,Kurunegala,Melsiripura,North Western,9304,4660,13964,372160,186400,558560
10/30/2024,Madhushika Chandrasiri,Kurunegala,Melsiripura,North Western,6970,2762,9732,278800,110480,389280
10/31/2024,Madhushika Chandrasiri,Kurunegala,Melsiripura,North Western,4992,5467,10459,199680,218680,418360
11/1/2024,Madhushika Chandrasiri,Kurunegala,Melsiripura,North Western,9111,833,9944,364440,33320,397760
11/2/2024,Madhushika Chandrasiri,Kurunegala,Melsiripura,North Western,6300,5613,11913,252000,224520,476520
11/3/2024,Madhushika Chandrasiri,Kurunegala,Melsiripura,North Western,110,3114,3224,4400,124560,128960
11/4/2024,Madhushika Chandrasiri,Kurunegala,Melsiripura,North Western,334,7810,8144,13360,312400,325760
11/5/2024,Madhushika Chandrasiri,Kurunegala,Melsiripura,North Western,4797,7334,12131,191880,293360,485240
11/6/2024,Madhushika Chandrasiri,Kurunegala,Melsiripura,North Western,3770,6562,10332,150800,262480,413280
11/7/2024,Madhushika Chandrasiri,Kurunegala,Melsiripura,North Western,1110,3333,4443,44400,133320,177720
11/8/2024,Madhushika Chandrasiri,Kurunegala,Melsiripura,North Western,3487,4545,8032,139480,181800,321280
11/9/2024,Madhushika Chandrasiri,Kurunegala,Melsiripura,North Western,155,8007,8162,6200,320280,326480
11/10/2024,Madhushika Chandrasiri,Kurunegala,Melsiripura,North Western,2538,2199,4737,101520,87960,189480
11/11/2024,Madhushika Chandrasiri,Kurunegala,Melsiripura,North Western,2836,1830,4666,113440,73200,186640
11/12/2024,Madhushika Chandrasiri,Kurunegala,Melsiripura,North Western,7093,3268,10361,283720,130720,414440
11/13/2024,Madhushika Chandrasiri,Kurunegala,Melsiripura,North Western,5819,1961,7780,232760,78440,311200
11/14/2024,Madhushika Chandrasiri,Kurunegala,Melsiripura,North Western,8580,5643,14223,343200,225720,568920
11/15/2024,Madhushika Chandrasiri,Kurunegala,Melsiripura,North Western,3461,7985,11446,138440,319400,457840
11/16/2024,Madhushika Chandrasiri,Kurunegala,Melsiripura,North Western,777,7897,8674,31080,315880,346960
11/17/2024,Madhushika Chandrasiri,Kurunegala,Melsiripura,North Western,7385,6108,13493,295400,244320,539720
11/18/2024,Madhushika Chandrasiri,Kurunegala,Melsiripura,North Western,2606,170,2776,104240,6800,111040
11/19/2024,Madhushika Chandrasiri,Kurunegala,Melsiripura,North Western,6069,1338,7407,242760,53520,296280
11/20/2024,Madhushika Chandrasiri,Kurunegala,Melsiripura,North Western,5102,3369,8471,204080,134760,338840
11/21/2024,Madhushika Chandrasiri,Kurunegala,Melsiripura,North Western,5530,6977,12507,221200,279080,500280
11/22/2024,Madhushika Chandrasiri,Kurunegala,Melsiripura,North Western,8476,6182,14658,339040,247280,586320
11/23/2024,Madhushika Chandrasiri,Kurunegala,Melsiripura,North Western,9472,9628,19100,378880,385120,764000
11/24/2024,Madhushika Chandrasiri,Kurunegala,Melsiripura,North Western,9539,9914,19453,381560,396560,778120
11/25/2024,Madhushika Chandrasiri,Kurunegala,Melsiripura,North Western,8483,5025,13508,339320,201000,540320
11/26/2024,Madhushika Chandrasiri,Kurunegala,Melsiripura,North Western,6448,6376,12824,257920,255040,512960
11/27/2024,Madhushika Chandrasiri,Kurunegala,Melsiripura,North Western,1097,4097,5194,43880,163880,207760
11/28/2024,Madhushika Chandrasiri,Kurunegala,Melsiripura,North Western,6171,8839,15010,246840,353560,600400
11/29/2024,Madhushika Chandrasiri,Kurunegala,Melsiripura,North Western,7988,9612,17600,319520,384480,704000
11/30/2024,Madhushika Chandrasiri,Kurunegala,Melsiripura,North Western,4267,1648,5915,170680,65920,236600
12/1/2024,Madhushika Chandrasiri,Kurunegala,Melsiripura,North Western,6011,7846,13857,240440,313840,554280
12/2/2024,Madhushika Chandrasiri,Kurunegala,Melsiripura,North Western,9030,1346,10376,361200,53840,415040
12/3/2024,Madhushika Chandrasiri,Kurunegala,Melsiripura,North Western,1817,7023,8840,72680,280920,353600
12/4/2024,Madhushika Chandrasiri,Kurunegala,Melsiripura,North Western,8883,6202,15085,355320,248080,603400
12/5/2024,Madhushika Chandrasiri,Kurunegala,Melsiripura,North Western,1792,9897,11689,71680,395880,467560
12/6/2024,Madhushika Chandrasiri,Kurunegala,Melsiripura,North Western,6644,13,6657,265760,520,266280
12/7/2024,Madhushika Chandrasiri,Kurunegala,Melsiripura,North Western,9654,9470,19124,386160,378800,764960
12/8/2024,Madhushika Chandrasiri,Kurunegala,Melsiripura,North Western,354,6211,6565,14160,248440,262600
12/9/2024,Madhushika Chandrasiri,Kurunegala,Melsiripura,North Western,1281,904,2185,51240,36160,87400
12/10/2024,Madhushika Chandrasiri,Kurunegala,Melsiripura,North Western,474,1328,1802,18960,53120,72080
12/11/2024,Madhushika Chandrasiri,Kurunegala,Melsiripura,North Western,8131,9028,17159,325240,361120,686360
12/12/2024,Madhushika Chandrasiri,Kurunegala,Melsiripura,North Western,5356,5585,10941,214240,223400,437640
12/13/2024,Madhushika Chandrasiri,Kurunegala,Melsiripura,North Western,3986,8092,12078,159440,323680,483120
12/14/2024,Madhushika Chandrasiri,Kurunegala,Melsiripura,North Western,6452,5185,11637,258080,207400,465480
12/15/2024,Madhushika Chandrasiri,Kurunegala,Melsiripura,North Western,4418,6004,10422,176720,240160,416880
12/16/2024,Madhushika Chandrasiri,Kurunegala,Melsiripura,North Western,2346,4821,7167,93840,192840,286680
12/17/2024,Madhushika Chandrasiri,Kurunegala,Melsiripura,North Western,4102,2687,6789,164080,107480,271560
12/18/2024,Madhushika Chandrasiri,Kurunegala,Melsiripura,North Western,8228,4231,12459,329120,169240,498360
12/19/2024,Madhushika Chandrasiri,Kurunegala,Melsiripura,North Western,7222,8308,15530,288880,332320,621200
12/20/2024,Madhushika Chandrasiri,Kurunegala,Melsiripura,North Western,7774,3504,11278,310960,140160,451120
12/21/2024,Madhushika Chandrasiri,Kurunegala,Melsiripura,North Western,8789,37,8826,351560,1480,353040
12/22/2024,Madhushika Chandrasiri,Kurunegala,Melsiripura,North Western,5014,3758,8772,200560,150320,350880
12/23/2024,Madhushika Chandrasiri,Kurunegala,Melsiripura,North Western,620,5412,6032,24800,216480,241280
12/24/2024,Madhushika Chandrasiri,Kurunegala,Melsiripura,North Western,8781,492,9273,351240,19680,370920
12/25/2024,Madhushika Chandrasiri,Kurunegala,Melsiripura,North Western,2294,4220,6514,91760,168800,260560
12/26/2024,Madhushika Chandrasiri,Kurunegala,Melsiripura,North Western,4040,1007,5047,161600,40280,201880
12/27/2024,Madhushika Chandrasiri,Kurunegala,Melsiripura,North Western,6600,1301,7901,264000,52040,316040
12/28/2024,Madhushika Chandrasiri,Kurunegala,Melsiripura,North Western,6624,273,6897,264960,10920,275880
12/29/2024,Madhushika Chandrasiri,Kurunegala,Melsiripura,North Western,1448,3271,4719,57920,130840,188760
12/30/2024,Madhushika Chandrasiri,Kurunegala,Melsiripura,North Western,175,8028,8203,7000,321120,328120
12/31/2024,Madhushika Chandrasiri,Kurunegala,Melsiripura,North Western,9199,5922,15121,367960,236880,604840
1/1/2025,Madhushika Chandrasiri,Kurunegala,Melsiripura,North Western,4498,7753,12251,179920,310120,490040
1/2/2025,Madhushika Chandrasiri,Kurunegala,Melsiripura,North Western,3738,3071,6809,149520,122840,272360
1/3/2025,Madhushika Chandrasiri,Kurunegala,Melsiripura,North Western,2527,3159,5686,101080,126360,227440
1/4/2025,Madhushika Chandrasiri,Kurunegala,Melsiripura,North Western,3918,6793,10711,156720,271720,428440
1/5/2025,Madhushika Chandrasiri,Kurunegala,Melsiripura,North Western,5429,9593,15022,217160,383720,600880
1/6/2025,Madhushika Chandrasiri,Kurunegala,Melsiripura,North Western,7652,6083,13735,306080,243320,549400
1/7/2025,Madhushika Chandrasiri,Kurunegala,Melsiripura,North Western,6574,877,7451,262960,35080,298040
1/8/2025,Madhushika Chandrasiri,Kurunegala,Melsiripura,North Western,268,2381,2649,10720,95240,105960
1/9/2025,Madhushika Chandrasiri,Kurunegala,Melsiripura,North Western,4166,3184,7350,166640,127360,294000
1/10/2025,Madhushika Chandrasiri,Kurunegala,Melsiripura,North Western,1761,2011,3772,70440,80440,150880
1/11/2025,Madhushika Chandrasiri,Kurunegala,Melsiripura,North Western,213,3965,4178,8520,158600,167120
1/12/2025,Madhushika Chandrasiri,Kurunegala,Melsiripura,North Western,6104,9250,15354,244160,370000,614160
1/13/2025,Madhushika Chandrasiri,Kurunegala,Melsiripura,North Western,1648,1074,2722,65920,42960,108880
1/14/2025,Madhushika Chandrasiri,Kurunegala,Melsiripura,North Western,8383,1228,9611,335320,49120,384440
1/15/2025,Madhushika Chandrasiri,Kurunegala,Melsiripura,North Western,8295,3736,12031,331800,149440,481240
1/16/2025,Madhushika Chandrasiri,Kurunegala,Melsiripura,North Western,8625,8595,17220,345000,343800,688800
1/17/2025,Madhushika Chandrasiri,Kurunegala,Melsiripura,North Western,1485,2754,4239,59400,110160,169560
1/18/2025,Madhushika Chandrasiri,Kurunegala,Melsiripura,North Western,5669,9477,15146,226760,379080,605840
1/19/2025,Madhushika Chandrasiri,Kurunegala,Melsiripura,North Western,1088,466,1554,43520,18640,62160
1/20/2025,Madhushika Chandrasiri,Kurunegala,Melsiripura,North Western,5447,6766,12213,217880,270640,488520
1/21/2025,Madhushika Chandrasiri,Kurunegala,Melsiripura,North Western,1084,2393,3477,43360,95720,139080
1/22/2025,Madhushika Chandrasiri,Kurunegala,Melsiripura,North Western,29,6132,6161,1160,245280,246440
1/23/2025,Madhushika Chandrasiri,Kurunegala,Melsiripura,North Western,6848,5173,12021,273920,206920,480840
1/24/2025,Madhushika Chandrasiri,Kurunegala,Melsiripura,North Western,8997,7833,16830,359880,313320,673200
1/25/2025,Madhushika Chandrasiri,Kurunegala,Melsiripura,North Western,8425,1159,9584,337000,46360,383360
1/26/2025,Madhushika Chandrasiri,Kurunegala,Melsiripura,North Western,6073,5457,11530,242920,218280,461200
1/27/2025,Madhushika Chandrasiri,Kurunegala,Melsiripura,North Western,6296,7501,13797,251840,300040,551880
1/28/2025,Madhushika Chandrasiri,Kurunegala,Melsiripura,North Western,7876,7463,15339,315040,298520,613560
1/29/2025,Madhushika Chandrasiri,Kurunegala,Melsiripura,North Western,8189,2906,11095,327560,116240,443800
1/30/2025,Madhushika Chandrasiri,Kurunegala,Melsiripura,North Western,4802,2096,6898,192080,83840,275920
1/31/2025,Madhushika Chandrasiri,Kurunegala,Melsiripura,North Western,6484,4235,10719,259360,169400,428760
2/1/2025,Madhushika Chandrasiri,Kurunegala,Melsiripura,North Western,3945,1836,5781,157800,73440,231240
2/2/2025,Madhushika Chandrasiri,Kurunegala,Melsiripura,North Western,3526,330,3856,141040,13200,154240
2/3/2025,Madhushika Chandrasiri,Kurunegala,Melsiripura,North Western,5524,2437,7961,220960,97480,318440
2/4/2025,Madhushika Chandrasiri,Kurunegala,Melsiripura,North Western,7506,1592,9098,300240,63680,363920
2/5/2025,Madhushika Chandrasiri,Kurunegala,Melsiripura,North Western,6644,8428,15072,265760,337120,602880
2/6/2025,Madhushika Chandrasiri,Kurunegala,Melsiripura,North Western,4352,5829,10181,174080,233160,407240
2/7/2025,Madhushika Chandrasiri,Kurunegala,Melsiripura,North Western,2495,1373,3868,99800,54920,154720
2/8/2025,Madhushika Chandrasiri,Kurunegala,Melsiripura,North Western,5689,2294,7983,227560,91760,319320
2/9/2025,Madhushika Chandrasiri,Kurunegala,Melsiripura,North Western,3867,3919,7786,154680,156760,311440
2/10/2025,Madhushika Chandrasiri,Kurunegala,Melsiripura,North Western,261,602,863,10440,24080,34520
2/11/2025,Madhushika Chandrasiri,Kurunegala,Melsiripura,North Western,8580,2605,11185,343200,104200,447400
2/12/2025,Madhushika Chandrasiri,Kurunegala,Melsiripura,North Western,5657,5585,11242,226280,223400,449680
2/13/2025,Madhushika Chandrasiri,Kurunegala,Melsiripura,North Western,504,1786,2290,20160,71440,91600
2/14/2025,Madhushika Chandrasiri,Kurunegala,Melsiripura,North Western,6627,3763,10390,265080,150520,415600
2/15/2025,Madhushika Chandrasiri,Kurunegala,Melsiripura,North Western,5952,4666,10618,238080,186640,424720
2/16/2025,Madhushika Chandrasiri,Kurunegala,Melsiripura,North Western,48,833,881,1920,33320,35240
2/17/2025,Madhushika Chandrasiri,Kurunegala,Melsiripura,North Western,548,4380,4928,21920,175200,197120
2/18/2025,Madhushika Chandrasiri,Kurunegala,Melsiripura,North Western,9866,8817,18683,394640,352680,747320
2/19/2025,Madhushika Chandrasiri,Kurunegala,Melsiripura,North Western,5872,7665,13537,234880,306600,541480
2/20/2025,Madhushika Chandrasiri,Kurunegala,Melsiripura,North Western,5700,4029,9729,228000,161160,389160
2/21/2025,Madhushika Chandrasiri,Kurunegala,Melsiripura,North Western,848,5662,6510,33920,226480,260400
2/22/2025,Madhushika Chandrasiri,Kurunegala,Melsiripura,North Western,7436,8690,16126,297440,347600,645040
2/23/2025,Madhushika Chandrasiri,Kurunegala,Melsiripura,North Western,8360,1887,10247,334400,75480,409880
2/24/2025,Madhushika Chandrasiri,Kurunegala,Melsiripura,North Western,3371,4715,8086,134840,188600,323440
2/25/2025,Madhushika Chandrasiri,Kurunegala,Melsiripura,North Western,5189,7629,12818,207560,305160,512720
2/26/2025,Madhushika Chandrasiri,Kurunegala,Melsiripura,North Western,3553,842,4395,142120,33680,175800
2/27/2025,Madhushika Chandrasiri,Kurunegala,Melsiripura,North Western,3457,2289,5746,138280,91560,229840
2/28/2025,Madhushika Chandrasiri,Kurunegala,Melsiripura,North Western,351,6767,7118,14040,270680,284720
3/1/2025,Madhushika Chandrasiri,Kurunegala,Melsiripura,North Western,8340,2329,10669,333600,93160,426760
3/2/2025,Madhushika Chandrasiri,Kurunegala,Melsiripura,North Western,7072,850,7922,282880,34000,316880
3/3/2025,Madhushika Chandrasiri,Kurunegala,Melsiripura,North Western,2087,9918,12005,83480,396720,480200
3/4/2025,Madhushika Chandrasiri,Kurunegala,Melsiripura,North Western,1747,3751,5498,69880,150040,219920
3/5/2025,Madhushika Chandrasiri,Kurunegala,Melsiripura,North Western,4678,4011,8689,187120,160440,347560
3/6/2025,Madhushika Chandrasiri,Kurunegala,Melsiripura,North Western,6552,6718,13270,262080,268720,530800
3/7/2025,Madhushika Chandrasiri,Kurunegala,Melsiripura,North Western,7857,9643,17500,314280,385720,700000
3/8/2025,Madhushika Chandrasiri,Kurunegala,Melsiripura,North Western,7754,8656,16410,310160,346240,656400
3/9/2025,Madhushika Chandrasiri,Kurunegala,Melsiripura,North Western,9169,2579,11748,366760,103160,469920
3/10/2025,Madhushika Chandrasiri,Kurunegala,Melsiripura,North Western,2768,2986,5754,110720,119440,230160
3/11/2025,Madhushika Chandrasiri,Kurunegala,Melsiripura,North Western,4651,8615,13266,186040,344600,530640
3/12/2025,Madhushika Chandrasiri,Kurunegala,Melsiripura,North Western,5211,6246,11457,208440,249840,458280
3/13/2025,Madhushika Chandrasiri,Kurunegala,Melsiripura,North Western,1659,6013,7672,66360,240520,306880
3/14/2025,Madhushika Chandrasiri,Kurunegala,Melsiripura,North Western,8002,9298,17300,320080,371920,692000
3/15/2025,Madhushika Chandrasiri,Kurunegala,Melsiripura,North Western,7204,180,7384,288160,7200,295360
3/16/2025,Madhushika Chandrasiri,Kurunegala,Melsiripura,North Western,8813,8024,16837,352520,320960,673480
3/17/2025,Madhushika Chandrasiri,Kurunegala,Melsiripura,North Western,178,1786,1964,7120,71440,78560
3/18/2025,Madhushika Chandrasiri,Kurunegala,Melsiripura,North Western,2553,2696,5249,102120,107840,209960
3/19/2025,Madhushika Chandrasiri,Kurunegala,Melsiripura,North Western,6490,9845,16335,259600,393800,653400
3/20/2025,Madhushika Chandrasiri,Kurunegala,Melsiripura,North Western,2034,8906,10940,81360,356240,437600
3/21/2025,Madhushika Chandrasiri,Kurunegala,Melsiripura,North Western,2358,4036,6394,94320,161440,255760
3/22/2025,Madhushika Chandrasiri,Kurunegala,Melsiripura,North Western,6735,6051,12786,269400,242040,511440
3/23/2025,Madhushika Chandrasiri,Kurunegala,Melsiripura,North Western,1245,2898,4143,49800,115920,165720
3/25/2024,Kaushalya Jayasundara,Ampara,Kalmunai,Eastern,9163,3237,12400,366520,129480,496000
3/26/2024,Kaushalya Jayasundara,Ampara,Kalmunai,Eastern,9624,573,10197,384960,22920,407880
3/27/2024,Kaushalya Jayasundara,Ampara,Kalmunai,Eastern,8131,8197,16328,325240,327880,653120
3/28/2024,Kaushalya Jayasundara,Ampara,Kalmunai,Eastern,2832,3933,6765,113280,157320,270600
3/29/2024,Kaushalya Jayasundara,Ampara,Kalmunai,Eastern,2951,2166,5117,118040,86640,204680
3/30/2024,Kaushalya Jayasundara,Ampara,Kalmunai,Eastern,4407,604,5011,176280,24160,200440
3/31/2024,Kaushalya Jayasundara,Ampara,Kalmunai,Eastern,8313,9111,17424,332520,364440,696960
4/1/2024,Kaushalya Jayasundara,Ampara,Kalmunai,Eastern,720,7929,8649,28800,317160,345960
4/2/2024,Kaushalya Jayasundara,Ampara,Kalmunai,Eastern,1742,2727,4469,69680,109080,178760
4/3/2024,Kaushalya Jayasundara,Ampara,Kalmunai,Eastern,1960,1682,3642,78400,67280,145680
4/4/2024,Kaushalya Jayasundara,Ampara,Kalmunai,Eastern,3756,4145,7901,150240,165800,316040
4/5/2024,Kaushalya Jayasundara,Ampara,Kalmunai,Eastern,6984,1005,7989,279360,40200,319560
4/6/2024,Kaushalya Jayasundara,Ampara,Kalmunai,Eastern,2865,1171,4036,114600,46840,161440
4/7/2024,Kaushalya Jayasundara,Ampara,Kalmunai,Eastern,4845,7962,12807,193800,318480,512280
4/8/2024,Kaushalya Jayasundara,Ampara,Kalmunai,Eastern,3340,8215,11555,133600,328600,462200
4/9/2024,Kaushalya Jayasundara,Ampara,Kalmunai,Eastern,5759,7838,13597,230360,313520,543880
4/10/2024,Kaushalya Jayasundara,Ampara,Kalmunai,Eastern,2009,8119,10128,80360,324760,405120
4/11/2024,Kaushalya Jayasundara,Ampara,Kalmunai,Eastern,4453,3776,8229,178120,151040,329160
4/19/2024,Kaushalya Jayasundara,Ampara,Kalmunai,Eastern,5834,6923,12757,233360,276920,510280
4/20/2024,Kaushalya Jayasundara,Ampara,Kalmunai,Eastern,754,2695,3449,30160,107800,137960
4/21/2024,Kaushalya Jayasundara,Ampara,Kalmunai,Eastern,3719,9749,13468,148760,389960,538720
4/22/2024,Kaushalya Jayasundara,Ampara,Kalmunai,Eastern,1618,1195,2813,64720,47800,112520
4/23/2024,Kaushalya Jayasundara,Ampara,Kalmunai,Eastern,3568,566,4134,142720,22640,165360
4/24/2024,Kaushalya Jayasundara,Ampara,Kalmunai,Eastern,7890,1449,9339,315600,57960,373560
4/25/2024,Kaushalya Jayasundara,Ampara,Kalmunai,Eastern,2972,7994,10966,118880,319760,438640
4/26/2024,Kaushalya Jayasundara,Ampara,Kalmunai,Eastern,151,8837,8988,6040,353480,359520
4/27/2024,Kaushalya Jayasundara,Ampara,Kalmunai,Eastern,9423,627,10050,376920,25080,402000
4/28/2024,Kaushalya Jayasundara,Ampara,Kalmunai,Eastern,2751,3759,6510,110040,150360,260400
4/29/2024,Kaushalya Jayasundara,Ampara,Kalmunai,Eastern,9202,3995,13197,368080,159800,527880
4/30/2024,Kaushalya Jayasundara,Ampara,Kalmunai,Eastern,5959,4725,10684,238360,189000,427360
5/1/2024,Kaushalya Jayasundara,Ampara,Kalmunai,Eastern,2669,61,2730,106760,2440,109200
5/2/2024,Kaushalya Jayasundara,Ampara,Kalmunai,Eastern,6207,6375,12582,248280,255000,503280
5/3/2024,Kaushalya Jayasundara,Ampara,Kalmunai,Eastern,1766,9258,11024,70640,370320,440960
5/4/2024,Kaushalya Jayasundara,Ampara,Kalmunai,Eastern,2847,828,3675,113880,33120,147000
5/5/2024,Kaushalya Jayasundara,Ampara,Kalmunai,Eastern,6484,4747,11231,259360,189880,449240
5/6/2024,Kaushalya Jayasundara,Ampara,Kalmunai,Eastern,9738,886,10624,389520,35440,424960
5/7/2024,Kaushalya Jayasundara,Ampara,Kalmunai,Eastern,8768,2130,10898,350720,85200,435920
5/8/2024,Kaushalya Jayasundara,Ampara,Kalmunai,Eastern,5671,6330,12001,226840,253200,480040
5/9/2024,Kaushalya Jayasundara,Ampara,Kalmunai,Eastern,7201,6071,13272,288040,242840,530880
5/10/2024,Kaushalya Jayasundara,Ampara,Kalmunai,Eastern,6620,7119,13739,264800,284760,549560
5/11/2024,Kaushalya Jayasundara,Ampara,Kalmunai,Eastern,5546,9033,14579,221840,361320,583160
5/12/2024,Kaushalya Jayasundara,Ampara,Kalmunai,Eastern,6896,2771,9667,275840,110840,386680
5/13/2024,Kaushalya Jayasundara,Ampara,Kalmunai,Eastern,8065,2075,10140,322600,83000,405600
5/14/2024,Kaushalya Jayasundara,Ampara,Kalmunai,Eastern,6602,5079,11681,264080,203160,467240
5/15/2024,Kaushalya Jayasundara,Ampara,Kalmunai,Eastern,7455,7249,14704,298200,289960,588160
5/16/2024,Kaushalya Jayasundara,Ampara,Kalmunai,Eastern,3720,829,4549,148800,33160,181960
5/17/2024,Kaushalya Jayasundara,Ampara,Kalmunai,Eastern,7839,122,7961,313560,4880,318440
5/18/2024,Kaushalya Jayasundara,Ampara,Kalmunai,Eastern,6980,5537,12517,279200,221480,500680
5/19/2024,Kaushalya Jayasundara,Ampara,Kalmunai,Eastern,9836,4816,14652,393440,192640,586080
5/20/2024,Kaushalya Jayasundara,Ampara,Kalmunai,Eastern,9704,1252,10956,388160,50080,438240
5/21/2024,Kaushalya Jayasundara,Ampara,Kalmunai,Eastern,395,9315,9710,15800,372600,388400
5/22/2024,Kaushalya Jayasundara,Ampara,Kalmunai,Eastern,4077,5218,9295,163080,208720,371800
5/24/2024,Kaushalya Jayasundara,Ampara,Kalmunai,Eastern,8458,8479,16937,338320,339160,677480
5/25/2024,Kaushalya Jayasundara,Ampara,Kalmunai,Eastern,9315,2768,12083,372600,110720,483320
5/26/2024,Kaushalya Jayasundara,Ampara,Kalmunai,Eastern,8291,7792,16083,331640,311680,643320
5/27/2024,Kaushalya Jayasundara,Ampara,Kalmunai,Eastern,999,5704,6703,39960,228160,268120
5/28/2024,Kaushalya Jayasundara,Ampara,Kalmunai,Eastern,6316,7404,13720,252640,296160,548800
5/29/2024,Kaushalya Jayasundara,Ampara,Kalmunai,Eastern,6648,9927,16575,265920,397080,663000
5/30/2024,Kaushalya Jayasundara,Ampara,Kalmunai,Eastern,8530,9153,17683,341200,366120,707320
5/31/2024,Kaushalya Jayasundara,Ampara,Kalmunai,Eastern,5397,729,6126,215880,29160,245040
6/1/2024,Kaushalya Jayasundara,Ampara,Kalmunai,Eastern,7313,4679,11992,292520,187160,479680
6/2/2024,Kaushalya Jayasundara,Ampara,Kalmunai,Eastern,7176,7576,14752,287040,303040,590080
6/3/2024,Kaushalya Jayasundara,Ampara,Kalmunai,Eastern,9275,4613,13888,371000,184520,555520
6/4/2024,Kaushalya Jayasundara,Ampara,Kalmunai,Eastern,8847,8426,17273,353880,337040,690920
6/5/2024,Kaushalya Jayasundara,Ampara,Kalmunai,Eastern,2038,179,2217,81520,7160,88680
6/6/2024,Kaushalya Jayasundara,Ampara,Kalmunai,Eastern,7980,375,8355,319200,15000,334200
6/7/2024,Kaushalya Jayasundara,Ampara,Kalmunai,Eastern,5441,2571,8012,217640,102840,320480
6/8/2024,Kaushalya Jayasundara,Ampara,Kalmunai,Eastern,5115,1941,7056,204600,77640,282240
6/9/2024,Kaushalya Jayasundara,Ampara,Kalmunai,Eastern,5473,4694,10167,218920,187760,406680
6/10/2024,Kaushalya Jayasundara,Ampara,Kalmunai,Eastern,4777,9125,13902,191080,365000,556080
6/11/2024,Kaushalya Jayasundara,Ampara,Kalmunai,Eastern,3816,3012,6828,152640,120480,273120
6/12/2024,Kaushalya Jayasundara,Ampara,Kalmunai,Eastern,2637,9205,11842,105480,368200,473680
6/13/2024,Kaushalya Jayasundara,Ampara,Kalmunai,Eastern,9994,7165,17159,399760,286600,686360
6/14/2024,Kaushalya Jayasundara,Ampara,Kalmunai,Eastern,1854,4151,6005,74160,166040,240200
6/15/2024,Kaushalya Jayasundara,Ampara,Kalmunai,Eastern,244,1151,1395,9760,46040,55800
6/16/2024,Kaushalya Jayasundara,Ampara,Kalmunai,Eastern,702,4672,5374,28080,186880,214960
6/17/2024,Kaushalya Jayasundara,Ampara,Kalmunai,Eastern,3510,9490,13000,140400,379600,520000
6/18/2024,Kaushalya Jayasundara,Ampara,Kalmunai,Eastern,7834,6529,14363,313360,261160,574520
6/19/2024,Kaushalya Jayasundara,Ampara,Kalmunai,Eastern,8974,4677,13651,358960,187080,546040
6/20/2024,Kaushalya Jayasundara,Ampara,Kalmunai,Eastern,3999,3805,7804,159960,152200,312160
6/21/2024,Kaushalya Jayasundara,Ampara,Kalmunai,Eastern,1540,9763,11303,61600,390520,452120
6/22/2024,Kaushalya Jayasundara,Ampara,Kalmunai,Eastern,5907,9192,15099,236280,367680,603960
6/23/2024,Kaushalya Jayasundara,Ampara,Kalmunai,Eastern,3244,196,3440,129760,7840,137600
6/24/2024,Kaushalya Jayasundara,Ampara,Kalmunai,Eastern,9356,6011,15367,374240,240440,614680
6/25/2024,Kaushalya Jayasundara,Ampara,Kalmunai,Eastern,8294,6735,15029,331760,269400,601160
6/26/2024,Kaushalya Jayasundara,Ampara,Kalmunai,Eastern,4235,3882,8117,169400,155280,324680
6/27/2024,Kaushalya Jayasundara,Ampara,Kalmunai,Eastern,1962,3037,4999,78480,121480,199960
6/28/2024,Kaushalya Jayasundara,Ampara,Kalmunai,Eastern,4253,1532,5785,170120,61280,231400
6/29/2024,Kaushalya Jayasundara,Ampara,Kalmunai,Eastern,7532,3384,10916,301280,135360,436640
6/30/2024,Kaushalya Jayasundara,Ampara,Kalmunai,Eastern,7090,4031,11121,283600,161240,444840
7/1/2024,Kaushalya Jayasundara,Ampara,Kalmunai,Eastern,319,2977,3296,12760,119080,131840
7/2/2024,Kaushalya Jayasundara,Ampara,Kalmunai,Eastern,425,2110,2535,17000,84400,101400
7/3/2024,Kaushalya Jayasundara,Ampara,Kalmunai,Eastern,8118,6926,15044,324720,277040,601760
7/4/2024,Kaushalya Jayasundara,Ampara,Kalmunai,Eastern,6946,5744,12690,277840,229760,507600
7/5/2024,Kaushalya Jayasundara,Ampara,Kalmunai,Eastern,352,8162,8514,14080,326480,340560
7/6/2024,Kaushalya Jayasundara,Ampara,Kalmunai,Eastern,9904,1041,10945,396160,41640,437800
7/7/2024,Kaushalya Jayasundara,Ampara,Kalmunai,Eastern,3839,91,3930,153560,3640,157200
7/8/2024,Kaushalya Jayasundara,Ampara,Kalmunai,Eastern,4239,6805,11044,169560,272200,441760
7/9/2024,Kaushalya Jayasundara,Ampara,Kalmunai,Eastern,6061,7785,13846,242440,311400,553840
7/10/2024,Kaushalya Jayasundara,Ampara,Kalmunai,Eastern,2422,1093,3515,96880,43720,140600
7/11/2024,Kaushalya Jayasundara,Ampara,Kalmunai,Eastern,3259,9875,13134,130360,395000,525360
7/12/2024,Kaushalya Jayasundara,Ampara,Kalmunai,Eastern,5754,4408,10162,230160,176320,406480
7/13/2024,Kaushalya Jayasundara,Ampara,Kalmunai,Eastern,784,2465,3249,31360,98600,129960
7/14/2024,Kaushalya Jayasundara,Ampara,Kalmunai,Eastern,5473,4016,9489,218920,160640,379560
7/15/2024,Kaushalya Jayasundara,Ampara,Kalmunai,Eastern,8400,7704,16104,336000,308160,644160
7/16/2024,Kaushalya Jayasundara,Ampara,Kalmunai,Eastern,4952,2835,7787,198080,113400,311480
7/17/2024,Kaushalya Jayasundara,Ampara,Kalmunai,Eastern,9582,4061,13643,383280,162440,545720
7/18/2024,Kaushalya Jayasundara,Ampara,Kalmunai,Eastern,3655,6728,10383,146200,269120,415320
7/19/2024,Kaushalya Jayasundara,Ampara,Kalmunai,Eastern,9042,1754,10796,361680,70160,431840
7/20/2024,Kaushalya Jayasundara,Ampara,Kalmunai,Eastern,462,3484,3946,18480,139360,157840
7/21/2024,Kaushalya Jayasundara,Ampara,Kalmunai,Eastern,993,7595,8588,39720,303800,343520
7/22/2024,Kaushalya Jayasundara,Ampara,Kalmunai,Eastern,9008,7776,16784,360320,311040,671360
7/23/2024,Kaushalya Jayasundara,Ampara,Kalmunai,Eastern,6321,8859,15180,252840,354360,607200
7/24/2024,Kaushalya Jayasundara,Ampara,Kalmunai,Eastern,7801,3550,11351,312040,142000,454040
7/25/2024,Kaushalya Jayasundara,Ampara,Kalmunai,Eastern,1700,7026,8726,68000,281040,349040
7/26/2024,Kaushalya Jayasundara,Ampara,Kalmunai,Eastern,3071,2726,5797,122840,109040,231880
7/27/2024,Kaushalya Jayasundara,Ampara,Kalmunai,Eastern,3574,2031,5605,142960,81240,224200
7/28/2024,Kaushalya Jayasundara,Ampara,Kalmunai,Eastern,311,4234,4545,12440,169360,181800
7/29/2024,Kaushalya Jayasundara,Ampara,Kalmunai,Eastern,547,3374,3921,21880,134960,156840
7/30/2024,Kaushalya Jayasundara,Ampara,Kalmunai,Eastern,850,4603,5453,34000,184120,218120
7/31/2024,Kaushalya Jayasundara,Ampara,Kalmunai,Eastern,4308,8269,12577,172320,330760,503080
8/1/2024,Kaushalya Jayasundara,Ampara,Kalmunai,Eastern,1510,3058,4568,60400,122320,182720
8/2/2024,Kaushalya Jayasundara,Ampara,Kalmunai,Eastern,4353,4322,8675,174120,172880,347000
8/3/2024,Kaushalya Jayasundara,Ampara,Kalmunai,Eastern,484,2688,3172,19360,107520,126880
8/4/2024,Kaushalya Jayasundara,Ampara,Kalmunai,Eastern,9796,5007,14803,391840,200280,592120
8/5/2024,Kaushalya Jayasundara,Ampara,Kalmunai,Eastern,3001,7147,10148,120040,285880,405920
8/6/2024,Kaushalya Jayasundara,Ampara,Kalmunai,Eastern,3027,695,3722,121080,27800,148880
8/7/2024,Kaushalya Jayasundara,Ampara,Kalmunai,Eastern,4354,9795,14149,174160,391800,565960
8/8/2024,Kaushalya Jayasundara,Ampara,Kalmunai,Eastern,5672,5762,11434,226880,230480,457360
8/9/2024,Kaushalya Jayasundara,Ampara,Kalmunai,Eastern,5963,4601,10564,238520,184040,422560
8/10/2024,Kaushalya Jayasundara,Ampara,Kalmunai,Eastern,6305,911,7216,252200,36440,288640
8/11/2024,Kaushalya Jayasundara,Ampara,Kalmunai,Eastern,5221,8703,13924,208840,348120,556960
8/12/2024,Kaushalya Jayasundara,Ampara,Kalmunai,Eastern,7760,5191,12951,310400,207640,518040
8/13/2024,Kaushalya Jayasundara,Ampara,Kalmunai,Eastern,8199,6754,14953,327960,270160,598120
8/14/2024,Kaushalya Jayasundara,Ampara,Kalmunai,Eastern,5787,4310,10097,231480,172400,403880
8/15/2024,Kaushalya Jayasundara,Ampara,Kalmunai,Eastern,9419,2519,11938,376760,100760,477520
8/16/2024,Kaushalya Jayasundara,Ampara,Kalmunai,Eastern,7995,3084,11079,319800,123360,443160
8/17/2024,Kaushalya Jayasundara,Ampara,Kalmunai,Eastern,7135,2349,9484,285400,93960,379360
8/18/2024,Kaushalya Jayasundara,Ampara,Kalmunai,Eastern,4133,7004,11137,165320,280160,445480
8/19/2024,Kaushalya Jayasundara,Ampara,Kalmunai,Eastern,4461,1493,5954,178440,59720,238160
8/20/2024,Kaushalya Jayasundara,Ampara,Kalmunai,Eastern,649,2402,3051,25960,96080,122040
8/21/2024,Kaushalya Jayasundara,Ampara,Kalmunai,Eastern,4599,1752,6351,183960,70080,254040
8/22/2024,Kaushalya Jayasundara,Ampara,Kalmunai,Eastern,5555,8097,13652,222200,323880,546080
8/23/2024,Kaushalya Jayasundara,Ampara,Kalmunai,Eastern,4644,1580,6224,185760,63200,248960
8/24/2024,Kaushalya Jayasundara,Ampara,Kalmunai,Eastern,6347,7636,13983,253880,305440,559320
8/25/2024,Kaushalya Jayasundara,Ampara,Kalmunai,Eastern,805,2372,3177,32200,94880,127080
8/26/2024,Kaushalya Jayasundara,Ampara,Kalmunai,Eastern,983,5545,6528,39320,221800,261120
8/27/2024,Kaushalya Jayasundara,Ampara,Kalmunai,Eastern,3023,7805,10828,120920,312200,433120
8/28/2024,Kaushalya Jayasundara,Ampara,Kalmunai,Eastern,4672,7782,12454,186880,311280,498160
8/29/2024,Kaushalya Jayasundara,Ampara,Kalmunai,Eastern,4146,2247,6393,165840,89880,255720
8/30/2024,Kaushalya Jayasundara,Ampara,Kalmunai,Eastern,4686,7321,12007,187440,292840,480280
8/31/2024,Kaushalya Jayasundara,Ampara,Kalmunai,Eastern,6616,2670,9286,264640,106800,371440
9/1/2024,Kaushalya Jayasundara,Ampara,Kalmunai,Eastern,6841,5189,12030,273640,207560,481200
9/2/2024,Kaushalya Jayasundara,Ampara,Kalmunai,Eastern,7399,6402,13801,295960,256080,552040
9/3/2024,Kaushalya Jayasundara,Ampara,Kalmunai,Eastern,49,4975,5024,1960,199000,200960
9/4/2024,Kaushalya Jayasundara,Ampara,Kalmunai,Eastern,8010,1420,9430,320400,56800,377200
9/5/2024,Kaushalya Jayasundara,Ampara,Kalmunai,Eastern,4567,3219,7786,182680,128760,311440
9/6/2024,Kaushalya Jayasundara,Ampara,Kalmunai,Eastern,3596,6395,9991,143840,255800,399640
9/7/2024,Kaushalya Jayasundara,Ampara,Kalmunai,Eastern,237,2483,2720,9480,99320,108800
9/8/2024,Kaushalya Jayasundara,Ampara,Kalmunai,Eastern,987,4114,5101,39480,164560,204040
9/9/2024,Kaushalya Jayasundara,Ampara,Kalmunai,Eastern,1349,9741,11090,53960,389640,443600
9/10/2024,Kaushalya Jayasundara,Ampara,Kalmunai,Eastern,879,7814,8693,35160,312560,347720
9/11/2024,Kaushalya Jayasundara,Ampara,Kalmunai,Eastern,7744,1808,9552,309760,72320,382080
9/12/2024,Kaushalya Jayasundara,Ampara,Kalmunai,Eastern,4217,5964,10181,168680,238560,407240
9/13/2024,Kaushalya Jayasundara,Ampara,Kalmunai,Eastern,7931,9553,17484,317240,382120,699360
9/14/2024,Kaushalya Jayasundara,Ampara,Kalmunai,Eastern,8329,9799,18128,333160,391960,725120
9/15/2024,Kaushalya Jayasundara,Ampara,Kalmunai,Eastern,3656,8763,12419,146240,350520,496760
9/16/2024,Kaushalya Jayasundara,Ampara,Kalmunai,Eastern,9611,5133,14744,384440,205320,589760
9/17/2024,Kaushalya Jayasundara,Ampara,Kalmunai,Eastern,5738,4756,10494,229520,190240,419760
9/18/2024,Kaushalya Jayasundara,Ampara,Kalmunai,Eastern,2113,7461,9574,84520,298440,382960
9/19/2024,Kaushalya Jayasundara,Ampara,Kalmunai,Eastern,6192,2348,8540,247680,93920,341600
9/20/2024,Kaushalya Jayasundara,Ampara,Kalmunai,Eastern,146,9502,9648,5840,380080,385920
9/21/2024,Kaushalya Jayasundara,Ampara,Kalmunai,Eastern,5109,4832,9941,204360,193280,397640
9/22/2024,Kaushalya Jayasundara,Ampara,Kalmunai,Eastern,1650,8805,10455,66000,352200,418200
9/23/2024,Kaushalya Jayasundara,Ampara,Kalmunai,Eastern,3861,1382,5243,154440,55280,209720
9/24/2024,Kaushalya Jayasundara,Ampara,Kalmunai,Eastern,3077,7936,11013,123080,317440,440520
9/25/2024,Kaushalya Jayasundara,Ampara,Kalmunai,Eastern,4093,5077,9170,163720,203080,366800
9/26/2024,Kaushalya Jayasundara,Ampara,Kalmunai,Eastern,4147,8330,12477,165880,333200,499080
9/27/2024,Kaushalya Jayasundara,Ampara,Kalmunai,Eastern,7681,1053,8734,307240,42120,349360
9/28/2024,Kaushalya Jayasundara,Ampara,Kalmunai,Eastern,8885,2128,11013,355400,85120,440520
9/29/2024,Kaushalya Jayasundara,Ampara,Kalmunai,Eastern,7972,9161,17133,318880,366440,685320
9/30/2024,Kaushalya Jayasundara,Ampara,Kalmunai,Eastern,7316,1098,8414,292640,43920,336560
10/1/2024,Kaushalya Jayasundara,Ampara,Kalmunai,Eastern,2665,1146,3811,106600,45840,152440
10/2/2024,Kaushalya Jayasundara,Ampara,Kalmunai,Eastern,1261,9083,10344,50440,363320,413760
10/3/2024,Kaushalya Jayasundara,Ampara,Kalmunai,Eastern,8709,4868,13577,348360,194720,543080
10/4/2024,Kaushalya Jayasundara,Ampara,Kalmunai,Eastern,3636,5959,9595,145440,238360,383800
10/5/2024,Kaushalya Jayasundara,Ampara,Kalmunai,Eastern,1091,8171,9262,43640,326840,370480
10/6/2024,Kaushalya Jayasundara,Ampara,Kalmunai,Eastern,2902,7830,10732,116080,313200,429280
10/7/2024,Kaushalya Jayasundara,Ampara,Kalmunai,Eastern,167,4535,4702,6680,181400,188080
10/8/2024,Kaushalya Jayasundara,Ampara,Kalmunai,Eastern,7645,9235,16880,305800,369400,675200
10/9/2024,Kaushalya Jayasundara,Ampara,Kalmunai,Eastern,2996,7496,10492,119840,299840,419680
10/10/2024,Kaushalya Jayasundara,Ampara,Kalmunai,Eastern,1578,202,1780,63120,8080,71200
10/11/2024,Kaushalya Jayasundara,Ampara,Kalmunai,Eastern,5989,7453,13442,239560,298120,537680
10/12/2024,Kaushalya Jayasundara,Ampara,Kalmunai,Eastern,5191,9669,14860,207640,386760,594400
10/13/2024,Kaushalya Jayasundara,Ampara,Kalmunai,Eastern,2986,1451,4437,119440,58040,177480
10/14/2024,Kaushalya Jayasundara,Ampara,Kalmunai,Eastern,7908,5475,13383,316320,219000,535320
10/15/2024,Kaushalya Jayasundara,Ampara,Kalmunai,Eastern,8150,4236,12386,326000,169440,495440
10/16/2024,Kaushalya Jayasundara,Ampara,Kalmunai,Eastern,6637,6599,13236,265480,263960,529440
10/17/2024,Kaushalya Jayasundara,Ampara,Kalmunai,Eastern,1385,5279,6664,55400,211160,266560
10/18/2024,Kaushalya Jayasundara,Ampara,Kalmunai,Eastern,621,4125,4746,24840,165000,189840
10/19/2024,Kaushalya Jayasundara,Ampara,Kalmunai,Eastern,9551,8548,18099,382040,341920,723960
10/20/2024,Kaushalya Jayasundara,Ampara,Kalmunai,Eastern,7848,5037,12885,313920,201480,515400
10/21/2024,Kaushalya Jayasundara,Ampara,Kalmunai,Eastern,3170,4992,8162,126800,199680,326480
10/22/2024,Kaushalya Jayasundara,Ampara,Kalmunai,Eastern,9443,9560,19003,377720,382400,760120
10/23/2024,Kaushalya Jayasundara,Ampara,Kalmunai,Eastern,889,152,1041,35560,6080,41640
10/24/2024,Kaushalya Jayasundara,Ampara,Kalmunai,Eastern,2140,9536,11676,85600,381440,467040
10/25/2024,Kaushalya Jayasundara,Ampara,Kalmunai,Eastern,8140,4900,13040,325600,196000,521600
10/26/2024,Kaushalya Jayasundara,Ampara,Kalmunai,Eastern,1361,9537,10898,54440,381480,435920
10/27/2024,Kaushalya Jayasundara,Ampara,Kalmunai,Eastern,9701,8379,18080,388040,335160,723200
10/28/2024,Kaushalya Jayasundara,Ampara,Kalmunai,Eastern,1649,2571,4220,65960,102840,168800
10/29/2024,Kaushalya Jayasundara,Ampara,Kalmunai,Eastern,6686,1106,7792,267440,44240,311680
10/30/2024,Kaushalya Jayasundara,Ampara,Kalmunai,Eastern,2629,7022,9651,105160,280880,386040
10/31/2024,Kaushalya Jayasundara,Ampara,Kalmunai,Eastern,8150,8071,16221,326000,322840,648840
11/1/2024,Kaushalya Jayasundara,Ampara,Kalmunai,Eastern,3613,3384,6997,144520,135360,279880
11/2/2024,Kaushalya Jayasundara,Ampara,Kalmunai,Eastern,3639,5865,9504,145560,234600,380160
11/3/2024,Kaushalya Jayasundara,Ampara,Kalmunai,Eastern,828,9577,10405,33120,383080,416200
11/4/2024,Kaushalya Jayasundara,Ampara,Kalmunai,Eastern,7478,649,8127,299120,25960,325080
11/5/2024,Kaushalya Jayasundara,Ampara,Kalmunai,Eastern,2289,9986,12275,91560,399440,491000
11/6/2024,Kaushalya Jayasundara,Ampara,Kalmunai,Eastern,223,24,247,8920,960,9880
11/7/2024,Kaushalya Jayasundara,Ampara,Kalmunai,Eastern,1270,9934,11204,50800,397360,448160
11/8/2024,Kaushalya Jayasundara,Ampara,Kalmunai,Eastern,1236,4191,5427,49440,167640,217080
11/9/2024,Kaushalya Jayasundara,Ampara,Kalmunai,Eastern,4887,8676,13563,195480,347040,542520
11/10/2024,Kaushalya Jayasundara,Ampara,Kalmunai,Eastern,1515,5120,6635,60600,204800,265400
11/11/2024,Kaushalya Jayasundara,Ampara,Kalmunai,Eastern,6822,4401,11223,272880,176040,448920
11/12/2024,Kaushalya Jayasundara,Ampara,Kalmunai,Eastern,6301,4153,10454,252040,166120,418160
11/13/2024,Kaushalya Jayasundara,Ampara,Kalmunai,Eastern,8261,5571,13832,330440,222840,553280
11/14/2024,Kaushalya Jayasundara,Ampara,Kalmunai,Eastern,1196,340,1536,47840,13600,61440
11/15/2024,Kaushalya Jayasundara,Ampara,Kalmunai,Eastern,8075,5514,13589,323000,220560,543560
11/16/2024,Kaushalya Jayasundara,Ampara,Kalmunai,Eastern,5456,3720,9176,218240,148800,367040
11/17/2024,Kaushalya Jayasundara,Ampara,Kalmunai,Eastern,3752,6910,10662,150080,276400,426480
11/18/2024,Kaushalya Jayasundara,Ampara,Kalmunai,Eastern,9706,3960,13666,388240,158400,546640
11/19/2024,Kaushalya Jayasundara,Ampara,Kalmunai,Eastern,3755,545,4300,150200,21800,172000
11/20/2024,Kaushalya Jayasundara,Ampara,Kalmunai,Eastern,2547,4549,7096,101880,181960,283840
11/21/2024,Kaushalya Jayasundara,Ampara,Kalmunai,Eastern,3768,1539,5307,150720,61560,212280
11/22/2024,Kaushalya Jayasundara,Ampara,Kalmunai,Eastern,5426,8967,14393,217040,358680,575720
11/23/2024,Kaushalya Jayasundara,Ampara,Kalmunai,Eastern,6072,2037,8109,242880,81480,324360
11/24/2024,Kaushalya Jayasundara,Ampara,Kalmunai,Eastern,7059,382,7441,282360,15280,297640
11/25/2024,Kaushalya Jayasundara,Ampara,Kalmunai,Eastern,5626,7972,13598,225040,318880,543920
11/26/2024,Kaushalya Jayasundara,Ampara,Kalmunai,Eastern,7053,5383,12436,282120,215320,497440
11/27/2024,Kaushalya Jayasundara,Ampara,Kalmunai,Eastern,2874,8364,11238,114960,334560,449520
11/28/2024,Kaushalya Jayasundara,Ampara,Kalmunai,Eastern,7885,9349,17234,315400,373960,689360
11/29/2024,Kaushalya Jayasundara,Ampara,Kalmunai,Eastern,5716,2151,7867,228640,86040,314680
11/30/2024,Kaushalya Jayasundara,Ampara,Kalmunai,Eastern,4870,8432,13302,194800,337280,532080
12/1/2024,Kaushalya Jayasundara,Ampara,Kalmunai,Eastern,7353,5679,13032,294120,227160,521280
12/2/2024,Kaushalya Jayasundara,Ampara,Kalmunai,Eastern,6011,7832,13843,240440,313280,553720
12/3/2024,Kaushalya Jayasundara,Ampara,Kalmunai,Eastern,1675,2687,4362,67000,107480,174480
12/4/2024,Kaushalya Jayasundara,Ampara,Kalmunai,Eastern,3235,9036,12271,129400,361440,490840
12/5/2024,Kaushalya Jayasundara,Ampara,Kalmunai,Eastern,9153,4993,14146,366120,199720,565840
12/6/2024,Kaushalya Jayasundara,Ampara,Kalmunai,Eastern,2738,5497,8235,109520,219880,329400
12/7/2024,Kaushalya Jayasundara,Ampara,Kalmunai,Eastern,704,7933,8637,28160,317320,345480
12/8/2024,Kaushalya Jayasundara,Ampara,Kalmunai,Eastern,8780,4416,13196,351200,176640,527840
12/9/2024,Kaushalya Jayasundara,Ampara,Kalmunai,Eastern,7590,823,8413,303600,32920,336520
12/10/2024,Kaushalya Jayasundara,Ampara,Kalmunai,Eastern,9341,4020,13361,373640,160800,534440
12/11/2024,Kaushalya Jayasundara,Ampara,Kalmunai,Eastern,3967,8487,12454,158680,339480,498160
12/12/2024,Kaushalya Jayasundara,Ampara,Kalmunai,Eastern,3259,1765,5024,130360,70600,200960
12/13/2024,Kaushalya Jayasundara,Ampara,Kalmunai,Eastern,450,1350,1800,18000,54000,72000
12/14/2024,Kaushalya Jayasundara,Ampara,Kalmunai,Eastern,3147,5276,8423,125880,211040,336920
12/15/2024,Kaushalya Jayasundara,Ampara,Kalmunai,Eastern,1131,1897,3028,45240,75880,121120
12/16/2024,Kaushalya Jayasundara,Ampara,Kalmunai,Eastern,7509,259,7768,300360,10360,310720
12/17/2024,Kaushalya Jayasundara,Ampara,Kalmunai,Eastern,9069,8288,17357,362760,331520,694280
12/18/2024,Kaushalya Jayasundara,Ampara,Kalmunai,Eastern,3890,596,4486,155600,23840,179440
12/19/2024,Kaushalya Jayasundara,Ampara,Kalmunai,Eastern,4991,2136,7127,199640,85440,285080
12/20/2024,Kaushalya Jayasundara,Ampara,Kalmunai,Eastern,6076,5978,12054,243040,239120,482160
12/21/2024,Kaushalya Jayasundara,Ampara,Kalmunai,Eastern,4709,9052,13761,188360,362080,550440
12/22/2024,Kaushalya Jayasundara,Ampara,Kalmunai,Eastern,9204,5116,14320,368160,204640,572800
12/23/2024,Kaushalya Jayasundara,Ampara,Kalmunai,Eastern,5635,7635,13270,225400,305400,530800
12/24/2024,Kaushalya Jayasundara,Ampara,Kalmunai,Eastern,1625,6837,8462,65000,273480,338480
12/25/2024,Kaushalya Jayasundara,Ampara,Kalmunai,Eastern,3200,7093,10293,128000,283720,411720
12/26/2024,Kaushalya Jayasundara,Ampara,Kalmunai,Eastern,9450,2056,11506,378000,82240,460240
12/27/2024,Kaushalya Jayasundara,Ampara,Kalmunai,Eastern,3661,9617,13278,146440,384680,531120
12/28/2024,Kaushalya Jayasundara,Ampara,Kalmunai,Eastern,7205,9100,16305,288200,364000,652200
12/29/2024,Kaushalya Jayasundara,Ampara,Kalmunai,Eastern,9019,1325,10344,360760,53000,413760
12/30/2024,Kaushalya Jayasundara,Ampara,Kalmunai,Eastern,3025,4368,7393,121000,174720,295720
12/31/2024,Kaushalya Jayasundara,Ampara,Kalmunai,Eastern,8196,2109,10305,327840,84360,412200
1/1/2025,Kaushalya Jayasundara,Ampara,Kalmunai,Eastern,877,769,1646,35080,30760,65840
1/2/2025,Kaushalya Jayasundara,Ampara,Kalmunai,Eastern,8256,2908,11164,330240,116320,446560
1/3/2025,Kaushalya Jayasundara,Ampara,Kalmunai,Eastern,9743,1113,10856,389720,44520,434240
1/4/2025,Kaushalya Jayasundara,Ampara,Kalmunai,Eastern,8425,3322,11747,337000,132880,469880
1/5/2025,Kaushalya Jayasundara,Ampara,Kalmunai,Eastern,3790,5069,8859,151600,202760,354360
1/6/2025,Kaushalya Jayasundara,Ampara,Kalmunai,Eastern,528,9133,9661,21120,365320,386440
1/7/2025,Kaushalya Jayasundara,Ampara,Kalmunai,Eastern,7412,1239,8651,296480,49560,346040
1/8/2025,Kaushalya Jayasundara,Ampara,Kalmunai,Eastern,2062,1170,3232,82480,46800,129280
1/9/2025,Kaushalya Jayasundara,Ampara,Kalmunai,Eastern,5928,1096,7024,237120,43840,280960
1/10/2025,Kaushalya Jayasundara,Ampara,Kalmunai,Eastern,1012,7855,8867,40480,314200,354680
1/11/2025,Kaushalya Jayasundara,Ampara,Kalmunai,Eastern,7019,9544,16563,280760,381760,662520
1/12/2025,Kaushalya Jayasundara,Ampara,Kalmunai,Eastern,341,4332,4673,13640,173280,186920
1/13/2025,Kaushalya Jayasundara,Ampara,Kalmunai,Eastern,1130,4533,5663,45200,181320,226520
1/14/2025,Kaushalya Jayasundara,Ampara,Kalmunai,Eastern,6802,3501,10303,272080,140040,412120
1/15/2025,Kaushalya Jayasundara,Ampara,Kalmunai,Eastern,1764,6333,8097,70560,253320,323880
1/16/2025,Kaushalya Jayasundara,Ampara,Kalmunai,Eastern,9257,145,9402,370280,5800,376080
1/17/2025,Kaushalya Jayasundara,Ampara,Kalmunai,Eastern,7764,3531,11295,310560,141240,451800
1/18/2025,Kaushalya Jayasundara,Ampara,Kalmunai,Eastern,6337,669,7006,253480,26760,280240
1/19/2025,Kaushalya Jayasundara,Ampara,Kalmunai,Eastern,7462,7521,14983,298480,300840,599320
1/20/2025,Kaushalya Jayasundara,Ampara,Kalmunai,Eastern,7618,1368,8986,304720,54720,359440
1/21/2025,Kaushalya Jayasundara,Ampara,Kalmunai,Eastern,8181,4270,12451,327240,170800,498040
1/22/2025,Kaushalya Jayasundara,Ampara,Kalmunai,Eastern,2711,3056,5767,108440,122240,230680
1/23/2025,Kaushalya Jayasundara,Ampara,Kalmunai,Eastern,4036,6051,10087,161440,242040,403480
1/24/2025,Kaushalya Jayasundara,Ampara,Kalmunai,Eastern,405,8841,9246,16200,353640,369840
1/25/2025,Kaushalya Jayasundara,Ampara,Kalmunai,Eastern,2106,9811,11917,84240,392440,476680
1/26/2025,Kaushalya Jayasundara,Ampara,Kalmunai,Eastern,2198,7817,10015,87920,312680,400600
1/27/2025,Kaushalya Jayasundara,Ampara,Kalmunai,Eastern,7097,4116,11213,283880,164640,448520
1/28/2025,Kaushalya Jayasundara,Ampara,Kalmunai,Eastern,120,935,1055,4800,37400,42200
1/29/2025,Kaushalya Jayasundara,Ampara,Kalmunai,Eastern,4247,3565,7812,169880,142600,312480
1/30/2025,Kaushalya Jayasundara,Ampara,Kalmunai,Eastern,6660,4309,10969,266400,172360,438760
1/31/2025,Kaushalya Jayasundara,Ampara,Kalmunai,Eastern,9740,5550,15290,389600,222000,611600
2/1/2025,Kaushalya Jayasundara,Ampara,Kalmunai,Eastern,1018,8974,9992,40720,358960,399680
2/2/2025,Kaushalya Jayasundara,Ampara,Kalmunai,Eastern,9698,6758,16456,387920,270320,658240
2/3/2025,Kaushalya Jayasundara,Ampara,Kalmunai,Eastern,3202,338,3540,128080,13520,141600
2/4/2025,Kaushalya Jayasundara,Ampara,Kalmunai,Eastern,3290,2240,5530,131600,89600,221200
2/5/2025,Kaushalya Jayasundara,Ampara,Kalmunai,Eastern,212,6649,6861,8480,265960,274440
2/6/2025,Kaushalya Jayasundara,Ampara,Kalmunai,Eastern,7535,1122,8657,301400,44880,346280
2/7/2025,Kaushalya Jayasundara,Ampara,Kalmunai,Eastern,6904,6490,13394,276160,259600,535760
2/8/2025,Kaushalya Jayasundara,Ampara,Kalmunai,Eastern,8105,8197,16302,324200,327880,652080
2/9/2025,Kaushalya Jayasundara,Ampara,Kalmunai,Eastern,4721,6561,11282,188840,262440,451280
2/10/2025,Kaushalya Jayasundara,Ampara,Kalmunai,Eastern,4764,2247,7011,190560,89880,280440
2/11/2025,Kaushalya Jayasundara,Ampara,Kalmunai,Eastern,310,3444,3754,12400,137760,150160
2/12/2025,Kaushalya Jayasundara,Ampara,Kalmunai,Eastern,6234,412,6646,249360,16480,265840
2/13/2025,Kaushalya Jayasundara,Ampara,Kalmunai,Eastern,5134,9871,15005,205360,394840,600200
2/14/2025,Kaushalya Jayasundara,Ampara,Kalmunai,Eastern,4135,673,4808,165400,26920,192320
2/15/2025,Kaushalya Jayasundara,Ampara,Kalmunai,Eastern,8911,1225,10136,356440,49000,405440
2/16/2025,Kaushalya Jayasundara,Ampara,Kalmunai,Eastern,278,1792,2070,11120,71680,82800
2/17/2025,Kaushalya Jayasundara,Ampara,Kalmunai,Eastern,9933,5669,15602,397320,226760,624080
2/18/2025,Kaushalya Jayasundara,Ampara,Kalmunai,Eastern,8875,9210,18085,355000,368400,723400
2/19/2025,Kaushalya Jayasundara,Ampara,Kalmunai,Eastern,8872,3099,11971,354880,123960,478840
2/20/2025,Kaushalya Jayasundara,Ampara,Kalmunai,Eastern,6944,6753,13697,277760,270120,547880
2/21/2025,Kaushalya Jayasundara,Ampara,Kalmunai,Eastern,1756,4926,6682,70240,197040,267280
2/22/2025,Kaushalya Jayasundara,Ampara,Kalmunai,Eastern,7894,6611,14505,315760,264440,580200
2/23/2025,Kaushalya Jayasundara,Ampara,Kalmunai,Eastern,8945,8756,17701,357800,350240,708040
2/24/2025,Kaushalya Jayasundara,Ampara,Kalmunai,Eastern,4608,195,4803,184320,7800,192120
2/25/2025,Kaushalya Jayasundara,Ampara,Kalmunai,Eastern,6925,2066,8991,277000,82640,359640
2/26/2025,Kaushalya Jayasundara,Ampara,Kalmunai,Eastern,8297,9677,17974,331880,387080,718960
2/27/2025,Kaushalya Jayasundara,Ampara,Kalmunai,Eastern,7357,2041,9398,294280,81640,375920
2/28/2025,Kaushalya Jayasundara,Ampara,Kalmunai,Eastern,742,3907,4649,29680,156280,185960
3/1/2025,Kaushalya Jayasundara,Ampara,Kalmunai,Eastern,1888,809,2697,75520,32360,107880
3/2/2025,Kaushalya Jayasundara,Ampara,Kalmunai,Eastern,6933,2786,9719,277320,111440,388760
3/3/2025,Kaushalya Jayasundara,Ampara,Kalmunai,Eastern,2487,5553,8040,99480,222120,321600
3/4/2025,Kaushalya Jayasundara,Ampara,Kalmunai,Eastern,7395,6119,13514,295800,244760,540560
3/5/2025,Kaushalya Jayasundara,Ampara,Kalmunai,Eastern,6695,5247,11942,267800,209880,477680
3/6/2025,Kaushalya Jayasundara,Ampara,Kalmunai,Eastern,7452,345,7797,298080,13800,311880
3/7/2025,Kaushalya Jayasundara,Ampara,Kalmunai,Eastern,2277,8340,10617,91080,333600,424680
3/8/2025,Kaushalya Jayasundara,Ampara,Kalmunai,Eastern,5247,1688,6935,209880,67520,277400
3/9/2025,Kaushalya Jayasundara,Ampara,Kalmunai,Eastern,8771,4319,13090,350840,172760,523600
3/10/2025,Kaushalya Jayasundara,Ampara,Kalmunai,Eastern,7713,5430,13143,308520,217200,525720
3/11/2025,Kaushalya Jayasundara,Ampara,Kalmunai,Eastern,3999,9733,13732,159960,389320,549280
3/12/2025,Kaushalya Jayasundara,Ampara,Kalmunai,Eastern,609,4369,4978,24360,174760,199120
3/13/2025,Kaushalya Jayasundara,Ampara,Kalmunai,Eastern,8646,4993,13639,345840,199720,545560
3/14/2025,Kaushalya Jayasundara,Ampara,Kalmunai,Eastern,9443,8719,18162,377720,348760,726480
3/15/2025,Kaushalya Jayasundara,Ampara,Kalmunai,Eastern,1816,3808,5624,72640,152320,224960
3/16/2025,Kaushalya Jayasundara,Ampara,Kalmunai,Eastern,6579,7435,14014,263160,297400,560560
3/17/2025,Kaushalya Jayasundara,Ampara,Kalmunai,Eastern,2498,2548,5046,99920,101920,201840
3/18/2025,Kaushalya Jayasundara,Ampara,Kalmunai,Eastern,4268,3445,7713,170720,137800,308520
3/19/2025,Kaushalya Jayasundara,Ampara,Kalmunai,Eastern,4074,3333,7407,162960,133320,296280
3/20/2025,Kaushalya Jayasundara,Ampara,Kalmunai,Eastern,6209,1264,7473,248360,50560,298920
3/21/2025,Kaushalya Jayasundara,Ampara,Kalmunai,Eastern,5427,7090,12517,217080,283600,500680
3/22/2025,Kaushalya Jayasundara,Ampara,Kalmunai,Eastern,4296,3955,8251,171840,158200,330040
3/23/2025,Kaushalya Jayasundara,Ampara,Kalmunai,Eastern,2034,9938,11972,81360,397520,478880
3/25/2024,Ashani Tharanga,Badulla,Badulla,Uva,602,5055,5657,24080,202200,226280
3/26/2024,Ashani Tharanga,Badulla,Badulla,Uva,4726,1507,6233,189040,60280,249320
3/27/2024,Ashani Tharanga,Badulla,Badulla,Uva,9502,2485,11987,380080,99400,479480
3/28/2024,Ashani Tharanga,Badulla,Badulla,Uva,7453,2053,9506,298120,82120,380240
3/29/2024,Ashani Tharanga,Badulla,Badulla,Uva,7644,2648,10292,305760,105920,411680
3/30/2024,Ashani Tharanga,Badulla,Badulla,Uva,2900,1509,4409,116000,60360,176360
3/31/2024,Ashani Tharanga,Badulla,Badulla,Uva,228,8377,8605,9120,335080,344200
4/1/2024,Ashani Tharanga,Badulla,Badulla,Uva,9155,9404,18559,366200,376160,742360
4/2/2024,Ashani Tharanga,Badulla,Badulla,Uva,2767,4543,7310,110680,181720,292400
4/3/2024,Ashani Tharanga,Badulla,Badulla,Uva,3857,3434,7291,154280,137360,291640
4/4/2024,Ashani Tharanga,Badulla,Badulla,Uva,4481,6910,11391,179240,276400,455640
4/5/2024,Ashani Tharanga,Badulla,Badulla,Uva,5909,7167,13076,236360,286680,523040
4/6/2024,Ashani Tharanga,Badulla,Badulla,Uva,3679,7947,11626,147160,317880,465040
4/7/2024,Ashani Tharanga,Badulla,Badulla,Uva,9613,4839,14452,384520,193560,578080
4/8/2024,Ashani Tharanga,Badulla,Badulla,Uva,6269,3033,9302,250760,121320,372080
4/9/2024,Ashani Tharanga,Badulla,Badulla,Uva,1433,336,1769,57320,13440,70760
4/10/2024,Ashani Tharanga,Badulla,Badulla,Uva,1185,3092,4277,47400,123680,171080
4/11/2024,Ashani Tharanga,Badulla,Badulla,Uva,3178,1101,4279,127120,44040,171160
4/19/2024,Ashani Tharanga,Badulla,Badulla,Uva,9223,7190,16413,368920,287600,656520
4/20/2024,Ashani Tharanga,Badulla,Badulla,Uva,7151,6212,13363,286040,248480,534520
4/21/2024,Ashani Tharanga,Badulla,Badulla,Uva,3278,4512,7790,131120,180480,311600
4/22/2024,Ashani Tharanga,Badulla,Badulla,Uva,1328,7928,9256,53120,317120,370240
4/23/2024,Ashani Tharanga,Badulla,Badulla,Uva,2733,5348,8081,109320,213920,323240
4/24/2024,Ashani Tharanga,Badulla,Badulla,Uva,6145,9268,15413,245800,370720,616520
4/25/2024,Ashani Tharanga,Badulla,Badulla,Uva,6529,6496,13025,261160,259840,521000
4/26/2024,Ashani Tharanga,Badulla,Badulla,Uva,4261,201,4462,170440,8040,178480
4/27/2024,Ashani Tharanga,Badulla,Badulla,Uva,6085,3514,9599,243400,140560,383960
4/28/2024,Ashani Tharanga,Badulla,Badulla,Uva,3509,4139,7648,140360,165560,305920
4/29/2024,Ashani Tharanga,Badulla,Badulla,Uva,3468,1266,4734,138720,50640,189360
4/30/2024,Ashani Tharanga,Badulla,Badulla,Uva,8161,6152,14313,326440,246080,572520
5/1/2024,Ashani Tharanga,Badulla,Badulla,Uva,3291,1767,5058,131640,70680,202320
5/2/2024,Ashani Tharanga,Badulla,Badulla,Uva,1174,113,1287,46960,4520,51480
5/3/2024,Ashani Tharanga,Badulla,Badulla,Uva,9390,7899,17289,375600,315960,691560
5/4/2024,Ashani Tharanga,Badulla,Badulla,Uva,2347,860,3207,93880,34400,128280
5/5/2024,Ashani Tharanga,Badulla,Badulla,Uva,3642,8554,12196,145680,342160,487840
5/6/2024,Ashani Tharanga,Badulla,Badulla,Uva,71,6445,6516,2840,257800,260640
5/7/2024,Ashani Tharanga,Badulla,Badulla,Uva,2720,1872,4592,108800,74880,183680
5/8/2024,Ashani Tharanga,Badulla,Badulla,Uva,7278,8056,15334,291120,322240,613360
5/9/2024,Ashani Tharanga,Badulla,Badulla,Uva,5984,6291,12275,239360,251640,491000
5/10/2024,Ashani Tharanga,Badulla,Badulla,Uva,7407,6103,13510,296280,244120,540400
5/11/2024,Ashani Tharanga,Badulla,Badulla,Uva,3843,4491,8334,153720,179640,333360
5/12/2024,Ashani Tharanga,Badulla,Badulla,Uva,8197,393,8590,327880,15720,343600
5/13/2024,Ashani Tharanga,Badulla,Badulla,Uva,8983,8267,17250,359320,330680,690000
5/14/2024,Ashani Tharanga,Badulla,Badulla,Uva,4325,6769,11094,173000,270760,443760
5/15/2024,Ashani Tharanga,Badulla,Badulla,Uva,7500,2890,10390,300000,115600,415600
5/16/2024,Ashani Tharanga,Badulla,Badulla,Uva,2079,7767,9846,83160,310680,393840
5/17/2024,Ashani Tharanga,Badulla,Badulla,Uva,8779,1420,10199,351160,56800,407960
5/18/2024,Ashani Tharanga,Badulla,Badulla,Uva,5306,6278,11584,212240,251120,463360
5/19/2024,Ashani Tharanga,Badulla,Badulla,Uva,7699,487,8186,307960,19480,327440
5/20/2024,Ashani Tharanga,Badulla,Badulla,Uva,9092,415,9507,363680,16600,380280
5/21/2024,Ashani Tharanga,Badulla,Badulla,Uva,2091,3054,5145,83640,122160,205800
5/22/2024,Ashani Tharanga,Badulla,Badulla,Uva,3910,6876,10786,156400,275040,431440
5/24/2024,Ashani Tharanga,Badulla,Badulla,Uva,9387,5957,15344,375480,238280,613760
5/25/2024,Ashani Tharanga,Badulla,Badulla,Uva,872,6842,7714,34880,273680,308560
5/26/2024,Ashani Tharanga,Badulla,Badulla,Uva,1117,7604,8721,44680,304160,348840
5/27/2024,Ashani Tharanga,Badulla,Badulla,Uva,6000,7295,13295,240000,291800,531800
5/28/2024,Ashani Tharanga,Badulla,Badulla,Uva,8572,3934,12506,342880,157360,500240
5/29/2024,Ashani Tharanga,Badulla,Badulla,Uva,4903,213,5116,196120,8520,204640
5/30/2024,Ashani Tharanga,Badulla,Badulla,Uva,7514,567,8081,300560,22680,323240
5/31/2024,Ashani Tharanga,Badulla,Badulla,Uva,9816,7003,16819,392640,280120,672760
6/1/2024,Ashani Tharanga,Badulla,Badulla,Uva,2047,3101,5148,81880,124040,205920
6/2/2024,Ashani Tharanga,Badulla,Badulla,Uva,8756,5890,14646,350240,235600,585840
6/3/2024,Ashani Tharanga,Badulla,Badulla,Uva,5216,7251,12467,208640,290040,498680
6/4/2024,Ashani Tharanga,Badulla,Badulla,Uva,4388,1128,5516,175520,45120,220640
6/5/2024,Ashani Tharanga,Badulla,Badulla,Uva,7581,303,7884,303240,12120,315360
6/6/2024,Ashani Tharanga,Badulla,Badulla,Uva,6610,4108,10718,264400,164320,428720
6/7/2024,Ashani Tharanga,Badulla,Badulla,Uva,2763,7572,10335,110520,302880,413400
6/8/2024,Ashani Tharanga,Badulla,Badulla,Uva,7310,4328,11638,292400,173120,465520
6/9/2024,Ashani Tharanga,Badulla,Badulla,Uva,5384,358,5742,215360,14320,229680
6/10/2024,Ashani Tharanga,Badulla,Badulla,Uva,2063,9809,11872,82520,392360,474880
6/11/2024,Ashani Tharanga,Badulla,Badulla,Uva,7420,423,7843,296800,16920,313720
6/12/2024,Ashani Tharanga,Badulla,Badulla,Uva,1661,3738,5399,66440,149520,215960
6/13/2024,Ashani Tharanga,Badulla,Badulla,Uva,7618,3122,10740,304720,124880,429600
6/14/2024,Ashani Tharanga,Badulla,Badulla,Uva,3906,4155,8061,156240,166200,322440
6/15/2024,Ashani Tharanga,Badulla,Badulla,Uva,2152,2418,4570,86080,96720,182800
6/16/2024,Ashani Tharanga,Badulla,Badulla,Uva,8726,6807,15533,349040,272280,621320
6/17/2024,Ashani Tharanga,Badulla,Badulla,Uva,9259,3024,12283,370360,120960,491320
6/18/2024,Ashani Tharanga,Badulla,Badulla,Uva,4821,4311,9132,192840,172440,365280
6/19/2024,Ashani Tharanga,Badulla,Badulla,Uva,6543,7605,14148,261720,304200,565920
6/20/2024,Ashani Tharanga,Badulla,Badulla,Uva,9524,2610,12134,380960,104400,485360
6/21/2024,Ashani Tharanga,Badulla,Badulla,Uva,4732,5798,10530,189280,231920,421200
6/22/2024,Ashani Tharanga,Badulla,Badulla,Uva,2286,5699,7985,91440,227960,319400
6/23/2024,Ashani Tharanga,Badulla,Badulla,Uva,216,1816,2032,8640,72640,81280
6/24/2024,Ashani Tharanga,Badulla,Badulla,Uva,2003,633,2636,80120,25320,105440
6/25/2024,Ashani Tharanga,Badulla,Badulla,Uva,2889,1,2890,115560,40,115600
6/26/2024,Ashani Tharanga,Badulla,Badulla,Uva,5639,4047,9686,225560,161880,387440
6/27/2024,Ashani Tharanga,Badulla,Badulla,Uva,4238,3469,7707,169520,138760,308280
6/28/2024,Ashani Tharanga,Badulla,Badulla,Uva,4372,9687,14059,174880,387480,562360
6/29/2024,Ashani Tharanga,Badulla,Badulla,Uva,8494,2805,11299,339760,112200,451960
6/30/2024,Ashani Tharanga,Badulla,Badulla,Uva,5244,5833,11077,209760,233320,443080
7/1/2024,Ashani Tharanga,Badulla,Badulla,Uva,5931,2254,8185,237240,90160,327400
7/2/2024,Ashani Tharanga,Badulla,Badulla,Uva,9082,2751,11833,363280,110040,473320
7/3/2024,Ashani Tharanga,Badulla,Badulla,Uva,1281,5118,6399,51240,204720,255960
7/4/2024,Ashani Tharanga,Badulla,Badulla,Uva,2699,1964,4663,107960,78560,186520
7/5/2024,Ashani Tharanga,Badulla,Badulla,Uva,6440,583,7023,257600,23320,280920
7/6/2024,Ashani Tharanga,Badulla,Badulla,Uva,1365,301,1666,54600,12040,66640
7/7/2024,Ashani Tharanga,Badulla,Badulla,Uva,6507,8758,15265,260280,350320,610600
7/8/2024,Ashani Tharanga,Badulla,Badulla,Uva,4383,9962,14345,175320,398480,573800
7/9/2024,Ashani Tharanga,Badulla,Badulla,Uva,4578,2573,7151,183120,102920,286040
7/10/2024,Ashani Tharanga,Badulla,Badulla,Uva,3013,7578,10591,120520,303120,423640
7/11/2024,Ashani Tharanga,Badulla,Badulla,Uva,3333,1305,4638,133320,52200,185520
7/12/2024,Ashani Tharanga,Badulla,Badulla,Uva,6845,4466,11311,273800,178640,452440
7/13/2024,Ashani Tharanga,Badulla,Badulla,Uva,7475,9343,16818,299000,373720,672720
7/14/2024,Ashani Tharanga,Badulla,Badulla,Uva,4891,2764,7655,195640,110560,306200
7/15/2024,Ashani Tharanga,Badulla,Badulla,Uva,7170,1843,9013,286800,73720,360520
7/16/2024,Ashani Tharanga,Badulla,Badulla,Uva,9465,6868,16333,378600,274720,653320
7/17/2024,Ashani Tharanga,Badulla,Badulla,Uva,4907,1079,5986,196280,43160,239440
7/18/2024,Ashani Tharanga,Badulla,Badulla,Uva,571,4919,5490,22840,196760,219600
7/19/2024,Ashani Tharanga,Badulla,Badulla,Uva,9132,3266,12398,365280,130640,495920
7/20/2024,Ashani Tharanga,Badulla,Badulla,Uva,6190,6754,12944,247600,270160,517760
7/21/2024,Ashani Tharanga,Badulla,Badulla,Uva,3595,2191,5786,143800,87640,231440
7/22/2024,Ashani Tharanga,Badulla,Badulla,Uva,6701,8081,14782,268040,323240,591280
7/23/2024,Ashani Tharanga,Badulla,Badulla,Uva,1799,7140,8939,71960,285600,357560
7/24/2024,Ashani Tharanga,Badulla,Badulla,Uva,8534,2053,10587,341360,82120,423480
7/25/2024,Ashani Tharanga,Badulla,Badulla,Uva,7808,1470,9278,312320,58800,371120
7/26/2024,Ashani Tharanga,Badulla,Badulla,Uva,8427,2908,11335,337080,116320,453400
7/27/2024,Ashani Tharanga,Badulla,Badulla,Uva,2989,658,3647,119560,26320,145880
7/28/2024,Ashani Tharanga,Badulla,Badulla,Uva,5411,5030,10441,216440,201200,417640
7/29/2024,Ashani Tharanga,Badulla,Badulla,Uva,4440,9102,13542,177600,364080,541680
7/30/2024,Ashani Tharanga,Badulla,Badulla,Uva,5253,1586,6839,210120,63440,273560
7/31/2024,Ashani Tharanga,Badulla,Badulla,Uva,5230,9475,14705,209200,379000,588200
8/1/2024,Ashani Tharanga,Badulla,Badulla,Uva,4313,4666,8979,172520,186640,359160
8/2/2024,Ashani Tharanga,Badulla,Badulla,Uva,9567,1643,11210,382680,65720,448400
8/3/2024,Ashani Tharanga,Badulla,Badulla,Uva,7932,6712,14644,317280,268480,585760
8/4/2024,Ashani Tharanga,Badulla,Badulla,Uva,6277,734,7011,251080,29360,280440
8/5/2024,Ashani Tharanga,Badulla,Badulla,Uva,7751,423,8174,310040,16920,326960
8/6/2024,Ashani Tharanga,Badulla,Badulla,Uva,20,4152,4172,800,166080,166880
8/7/2024,Ashani Tharanga,Badulla,Badulla,Uva,4413,2515,6928,176520,100600,277120
8/8/2024,Ashani Tharanga,Badulla,Badulla,Uva,1612,3638,5250,64480,145520,210000
8/9/2024,Ashani Tharanga,Badulla,Badulla,Uva,8467,4534,13001,338680,181360,520040
8/10/2024,Ashani Tharanga,Badulla,Badulla,Uva,4036,6850,10886,161440,274000,435440
8/11/2024,Ashani Tharanga,Badulla,Badulla,Uva,85,6128,6213,3400,245120,248520
8/12/2024,Ashani Tharanga,Badulla,Badulla,Uva,3313,8175,11488,132520,327000,459520
8/13/2024,Ashani Tharanga,Badulla,Badulla,Uva,2085,3780,5865,83400,151200,234600
8/14/2024,Ashani Tharanga,Badulla,Badulla,Uva,1911,1492,3403,76440,59680,136120
8/15/2024,Ashani Tharanga,Badulla,Badulla,Uva,8985,5734,14719,359400,229360,588760
8/16/2024,Ashani Tharanga,Badulla,Badulla,Uva,6722,7866,14588,268880,314640,583520
8/17/2024,Ashani Tharanga,Badulla,Badulla,Uva,5982,8420,14402,239280,336800,576080
8/18/2024,Ashani Tharanga,Badulla,Badulla,Uva,6119,3999,10118,244760,159960,404720
8/19/2024,Ashani Tharanga,Badulla,Badulla,Uva,4640,6641,11281,185600,265640,451240
8/20/2024,Ashani Tharanga,Badulla,Badulla,Uva,3816,5226,9042,152640,209040,361680
8/21/2024,Ashani Tharanga,Badulla,Badulla,Uva,3461,3820,7281,138440,152800,291240
8/22/2024,Ashani Tharanga,Badulla,Badulla,Uva,3903,5787,9690,156120,231480,387600
8/23/2024,Ashani Tharanga,Badulla,Badulla,Uva,9759,1845,11604,390360,73800,464160
8/24/2024,Ashani Tharanga,Badulla,Badulla,Uva,3103,8624,11727,124120,344960,469080
8/25/2024,Ashani Tharanga,Badulla,Badulla,Uva,9364,4661,14025,374560,186440,561000
8/26/2024,Ashani Tharanga,Badulla,Badulla,Uva,7862,7911,15773,314480,316440,630920
8/27/2024,Ashani Tharanga,Badulla,Badulla,Uva,1617,1898,3515,64680,75920,140600
8/28/2024,Ashani Tharanga,Badulla,Badulla,Uva,5460,5322,10782,218400,212880,431280
8/29/2024,Ashani Tharanga,Badulla,Badulla,Uva,6535,2922,9457,261400,116880,378280
8/30/2024,Ashani Tharanga,Badulla,Badulla,Uva,7819,5579,13398,312760,223160,535920
8/31/2024,Ashani Tharanga,Badulla,Badulla,Uva,5782,5454,11236,231280,218160,449440
9/1/2024,Ashani Tharanga,Badulla,Badulla,Uva,4935,4467,9402,197400,178680,376080
9/2/2024,Ashani Tharanga,Badulla,Badulla,Uva,388,5851,6239,15520,234040,249560
9/3/2024,Ashani Tharanga,Badulla,Badulla,Uva,213,2019,2232,8520,80760,89280
9/4/2024,Ashani Tharanga,Badulla,Badulla,Uva,9678,6558,16236,387120,262320,649440
9/5/2024,Ashani Tharanga,Badulla,Badulla,Uva,8796,5343,14139,351840,213720,565560
9/6/2024,Ashani Tharanga,Badulla,Badulla,Uva,4934,5429,10363,197360,217160,414520
9/7/2024,Ashani Tharanga,Badulla,Badulla,Uva,4036,3929,7965,161440,157160,318600
9/8/2024,Ashani Tharanga,Badulla,Badulla,Uva,6329,8993,15322,253160,359720,612880
9/9/2024,Ashani Tharanga,Badulla,Badulla,Uva,6367,567,6934,254680,22680,277360
9/10/2024,Ashani Tharanga,Badulla,Badulla,Uva,3623,9018,12641,144920,360720,505640
9/11/2024,Ashani Tharanga,Badulla,Badulla,Uva,9664,1580,11244,386560,63200,449760
9/12/2024,Ashani Tharanga,Badulla,Badulla,Uva,8600,7443,16043,344000,297720,641720
9/13/2024,Ashani Tharanga,Badulla,Badulla,Uva,623,371,994,24920,14840,39760
9/14/2024,Ashani Tharanga,Badulla,Badulla,Uva,5060,8226,13286,202400,329040,531440
9/15/2024,Ashani Tharanga,Badulla,Badulla,Uva,6003,246,6249,240120,9840,249960
9/16/2024,Ashani Tharanga,Badulla,Badulla,Uva,2985,7394,10379,119400,295760,415160
9/17/2024,Ashani Tharanga,Badulla,Badulla,Uva,9858,5111,14969,394320,204440,598760
9/18/2024,Ashani Tharanga,Badulla,Badulla,Uva,4150,5747,9897,166000,229880,395880
9/19/2024,Ashani Tharanga,Badulla,Badulla,Uva,7154,879,8033,286160,35160,321320
9/20/2024,Ashani Tharanga,Badulla,Badulla,Uva,2315,7816,10131,92600,312640,405240
9/21/2024,Ashani Tharanga,Badulla,Badulla,Uva,7170,1427,8597,286800,57080,343880
9/22/2024,Ashani Tharanga,Badulla,Badulla,Uva,2265,4183,6448,90600,167320,257920
9/23/2024,Ashani Tharanga,Badulla,Badulla,Uva,1079,5528,6607,43160,221120,264280
9/24/2024,Ashani Tharanga,Badulla,Badulla,Uva,759,456,1215,30360,18240,48600
9/25/2024,Ashani Tharanga,Badulla,Badulla,Uva,735,9826,10561,29400,393040,422440
9/26/2024,Ashani Tharanga,Badulla,Badulla,Uva,713,155,868,28520,6200,34720
9/27/2024,Ashani Tharanga,Badulla,Badulla,Uva,2146,9017,11163,85840,360680,446520
9/28/2024,Ashani Tharanga,Badulla,Badulla,Uva,2377,5850,8227,95080,234000,329080
9/29/2024,Ashani Tharanga,Badulla,Badulla,Uva,6506,21,6527,260240,840,261080
9/30/2024,Ashani Tharanga,Badulla,Badulla,Uva,6438,720,7158,257520,28800,286320
10/1/2024,Ashani Tharanga,Badulla,Badulla,Uva,3111,6072,9183,124440,242880,367320
10/2/2024,Ashani Tharanga,Badulla,Badulla,Uva,5331,4469,9800,213240,178760,392000
10/3/2024,Ashani Tharanga,Badulla,Badulla,Uva,2083,2496,4579,83320,99840,183160
10/4/2024,Ashani Tharanga,Badulla,Badulla,Uva,5604,394,5998,224160,15760,239920
10/5/2024,Ashani Tharanga,Badulla,Badulla,Uva,3186,1551,4737,127440,62040,189480
10/6/2024,Ashani Tharanga,Badulla,Badulla,Uva,7276,4891,12167,291040,195640,486680
10/7/2024,Ashani Tharanga,Badulla,Badulla,Uva,2444,4769,7213,97760,190760,288520
10/8/2024,Ashani Tharanga,Badulla,Badulla,Uva,6060,8779,14839,242400,351160,593560
10/9/2024,Ashani Tharanga,Badulla,Badulla,Uva,817,4321,5138,32680,172840,205520
10/10/2024,Ashani Tharanga,Badulla,Badulla,Uva,9391,3695,13086,375640,147800,523440
10/11/2024,Ashani Tharanga,Badulla,Badulla,Uva,6594,7127,13721,263760,285080,548840
10/12/2024,Ashani Tharanga,Badulla,Badulla,Uva,5115,9844,14959,204600,393760,598360
10/13/2024,Ashani Tharanga,Badulla,Badulla,Uva,6607,9856,16463,264280,394240,658520
10/14/2024,Ashani Tharanga,Badulla,Badulla,Uva,1083,1961,3044,43320,78440,121760
10/15/2024,Ashani Tharanga,Badulla,Badulla,Uva,7387,8377,15764,295480,335080,630560
10/16/2024,Ashani Tharanga,Badulla,Badulla,Uva,181,3957,4138,7240,158280,165520
10/17/2024,Ashani Tharanga,Badulla,Badulla,Uva,656,5750,6406,26240,230000,256240
10/18/2024,Ashani Tharanga,Badulla,Badulla,Uva,4703,2317,7020,188120,92680,280800
10/19/2024,Ashani Tharanga,Badulla,Badulla,Uva,2081,4156,6237,83240,166240,249480
10/20/2024,Ashani Tharanga,Badulla,Badulla,Uva,1412,4416,5828,56480,176640,233120
10/21/2024,Ashani Tharanga,Badulla,Badulla,Uva,8695,4359,13054,347800,174360,522160
10/22/2024,Ashani Tharanga,Badulla,Badulla,Uva,5349,2950,8299,213960,118000,331960
10/23/2024,Ashani Tharanga,Badulla,Badulla,Uva,5274,6357,11631,210960,254280,465240
10/24/2024,Ashani Tharanga,Badulla,Badulla,Uva,9590,9078,18668,383600,363120,746720
10/25/2024,Ashani Tharanga,Badulla,Badulla,Uva,4766,608,5374,190640,24320,214960
10/26/2024,Ashani Tharanga,Badulla,Badulla,Uva,3034,2921,5955,121360,116840,238200
10/27/2024,Ashani Tharanga,Badulla,Badulla,Uva,4746,1880,6626,189840,75200,265040
10/28/2024,Ashani Tharanga,Badulla,Badulla,Uva,1187,1793,2980,47480,71720,119200
10/29/2024,Ashani Tharanga,Badulla,Badulla,Uva,3499,864,4363,139960,34560,174520
10/30/2024,Ashani Tharanga,Badulla,Badulla,Uva,5439,7331,12770,217560,293240,510800
10/31/2024,Ashani Tharanga,Badulla,Badulla,Uva,2130,1529,3659,85200,61160,146360
11/1/2024,Ashani Tharanga,Badulla,Badulla,Uva,1116,6617,7733,44640,264680,309320
11/2/2024,Ashani Tharanga,Badulla,Badulla,Uva,7543,306,7849,301720,12240,313960
11/3/2024,Ashani Tharanga,Badulla,Badulla,Uva,3200,2140,5340,128000,85600,213600
11/4/2024,Ashani Tharanga,Badulla,Badulla,Uva,873,2769,3642,34920,110760,145680
11/5/2024,Ashani Tharanga,Badulla,Badulla,Uva,7277,6942,14219,291080,277680,568760
11/6/2024,Ashani Tharanga,Badulla,Badulla,Uva,4285,1685,5970,171400,67400,238800
11/7/2024,Ashani Tharanga,Badulla,Badulla,Uva,1597,6686,8283,63880,267440,331320
11/8/2024,Ashani Tharanga,Badulla,Badulla,Uva,6169,5589,11758,246760,223560,470320
11/9/2024,Ashani Tharanga,Badulla,Badulla,Uva,7576,6183,13759,303040,247320,550360
11/10/2024,Ashani Tharanga,Badulla,Badulla,Uva,8072,9434,17506,322880,377360,700240
11/11/2024,Ashani Tharanga,Badulla,Badulla,Uva,1276,8076,9352,51040,323040,374080
11/12/2024,Ashani Tharanga,Badulla,Badulla,Uva,7312,6316,13628,292480,252640,545120
11/13/2024,Ashani Tharanga,Badulla,Badulla,Uva,1448,3114,4562,57920,124560,182480
11/14/2024,Ashani Tharanga,Badulla,Badulla,Uva,6181,5439,11620,247240,217560,464800
11/15/2024,Ashani Tharanga,Badulla,Badulla,Uva,549,4014,4563,21960,160560,182520
11/16/2024,Ashani Tharanga,Badulla,Badulla,Uva,8311,7793,16104,332440,311720,644160
11/17/2024,Ashani Tharanga,Badulla,Badulla,Uva,8220,7494,15714,328800,299760,628560
11/18/2024,Ashani Tharanga,Badulla,Badulla,Uva,7681,5314,12995,307240,212560,519800
11/19/2024,Ashani Tharanga,Badulla,Badulla,Uva,4269,9668,13937,170760,386720,557480
11/20/2024,Ashani Tharanga,Badulla,Badulla,Uva,3196,3398,6594,127840,135920,263760
11/21/2024,Ashani Tharanga,Badulla,Badulla,Uva,1221,287,1508,48840,11480,60320
11/22/2024,Ashani Tharanga,Badulla,Badulla,Uva,4572,4255,8827,182880,170200,353080
11/23/2024,Ashani Tharanga,Badulla,Badulla,Uva,6417,7162,13579,256680,286480,543160
11/24/2024,Ashani Tharanga,Badulla,Badulla,Uva,8515,6418,14933,340600,256720,597320
11/25/2024,Ashani Tharanga,Badulla,Badulla,Uva,5164,8844,14008,206560,353760,560320
11/26/2024,Ashani Tharanga,Badulla,Badulla,Uva,3531,5362,8893,141240,214480,355720
11/27/2024,Ashani Tharanga,Badulla,Badulla,Uva,9997,548,10545,399880,21920,421800
11/28/2024,Ashani Tharanga,Badulla,Badulla,Uva,3165,6453,9618,126600,258120,384720
11/29/2024,Ashani Tharanga,Badulla,Badulla,Uva,5989,1489,7478,239560,59560,299120
11/30/2024,Ashani Tharanga,Badulla,Badulla,Uva,1474,7777,9251,58960,311080,370040
12/1/2024,Ashani Tharanga,Badulla,Badulla,Uva,7656,9087,16743,306240,363480,669720
12/2/2024,Ashani Tharanga,Badulla,Badulla,Uva,4436,310,4746,177440,12400,189840
12/3/2024,Ashani Tharanga,Badulla,Badulla,Uva,2619,9068,11687,104760,362720,467480
12/4/2024,Ashani Tharanga,Badulla,Badulla,Uva,4080,2805,6885,163200,112200,275400
12/5/2024,Ashani Tharanga,Badulla,Badulla,Uva,5780,3101,8881,231200,124040,355240
12/6/2024,Ashani Tharanga,Badulla,Badulla,Uva,6178,748,6926,247120,29920,277040
12/7/2024,Ashani Tharanga,Badulla,Badulla,Uva,3976,5302,9278,159040,212080,371120
12/8/2024,Ashani Tharanga,Badulla,Badulla,Uva,5667,6674,12341,226680,266960,493640
12/9/2024,Ashani Tharanga,Badulla,Badulla,Uva,1704,1377,3081,68160,55080,123240
12/10/2024,Ashani Tharanga,Badulla,Badulla,Uva,884,9583,10467,35360,383320,418680
12/11/2024,Ashani Tharanga,Badulla,Badulla,Uva,2035,2787,4822,81400,111480,192880
12/12/2024,Ashani Tharanga,Badulla,Badulla,Uva,2473,5913,8386,98920,236520,335440
12/13/2024,Ashani Tharanga,Badulla,Badulla,Uva,7907,9097,17004,316280,363880,680160
12/14/2024,Ashani Tharanga,Badulla,Badulla,Uva,5405,3241,8646,216200,129640,345840
12/15/2024,Ashani Tharanga,Badulla,Badulla,Uva,9256,1525,10781,370240,61000,431240
12/16/2024,Ashani Tharanga,Badulla,Badulla,Uva,8475,5684,14159,339000,227360,566360
12/17/2024,Ashani Tharanga,Badulla,Badulla,Uva,4302,6403,10705,172080,256120,428200
12/18/2024,Ashani Tharanga,Badulla,Badulla,Uva,9656,1992,11648,386240,79680,465920
12/19/2024,Ashani Tharanga,Badulla,Badulla,Uva,4394,2430,6824,175760,97200,272960
12/20/2024,Ashani Tharanga,Badulla,Badulla,Uva,1897,5434,7331,75880,217360,293240
12/21/2024,Ashani Tharanga,Badulla,Badulla,Uva,9744,7620,17364,389760,304800,694560
12/22/2024,Ashani Tharanga,Badulla,Badulla,Uva,2179,2235,4414,87160,89400,176560
12/23/2024,Ashani Tharanga,Badulla,Badulla,Uva,1214,6488,7702,48560,259520,308080
12/24/2024,Ashani Tharanga,Badulla,Badulla,Uva,4676,2379,7055,187040,95160,282200
12/25/2024,Ashani Tharanga,Badulla,Badulla,Uva,5408,3374,8782,216320,134960,351280
12/26/2024,Ashani Tharanga,Badulla,Badulla,Uva,7351,7568,14919,294040,302720,596760
12/27/2024,Ashani Tharanga,Badulla,Badulla,Uva,2261,5213,7474,90440,208520,298960
12/28/2024,Ashani Tharanga,Badulla,Badulla,Uva,1395,353,1748,55800,14120,69920
12/29/2024,Ashani Tharanga,Badulla,Badulla,Uva,8859,8238,17097,354360,329520,683880
12/30/2024,Ashani Tharanga,Badulla,Badulla,Uva,6917,5714,12631,276680,228560,505240
12/31/2024,Ashani Tharanga,Badulla,Badulla,Uva,1187,7495,8682,47480,299800,347280
1/1/2025,Ashani Tharanga,Badulla,Badulla,Uva,8424,2337,10761,336960,93480,430440
1/2/2025,Ashani Tharanga,Badulla,Badulla,Uva,1770,2586,4356,70800,103440,174240
1/3/2025,Ashani Tharanga,Badulla,Badulla,Uva,1578,9320,10898,63120,372800,435920
1/4/2025,Ashani Tharanga,Badulla,Badulla,Uva,7287,435,7722,291480,17400,308880
1/5/2025,Ashani Tharanga,Badulla,Badulla,Uva,4977,3371,8348,199080,134840,333920
1/6/2025,Ashani Tharanga,Badulla,Badulla,Uva,5297,8977,14274,211880,359080,570960
1/7/2025,Ashani Tharanga,Badulla,Badulla,Uva,4673,3483,8156,186920,139320,326240
1/8/2025,Ashani Tharanga,Badulla,Badulla,Uva,8591,7994,16585,343640,319760,663400
1/9/2025,Ashani Tharanga,Badulla,Badulla,Uva,9989,7541,17530,399560,301640,701200
1/10/2025,Ashani Tharanga,Badulla,Badulla,Uva,5001,9971,14972,200040,398840,598880
1/11/2025,Ashani Tharanga,Badulla,Badulla,Uva,6573,6424,12997,262920,256960,519880
1/12/2025,Ashani Tharanga,Badulla,Badulla,Uva,7584,41,7625,303360,1640,305000
1/13/2025,Ashani Tharanga,Badulla,Badulla,Uva,3236,3280,6516,129440,131200,260640
1/14/2025,Ashani Tharanga,Badulla,Badulla,Uva,5433,5338,10771,217320,213520,430840
1/15/2025,Ashani Tharanga,Badulla,Badulla,Uva,3922,5333,9255,156880,213320,370200
1/16/2025,Ashani Tharanga,Badulla,Badulla,Uva,7967,4568,12535,318680,182720,501400
1/17/2025,Ashani Tharanga,Badulla,Badulla,Uva,1829,2367,4196,73160,94680,167840
1/18/2025,Ashani Tharanga,Badulla,Badulla,Uva,436,6947,7383,17440,277880,295320
1/19/2025,Ashani Tharanga,Badulla,Badulla,Uva,5611,8201,13812,224440,328040,552480
1/20/2025,Ashani Tharanga,Badulla,Badulla,Uva,8671,9090,17761,346840,363600,710440
1/21/2025,Ashani Tharanga,Badulla,Badulla,Uva,6460,2398,8858,258400,95920,354320
1/22/2025,Ashani Tharanga,Badulla,Badulla,Uva,4186,3195,7381,167440,127800,295240
1/23/2025,Ashani Tharanga,Badulla,Badulla,Uva,3258,3037,6295,130320,121480,251800
1/24/2025,Ashani Tharanga,Badulla,Badulla,Uva,6822,1405,8227,272880,56200,329080
1/25/2025,Ashani Tharanga,Badulla,Badulla,Uva,7776,4885,12661,311040,195400,506440
1/26/2025,Ashani Tharanga,Badulla,Badulla,Uva,2902,5103,8005,116080,204120,320200
1/27/2025,Ashani Tharanga,Badulla,Badulla,Uva,4091,7832,11923,163640,313280,476920
1/28/2025,Ashani Tharanga,Badulla,Badulla,Uva,7438,9472,16910,297520,378880,676400
1/29/2025,Ashani Tharanga,Badulla,Badulla,Uva,6113,7635,13748,244520,305400,549920
1/30/2025,Ashani Tharanga,Badulla,Badulla,Uva,8670,6789,15459,346800,271560,618360
1/31/2025,Ashani Tharanga,Badulla,Badulla,Uva,9087,9932,19019,363480,397280,760760
2/1/2025,Ashani Tharanga,Badulla,Badulla,Uva,3303,7147,10450,132120,285880,418000
2/2/2025,Ashani Tharanga,Badulla,Badulla,Uva,6457,6723,13180,258280,268920,527200
2/3/2025,Ashani Tharanga,Badulla,Badulla,Uva,1263,2774,4037,50520,110960,161480
2/4/2025,Ashani Tharanga,Badulla,Badulla,Uva,250,6869,7119,10000,274760,284760
2/5/2025,Ashani Tharanga,Badulla,Badulla,Uva,7218,1363,8581,288720,54520,343240
2/6/2025,Ashani Tharanga,Badulla,Badulla,Uva,7933,1449,9382,317320,57960,375280
2/7/2025,Ashani Tharanga,Badulla,Badulla,Uva,4164,9067,13231,166560,362680,529240
2/8/2025,Ashani Tharanga,Badulla,Badulla,Uva,4846,8196,13042,193840,327840,521680
2/9/2025,Ashani Tharanga,Badulla,Badulla,Uva,7845,1496,9341,313800,59840,373640
2/10/2025,Ashani Tharanga,Badulla,Badulla,Uva,4409,6736,11145,176360,269440,445800
2/11/2025,Ashani Tharanga,Badulla,Badulla,Uva,5561,9730,15291,222440,389200,611640
2/12/2025,Ashani Tharanga,Badulla,Badulla,Uva,1133,7913,9046,45320,316520,361840
2/13/2025,Ashani Tharanga,Badulla,Badulla,Uva,4986,1938,6924,199440,77520,276960
2/14/2025,Ashani Tharanga,Badulla,Badulla,Uva,8943,5705,14648,357720,228200,585920
2/15/2025,Ashani Tharanga,Badulla,Badulla,Uva,3663,1258,4921,146520,50320,196840
2/16/2025,Ashani Tharanga,Badulla,Badulla,Uva,699,782,1481,27960,31280,59240
2/17/2025,Ashani Tharanga,Badulla,Badulla,Uva,3358,6323,9681,134320,252920,387240
2/18/2025,Ashani Tharanga,Badulla,Badulla,Uva,8310,7780,16090,332400,311200,643600
2/19/2025,Ashani Tharanga,Badulla,Badulla,Uva,8209,9928,18137,328360,397120,725480
2/20/2025,Ashani Tharanga,Badulla,Badulla,Uva,3273,9968,13241,130920,398720,529640
2/21/2025,Ashani Tharanga,Badulla,Badulla,Uva,1313,9496,10809,52520,379840,432360
2/22/2025,Ashani Tharanga,Badulla,Badulla,Uva,6451,982,7433,258040,39280,297320
2/23/2025,Ashani Tharanga,Badulla,Badulla,Uva,1058,3670,4728,42320,146800,189120
2/24/2025,Ashani Tharanga,Badulla,Badulla,Uva,8468,4991,13459,338720,199640,538360
2/25/2025,Ashani Tharanga,Badulla,Badulla,Uva,5730,3736,9466,229200,149440,378640
2/26/2025,Ashani Tharanga,Badulla,Badulla,Uva,2982,1216,4198,119280,48640,167920
2/27/2025,Ashani Tharanga,Badulla,Badulla,Uva,9087,8829,17916,363480,353160,716640
2/28/2025,Ashani Tharanga,Badulla,Badulla,Uva,867,998,1865,34680,39920,74600
3/1/2025,Ashani Tharanga,Badulla,Badulla,Uva,1860,6314,8174,74400,252560,326960
3/2/2025,Ashani Tharanga,Badulla,Badulla,Uva,1201,8457,9658,48040,338280,386320
3/3/2025,Ashani Tharanga,Badulla,Badulla,Uva,1533,2908,4441,61320,116320,177640
3/4/2025,Ashani Tharanga,Badulla,Badulla,Uva,6817,436,7253,272680,17440,290120
3/5/2025,Ashani Tharanga,Badulla,Badulla,Uva,8702,5329,14031,348080,213160,561240
3/6/2025,Ashani Tharanga,Badulla,Badulla,Uva,7371,7241,14612,294840,289640,584480
3/7/2025,Ashani Tharanga,Badulla,Badulla,Uva,8873,7522,16395,354920,300880,655800
3/8/2025,Ashani Tharanga,Badulla,Badulla,Uva,9023,5561,14584,360920,222440,583360
3/9/2025,Ashani Tharanga,Badulla,Badulla,Uva,9037,3627,12664,361480,145080,506560
3/10/2025,Ashani Tharanga,Badulla,Badulla,Uva,7329,3150,10479,293160,126000,419160
3/11/2025,Ashani Tharanga,Badulla,Badulla,Uva,5823,7811,13634,232920,312440,545360
3/12/2025,Ashani Tharanga,Badulla,Badulla,Uva,1653,1429,3082,66120,57160,123280
3/13/2025,Ashani Tharanga,Badulla,Badulla,Uva,3491,7620,11111,139640,304800,444440
3/14/2025,Ashani Tharanga,Badulla,Badulla,Uva,7673,9008,16681,306920,360320,667240
3/15/2025,Ashani Tharanga,Badulla,Badulla,Uva,1354,1272,2626,54160,50880,105040
3/16/2025,Ashani Tharanga,Badulla,Badulla,Uva,2665,7646,10311,106600,305840,412440
3/17/2025,Ashani Tharanga,Badulla,Badulla,Uva,9421,7111,16532,376840,284440,661280
3/18/2025,Ashani Tharanga,Badulla,Badulla,Uva,9029,6926,15955,361160,277040,638200
3/19/2025,Ashani Tharanga,Badulla,Badulla,Uva,6091,3424,9515,243640,136960,380600
3/20/2025,Ashani Tharanga,Badulla,Badulla,Uva,8795,2272,11067,351800,90880,442680
3/21/2025,Ashani Tharanga,Badulla,Badulla,Uva,5744,7132,12876,229760,285280,515040
3/22/2025,Ashani Tharanga,Badulla,Badulla,Uva,7975,9362,17337,319000,374480,693480
3/23/2025,Ashani Tharanga,Badulla,Badulla,Uva,7407,2745,10152,296280,109800,406080
3/25/2024,Manisha Tharuka,Kandy,Hunnasgiriya,Central,7270,8191,15461,290800,327640,618440
3/26/2024,Manisha Tharuka,Kandy,Hunnasgiriya,Central,6601,1764,8365,264040,70560,334600
3/27/2024,Manisha Tharuka,Kandy,Hunnasgiriya,Central,8899,9179,18078,355960,367160,723120
3/28/2024,Manisha Tharuka,Kandy,Hunnasgiriya,Central,790,5519,6309,31600,220760,252360
3/29/2024,Manisha Tharuka,Kandy,Hunnasgiriya,Central,1340,6753,8093,53600,270120,323720
3/30/2024,Manisha Tharuka,Kandy,Hunnasgiriya,Central,4931,3396,8327,197240,135840,333080
3/31/2024,Manisha Tharuka,Kandy,Hunnasgiriya,Central,5135,7781,12916,205400,311240,516640
4/1/2024,Manisha Tharuka,Kandy,Hunnasgiriya,Central,3035,7574,10609,121400,302960,424360
4/2/2024,Manisha Tharuka,Kandy,Hunnasgiriya,Central,2721,4100,6821,108840,164000,272840
4/3/2024,Manisha Tharuka,Kandy,Hunnasgiriya,Central,6254,6904,13158,250160,276160,526320
4/4/2024,Manisha Tharuka,Kandy,Hunnasgiriya,Central,4479,5621,10100,179160,224840,404000
4/5/2024,Manisha Tharuka,Kandy,Hunnasgiriya,Central,3592,2230,5822,143680,89200,232880
4/6/2024,Manisha Tharuka,Kandy,Hunnasgiriya,Central,9457,7186,16643,378280,287440,665720
4/7/2024,Manisha Tharuka,Kandy,Hunnasgiriya,Central,4152,3485,7637,166080,139400,305480
4/8/2024,Manisha Tharuka,Kandy,Hunnasgiriya,Central,8266,2217,10483,330640,88680,419320
4/9/2024,Manisha Tharuka,Kandy,Hunnasgiriya,Central,2958,1827,4785,118320,73080,191400
4/10/2024,Manisha Tharuka,Kandy,Hunnasgiriya,Central,7493,3916,11409,299720,156640,456360
4/11/2024,Manisha Tharuka,Kandy,Hunnasgiriya,Central,6463,7389,13852,258520,295560,554080
4/19/2024,Manisha Tharuka,Kandy,Hunnasgiriya,Central,8804,4305,13109,352160,172200,524360
4/20/2024,Manisha Tharuka,Kandy,Hunnasgiriya,Central,53,4422,4475,2120,176880,179000
4/21/2024,Manisha Tharuka,Kandy,Hunnasgiriya,Central,2547,5246,7793,101880,209840,311720
4/22/2024,Manisha Tharuka,Kandy,Hunnasgiriya,Central,8841,2520,11361,353640,100800,454440
4/23/2024,Manisha Tharuka,Kandy,Hunnasgiriya,Central,4718,6778,11496,188720,271120,459840
4/24/2024,Manisha Tharuka,Kandy,Hunnasgiriya,Central,7028,7081,14109,281120,283240,564360
4/25/2024,Manisha Tharuka,Kandy,Hunnasgiriya,Central,479,7570,8049,19160,302800,321960
4/26/2024,Manisha Tharuka,Kandy,Hunnasgiriya,Central,4757,3002,7759,190280,120080,310360
4/27/2024,Manisha Tharuka,Kandy,Hunnasgiriya,Central,5777,1678,7455,231080,67120,298200
4/28/2024,Manisha Tharuka,Kandy,Hunnasgiriya,Central,9576,6713,16289,383040,268520,651560
4/29/2024,Manisha Tharuka,Kandy,Hunnasgiriya,Central,1415,877,2292,56600,35080,91680
4/30/2024,Manisha Tharuka,Kandy,Hunnasgiriya,Central,1326,2613,3939,53040,104520,157560
5/1/2024,Manisha Tharuka,Kandy,Hunnasgiriya,Central,9687,6486,16173,387480,259440,646920
5/2/2024,Manisha Tharuka,Kandy,Hunnasgiriya,Central,9504,2031,11535,380160,81240,461400
5/3/2024,Manisha Tharuka,Kandy,Hunnasgiriya,Central,6465,6661,13126,258600,266440,525040
5/4/2024,Manisha Tharuka,Kandy,Hunnasgiriya,Central,5626,3772,9398,225040,150880,375920
5/5/2024,Manisha Tharuka,Kandy,Hunnasgiriya,Central,411,7095,7506,16440,283800,300240
5/6/2024,Manisha Tharuka,Kandy,Hunnasgiriya,Central,9077,5960,15037,363080,238400,601480
5/7/2024,Manisha Tharuka,Kandy,Hunnasgiriya,Central,9111,3735,12846,364440,149400,513840
5/8/2024,Manisha Tharuka,Kandy,Hunnasgiriya,Central,9457,1663,11120,378280,66520,444800
5/9/2024,Manisha Tharuka,Kandy,Hunnasgiriya,Central,5927,8449,14376,237080,337960,575040
5/10/2024,Manisha Tharuka,Kandy,Hunnasgiriya,Central,5294,840,6134,211760,33600,245360
5/11/2024,Manisha Tharuka,Kandy,Hunnasgiriya,Central,9870,2221,12091,394800,88840,483640
5/12/2024,Manisha Tharuka,Kandy,Hunnasgiriya,Central,1852,9480,11332,74080,379200,453280
5/13/2024,Manisha Tharuka,Kandy,Hunnasgiriya,Central,4212,9776,13988,168480,391040,559520
5/14/2024,Manisha Tharuka,Kandy,Hunnasgiriya,Central,5453,3305,8758,218120,132200,350320
5/15/2024,Manisha Tharuka,Kandy,Hunnasgiriya,Central,6023,7637,13660,240920,305480,546400
5/16/2024,Manisha Tharuka,Kandy,Hunnasgiriya,Central,8900,9025,17925,356000,361000,717000
5/17/2024,Manisha Tharuka,Kandy,Hunnasgiriya,Central,3353,9291,12644,134120,371640,505760
5/18/2024,Manisha Tharuka,Kandy,Hunnasgiriya,Central,5424,7651,13075,216960,306040,523000
5/19/2024,Manisha Tharuka,Kandy,Hunnasgiriya,Central,961,9603,10564,38440,384120,422560
5/20/2024,Manisha Tharuka,Kandy,Hunnasgiriya,Central,9606,6805,16411,384240,272200,656440
5/21/2024,Manisha Tharuka,Kandy,Hunnasgiriya,Central,5298,6855,12153,211920,274200,486120
5/22/2024,Manisha Tharuka,Kandy,Hunnasgiriya,Central,3586,7493,11079,143440,299720,443160
5/24/2024,Manisha Tharuka,Kandy,Hunnasgiriya,Central,1465,368,1833,58600,14720,73320
5/25/2024,Manisha Tharuka,Kandy,Hunnasgiriya,Central,6600,9867,16467,264000,394680,658680
5/26/2024,Manisha Tharuka,Kandy,Hunnasgiriya,Central,7350,6876,14226,294000,275040,569040
5/27/2024,Manisha Tharuka,Kandy,Hunnasgiriya,Central,7809,4730,12539,312360,189200,501560
5/28/2024,Manisha Tharuka,Kandy,Hunnasgiriya,Central,8815,498,9313,352600,19920,372520
5/29/2024,Manisha Tharuka,Kandy,Hunnasgiriya,Central,9208,7383,16591,368320,295320,663640
5/30/2024,Manisha Tharuka,Kandy,Hunnasgiriya,Central,7228,7744,14972,289120,309760,598880
5/31/2024,Manisha Tharuka,Kandy,Hunnasgiriya,Central,7400,1417,8817,296000,56680,352680
6/1/2024,Manisha Tharuka,Kandy,Hunnasgiriya,Central,7195,4870,12065,287800,194800,482600
6/2/2024,Manisha Tharuka,Kandy,Hunnasgiriya,Central,8899,3630,12529,355960,145200,501160
6/3/2024,Manisha Tharuka,Kandy,Hunnasgiriya,Central,5740,4939,10679,229600,197560,427160
6/4/2024,Manisha Tharuka,Kandy,Hunnasgiriya,Central,4935,6239,11174,197400,249560,446960
6/5/2024,Manisha Tharuka,Kandy,Hunnasgiriya,Central,7319,165,7484,292760,6600,299360
6/6/2024,Manisha Tharuka,Kandy,Hunnasgiriya,Central,3059,4011,7070,122360,160440,282800
6/7/2024,Manisha Tharuka,Kandy,Hunnasgiriya,Central,2128,2692,4820,85120,107680,192800
6/8/2024,Manisha Tharuka,Kandy,Hunnasgiriya,Central,3824,6657,10481,152960,266280,419240
6/9/2024,Manisha Tharuka,Kandy,Hunnasgiriya,Central,2264,6,2270,90560,240,90800
6/10/2024,Manisha Tharuka,Kandy,Hunnasgiriya,Central,9062,4179,13241,362480,167160,529640
6/11/2024,Manisha Tharuka,Kandy,Hunnasgiriya,Central,812,3245,4057,32480,129800,162280
6/12/2024,Manisha Tharuka,Kandy,Hunnasgiriya,Central,7595,9716,17311,303800,388640,692440
6/13/2024,Manisha Tharuka,Kandy,Hunnasgiriya,Central,6688,5006,11694,267520,200240,467760
6/14/2024,Manisha Tharuka,Kandy,Hunnasgiriya,Central,1632,7118,8750,65280,284720,350000
6/15/2024,Manisha Tharuka,Kandy,Hunnasgiriya,Central,2721,4596,7317,108840,183840,292680
6/16/2024,Manisha Tharuka,Kandy,Hunnasgiriya,Central,5683,4852,10535,227320,194080,421400
6/17/2024,Manisha Tharuka,Kandy,Hunnasgiriya,Central,4545,5533,10078,181800,221320,403120
6/18/2024,Manisha Tharuka,Kandy,Hunnasgiriya,Central,9137,2378,11515,365480,95120,460600
6/19/2024,Manisha Tharuka,Kandy,Hunnasgiriya,Central,1111,3361,4472,44440,134440,178880
6/20/2024,Manisha Tharuka,Kandy,Hunnasgiriya,Central,3219,8594,11813,128760,343760,472520
6/21/2024,Manisha Tharuka,Kandy,Hunnasgiriya,Central,6092,2150,8242,243680,86000,329680
6/22/2024,Manisha Tharuka,Kandy,Hunnasgiriya,Central,9757,807,10564,390280,32280,422560
6/23/2024,Manisha Tharuka,Kandy,Hunnasgiriya,Central,5168,3245,8413,206720,129800,336520
6/24/2024,Manisha Tharuka,Kandy,Hunnasgiriya,Central,7470,3043,10513,298800,121720,420520
6/25/2024,Manisha Tharuka,Kandy,Hunnasgiriya,Central,4350,9907,14257,174000,396280,570280
6/26/2024,Manisha Tharuka,Kandy,Hunnasgiriya,Central,6212,2065,8277,248480,82600,331080
6/27/2024,Manisha Tharuka,Kandy,Hunnasgiriya,Central,3948,3369,7317,157920,134760,292680
6/28/2024,Manisha Tharuka,Kandy,Hunnasgiriya,Central,223,3850,4073,8920,154000,162920
6/29/2024,Manisha Tharuka,Kandy,Hunnasgiriya,Central,4474,9523,13997,178960,380920,559880
6/30/2024,Manisha Tharuka,Kandy,Hunnasgiriya,Central,4169,1037,5206,166760,41480,208240
7/1/2024,Manisha Tharuka,Kandy,Hunnasgiriya,Central,3469,2962,6431,138760,118480,257240
7/2/2024,Manisha Tharuka,Kandy,Hunnasgiriya,Central,3192,4624,7816,127680,184960,312640
7/3/2024,Manisha Tharuka,Kandy,Hunnasgiriya,Central,4648,1683,6331,185920,67320,253240
7/4/2024,Manisha Tharuka,Kandy,Hunnasgiriya,Central,3168,2976,6144,126720,119040,245760
7/5/2024,Manisha Tharuka,Kandy,Hunnasgiriya,Central,4285,9386,13671,171400,375440,546840
7/6/2024,Manisha Tharuka,Kandy,Hunnasgiriya,Central,5932,9754,15686,237280,390160,627440
7/7/2024,Manisha Tharuka,Kandy,Hunnasgiriya,Central,1385,9100,10485,55400,364000,419400
7/8/2024,Manisha Tharuka,Kandy,Hunnasgiriya,Central,5319,3772,9091,212760,150880,363640
7/9/2024,Manisha Tharuka,Kandy,Hunnasgiriya,Central,5397,7226,12623,215880,289040,504920
7/10/2024,Manisha Tharuka,Kandy,Hunnasgiriya,Central,921,6759,7680,36840,270360,307200
7/11/2024,Manisha Tharuka,Kandy,Hunnasgiriya,Central,1311,497,1808,52440,19880,72320
7/12/2024,Manisha Tharuka,Kandy,Hunnasgiriya,Central,8306,9089,17395,332240,363560,695800
7/13/2024,Manisha Tharuka,Kandy,Hunnasgiriya,Central,7370,6509,13879,294800,260360,555160
7/14/2024,Manisha Tharuka,Kandy,Hunnasgiriya,Central,3729,6605,10334,149160,264200,413360
7/15/2024,Manisha Tharuka,Kandy,Hunnasgiriya,Central,3130,6154,9284,125200,246160,371360
7/16/2024,Manisha Tharuka,Kandy,Hunnasgiriya,Central,1207,4890,6097,48280,195600,243880
7/17/2024,Manisha Tharuka,Kandy,Hunnasgiriya,Central,9297,4825,14122,371880,193000,564880
7/18/2024,Manisha Tharuka,Kandy,Hunnasgiriya,Central,4429,5749,10178,177160,229960,407120
7/19/2024,Manisha Tharuka,Kandy,Hunnasgiriya,Central,9025,8922,17947,361000,356880,717880
7/20/2024,Manisha Tharuka,Kandy,Hunnasgiriya,Central,3355,7289,10644,134200,291560,425760
7/21/2024,Manisha Tharuka,Kandy,Hunnasgiriya,Central,8428,4537,12965,337120,181480,518600
7/22/2024,Manisha Tharuka,Kandy,Hunnasgiriya,Central,745,2120,2865,29800,84800,114600
7/23/2024,Manisha Tharuka,Kandy,Hunnasgiriya,Central,3842,4319,8161,153680,172760,326440
7/24/2024,Manisha Tharuka,Kandy,Hunnasgiriya,Central,2092,618,2710,83680,24720,108400
7/25/2024,Manisha Tharuka,Kandy,Hunnasgiriya,Central,3220,7878,11098,128800,315120,443920
7/26/2024,Manisha Tharuka,Kandy,Hunnasgiriya,Central,7070,2711,9781,282800,108440,391240
7/27/2024,Manisha Tharuka,Kandy,Hunnasgiriya,Central,7729,2077,9806,309160,83080,392240
7/28/2024,Manisha Tharuka,Kandy,Hunnasgiriya,Central,5602,1505,7107,224080,60200,284280
7/29/2024,Manisha Tharuka,Kandy,Hunnasgiriya,Central,12,1560,1572,480,62400,62880
7/30/2024,Manisha Tharuka,Kandy,Hunnasgiriya,Central,5038,1136,6174,201520,45440,246960
7/31/2024,Manisha Tharuka,Kandy,Hunnasgiriya,Central,5889,2862,8751,235560,114480,350040
8/1/2024,Manisha Tharuka,Kandy,Hunnasgiriya,Central,6969,6068,13037,278760,242720,521480
8/2/2024,Manisha Tharuka,Kandy,Hunnasgiriya,Central,3742,1572,5314,149680,62880,212560
8/3/2024,Manisha Tharuka,Kandy,Hunnasgiriya,Central,4236,902,5138,169440,36080,205520
8/4/2024,Manisha Tharuka,Kandy,Hunnasgiriya,Central,8760,6212,14972,350400,248480,598880
8/5/2024,Manisha Tharuka,Kandy,Hunnasgiriya,Central,8402,6855,15257,336080,274200,610280
8/6/2024,Manisha Tharuka,Kandy,Hunnasgiriya,Central,9369,8853,18222,374760,354120,728880
8/7/2024,Manisha Tharuka,Kandy,Hunnasgiriya,Central,6417,5589,12006,256680,223560,480240
8/8/2024,Manisha Tharuka,Kandy,Hunnasgiriya,Central,2567,1479,4046,102680,59160,161840
8/9/2024,Manisha Tharuka,Kandy,Hunnasgiriya,Central,1677,1394,3071,67080,55760,122840
8/10/2024,Manisha Tharuka,Kandy,Hunnasgiriya,Central,4884,8827,13711,195360,353080,548440
8/11/2024,Manisha Tharuka,Kandy,Hunnasgiriya,Central,6714,5999,12713,268560,239960,508520
8/12/2024,Manisha Tharuka,Kandy,Hunnasgiriya,Central,3519,6967,10486,140760,278680,419440
8/13/2024,Manisha Tharuka,Kandy,Hunnasgiriya,Central,900,5006,5906,36000,200240,236240
8/14/2024,Manisha Tharuka,Kandy,Hunnasgiriya,Central,9910,1149,11059,396400,45960,442360
8/15/2024,Manisha Tharuka,Kandy,Hunnasgiriya,Central,6936,2167,9103,277440,86680,364120
8/16/2024,Manisha Tharuka,Kandy,Hunnasgiriya,Central,5013,2486,7499,200520,99440,299960
8/17/2024,Manisha Tharuka,Kandy,Hunnasgiriya,Central,1288,8171,9459,51520,326840,378360
8/18/2024,Manisha Tharuka,Kandy,Hunnasgiriya,Central,5117,9486,14603,204680,379440,584120
8/19/2024,Manisha Tharuka,Kandy,Hunnasgiriya,Central,9370,9939,19309,374800,397560,772360
8/20/2024,Manisha Tharuka,Kandy,Hunnasgiriya,Central,233,3212,3445,9320,128480,137800
8/21/2024,Manisha Tharuka,Kandy,Hunnasgiriya,Central,2984,7144,10128,119360,285760,405120
8/22/2024,Manisha Tharuka,Kandy,Hunnasgiriya,Central,282,7269,7551,11280,290760,302040
8/23/2024,Manisha Tharuka,Kandy,Hunnasgiriya,Central,9788,9894,19682,391520,395760,787280
8/24/2024,Manisha Tharuka,Kandy,Hunnasgiriya,Central,7124,2030,9154,284960,81200,366160
8/25/2024,Manisha Tharuka,Kandy,Hunnasgiriya,Central,8188,719,8907,327520,28760,356280
8/26/2024,Manisha Tharuka,Kandy,Hunnasgiriya,Central,2731,5439,8170,109240,217560,326800
8/27/2024,Manisha Tharuka,Kandy,Hunnasgiriya,Central,4267,7767,12034,170680,310680,481360
8/28/2024,Manisha Tharuka,Kandy,Hunnasgiriya,Central,2330,3443,5773,93200,137720,230920
8/29/2024,Manisha Tharuka,Kandy,Hunnasgiriya,Central,2616,4701,7317,104640,188040,292680
8/30/2024,Manisha Tharuka,Kandy,Hunnasgiriya,Central,6389,4750,11139,255560,190000,445560
8/31/2024,Manisha Tharuka,Kandy,Hunnasgiriya,Central,1779,4355,6134,71160,174200,245360
9/1/2024,Manisha Tharuka,Kandy,Hunnasgiriya,Central,9083,449,9532,363320,17960,381280
9/2/2024,Manisha Tharuka,Kandy,Hunnasgiriya,Central,4576,6928,11504,183040,277120,460160
9/3/2024,Manisha Tharuka,Kandy,Hunnasgiriya,Central,5954,7002,12956,238160,280080,518240
9/4/2024,Manisha Tharuka,Kandy,Hunnasgiriya,Central,8699,4818,13517,347960,192720,540680
9/5/2024,Manisha Tharuka,Kandy,Hunnasgiriya,Central,1382,4996,6378,55280,199840,255120
9/6/2024,Manisha Tharuka,Kandy,Hunnasgiriya,Central,3749,3210,6959,149960,128400,278360
9/7/2024,Manisha Tharuka,Kandy,Hunnasgiriya,Central,24,3669,3693,960,146760,147720
9/8/2024,Manisha Tharuka,Kandy,Hunnasgiriya,Central,3471,3331,6802,138840,133240,272080
9/9/2024,Manisha Tharuka,Kandy,Hunnasgiriya,Central,3761,454,4215,150440,18160,168600
9/10/2024,Manisha Tharuka,Kandy,Hunnasgiriya,Central,327,3357,3684,13080,134280,147360
9/11/2024,Manisha Tharuka,Kandy,Hunnasgiriya,Central,5720,7453,13173,228800,298120,526920
9/12/2024,Manisha Tharuka,Kandy,Hunnasgiriya,Central,9370,8977,18347,374800,359080,733880
9/13/2024,Manisha Tharuka,Kandy,Hunnasgiriya,Central,1038,9031,10069,41520,361240,402760
9/14/2024,Manisha Tharuka,Kandy,Hunnasgiriya,Central,8255,5688,13943,330200,227520,557720
9/15/2024,Manisha Tharuka,Kandy,Hunnasgiriya,Central,4709,8445,13154,188360,337800,526160
9/16/2024,Manisha Tharuka,Kandy,Hunnasgiriya,Central,6258,8671,14929,250320,346840,597160
9/17/2024,Manisha Tharuka,Kandy,Hunnasgiriya,Central,1421,9620,11041,56840,384800,441640
9/18/2024,Manisha Tharuka,Kandy,Hunnasgiriya,Central,1561,5546,7107,62440,221840,284280
9/19/2024,Manisha Tharuka,Kandy,Hunnasgiriya,Central,2766,7074,9840,110640,282960,393600
9/20/2024,Manisha Tharuka,Kandy,Hunnasgiriya,Central,9368,3134,12502,374720,125360,500080
9/21/2024,Manisha Tharuka,Kandy,Hunnasgiriya,Central,9919,2040,11959,396760,81600,478360
9/22/2024,Manisha Tharuka,Kandy,Hunnasgiriya,Central,7896,6320,14216,315840,252800,568640
9/23/2024,Manisha Tharuka,Kandy,Hunnasgiriya,Central,8664,6446,15110,346560,257840,604400
9/24/2024,Manisha Tharuka,Kandy,Hunnasgiriya,Central,8813,1257,10070,352520,50280,402800
9/25/2024,Manisha Tharuka,Kandy,Hunnasgiriya,Central,2466,767,3233,98640,30680,129320
9/26/2024,Manisha Tharuka,Kandy,Hunnasgiriya,Central,881,5667,6548,35240,226680,261920
9/27/2024,Manisha Tharuka,Kandy,Hunnasgiriya,Central,9074,7008,16082,362960,280320,643280
9/28/2024,Manisha Tharuka,Kandy,Hunnasgiriya,Central,116,5272,5388,4640,210880,215520
9/29/2024,Manisha Tharuka,Kandy,Hunnasgiriya,Central,3099,7564,10663,123960,302560,426520
9/30/2024,Manisha Tharuka,Kandy,Hunnasgiriya,Central,8593,1759,10352,343720,70360,414080
10/1/2024,Manisha Tharuka,Kandy,Hunnasgiriya,Central,3371,6404,9775,134840,256160,391000
10/2/2024,Manisha Tharuka,Kandy,Hunnasgiriya,Central,5609,3233,8842,224360,129320,353680
10/3/2024,Manisha Tharuka,Kandy,Hunnasgiriya,Central,49,9744,9793,1960,389760,391720
10/4/2024,Manisha Tharuka,Kandy,Hunnasgiriya,Central,2528,1420,3948,101120,56800,157920
10/5/2024,Manisha Tharuka,Kandy,Hunnasgiriya,Central,3193,1643,4836,127720,65720,193440
10/6/2024,Manisha Tharuka,Kandy,Hunnasgiriya,Central,4575,7478,12053,183000,299120,482120
10/7/2024,Manisha Tharuka,Kandy,Hunnasgiriya,Central,1773,9219,10992,70920,368760,439680
10/8/2024,Manisha Tharuka,Kandy,Hunnasgiriya,Central,5530,88,5618,221200,3520,224720
10/9/2024,Manisha Tharuka,Kandy,Hunnasgiriya,Central,8313,6570,14883,332520,262800,595320
10/10/2024,Manisha Tharuka,Kandy,Hunnasgiriya,Central,9635,9132,18767,385400,365280,750680
10/11/2024,Manisha Tharuka,Kandy,Hunnasgiriya,Central,1303,7209,8512,52120,288360,340480
10/12/2024,Manisha Tharuka,Kandy,Hunnasgiriya,Central,1170,8488,9658,46800,339520,386320
10/13/2024,Manisha Tharuka,Kandy,Hunnasgiriya,Central,2852,6174,9026,114080,246960,361040
10/14/2024,Manisha Tharuka,Kandy,Hunnasgiriya,Central,5633,5369,11002,225320,214760,440080
10/15/2024,Manisha Tharuka,Kandy,Hunnasgiriya,Central,3220,157,3377,128800,6280,135080
10/16/2024,Manisha Tharuka,Kandy,Hunnasgiriya,Central,9022,9674,18696,360880,386960,747840
10/17/2024,Manisha Tharuka,Kandy,Hunnasgiriya,Central,7639,3741,11380,305560,149640,455200
10/18/2024,Manisha Tharuka,Kandy,Hunnasgiriya,Central,5735,3826,9561,229400,153040,382440
10/19/2024,Manisha Tharuka,Kandy,Hunnasgiriya,Central,9405,4337,13742,376200,173480,549680
10/20/2024,Manisha Tharuka,Kandy,Hunnasgiriya,Central,1538,6517,8055,61520,260680,322200
10/21/2024,Manisha Tharuka,Kandy,Hunnasgiriya,Central,1348,2810,4158,53920,112400,166320
10/22/2024,Manisha Tharuka,Kandy,Hunnasgiriya,Central,6638,6905,13543,265520,276200,541720
10/23/2024,Manisha Tharuka,Kandy,Hunnasgiriya,Central,4341,5965,10306,173640,238600,412240
10/24/2024,Manisha Tharuka,Kandy,Hunnasgiriya,Central,2862,3749,6611,114480,149960,264440
10/25/2024,Manisha Tharuka,Kandy,Hunnasgiriya,Central,4409,1678,6087,176360,67120,243480
10/26/2024,Manisha Tharuka,Kandy,Hunnasgiriya,Central,5169,4624,9793,206760,184960,391720
10/27/2024,Manisha Tharuka,Kandy,Hunnasgiriya,Central,262,9179,9441,10480,367160,377640
10/28/2024,Manisha Tharuka,Kandy,Hunnasgiriya,Central,72,2685,2757,2880,107400,110280
10/29/2024,Manisha Tharuka,Kandy,Hunnasgiriya,Central,2407,1903,4310,96280,76120,172400
10/30/2024,Manisha Tharuka,Kandy,Hunnasgiriya,Central,9205,3237,12442,368200,129480,497680
10/31/2024,Manisha Tharuka,Kandy,Hunnasgiriya,Central,1771,4011,5782,70840,160440,231280
11/1/2024,Manisha Tharuka,Kandy,Hunnasgiriya,Central,5033,8741,13774,201320,349640,550960
11/2/2024,Manisha Tharuka,Kandy,Hunnasgiriya,Central,5927,1537,7464,237080,61480,298560
11/3/2024,Manisha Tharuka,Kandy,Hunnasgiriya,Central,9944,68,10012,397760,2720,400480
11/4/2024,Manisha Tharuka,Kandy,Hunnasgiriya,Central,2087,1227,3314,83480,49080,132560
11/5/2024,Manisha Tharuka,Kandy,Hunnasgiriya,Central,8744,1993,10737,349760,79720,429480
11/6/2024,Manisha Tharuka,Kandy,Hunnasgiriya,Central,2507,7252,9759,100280,290080,390360
11/7/2024,Manisha Tharuka,Kandy,Hunnasgiriya,Central,9039,6903,15942,361560,276120,637680
11/8/2024,Manisha Tharuka,Kandy,Hunnasgiriya,Central,9531,2450,11981,381240,98000,479240
11/9/2024,Manisha Tharuka,Kandy,Hunnasgiriya,Central,525,807,1332,21000,32280,53280
11/10/2024,Manisha Tharuka,Kandy,Hunnasgiriya,Central,7217,733,7950,288680,29320,318000
11/11/2024,Manisha Tharuka,Kandy,Hunnasgiriya,Central,4960,16,4976,198400,640,199040
11/12/2024,Manisha Tharuka,Kandy,Hunnasgiriya,Central,3198,7715,10913,127920,308600,436520
11/13/2024,Manisha Tharuka,Kandy,Hunnasgiriya,Central,3166,4650,7816,126640,186000,312640
11/14/2024,Manisha Tharuka,Kandy,Hunnasgiriya,Central,2896,5989,8885,115840,239560,355400
11/15/2024,Manisha Tharuka,Kandy,Hunnasgiriya,Central,2462,4426,6888,98480,177040,275520
11/16/2024,Manisha Tharuka,Kandy,Hunnasgiriya,Central,331,9133,9464,13240,365320,378560
11/17/2024,Manisha Tharuka,Kandy,Hunnasgiriya,Central,6423,6470,12893,256920,258800,515720
11/18/2024,Manisha Tharuka,Kandy,Hunnasgiriya,Central,9044,6544,15588,361760,261760,623520
11/19/2024,Manisha Tharuka,Kandy,Hunnasgiriya,Central,9102,5980,15082,364080,239200,603280
11/20/2024,Manisha Tharuka,Kandy,Hunnasgiriya,Central,2688,1635,4323,107520,65400,172920
11/21/2024,Manisha Tharuka,Kandy,Hunnasgiriya,Central,5920,1899,7819,236800,75960,312760
11/22/2024,Manisha Tharuka,Kandy,Hunnasgiriya,Central,5197,6940,12137,207880,277600,485480
11/23/2024,Manisha Tharuka,Kandy,Hunnasgiriya,Central,5852,4092,9944,234080,163680,397760
11/24/2024,Manisha Tharuka,Kandy,Hunnasgiriya,Central,6590,5732,12322,263600,229280,492880
11/25/2024,Manisha Tharuka,Kandy,Hunnasgiriya,Central,102,5432,5534,4080,217280,221360
11/26/2024,Manisha Tharuka,Kandy,Hunnasgiriya,Central,9166,4451,13617,366640,178040,544680
11/27/2024,Manisha Tharuka,Kandy,Hunnasgiriya,Central,5674,4175,9849,226960,167000,393960
11/28/2024,Manisha Tharuka,Kandy,Hunnasgiriya,Central,1638,8185,9823,65520,327400,392920
11/29/2024,Manisha Tharuka,Kandy,Hunnasgiriya,Central,4822,8762,13584,192880,350480,543360
11/30/2024,Manisha Tharuka,Kandy,Hunnasgiriya,Central,7279,8874,16153,291160,354960,646120
12/1/2024,Manisha Tharuka,Kandy,Hunnasgiriya,Central,3829,3051,6880,153160,122040,275200
12/2/2024,Manisha Tharuka,Kandy,Hunnasgiriya,Central,1518,3573,5091,60720,142920,203640
12/3/2024,Manisha Tharuka,Kandy,Hunnasgiriya,Central,7423,9975,17398,296920,399000,695920
12/4/2024,Manisha Tharuka,Kandy,Hunnasgiriya,Central,7919,2637,10556,316760,105480,422240
12/5/2024,Manisha Tharuka,Kandy,Hunnasgiriya,Central,9236,9304,18540,369440,372160,741600
12/6/2024,Manisha Tharuka,Kandy,Hunnasgiriya,Central,2527,1314,3841,101080,52560,153640
12/7/2024,Manisha Tharuka,Kandy,Hunnasgiriya,Central,5893,5051,10944,235720,202040,437760
12/8/2024,Manisha Tharuka,Kandy,Hunnasgiriya,Central,6088,7015,13103,243520,280600,524120
12/9/2024,Manisha Tharuka,Kandy,Hunnasgiriya,Central,1017,6028,7045,40680,241120,281800
12/10/2024,Manisha Tharuka,Kandy,Hunnasgiriya,Central,3911,5513,9424,156440,220520,376960
12/11/2024,Manisha Tharuka,Kandy,Hunnasgiriya,Central,6208,5112,11320,248320,204480,452800
12/12/2024,Manisha Tharuka,Kandy,Hunnasgiriya,Central,1790,7759,9549,71600,310360,381960
12/13/2024,Manisha Tharuka,Kandy,Hunnasgiriya,Central,9994,729,10723,399760,29160,428920
12/14/2024,Manisha Tharuka,Kandy,Hunnasgiriya,Central,9168,853,10021,366720,34120,400840
12/15/2024,Manisha Tharuka,Kandy,Hunnasgiriya,Central,5005,5333,10338,200200,213320,413520
12/16/2024,Manisha Tharuka,Kandy,Hunnasgiriya,Central,3893,7828,11721,155720,313120,468840
12/17/2024,Manisha Tharuka,Kandy,Hunnasgiriya,Central,7603,9991,17594,304120,399640,703760
12/18/2024,Manisha Tharuka,Kandy,Hunnasgiriya,Central,8893,1810,10703,355720,72400,428120
12/19/2024,Manisha Tharuka,Kandy,Hunnasgiriya,Central,2903,7238,10141,116120,289520,405640
12/20/2024,Manisha Tharuka,Kandy,Hunnasgiriya,Central,315,6069,6384,12600,242760,255360
12/21/2024,Manisha Tharuka,Kandy,Hunnasgiriya,Central,7524,7608,15132,300960,304320,605280
12/22/2024,Manisha Tharuka,Kandy,Hunnasgiriya,Central,7746,8377,16123,309840,335080,644920
12/23/2024,Manisha Tharuka,Kandy,Hunnasgiriya,Central,7433,8679,16112,297320,347160,644480
12/24/2024,Manisha Tharuka,Kandy,Hunnasgiriya,Central,9054,7832,16886,362160,313280,675440
12/25/2024,Manisha Tharuka,Kandy,Hunnasgiriya,Central,3258,4166,7424,130320,166640,296960
12/26/2024,Manisha Tharuka,Kandy,Hunnasgiriya,Central,9001,3443,12444,360040,137720,497760
12/27/2024,Manisha Tharuka,Kandy,Hunnasgiriya,Central,3813,9602,13415,152520,384080,536600
12/28/2024,Manisha Tharuka,Kandy,Hunnasgiriya,Central,5155,5277,10432,206200,211080,417280
12/29/2024,Manisha Tharuka,Kandy,Hunnasgiriya,Central,6306,4824,11130,252240,192960,445200
12/30/2024,Manisha Tharuka,Kandy,Hunnasgiriya,Central,3011,1038,4049,120440,41520,161960
12/31/2024,Manisha Tharuka,Kandy,Hunnasgiriya,Central,6273,6694,12967,250920,267760,518680
1/1/2025,Manisha Tharuka,Kandy,Hunnasgiriya,Central,2556,3218,5774,102240,128720,230960
1/2/2025,Manisha Tharuka,Kandy,Hunnasgiriya,Central,9612,5623,15235,384480,224920,609400
1/3/2025,Manisha Tharuka,Kandy,Hunnasgiriya,Central,8786,9200,17986,351440,368000,719440
1/4/2025,Manisha Tharuka,Kandy,Hunnasgiriya,Central,4304,7770,12074,172160,310800,482960
1/5/2025,Manisha Tharuka,Kandy,Hunnasgiriya,Central,1190,2844,4034,47600,113760,161360
1/6/2025,Manisha Tharuka,Kandy,Hunnasgiriya,Central,7357,44,7401,294280,1760,296040
1/7/2025,Manisha Tharuka,Kandy,Hunnasgiriya,Central,9254,8293,17547,370160,331720,701880
1/8/2025,Manisha Tharuka,Kandy,Hunnasgiriya,Central,6554,2760,9314,262160,110400,372560
1/9/2025,Manisha Tharuka,Kandy,Hunnasgiriya,Central,8007,9094,17101,320280,363760,684040
1/10/2025,Manisha Tharuka,Kandy,Hunnasgiriya,Central,6060,5635,11695,242400,225400,467800
1/11/2025,Manisha Tharuka,Kandy,Hunnasgiriya,Central,6436,9909,16345,257440,396360,653800
1/12/2025,Manisha Tharuka,Kandy,Hunnasgiriya,Central,2002,1445,3447,80080,57800,137880
1/13/2025,Manisha Tharuka,Kandy,Hunnasgiriya,Central,9775,2370,12145,391000,94800,485800
1/14/2025,Manisha Tharuka,Kandy,Hunnasgiriya,Central,9490,7512,17002,379600,300480,680080
1/15/2025,Manisha Tharuka,Kandy,Hunnasgiriya,Central,2514,6408,8922,100560,256320,356880
1/16/2025,Manisha Tharuka,Kandy,Hunnasgiriya,Central,8966,6405,15371,358640,256200,614840
1/17/2025,Manisha Tharuka,Kandy,Hunnasgiriya,Central,3906,5070,8976,156240,202800,359040
1/18/2025,Manisha Tharuka,Kandy,Hunnasgiriya,Central,30,5228,5258,1200,209120,210320
1/19/2025,Manisha Tharuka,Kandy,Hunnasgiriya,Central,1728,8991,10719,69120,359640,428760
1/20/2025,Manisha Tharuka,Kandy,Hunnasgiriya,Central,3555,9389,12944,142200,375560,517760
1/21/2025,Manisha Tharuka,Kandy,Hunnasgiriya,Central,5007,2410,7417,200280,96400,296680
1/22/2025,Manisha Tharuka,Kandy,Hunnasgiriya,Central,6792,6051,12843,271680,242040,513720
1/23/2025,Manisha Tharuka,Kandy,Hunnasgiriya,Central,6079,2864,8943,243160,114560,357720
1/24/2025,Manisha Tharuka,Kandy,Hunnasgiriya,Central,6914,3836,10750,276560,153440,430000
1/25/2025,Manisha Tharuka,Kandy,Hunnasgiriya,Central,8106,2857,10963,324240,114280,438520
1/26/2025,Manisha Tharuka,Kandy,Hunnasgiriya,Central,5496,33,5529,219840,1320,221160
1/27/2025,Manisha Tharuka,Kandy,Hunnasgiriya,Central,5794,2947,8741,231760,117880,349640
1/28/2025,Manisha Tharuka,Kandy,Hunnasgiriya,Central,9554,7885,17439,382160,315400,697560
1/29/2025,Manisha Tharuka,Kandy,Hunnasgiriya,Central,9215,3658,12873,368600,146320,514920
1/30/2025,Manisha Tharuka,Kandy,Hunnasgiriya,Central,9522,2045,11567,380880,81800,462680
1/31/2025,Manisha Tharuka,Kandy,Hunnasgiriya,Central,5186,1354,6540,207440,54160,261600
2/1/2025,Manisha Tharuka,Kandy,Hunnasgiriya,Central,7974,9392,17366,318960,375680,694640
2/2/2025,Manisha Tharuka,Kandy,Hunnasgiriya,Central,5136,751,5887,205440,30040,235480
2/3/2025,Manisha Tharuka,Kandy,Hunnasgiriya,Central,6420,8701,15121,256800,348040,604840
2/4/2025,Manisha Tharuka,Kandy,Hunnasgiriya,Central,8035,7757,15792,321400,310280,631680
2/5/2025,Manisha Tharuka,Kandy,Hunnasgiriya,Central,571,2521,3092,22840,100840,123680
2/6/2025,Manisha Tharuka,Kandy,Hunnasgiriya,Central,4267,779,5046,170680,31160,201840
2/7/2025,Manisha Tharuka,Kandy,Hunnasgiriya,Central,1309,9395,10704,52360,375800,428160
2/8/2025,Manisha Tharuka,Kandy,Hunnasgiriya,Central,5133,8224,13357,205320,328960,534280
2/9/2025,Manisha Tharuka,Kandy,Hunnasgiriya,Central,7758,4829,12587,310320,193160,503480
2/10/2025,Manisha Tharuka,Kandy,Hunnasgiriya,Central,1040,900,1940,41600,36000,77600
2/11/2025,Manisha Tharuka,Kandy,Hunnasgiriya,Central,6286,2563,8849,251440,102520,353960
2/12/2025,Manisha Tharuka,Kandy,Hunnasgiriya,Central,6827,20,6847,273080,800,273880
2/13/2025,Manisha Tharuka,Kandy,Hunnasgiriya,Central,5803,7611,13414,232120,304440,536560
2/14/2025,Manisha Tharuka,Kandy,Hunnasgiriya,Central,1169,8823,9992,46760,352920,399680
2/15/2025,Manisha Tharuka,Kandy,Hunnasgiriya,Central,4290,5449,9739,171600,217960,389560
2/16/2025,Manisha Tharuka,Kandy,Hunnasgiriya,Central,6949,9913,16862,277960,396520,674480
2/17/2025,Manisha Tharuka,Kandy,Hunnasgiriya,Central,1436,5222,6658,57440,208880,266320
2/18/2025,Manisha Tharuka,Kandy,Hunnasgiriya,Central,5143,1449,6592,205720,57960,263680
2/19/2025,Manisha Tharuka,Kandy,Hunnasgiriya,Central,7278,4329,11607,291120,173160,464280
2/20/2025,Manisha Tharuka,Kandy,Hunnasgiriya,Central,8717,8705,17422,348680,348200,696880
2/21/2025,Manisha Tharuka,Kandy,Hunnasgiriya,Central,8432,2349,10781,337280,93960,431240
2/22/2025,Manisha Tharuka,Kandy,Hunnasgiriya,Central,8898,7628,16526,355920,305120,661040
2/23/2025,Manisha Tharuka,Kandy,Hunnasgiriya,Central,3709,7502,11211,148360,300080,448440
2/24/2025,Manisha Tharuka,Kandy,Hunnasgiriya,Central,6799,6693,13492,271960,267720,539680
2/25/2025,Manisha Tharuka,Kandy,Hunnasgiriya,Central,8592,4544,13136,343680,181760,525440
2/26/2025,Manisha Tharuka,Kandy,Hunnasgiriya,Central,3715,4042,7757,148600,161680,310280
2/27/2025,Manisha Tharuka,Kandy,Hunnasgiriya,Central,26,9455,9481,1040,378200,379240
2/28/2025,Manisha Tharuka,Kandy,Hunnasgiriya,Central,6781,1826,8607,271240,73040,344280
3/1/2025,Manisha Tharuka,Kandy,Hunnasgiriya,Central,3989,900,4889,159560,36000,195560
3/2/2025,Manisha Tharuka,Kandy,Hunnasgiriya,Central,1559,2594,4153,62360,103760,166120
3/3/2025,Manisha Tharuka,Kandy,Hunnasgiriya,Central,3304,4715,8019,132160,188600,320760
3/4/2025,Manisha Tharuka,Kandy,Hunnasgiriya,Central,4223,332,4555,168920,13280,182200
3/5/2025,Manisha Tharuka,Kandy,Hunnasgiriya,Central,2815,1810,4625,112600,72400,185000
3/6/2025,Manisha Tharuka,Kandy,Hunnasgiriya,Central,995,5471,6466,39800,218840,258640
3/7/2025,Manisha Tharuka,Kandy,Hunnasgiriya,Central,5559,3349,8908,222360,133960,356320
3/8/2025,Manisha Tharuka,Kandy,Hunnasgiriya,Central,1208,399,1607,48320,15960,64280
3/9/2025,Manisha Tharuka,Kandy,Hunnasgiriya,Central,8197,6193,14390,327880,247720,575600
3/10/2025,Manisha Tharuka,Kandy,Hunnasgiriya,Central,8157,4303,12460,326280,172120,498400
3/11/2025,Manisha Tharuka,Kandy,Hunnasgiriya,Central,4674,1289,5963,186960,51560,238520
3/12/2025,Manisha Tharuka,Kandy,Hunnasgiriya,Central,5401,3633,9034,216040,145320,361360
3/13/2025,Manisha Tharuka,Kandy,Hunnasgiriya,Central,7607,1356,8963,304280,54240,358520
3/14/2025,Manisha Tharuka,Kandy,Hunnasgiriya,Central,5487,2063,7550,219480,82520,302000
3/15/2025,Manisha Tharuka,Kandy,Hunnasgiriya,Central,315,5999,6314,12600,239960,252560
3/16/2025,Manisha Tharuka,Kandy,Hunnasgiriya,Central,1594,4797,6391,63760,191880,255640
3/17/2025,Manisha Tharuka,Kandy,Hunnasgiriya,Central,8228,68,8296,329120,2720,331840
3/18/2025,Manisha Tharuka,Kandy,Hunnasgiriya,Central,1359,3818,5177,54360,152720,207080
3/19/2025,Manisha Tharuka,Kandy,Hunnasgiriya,Central,8332,2865,11197,333280,114600,447880
3/20/2025,Manisha Tharuka,Kandy,Hunnasgiriya,Central,1723,4450,6173,68920,178000,246920
3/21/2025,Manisha Tharuka,Kandy,Hunnasgiriya,Central,3344,5712,9056,133760,228480,362240
3/22/2025,Manisha Tharuka,Kandy,Hunnasgiriya,Central,3664,7485,11149,146560,299400,445960
3/23/2025,Manisha Tharuka,Kandy,Hunnasgiriya,Central,3995,6563,10558,159800,262520,422320
3/25/2024,Dinesh Bandara,Moneragala,Wellawaya,Uva,1555,2369,3924,62200,94760,156960
3/26/2024,Dinesh Bandara,Moneragala,Wellawaya,Uva,8823,7992,16815,352920,319680,672600
3/27/2024,Dinesh Bandara,Moneragala,Wellawaya,Uva,8524,1987,10511,340960,79480,420440
3/28/2024,Dinesh Bandara,Moneragala,Wellawaya,Uva,3459,5565,9024,138360,222600,360960
3/29/2024,Dinesh Bandara,Moneragala,Wellawaya,Uva,3714,8071,11785,148560,322840,471400
3/30/2024,Dinesh Bandara,Moneragala,Wellawaya,Uva,9853,3656,13509,394120,146240,540360
3/31/2024,Dinesh Bandara,Moneragala,Wellawaya,Uva,9157,9740,18897,366280,389600,755880
4/1/2024,Dinesh Bandara,Moneragala,Wellawaya,Uva,8778,4180,12958,351120,167200,518320
4/2/2024,Dinesh Bandara,Moneragala,Wellawaya,Uva,4650,3295,7945,186000,131800,317800
4/3/2024,Dinesh Bandara,Moneragala,Wellawaya,Uva,2181,2447,4628,87240,97880,185120
4/4/2024,Dinesh Bandara,Moneragala,Wellawaya,Uva,3391,8775,12166,135640,351000,486640
4/5/2024,Dinesh Bandara,Moneragala,Wellawaya,Uva,2061,6847,8908,82440,273880,356320
4/6/2024,Dinesh Bandara,Moneragala,Wellawaya,Uva,7675,9541,17216,307000,381640,688640
4/7/2024,Dinesh Bandara,Moneragala,Wellawaya,Uva,7512,1746,9258,300480,69840,370320
4/8/2024,Dinesh Bandara,Moneragala,Wellawaya,Uva,2984,5791,8775,119360,231640,351000
4/9/2024,Dinesh Bandara,Moneragala,Wellawaya,Uva,4551,4441,8992,182040,177640,359680
4/10/2024,Dinesh Bandara,Moneragala,Wellawaya,Uva,8682,3590,12272,347280,143600,490880
4/11/2024,Dinesh Bandara,Moneragala,Wellawaya,Uva,8685,4133,12818,347400,165320,512720
4/19/2024,Dinesh Bandara,Moneragala,Wellawaya,Uva,2007,8878,10885,80280,355120,435400
4/20/2024,Dinesh Bandara,Moneragala,Wellawaya,Uva,575,8714,9289,23000,348560,371560
4/21/2024,Dinesh Bandara,Moneragala,Wellawaya,Uva,6771,4802,11573,270840,192080,462920
4/22/2024,Dinesh Bandara,Moneragala,Wellawaya,Uva,5607,7484,13091,224280,299360,523640
4/23/2024,Dinesh Bandara,Moneragala,Wellawaya,Uva,5390,9354,14744,215600,374160,589760
4/24/2024,Dinesh Bandara,Moneragala,Wellawaya,Uva,3015,6897,9912,120600,275880,396480
4/25/2024,Dinesh Bandara,Moneragala,Wellawaya,Uva,8482,1469,9951,339280,58760,398040
4/26/2024,Dinesh Bandara,Moneragala,Wellawaya,Uva,5851,5626,11477,234040,225040,459080
4/27/2024,Dinesh Bandara,Moneragala,Wellawaya,Uva,8746,7382,16128,349840,295280,645120
4/28/2024,Dinesh Bandara,Moneragala,Wellawaya,Uva,9247,2940,12187,369880,117600,487480
4/29/2024,Dinesh Bandara,Moneragala,Wellawaya,Uva,3843,4295,8138,153720,171800,325520
4/30/2024,Dinesh Bandara,Moneragala,Wellawaya,Uva,2514,2662,5176,100560,106480,207040
5/1/2024,Dinesh Bandara,Moneragala,Wellawaya,Uva,8367,9278,17645,334680,371120,705800
5/2/2024,Dinesh Bandara,Moneragala,Wellawaya,Uva,5049,1903,6952,201960,76120,278080
5/3/2024,Dinesh Bandara,Moneragala,Wellawaya,Uva,5120,5519,10639,204800,220760,425560
5/4/2024,Dinesh Bandara,Moneragala,Wellawaya,Uva,1158,8996,10154,46320,359840,406160
5/5/2024,Dinesh Bandara,Moneragala,Wellawaya,Uva,2205,7826,10031,88200,313040,401240
5/6/2024,Dinesh Bandara,Moneragala,Wellawaya,Uva,301,7380,7681,12040,295200,307240
5/7/2024,Dinesh Bandara,Moneragala,Wellawaya,Uva,1051,740,1791,42040,29600,71640
5/8/2024,Dinesh Bandara,Moneragala,Wellawaya,Uva,6754,1743,8497,270160,69720,339880
5/9/2024,Dinesh Bandara,Moneragala,Wellawaya,Uva,1491,8276,9767,59640,331040,390680
5/10/2024,Dinesh Bandara,Moneragala,Wellawaya,Uva,4478,8401,12879,179120,336040,515160
5/11/2024,Dinesh Bandara,Moneragala,Wellawaya,Uva,6870,5180,12050,274800,207200,482000
5/12/2024,Dinesh Bandara,Moneragala,Wellawaya,Uva,2669,6464,9133,106760,258560,365320
5/13/2024,Dinesh Bandara,Moneragala,Wellawaya,Uva,7281,1414,8695,291240,56560,347800
5/14/2024,Dinesh Bandara,Moneragala,Wellawaya,Uva,5017,3423,8440,200680,136920,337600
5/15/2024,Dinesh Bandara,Moneragala,Wellawaya,Uva,6693,5198,11891,267720,207920,475640
5/16/2024,Dinesh Bandara,Moneragala,Wellawaya,Uva,3695,9439,13134,147800,377560,525360
5/17/2024,Dinesh Bandara,Moneragala,Wellawaya,Uva,4851,1909,6760,194040,76360,270400
5/18/2024,Dinesh Bandara,Moneragala,Wellawaya,Uva,8577,2479,11056,343080,99160,442240
5/19/2024,Dinesh Bandara,Moneragala,Wellawaya,Uva,4711,7972,12683,188440,318880,507320
5/20/2024,Dinesh Bandara,Moneragala,Wellawaya,Uva,3985,5446,9431,159400,217840,377240
5/21/2024,Dinesh Bandara,Moneragala,Wellawaya,Uva,6705,9100,15805,268200,364000,632200
5/22/2024,Dinesh Bandara,Moneragala,Wellawaya,Uva,8566,1202,9768,342640,48080,390720
5/24/2024,Dinesh Bandara,Moneragala,Wellawaya,Uva,44,5946,5990,1760,237840,239600
5/25/2024,Dinesh Bandara,Moneragala,Wellawaya,Uva,2051,3782,5833,82040,151280,233320
5/26/2024,Dinesh Bandara,Moneragala,Wellawaya,Uva,2331,5541,7872,93240,221640,314880
5/27/2024,Dinesh Bandara,Moneragala,Wellawaya,Uva,1909,3858,5767,76360,154320,230680
5/28/2024,Dinesh Bandara,Moneragala,Wellawaya,Uva,2624,4475,7099,104960,179000,283960
5/29/2024,Dinesh Bandara,Moneragala,Wellawaya,Uva,9580,2602,12182,383200,104080,487280
5/30/2024,Dinesh Bandara,Moneragala,Wellawaya,Uva,2321,1027,3348,92840,41080,133920
5/31/2024,Dinesh Bandara,Moneragala,Wellawaya,Uva,5068,5036,10104,202720,201440,404160
6/1/2024,Dinesh Bandara,Moneragala,Wellawaya,Uva,7372,3962,11334,294880,158480,453360
6/2/2024,Dinesh Bandara,Moneragala,Wellawaya,Uva,8562,4372,12934,342480,174880,517360
6/3/2024,Dinesh Bandara,Moneragala,Wellawaya,Uva,5533,119,5652,221320,4760,226080
6/4/2024,Dinesh Bandara,Moneragala,Wellawaya,Uva,3731,9766,13497,149240,390640,539880
6/5/2024,Dinesh Bandara,Moneragala,Wellawaya,Uva,1647,6227,7874,65880,249080,314960
6/6/2024,Dinesh Bandara,Moneragala,Wellawaya,Uva,8951,690,9641,358040,27600,385640
6/7/2024,Dinesh Bandara,Moneragala,Wellawaya,Uva,7965,6914,14879,318600,276560,595160
6/8/2024,Dinesh Bandara,Moneragala,Wellawaya,Uva,399,7845,8244,15960,313800,329760
6/9/2024,Dinesh Bandara,Moneragala,Wellawaya,Uva,2906,9651,12557,116240,386040,502280
6/10/2024,Dinesh Bandara,Moneragala,Wellawaya,Uva,4860,3390,8250,194400,135600,330000
6/11/2024,Dinesh Bandara,Moneragala,Wellawaya,Uva,9608,1826,11434,384320,73040,457360
6/12/2024,Dinesh Bandara,Moneragala,Wellawaya,Uva,3457,9032,12489,138280,361280,499560
6/13/2024,Dinesh Bandara,Moneragala,Wellawaya,Uva,8746,607,9353,349840,24280,374120
6/14/2024,Dinesh Bandara,Moneragala,Wellawaya,Uva,8019,1508,9527,320760,60320,381080
6/15/2024,Dinesh Bandara,Moneragala,Wellawaya,Uva,2224,1454,3678,88960,58160,147120
6/16/2024,Dinesh Bandara,Moneragala,Wellawaya,Uva,5536,4313,9849,221440,172520,393960
6/17/2024,Dinesh Bandara,Moneragala,Wellawaya,Uva,4567,6898,11465,182680,275920,458600
6/18/2024,Dinesh Bandara,Moneragala,Wellawaya,Uva,8915,5524,14439,356600,220960,577560
6/19/2024,Dinesh Bandara,Moneragala,Wellawaya,Uva,4384,9027,13411,175360,361080,536440
6/20/2024,Dinesh Bandara,Moneragala,Wellawaya,Uva,7337,990,8327,293480,39600,333080
6/21/2024,Dinesh Bandara,Moneragala,Wellawaya,Uva,8059,2906,10965,322360,116240,438600
6/22/2024,Dinesh Bandara,Moneragala,Wellawaya,Uva,8586,5878,14464,343440,235120,578560
6/23/2024,Dinesh Bandara,Moneragala,Wellawaya,Uva,9516,2177,11693,380640,87080,467720
6/24/2024,Dinesh Bandara,Moneragala,Wellawaya,Uva,9265,503,9768,370600,20120,390720
6/25/2024,Dinesh Bandara,Moneragala,Wellawaya,Uva,3978,235,4213,159120,9400,168520
6/26/2024,Dinesh Bandara,Moneragala,Wellawaya,Uva,6550,5275,11825,262000,211000,473000
6/27/2024,Dinesh Bandara,Moneragala,Wellawaya,Uva,1187,5100,6287,47480,204000,251480
6/28/2024,Dinesh Bandara,Moneragala,Wellawaya,Uva,9509,6617,16126,380360,264680,645040
6/29/2024,Dinesh Bandara,Moneragala,Wellawaya,Uva,5617,9781,15398,224680,391240,615920
6/30/2024,Dinesh Bandara,Moneragala,Wellawaya,Uva,4892,5614,10506,195680,224560,420240
7/1/2024,Dinesh Bandara,Moneragala,Wellawaya,Uva,9880,8053,17933,395200,322120,717320
7/2/2024,Dinesh Bandara,Moneragala,Wellawaya,Uva,997,2044,3041,39880,81760,121640
7/3/2024,Dinesh Bandara,Moneragala,Wellawaya,Uva,7676,1945,9621,307040,77800,384840
7/4/2024,Dinesh Bandara,Moneragala,Wellawaya,Uva,4261,2360,6621,170440,94400,264840
7/5/2024,Dinesh Bandara,Moneragala,Wellawaya,Uva,268,5158,5426,10720,206320,217040
7/6/2024,Dinesh Bandara,Moneragala,Wellawaya,Uva,3239,8137,11376,129560,325480,455040
7/7/2024,Dinesh Bandara,Moneragala,Wellawaya,Uva,1614,2551,4165,64560,102040,166600
7/8/2024,Dinesh Bandara,Moneragala,Wellawaya,Uva,9317,9340,18657,372680,373600,746280
7/9/2024,Dinesh Bandara,Moneragala,Wellawaya,Uva,5654,3568,9222,226160,142720,368880
7/10/2024,Dinesh Bandara,Moneragala,Wellawaya,Uva,4111,2124,6235,164440,84960,249400
7/11/2024,Dinesh Bandara,Moneragala,Wellawaya,Uva,5172,9760,14932,206880,390400,597280
7/12/2024,Dinesh Bandara,Moneragala,Wellawaya,Uva,1113,8833,9946,44520,353320,397840
7/13/2024,Dinesh Bandara,Moneragala,Wellawaya,Uva,1667,9690,11357,66680,387600,454280
7/14/2024,Dinesh Bandara,Moneragala,Wellawaya,Uva,1077,1501,2578,43080,60040,103120
7/15/2024,Dinesh Bandara,Moneragala,Wellawaya,Uva,3133,1757,4890,125320,70280,195600
7/16/2024,Dinesh Bandara,Moneragala,Wellawaya,Uva,1163,5973,7136,46520,238920,285440
7/17/2024,Dinesh Bandara,Moneragala,Wellawaya,Uva,9157,4752,13909,366280,190080,556360
7/18/2024,Dinesh Bandara,Moneragala,Wellawaya,Uva,4799,728,5527,191960,29120,221080
7/19/2024,Dinesh Bandara,Moneragala,Wellawaya,Uva,6582,7488,14070,263280,299520,562800
7/20/2024,Dinesh Bandara,Moneragala,Wellawaya,Uva,2478,9089,11567,99120,363560,462680
7/21/2024,Dinesh Bandara,Moneragala,Wellawaya,Uva,4414,9162,13576,176560,366480,543040
7/22/2024,Dinesh Bandara,Moneragala,Wellawaya,Uva,5805,563,6368,232200,22520,254720
7/23/2024,Dinesh Bandara,Moneragala,Wellawaya,Uva,8679,7299,15978,347160,291960,639120
7/24/2024,Dinesh Bandara,Moneragala,Wellawaya,Uva,4358,5725,10083,174320,229000,403320
7/25/2024,Dinesh Bandara,Moneragala,Wellawaya,Uva,5054,4553,9607,202160,182120,384280
7/26/2024,Dinesh Bandara,Moneragala,Wellawaya,Uva,553,8223,8776,22120,328920,351040
7/27/2024,Dinesh Bandara,Moneragala,Wellawaya,Uva,3837,3826,7663,153480,153040,306520
7/28/2024,Dinesh Bandara,Moneragala,Wellawaya,Uva,4153,7355,11508,166120,294200,460320
7/29/2024,Dinesh Bandara,Moneragala,Wellawaya,Uva,7876,4713,12589,315040,188520,503560
7/30/2024,Dinesh Bandara,Moneragala,Wellawaya,Uva,9031,3063,12094,361240,122520,483760
7/31/2024,Dinesh Bandara,Moneragala,Wellawaya,Uva,1000,8571,9571,40000,342840,382840
8/1/2024,Dinesh Bandara,Moneragala,Wellawaya,Uva,6958,1164,8122,278320,46560,324880
8/2/2024,Dinesh Bandara,Moneragala,Wellawaya,Uva,1491,310,1801,59640,12400,72040
8/3/2024,Dinesh Bandara,Moneragala,Wellawaya,Uva,2111,8715,10826,84440,348600,433040
8/4/2024,Dinesh Bandara,Moneragala,Wellawaya,Uva,5993,1426,7419,239720,57040,296760
8/5/2024,Dinesh Bandara,Moneragala,Wellawaya,Uva,492,1245,1737,19680,49800,69480
8/6/2024,Dinesh Bandara,Moneragala,Wellawaya,Uva,7845,913,8758,313800,36520,350320
8/7/2024,Dinesh Bandara,Moneragala,Wellawaya,Uva,486,164,650,19440,6560,26000
8/8/2024,Dinesh Bandara,Moneragala,Wellawaya,Uva,2473,7544,10017,98920,301760,400680
8/9/2024,Dinesh Bandara,Moneragala,Wellawaya,Uva,106,5909,6015,4240,236360,240600
8/10/2024,Dinesh Bandara,Moneragala,Wellawaya,Uva,9099,4050,13149,363960,162000,525960
8/11/2024,Dinesh Bandara,Moneragala,Wellawaya,Uva,9052,6119,15171,362080,244760,606840
8/12/2024,Dinesh Bandara,Moneragala,Wellawaya,Uva,8023,6194,14217,320920,247760,568680
8/13/2024,Dinesh Bandara,Moneragala,Wellawaya,Uva,3333,6991,10324,133320,279640,412960
8/14/2024,Dinesh Bandara,Moneragala,Wellawaya,Uva,2220,3925,6145,88800,157000,245800
8/15/2024,Dinesh Bandara,Moneragala,Wellawaya,Uva,882,24,906,35280,960,36240
8/16/2024,Dinesh Bandara,Moneragala,Wellawaya,Uva,5583,6104,11687,223320,244160,467480
8/17/2024,Dinesh Bandara,Moneragala,Wellawaya,Uva,8937,8706,17643,357480,348240,705720
8/18/2024,Dinesh Bandara,Moneragala,Wellawaya,Uva,7962,6214,14176,318480,248560,567040
8/19/2024,Dinesh Bandara,Moneragala,Wellawaya,Uva,9279,9419,18698,371160,376760,747920
8/20/2024,Dinesh Bandara,Moneragala,Wellawaya,Uva,8314,8962,17276,332560,358480,691040
8/21/2024,Dinesh Bandara,Moneragala,Wellawaya,Uva,2085,4327,6412,83400,173080,256480
8/22/2024,Dinesh Bandara,Moneragala,Wellawaya,Uva,5317,1931,7248,212680,77240,289920
8/23/2024,Dinesh Bandara,Moneragala,Wellawaya,Uva,4490,4124,8614,179600,164960,344560
8/24/2024,Dinesh Bandara,Moneragala,Wellawaya,Uva,8019,4546,12565,320760,181840,502600
8/25/2024,Dinesh Bandara,Moneragala,Wellawaya,Uva,7950,2291,10241,318000,91640,409640
8/26/2024,Dinesh Bandara,Moneragala,Wellawaya,Uva,8720,8151,16871,348800,326040,674840
8/27/2024,Dinesh Bandara,Moneragala,Wellawaya,Uva,7583,1280,8863,303320,51200,354520
8/28/2024,Dinesh Bandara,Moneragala,Wellawaya,Uva,74,1751,1825,2960,70040,73000
8/29/2024,Dinesh Bandara,Moneragala,Wellawaya,Uva,1222,3515,4737,48880,140600,189480
8/30/2024,Dinesh Bandara,Moneragala,Wellawaya,Uva,9043,8440,17483,361720,337600,699320
8/31/2024,Dinesh Bandara,Moneragala,Wellawaya,Uva,8856,7715,16571,354240,308600,662840
9/1/2024,Dinesh Bandara,Moneragala,Wellawaya,Uva,3156,3710,6866,126240,148400,274640
9/2/2024,Dinesh Bandara,Moneragala,Wellawaya,Uva,4099,43,4142,163960,1720,165680
9/3/2024,Dinesh Bandara,Moneragala,Wellawaya,Uva,1037,6339,7376,41480,253560,295040
9/4/2024,Dinesh Bandara,Moneragala,Wellawaya,Uva,6864,6913,13777,274560,276520,551080
9/5/2024,Dinesh Bandara,Moneragala,Wellawaya,Uva,7413,9975,17388,296520,399000,695520
9/6/2024,Dinesh Bandara,Moneragala,Wellawaya,Uva,709,404,1113,28360,16160,44520
9/7/2024,Dinesh Bandara,Moneragala,Wellawaya,Uva,9139,7585,16724,365560,303400,668960
9/8/2024,Dinesh Bandara,Moneragala,Wellawaya,Uva,8524,2880,11404,340960,115200,456160
9/9/2024,Dinesh Bandara,Moneragala,Wellawaya,Uva,970,7074,8044,38800,282960,321760
9/10/2024,Dinesh Bandara,Moneragala,Wellawaya,Uva,1712,5055,6767,68480,202200,270680
9/11/2024,Dinesh Bandara,Moneragala,Wellawaya,Uva,7407,5417,12824,296280,216680,512960
9/12/2024,Dinesh Bandara,Moneragala,Wellawaya,Uva,5018,2015,7033,200720,80600,281320
9/13/2024,Dinesh Bandara,Moneragala,Wellawaya,Uva,4443,4549,8992,177720,181960,359680
9/14/2024,Dinesh Bandara,Moneragala,Wellawaya,Uva,5726,8798,14524,229040,351920,580960
9/15/2024,Dinesh Bandara,Moneragala,Wellawaya,Uva,8157,6497,14654,326280,259880,586160
9/16/2024,Dinesh Bandara,Moneragala,Wellawaya,Uva,6338,3143,9481,253520,125720,379240
9/17/2024,Dinesh Bandara,Moneragala,Wellawaya,Uva,8430,2012,10442,337200,80480,417680
9/18/2024,Dinesh Bandara,Moneragala,Wellawaya,Uva,2207,2538,4745,88280,101520,189800
9/19/2024,Dinesh Bandara,Moneragala,Wellawaya,Uva,1749,491,2240,69960,19640,89600
9/20/2024,Dinesh Bandara,Moneragala,Wellawaya,Uva,2052,1813,3865,82080,72520,154600
9/21/2024,Dinesh Bandara,Moneragala,Wellawaya,Uva,9344,4391,13735,373760,175640,549400
9/22/2024,Dinesh Bandara,Moneragala,Wellawaya,Uva,8788,8509,17297,351520,340360,691880
9/23/2024,Dinesh Bandara,Moneragala,Wellawaya,Uva,9891,1727,11618,395640,69080,464720
9/24/2024,Dinesh Bandara,Moneragala,Wellawaya,Uva,5970,3225,9195,238800,129000,367800
9/25/2024,Dinesh Bandara,Moneragala,Wellawaya,Uva,2664,8510,11174,106560,340400,446960
9/26/2024,Dinesh Bandara,Moneragala,Wellawaya,Uva,450,5743,6193,18000,229720,247720
9/27/2024,Dinesh Bandara,Moneragala,Wellawaya,Uva,195,5940,6135,7800,237600,245400
9/28/2024,Dinesh Bandara,Moneragala,Wellawaya,Uva,7943,9404,17347,317720,376160,693880
9/29/2024,Dinesh Bandara,Moneragala,Wellawaya,Uva,4974,423,5397,198960,16920,215880
9/30/2024,Dinesh Bandara,Moneragala,Wellawaya,Uva,7565,8401,15966,302600,336040,638640
10/1/2024,Dinesh Bandara,Moneragala,Wellawaya,Uva,9293,617,9910,371720,24680,396400
10/2/2024,Dinesh Bandara,Moneragala,Wellawaya,Uva,9549,7232,16781,381960,289280,671240
10/3/2024,Dinesh Bandara,Moneragala,Wellawaya,Uva,865,8899,9764,34600,355960,390560
10/4/2024,Dinesh Bandara,Moneragala,Wellawaya,Uva,8768,4372,13140,350720,174880,525600
10/5/2024,Dinesh Bandara,Moneragala,Wellawaya,Uva,8292,5962,14254,331680,238480,570160
10/6/2024,Dinesh Bandara,Moneragala,Wellawaya,Uva,106,1677,1783,4240,67080,71320
10/7/2024,Dinesh Bandara,Moneragala,Wellawaya,Uva,6526,5971,12497,261040,238840,499880
10/8/2024,Dinesh Bandara,Moneragala,Wellawaya,Uva,2587,5547,8134,103480,221880,325360
10/9/2024,Dinesh Bandara,Moneragala,Wellawaya,Uva,846,5656,6502,33840,226240,260080
10/10/2024,Dinesh Bandara,Moneragala,Wellawaya,Uva,1974,4592,6566,78960,183680,262640
10/11/2024,Dinesh Bandara,Moneragala,Wellawaya,Uva,2824,8331,11155,112960,333240,446200
10/12/2024,Dinesh Bandara,Moneragala,Wellawaya,Uva,3423,4072,7495,136920,162880,299800
10/13/2024,Dinesh Bandara,Moneragala,Wellawaya,Uva,7242,9522,16764,289680,380880,670560
10/14/2024,Dinesh Bandara,Moneragala,Wellawaya,Uva,2770,3489,6259,110800,139560,250360
10/15/2024,Dinesh Bandara,Moneragala,Wellawaya,Uva,1917,137,2054,76680,5480,82160
10/16/2024,Dinesh Bandara,Moneragala,Wellawaya,Uva,7638,2207,9845,305520,88280,393800
10/17/2024,Dinesh Bandara,Moneragala,Wellawaya,Uva,7498,1319,8817,299920,52760,352680
10/18/2024,Dinesh Bandara,Moneragala,Wellawaya,Uva,2304,215,2519,92160,8600,100760
10/19/2024,Dinesh Bandara,Moneragala,Wellawaya,Uva,5108,7408,12516,204320,296320,500640
10/20/2024,Dinesh Bandara,Moneragala,Wellawaya,Uva,662,57,719,26480,2280,28760
10/21/2024,Dinesh Bandara,Moneragala,Wellawaya,Uva,4477,2909,7386,179080,116360,295440
10/22/2024,Dinesh Bandara,Moneragala,Wellawaya,Uva,719,4234,4953,28760,169360,198120
10/23/2024,Dinesh Bandara,Moneragala,Wellawaya,Uva,1482,2426,3908,59280,97040,156320
10/24/2024,Dinesh Bandara,Moneragala,Wellawaya,Uva,5172,2986,8158,206880,119440,326320
10/25/2024,Dinesh Bandara,Moneragala,Wellawaya,Uva,9808,1974,11782,392320,78960,471280
10/26/2024,Dinesh Bandara,Moneragala,Wellawaya,Uva,2032,1961,3993,81280,78440,159720
10/27/2024,Dinesh Bandara,Moneragala,Wellawaya,Uva,8448,9029,17477,337920,361160,699080
10/28/2024,Dinesh Bandara,Moneragala,Wellawaya,Uva,2693,1744,4437,107720,69760,177480
10/29/2024,Dinesh Bandara,Moneragala,Wellawaya,Uva,1506,7259,8765,60240,290360,350600
10/30/2024,Dinesh Bandara,Moneragala,Wellawaya,Uva,6173,7756,13929,246920,310240,557160
10/31/2024,Dinesh Bandara,Moneragala,Wellawaya,Uva,6828,4458,11286,273120,178320,451440
11/1/2024,Dinesh Bandara,Moneragala,Wellawaya,Uva,7948,2225,10173,317920,89000,406920
11/2/2024,Dinesh Bandara,Moneragala,Wellawaya,Uva,5138,2549,7687,205520,101960,307480
11/3/2024,Dinesh Bandara,Moneragala,Wellawaya,Uva,5885,1963,7848,235400,78520,313920
11/4/2024,Dinesh Bandara,Moneragala,Wellawaya,Uva,4264,8507,12771,170560,340280,510840
11/5/2024,Dinesh Bandara,Moneragala,Wellawaya,Uva,2528,4898,7426,101120,195920,297040
11/6/2024,Dinesh Bandara,Moneragala,Wellawaya,Uva,7197,1296,8493,287880,51840,339720
11/7/2024,Dinesh Bandara,Moneragala,Wellawaya,Uva,6051,3799,9850,242040,151960,394000
11/8/2024,Dinesh Bandara,Moneragala,Wellawaya,Uva,2617,4517,7134,104680,180680,285360
11/9/2024,Dinesh Bandara,Moneragala,Wellawaya,Uva,2708,6206,8914,108320,248240,356560
11/10/2024,Dinesh Bandara,Moneragala,Wellawaya,Uva,9571,701,10272,382840,28040,410880
11/11/2024,Dinesh Bandara,Moneragala,Wellawaya,Uva,8386,1649,10035,335440,65960,401400
11/12/2024,Dinesh Bandara,Moneragala,Wellawaya,Uva,8873,5399,14272,354920,215960,570880
11/13/2024,Dinesh Bandara,Moneragala,Wellawaya,Uva,9063,2325,11388,362520,93000,455520
11/14/2024,Dinesh Bandara,Moneragala,Wellawaya,Uva,5670,8893,14563,226800,355720,582520
11/15/2024,Dinesh Bandara,Moneragala,Wellawaya,Uva,3195,4370,7565,127800,174800,302600
11/16/2024,Dinesh Bandara,Moneragala,Wellawaya,Uva,5686,2539,8225,227440,101560,329000
11/17/2024,Dinesh Bandara,Moneragala,Wellawaya,Uva,7701,3245,10946,308040,129800,437840
11/18/2024,Dinesh Bandara,Moneragala,Wellawaya,Uva,7812,498,8310,312480,19920,332400
11/19/2024,Dinesh Bandara,Moneragala,Wellawaya,Uva,366,2788,3154,14640,111520,126160
11/20/2024,Dinesh Bandara,Moneragala,Wellawaya,Uva,4859,3546,8405,194360,141840,336200
11/21/2024,Dinesh Bandara,Moneragala,Wellawaya,Uva,7569,2439,10008,302760,97560,400320
11/22/2024,Dinesh Bandara,Moneragala,Wellawaya,Uva,8825,40,8865,353000,1600,354600
11/23/2024,Dinesh Bandara,Moneragala,Wellawaya,Uva,8084,2349,10433,323360,93960,417320
11/24/2024,Dinesh Bandara,Moneragala,Wellawaya,Uva,1281,1086,2367,51240,43440,94680
11/25/2024,Dinesh Bandara,Moneragala,Wellawaya,Uva,2554,9179,11733,102160,367160,469320
11/26/2024,Dinesh Bandara,Moneragala,Wellawaya,Uva,547,9852,10399,21880,394080,415960
11/27/2024,Dinesh Bandara,Moneragala,Wellawaya,Uva,9289,56,9345,371560,2240,373800
11/28/2024,Dinesh Bandara,Moneragala,Wellawaya,Uva,5074,7147,12221,202960,285880,488840
11/29/2024,Dinesh Bandara,Moneragala,Wellawaya,Uva,1731,1774,3505,69240,70960,140200
11/30/2024,Dinesh Bandara,Moneragala,Wellawaya,Uva,8831,5410,14241,353240,216400,569640
12/1/2024,Dinesh Bandara,Moneragala,Wellawaya,Uva,1710,6221,7931,68400,248840,317240
12/2/2024,Dinesh Bandara,Moneragala,Wellawaya,Uva,6332,236,6568,253280,9440,262720
12/3/2024,Dinesh Bandara,Moneragala,Wellawaya,Uva,9211,2972,12183,368440,118880,487320
12/4/2024,Dinesh Bandara,Moneragala,Wellawaya,Uva,7711,6180,13891,308440,247200,555640
12/5/2024,Dinesh Bandara,Moneragala,Wellawaya,Uva,2495,3534,6029,99800,141360,241160
12/6/2024,Dinesh Bandara,Moneragala,Wellawaya,Uva,1520,3124,4644,60800,124960,185760
12/7/2024,Dinesh Bandara,Moneragala,Wellawaya,Uva,4490,798,5288,179600,31920,211520
12/8/2024,Dinesh Bandara,Moneragala,Wellawaya,Uva,681,5386,6067,27240,215440,242680
12/9/2024,Dinesh Bandara,Moneragala,Wellawaya,Uva,9457,9308,18765,378280,372320,750600
12/10/2024,Dinesh Bandara,Moneragala,Wellawaya,Uva,1693,4372,6065,67720,174880,242600
12/11/2024,Dinesh Bandara,Moneragala,Wellawaya,Uva,8928,2923,11851,357120,116920,474040
12/12/2024,Dinesh Bandara,Moneragala,Wellawaya,Uva,4770,3315,8085,190800,132600,323400
12/13/2024,Dinesh Bandara,Moneragala,Wellawaya,Uva,2516,1596,4112,100640,63840,164480
12/14/2024,Dinesh Bandara,Moneragala,Wellawaya,Uva,3317,7735,11052,132680,309400,442080
12/15/2024,Dinesh Bandara,Moneragala,Wellawaya,Uva,4514,1472,5986,180560,58880,239440
12/16/2024,Dinesh Bandara,Moneragala,Wellawaya,Uva,1280,2443,3723,51200,97720,148920
12/17/2024,Dinesh Bandara,Moneragala,Wellawaya,Uva,8937,5090,14027,357480,203600,561080
12/18/2024,Dinesh Bandara,Moneragala,Wellawaya,Uva,152,3027,3179,6080,121080,127160
12/19/2024,Dinesh Bandara,Moneragala,Wellawaya,Uva,7489,4828,12317,299560,193120,492680
12/20/2024,Dinesh Bandara,Moneragala,Wellawaya,Uva,6266,730,6996,250640,29200,279840
12/21/2024,Dinesh Bandara,Moneragala,Wellawaya,Uva,9287,6841,16128,371480,273640,645120
12/22/2024,Dinesh Bandara,Moneragala,Wellawaya,Uva,7674,7812,15486,306960,312480,619440
12/23/2024,Dinesh Bandara,Moneragala,Wellawaya,Uva,7410,3041,10451,296400,121640,418040
12/24/2024,Dinesh Bandara,Moneragala,Wellawaya,Uva,1363,5591,6954,54520,223640,278160
12/25/2024,Dinesh Bandara,Moneragala,Wellawaya,Uva,9028,5541,14569,361120,221640,582760
12/26/2024,Dinesh Bandara,Moneragala,Wellawaya,Uva,9067,2800,11867,362680,112000,474680
12/27/2024,Dinesh Bandara,Moneragala,Wellawaya,Uva,1974,2452,4426,78960,98080,177040
12/28/2024,Dinesh Bandara,Moneragala,Wellawaya,Uva,576,5772,6348,23040,230880,253920
12/29/2024,Dinesh Bandara,Moneragala,Wellawaya,Uva,5588,9047,14635,223520,361880,585400
12/30/2024,Dinesh Bandara,Moneragala,Wellawaya,Uva,6419,530,6949,256760,21200,277960
12/31/2024,Dinesh Bandara,Moneragala,Wellawaya,Uva,9223,1207,10430,368920,48280,417200
1/1/2025,Dinesh Bandara,Moneragala,Wellawaya,Uva,2789,7081,9870,111560,283240,394800
1/2/2025,Dinesh Bandara,Moneragala,Wellawaya,Uva,9258,4792,14050,370320,191680,562000
1/3/2025,Dinesh Bandara,Moneragala,Wellawaya,Uva,863,5865,6728,34520,234600,269120
1/4/2025,Dinesh Bandara,Moneragala,Wellawaya,Uva,2643,7675,10318,105720,307000,412720
1/5/2025,Dinesh Bandara,Moneragala,Wellawaya,Uva,3969,5824,9793,158760,232960,391720
1/6/2025,Dinesh Bandara,Moneragala,Wellawaya,Uva,1015,5707,6722,40600,228280,268880
1/7/2025,Dinesh Bandara,Moneragala,Wellawaya,Uva,8753,2580,11333,350120,103200,453320
1/8/2025,Dinesh Bandara,Moneragala,Wellawaya,Uva,2818,1910,4728,112720,76400,189120
1/9/2025,Dinesh Bandara,Moneragala,Wellawaya,Uva,3806,7424,11230,152240,296960,449200
1/10/2025,Dinesh Bandara,Moneragala,Wellawaya,Uva,1109,7688,8797,44360,307520,351880
1/11/2025,Dinesh Bandara,Moneragala,Wellawaya,Uva,3407,1582,4989,136280,63280,199560
1/12/2025,Dinesh Bandara,Moneragala,Wellawaya,Uva,1103,4071,5174,44120,162840,206960
1/13/2025,Dinesh Bandara,Moneragala,Wellawaya,Uva,2865,1372,4237,114600,54880,169480
1/14/2025,Dinesh Bandara,Moneragala,Wellawaya,Uva,1165,2758,3923,46600,110320,156920
1/15/2025,Dinesh Bandara,Moneragala,Wellawaya,Uva,8685,8196,16881,347400,327840,675240
1/16/2025,Dinesh Bandara,Moneragala,Wellawaya,Uva,369,3647,4016,14760,145880,160640
1/17/2025,Dinesh Bandara,Moneragala,Wellawaya,Uva,5436,3794,9230,217440,151760,369200
1/18/2025,Dinesh Bandara,Moneragala,Wellawaya,Uva,1816,2711,4527,72640,108440,181080
1/19/2025,Dinesh Bandara,Moneragala,Wellawaya,Uva,2959,7437,10396,118360,297480,415840
1/20/2025,Dinesh Bandara,Moneragala,Wellawaya,Uva,3597,3161,6758,143880,126440,270320
1/21/2025,Dinesh Bandara,Moneragala,Wellawaya,Uva,7315,2618,9933,292600,104720,397320
1/22/2025,Dinesh Bandara,Moneragala,Wellawaya,Uva,9968,3398,13366,398720,135920,534640
1/23/2025,Dinesh Bandara,Moneragala,Wellawaya,Uva,1243,7731,8974,49720,309240,358960
1/24/2025,Dinesh Bandara,Moneragala,Wellawaya,Uva,7213,5061,12274,288520,202440,490960
1/25/2025,Dinesh Bandara,Moneragala,Wellawaya,Uva,8445,9298,17743,337800,371920,709720
1/26/2025,Dinesh Bandara,Moneragala,Wellawaya,Uva,9078,1140,10218,363120,45600,408720
1/27/2025,Dinesh Bandara,Moneragala,Wellawaya,Uva,6663,6591,13254,266520,263640,530160
1/28/2025,Dinesh Bandara,Moneragala,Wellawaya,Uva,6513,9198,15711,260520,367920,628440
1/29/2025,Dinesh Bandara,Moneragala,Wellawaya,Uva,7281,9363,16644,291240,374520,665760
1/30/2025,Dinesh Bandara,Moneragala,Wellawaya,Uva,3075,1784,4859,123000,71360,194360
1/31/2025,Dinesh Bandara,Moneragala,Wellawaya,Uva,2322,1504,3826,92880,60160,153040
2/1/2025,Dinesh Bandara,Moneragala,Wellawaya,Uva,9553,6219,15772,382120,248760,630880
2/2/2025,Dinesh Bandara,Moneragala,Wellawaya,Uva,2592,3544,6136,103680,141760,245440
2/3/2025,Dinesh Bandara,Moneragala,Wellawaya,Uva,2666,1380,4046,106640,55200,161840
2/4/2025,Dinesh Bandara,Moneragala,Wellawaya,Uva,7838,5913,13751,313520,236520,550040
2/5/2025,Dinesh Bandara,Moneragala,Wellawaya,Uva,5334,8992,14326,213360,359680,573040
2/6/2025,Dinesh Bandara,Moneragala,Wellawaya,Uva,8311,9810,18121,332440,392400,724840
2/7/2025,Dinesh Bandara,Moneragala,Wellawaya,Uva,6086,4771,10857,243440,190840,434280
2/8/2025,Dinesh Bandara,Moneragala,Wellawaya,Uva,193,8703,8896,7720,348120,355840
2/9/2025,Dinesh Bandara,Moneragala,Wellawaya,Uva,9178,1429,10607,367120,57160,424280
2/10/2025,Dinesh Bandara,Moneragala,Wellawaya,Uva,2449,4687,7136,97960,187480,285440
2/11/2025,Dinesh Bandara,Moneragala,Wellawaya,Uva,8874,9410,18284,354960,376400,731360
2/12/2025,Dinesh Bandara,Moneragala,Wellawaya,Uva,3393,1951,5344,135720,78040,213760
2/13/2025,Dinesh Bandara,Moneragala,Wellawaya,Uva,129,2228,2357,5160,89120,94280
2/14/2025,Dinesh Bandara,Moneragala,Wellawaya,Uva,9534,2421,11955,381360,96840,478200
2/15/2025,Dinesh Bandara,Moneragala,Wellawaya,Uva,4093,1908,6001,163720,76320,240040
2/16/2025,Dinesh Bandara,Moneragala,Wellawaya,Uva,7079,7133,14212,283160,285320,568480
2/17/2025,Dinesh Bandara,Moneragala,Wellawaya,Uva,353,4825,5178,14120,193000,207120
2/18/2025,Dinesh Bandara,Moneragala,Wellawaya,Uva,2159,3549,5708,86360,141960,228320
2/19/2025,Dinesh Bandara,Moneragala,Wellawaya,Uva,7919,2172,10091,316760,86880,403640
2/20/2025,Dinesh Bandara,Moneragala,Wellawaya,Uva,680,2855,3535,27200,114200,141400
2/21/2025,Dinesh Bandara,Moneragala,Wellawaya,Uva,6928,5478,12406,277120,219120,496240
2/22/2025,Dinesh Bandara,Moneragala,Wellawaya,Uva,5921,5818,11739,236840,232720,469560
2/23/2025,Dinesh Bandara,Moneragala,Wellawaya,Uva,9315,9568,18883,372600,382720,755320
2/24/2025,Dinesh Bandara,Moneragala,Wellawaya,Uva,4144,1792,5936,165760,71680,237440
2/25/2025,Dinesh Bandara,Moneragala,Wellawaya,Uva,9931,7930,17861,397240,317200,714440
2/26/2025,Dinesh Bandara,Moneragala,Wellawaya,Uva,7878,4006,11884,315120,160240,475360
2/27/2025,Dinesh Bandara,Moneragala,Wellawaya,Uva,7269,7181,14450,290760,287240,578000
2/28/2025,Dinesh Bandara,Moneragala,Wellawaya,Uva,6491,6110,12601,259640,244400,504040
3/1/2025,Dinesh Bandara,Moneragala,Wellawaya,Uva,1295,9240,10535,51800,369600,421400
3/2/2025,Dinesh Bandara,Moneragala,Wellawaya,Uva,4726,6074,10800,189040,242960,432000
3/3/2025,Dinesh Bandara,Moneragala,Wellawaya,Uva,3718,8849,12567,148720,353960,502680
3/4/2025,Dinesh Bandara,Moneragala,Wellawaya,Uva,4184,9328,13512,167360,373120,540480
3/5/2025,Dinesh Bandara,Moneragala,Wellawaya,Uva,2424,5197,7621,96960,207880,304840
3/6/2025,Dinesh Bandara,Moneragala,Wellawaya,Uva,7458,8234,15692,298320,329360,627680
3/7/2025,Dinesh Bandara,Moneragala,Wellawaya,Uva,2607,9982,12589,104280,399280,503560
3/8/2025,Dinesh Bandara,Moneragala,Wellawaya,Uva,1371,6058,7429,54840,242320,297160
3/9/2025,Dinesh Bandara,Moneragala,Wellawaya,Uva,8761,4340,13101,350440,173600,524040
3/10/2025,Dinesh Bandara,Moneragala,Wellawaya,Uva,1137,7499,8636,45480,299960,345440
3/11/2025,Dinesh Bandara,Moneragala,Wellawaya,Uva,8543,5953,14496,341720,238120,579840
3/12/2025,Dinesh Bandara,Moneragala,Wellawaya,Uva,8134,9105,17239,325360,364200,689560
3/13/2025,Dinesh Bandara,Moneragala,Wellawaya,Uva,7368,4919,12287,294720,196760,491480
3/14/2025,Dinesh Bandara,Moneragala,Wellawaya,Uva,2817,9121,11938,112680,364840,477520
3/15/2025,Dinesh Bandara,Moneragala,Wellawaya,Uva,3075,621,3696,123000,24840,147840
3/16/2025,Dinesh Bandara,Moneragala,Wellawaya,Uva,1296,4729,6025,51840,189160,241000
3/17/2025,Dinesh Bandara,Moneragala,Wellawaya,Uva,2737,3629,6366,109480,145160,254640
3/18/2025,Dinesh Bandara,Moneragala,Wellawaya,Uva,7788,7048,14836,311520,281920,593440
3/19/2025,Dinesh Bandara,Moneragala,Wellawaya,Uva,329,9748,10077,13160,389920,403080
3/20/2025,Dinesh Bandara,Moneragala,Wellawaya,Uva,8203,5096,13299,328120,203840,531960
3/21/2025,Dinesh Bandara,Moneragala,Wellawaya,Uva,4714,7356,12070,188560,294240,482800
3/22/2025,Dinesh Bandara,Moneragala,Wellawaya,Uva,4647,6800,11447,185880,272000,457880
3/23/2025,Dinesh Bandara,Moneragala,Wellawaya,Uva,6977,7823,14800,279080,312920,592000
3/25/2024,Lakmini Ekanayake,Moneragala,Siyambalanduwa,Uva,8752,8753,17505,350080,350120,700200
3/26/2024,Lakmini Ekanayake,Moneragala,Siyambalanduwa,Uva,7763,4411,12174,310520,176440,486960
3/27/2024,Lakmini Ekanayake,Moneragala,Siyambalanduwa,Uva,6841,9778,16619,273640,391120,664760
3/28/2024,Lakmini Ekanayake,Moneragala,Siyambalanduwa,Uva,2871,4822,7693,114840,192880,307720
3/29/2024,Lakmini Ekanayake,Moneragala,Siyambalanduwa,Uva,4819,6862,11681,192760,274480,467240
3/30/2024,Lakmini Ekanayake,Moneragala,Siyambalanduwa,Uva,7316,7591,14907,292640,303640,596280
3/31/2024,Lakmini Ekanayake,Moneragala,Siyambalanduwa,Uva,8977,4143,13120,359080,165720,524800
4/1/2024,Lakmini Ekanayake,Moneragala,Siyambalanduwa,Uva,7954,2375,10329,318160,95000,413160
4/2/2024,Lakmini Ekanayake,Moneragala,Siyambalanduwa,Uva,1928,2845,4773,77120,113800,190920
4/3/2024,Lakmini Ekanayake,Moneragala,Siyambalanduwa,Uva,1565,1979,3544,62600,79160,141760
4/4/2024,Lakmini Ekanayake,Moneragala,Siyambalanduwa,Uva,5279,162,5441,211160,6480,217640
4/5/2024,Lakmini Ekanayake,Moneragala,Siyambalanduwa,Uva,3723,3920,7643,148920,156800,305720
4/6/2024,Lakmini Ekanayake,Moneragala,Siyambalanduwa,Uva,7879,5007,12886,315160,200280,515440
4/7/2024,Lakmini Ekanayake,Moneragala,Siyambalanduwa,Uva,2146,3382,5528,85840,135280,221120
4/8/2024,Lakmini Ekanayake,Moneragala,Siyambalanduwa,Uva,1823,9299,11122,72920,371960,444880
4/9/2024,Lakmini Ekanayake,Moneragala,Siyambalanduwa,Uva,7631,4121,11752,305240,164840,470080
4/10/2024,Lakmini Ekanayake,Moneragala,Siyambalanduwa,Uva,4081,1473,5554,163240,58920,222160
4/11/2024,Lakmini Ekanayake,Moneragala,Siyambalanduwa,Uva,9068,8327,17395,362720,333080,695800
4/19/2024,Lakmini Ekanayake,Moneragala,Siyambalanduwa,Uva,4094,4450,8544,163760,178000,341760
4/20/2024,Lakmini Ekanayake,Moneragala,Siyambalanduwa,Uva,7352,2390,9742,294080,95600,389680
4/21/2024,Lakmini Ekanayake,Moneragala,Siyambalanduwa,Uva,463,3459,3922,18520,138360,156880
4/22/2024,Lakmini Ekanayake,Moneragala,Siyambalanduwa,Uva,2628,5794,8422,105120,231760,336880
4/23/2024,Lakmini Ekanayake,Moneragala,Siyambalanduwa,Uva,4705,1836,6541,188200,73440,261640
4/24/2024,Lakmini Ekanayake,Moneragala,Siyambalanduwa,Uva,5583,3043,8626,223320,121720,345040
4/25/2024,Lakmini Ekanayake,Moneragala,Siyambalanduwa,Uva,8154,8926,17080,326160,357040,683200
4/26/2024,Lakmini Ekanayake,Moneragala,Siyambalanduwa,Uva,2440,5799,8239,97600,231960,329560
4/27/2024,Lakmini Ekanayake,Moneragala,Siyambalanduwa,Uva,2948,3492,6440,117920,139680,257600
4/28/2024,Lakmini Ekanayake,Moneragala,Siyambalanduwa,Uva,2087,1699,3786,83480,67960,151440
4/29/2024,Lakmini Ekanayake,Moneragala,Siyambalanduwa,Uva,6271,7841,14112,250840,313640,564480
4/30/2024,Lakmini Ekanayake,Moneragala,Siyambalanduwa,Uva,3407,1672,5079,136280,66880,203160
5/1/2024,Lakmini Ekanayake,Moneragala,Siyambalanduwa,Uva,2556,890,3446,102240,35600,137840
5/2/2024,Lakmini Ekanayake,Moneragala,Siyambalanduwa,Uva,9489,2187,11676,379560,87480,467040
5/3/2024,Lakmini Ekanayake,Moneragala,Siyambalanduwa,Uva,6118,2670,8788,244720,106800,351520
5/4/2024,Lakmini Ekanayake,Moneragala,Siyambalanduwa,Uva,8658,6358,15016,346320,254320,600640
5/5/2024,Lakmini Ekanayake,Moneragala,Siyambalanduwa,Uva,6225,5581,11806,249000,223240,472240
5/6/2024,Lakmini Ekanayake,Moneragala,Siyambalanduwa,Uva,417,8986,9403,16680,359440,376120
5/7/2024,Lakmini Ekanayake,Moneragala,Siyambalanduwa,Uva,3879,3382,7261,155160,135280,290440
5/8/2024,Lakmini Ekanayake,Moneragala,Siyambalanduwa,Uva,1685,7002,8687,67400,280080,347480
5/9/2024,Lakmini Ekanayake,Moneragala,Siyambalanduwa,Uva,7534,5997,13531,301360,239880,541240
5/10/2024,Lakmini Ekanayake,Moneragala,Siyambalanduwa,Uva,993,5370,6363,39720,214800,254520
5/11/2024,Lakmini Ekanayake,Moneragala,Siyambalanduwa,Uva,1973,4894,6867,78920,195760,274680
5/12/2024,Lakmini Ekanayake,Moneragala,Siyambalanduwa,Uva,4378,9520,13898,175120,380800,555920
5/13/2024,Lakmini Ekanayake,Moneragala,Siyambalanduwa,Uva,4308,2965,7273,172320,118600,290920
5/14/2024,Lakmini Ekanayake,Moneragala,Siyambalanduwa,Uva,9312,1528,10840,372480,61120,433600
5/15/2024,Lakmini Ekanayake,Moneragala,Siyambalanduwa,Uva,1195,8613,9808,47800,344520,392320
5/16/2024,Lakmini Ekanayake,Moneragala,Siyambalanduwa,Uva,5453,5289,10742,218120,211560,429680
5/17/2024,Lakmini Ekanayake,Moneragala,Siyambalanduwa,Uva,45,7517,7562,1800,300680,302480
5/18/2024,Lakmini Ekanayake,Moneragala,Siyambalanduwa,Uva,862,2498,3360,34480,99920,134400
5/19/2024,Lakmini Ekanayake,Moneragala,Siyambalanduwa,Uva,3839,8083,11922,153560,323320,476880
5/20/2024,Lakmini Ekanayake,Moneragala,Siyambalanduwa,Uva,7520,1649,9169,300800,65960,366760
5/21/2024,Lakmini Ekanayake,Moneragala,Siyambalanduwa,Uva,2923,589,3512,116920,23560,140480
5/22/2024,Lakmini Ekanayake,Moneragala,Siyambalanduwa,Uva,60,8982,9042,2400,359280,361680
5/24/2024,Lakmini Ekanayake,Moneragala,Siyambalanduwa,Uva,8388,1480,9868,335520,59200,394720
5/25/2024,Lakmini Ekanayake,Moneragala,Siyambalanduwa,Uva,1618,8785,10403,64720,351400,416120
5/26/2024,Lakmini Ekanayake,Moneragala,Siyambalanduwa,Uva,2801,3462,6263,112040,138480,250520
5/27/2024,Lakmini Ekanayake,Moneragala,Siyambalanduwa,Uva,9170,9237,18407,366800,369480,736280
5/28/2024,Lakmini Ekanayake,Moneragala,Siyambalanduwa,Uva,5804,9194,14998,232160,367760,599920
5/29/2024,Lakmini Ekanayake,Moneragala,Siyambalanduwa,Uva,4009,1427,5436,160360,57080,217440
5/30/2024,Lakmini Ekanayake,Moneragala,Siyambalanduwa,Uva,5110,4232,9342,204400,169280,373680
5/31/2024,Lakmini Ekanayake,Moneragala,Siyambalanduwa,Uva,5672,1054,6726,226880,42160,269040
6/1/2024,Lakmini Ekanayake,Moneragala,Siyambalanduwa,Uva,3367,7828,11195,134680,313120,447800
6/2/2024,Lakmini Ekanayake,Moneragala,Siyambalanduwa,Uva,5518,8461,13979,220720,338440,559160
6/3/2024,Lakmini Ekanayake,Moneragala,Siyambalanduwa,Uva,4474,801,5275,178960,32040,211000
6/4/2024,Lakmini Ekanayake,Moneragala,Siyambalanduwa,Uva,1326,2932,4258,53040,117280,170320
6/5/2024,Lakmini Ekanayake,Moneragala,Siyambalanduwa,Uva,6582,2483,9065,263280,99320,362600
6/6/2024,Lakmini Ekanayake,Moneragala,Siyambalanduwa,Uva,4356,1929,6285,174240,77160,251400
6/7/2024,Lakmini Ekanayake,Moneragala,Siyambalanduwa,Uva,929,8949,9878,37160,357960,395120
6/8/2024,Lakmini Ekanayake,Moneragala,Siyambalanduwa,Uva,885,1481,2366,35400,59240,94640
6/9/2024,Lakmini Ekanayake,Moneragala,Siyambalanduwa,Uva,2424,8696,11120,96960,347840,444800
6/10/2024,Lakmini Ekanayake,Moneragala,Siyambalanduwa,Uva,731,9303,10034,29240,372120,401360
6/11/2024,Lakmini Ekanayake,Moneragala,Siyambalanduwa,Uva,4624,2527,7151,184960,101080,286040
6/12/2024,Lakmini Ekanayake,Moneragala,Siyambalanduwa,Uva,694,5132,5826,27760,205280,233040
6/13/2024,Lakmini Ekanayake,Moneragala,Siyambalanduwa,Uva,7067,3642,10709,282680,145680,428360
6/14/2024,Lakmini Ekanayake,Moneragala,Siyambalanduwa,Uva,9603,4385,13988,384120,175400,559520
6/15/2024,Lakmini Ekanayake,Moneragala,Siyambalanduwa,Uva,3772,3536,7308,150880,141440,292320
6/16/2024,Lakmini Ekanayake,Moneragala,Siyambalanduwa,Uva,402,2137,2539,16080,85480,101560
6/17/2024,Lakmini Ekanayake,Moneragala,Siyambalanduwa,Uva,9791,6650,16441,391640,266000,657640
6/18/2024,Lakmini Ekanayake,Moneragala,Siyambalanduwa,Uva,390,5603,5993,15600,224120,239720
6/19/2024,Lakmini Ekanayake,Moneragala,Siyambalanduwa,Uva,5483,1548,7031,219320,61920,281240
6/20/2024,Lakmini Ekanayake,Moneragala,Siyambalanduwa,Uva,6056,9230,15286,242240,369200,611440
6/21/2024,Lakmini Ekanayake,Moneragala,Siyambalanduwa,Uva,705,3421,4126,28200,136840,165040
6/22/2024,Lakmini Ekanayake,Moneragala,Siyambalanduwa,Uva,5378,7600,12978,215120,304000,519120
6/23/2024,Lakmini Ekanayake,Moneragala,Siyambalanduwa,Uva,13,4697,4710,520,187880,188400
6/24/2024,Lakmini Ekanayake,Moneragala,Siyambalanduwa,Uva,7402,7450,14852,296080,298000,594080
6/25/2024,Lakmini Ekanayake,Moneragala,Siyambalanduwa,Uva,1984,9805,11789,79360,392200,471560
6/26/2024,Lakmini Ekanayake,Moneragala,Siyambalanduwa,Uva,6142,3973,10115,245680,158920,404600
6/27/2024,Lakmini Ekanayake,Moneragala,Siyambalanduwa,Uva,4295,2238,6533,171800,89520,261320
6/28/2024,Lakmini Ekanayake,Moneragala,Siyambalanduwa,Uva,5092,6716,11808,203680,268640,472320
6/29/2024,Lakmini Ekanayake,Moneragala,Siyambalanduwa,Uva,3442,8135,11577,137680,325400,463080
6/30/2024,Lakmini Ekanayake,Moneragala,Siyambalanduwa,Uva,7471,6152,13623,298840,246080,544920
7/1/2024,Lakmini Ekanayake,Moneragala,Siyambalanduwa,Uva,990,360,1350,39600,14400,54000
7/2/2024,Lakmini Ekanayake,Moneragala,Siyambalanduwa,Uva,1765,6134,7899,70600,245360,315960
7/3/2024,Lakmini Ekanayake,Moneragala,Siyambalanduwa,Uva,6952,3864,10816,278080,154560,432640
7/4/2024,Lakmini Ekanayake,Moneragala,Siyambalanduwa,Uva,2183,7075,9258,87320,283000,370320
7/5/2024,Lakmini Ekanayake,Moneragala,Siyambalanduwa,Uva,4874,8850,13724,194960,354000,548960
7/6/2024,Lakmini Ekanayake,Moneragala,Siyambalanduwa,Uva,3595,3306,6901,143800,132240,276040
7/7/2024,Lakmini Ekanayake,Moneragala,Siyambalanduwa,Uva,7679,1155,8834,307160,46200,353360
7/8/2024,Lakmini Ekanayake,Moneragala,Siyambalanduwa,Uva,5694,7825,13519,227760,313000,540760
7/9/2024,Lakmini Ekanayake,Moneragala,Siyambalanduwa,Uva,1444,5293,6737,57760,211720,269480
7/10/2024,Lakmini Ekanayake,Moneragala,Siyambalanduwa,Uva,4803,7004,11807,192120,280160,472280
7/11/2024,Lakmini Ekanayake,Moneragala,Siyambalanduwa,Uva,6520,2679,9199,260800,107160,367960
7/12/2024,Lakmini Ekanayake,Moneragala,Siyambalanduwa,Uva,7570,259,7829,302800,10360,313160
7/13/2024,Lakmini Ekanayake,Moneragala,Siyambalanduwa,Uva,484,3068,3552,19360,122720,142080
7/14/2024,Lakmini Ekanayake,Moneragala,Siyambalanduwa,Uva,2311,4555,6866,92440,182200,274640
7/15/2024,Lakmini Ekanayake,Moneragala,Siyambalanduwa,Uva,907,4540,5447,36280,181600,217880
7/16/2024,Lakmini Ekanayake,Moneragala,Siyambalanduwa,Uva,6584,4469,11053,263360,178760,442120
7/17/2024,Lakmini Ekanayake,Moneragala,Siyambalanduwa,Uva,5385,376,5761,215400,15040,230440
7/18/2024,Lakmini Ekanayake,Moneragala,Siyambalanduwa,Uva,6389,9009,15398,255560,360360,615920
7/19/2024,Lakmini Ekanayake,Moneragala,Siyambalanduwa,Uva,1615,6472,8087,64600,258880,323480
7/20/2024,Lakmini Ekanayake,Moneragala,Siyambalanduwa,Uva,2354,9380,11734,94160,375200,469360
7/21/2024,Lakmini Ekanayake,Moneragala,Siyambalanduwa,Uva,2124,981,3105,84960,39240,124200
7/22/2024,Lakmini Ekanayake,Moneragala,Siyambalanduwa,Uva,386,9755,10141,15440,390200,405640
7/23/2024,Lakmini Ekanayake,Moneragala,Siyambalanduwa,Uva,7846,9638,17484,313840,385520,699360
7/24/2024,Lakmini Ekanayake,Moneragala,Siyambalanduwa,Uva,4741,2970,7711,189640,118800,308440
7/25/2024,Lakmini Ekanayake,Moneragala,Siyambalanduwa,Uva,7688,4215,11903,307520,168600,476120
7/26/2024,Lakmini Ekanayake,Moneragala,Siyambalanduwa,Uva,1875,3121,4996,75000,124840,199840
7/27/2024,Lakmini Ekanayake,Moneragala,Siyambalanduwa,Uva,5576,2721,8297,223040,108840,331880
7/28/2024,Lakmini Ekanayake,Moneragala,Siyambalanduwa,Uva,6743,9006,15749,269720,360240,629960
7/29/2024,Lakmini Ekanayake,Moneragala,Siyambalanduwa,Uva,6380,1530,7910,255200,61200,316400
7/30/2024,Lakmini Ekanayake,Moneragala,Siyambalanduwa,Uva,4664,5403,10067,186560,216120,402680
7/31/2024,Lakmini Ekanayake,Moneragala,Siyambalanduwa,Uva,5465,1385,6850,218600,55400,274000
8/1/2024,Lakmini Ekanayake,Moneragala,Siyambalanduwa,Uva,4847,8067,12914,193880,322680,516560
8/2/2024,Lakmini Ekanayake,Moneragala,Siyambalanduwa,Uva,561,8817,9378,22440,352680,375120
8/3/2024,Lakmini Ekanayake,Moneragala,Siyambalanduwa,Uva,4479,570,5049,179160,22800,201960
8/4/2024,Lakmini Ekanayake,Moneragala,Siyambalanduwa,Uva,8237,6081,14318,329480,243240,572720
8/5/2024,Lakmini Ekanayake,Moneragala,Siyambalanduwa,Uva,8909,3237,12146,356360,129480,485840
8/6/2024,Lakmini Ekanayake,Moneragala,Siyambalanduwa,Uva,9460,9972,19432,378400,398880,777280
8/7/2024,Lakmini Ekanayake,Moneragala,Siyambalanduwa,Uva,7644,8346,15990,305760,333840,639600
8/8/2024,Lakmini Ekanayake,Moneragala,Siyambalanduwa,Uva,8867,4846,13713,354680,193840,548520
8/9/2024,Lakmini Ekanayake,Moneragala,Siyambalanduwa,Uva,2565,1233,3798,102600,49320,151920
8/10/2024,Lakmini Ekanayake,Moneragala,Siyambalanduwa,Uva,5700,4199,9899,228000,167960,395960
8/11/2024,Lakmini Ekanayake,Moneragala,Siyambalanduwa,Uva,3687,8842,12529,147480,353680,501160
8/12/2024,Lakmini Ekanayake,Moneragala,Siyambalanduwa,Uva,1877,866,2743,75080,34640,109720
8/13/2024,Lakmini Ekanayake,Moneragala,Siyambalanduwa,Uva,5478,3531,9009,219120,141240,360360
8/14/2024,Lakmini Ekanayake,Moneragala,Siyambalanduwa,Uva,6048,6675,12723,241920,267000,508920
8/15/2024,Lakmini Ekanayake,Moneragala,Siyambalanduwa,Uva,4436,39,4475,177440,1560,179000
8/16/2024,Lakmini Ekanayake,Moneragala,Siyambalanduwa,Uva,7163,4525,11688,286520,181000,467520
8/17/2024,Lakmini Ekanayake,Moneragala,Siyambalanduwa,Uva,8884,9822,18706,355360,392880,748240
8/18/2024,Lakmini Ekanayake,Moneragala,Siyambalanduwa,Uva,6198,4408,10606,247920,176320,424240
8/19/2024,Lakmini Ekanayake,Moneragala,Siyambalanduwa,Uva,2660,2445,5105,106400,97800,204200
8/20/2024,Lakmini Ekanayake,Moneragala,Siyambalanduwa,Uva,2752,9589,12341,110080,383560,493640
8/21/2024,Lakmini Ekanayake,Moneragala,Siyambalanduwa,Uva,5030,4689,9719,201200,187560,388760
8/22/2024,Lakmini Ekanayake,Moneragala,Siyambalanduwa,Uva,5188,7811,12999,207520,312440,519960
8/23/2024,Lakmini Ekanayake,Moneragala,Siyambalanduwa,Uva,8321,4316,12637,332840,172640,505480
8/24/2024,Lakmini Ekanayake,Moneragala,Siyambalanduwa,Uva,8011,2954,10965,320440,118160,438600
8/25/2024,Lakmini Ekanayake,Moneragala,Siyambalanduwa,Uva,9120,2284,11404,364800,91360,456160
8/26/2024,Lakmini Ekanayake,Moneragala,Siyambalanduwa,Uva,886,1358,2244,35440,54320,89760
8/27/2024,Lakmini Ekanayake,Moneragala,Siyambalanduwa,Uva,7384,3376,10760,295360,135040,430400
8/28/2024,Lakmini Ekanayake,Moneragala,Siyambalanduwa,Uva,2181,3108,5289,87240,124320,211560
8/29/2024,Lakmini Ekanayake,Moneragala,Siyambalanduwa,Uva,6732,6335,13067,269280,253400,522680
8/30/2024,Lakmini Ekanayake,Moneragala,Siyambalanduwa,Uva,1005,5464,6469,40200,218560,258760
8/31/2024,Lakmini Ekanayake,Moneragala,Siyambalanduwa,Uva,648,687,1335,25920,27480,53400
9/1/2024,Lakmini Ekanayake,Moneragala,Siyambalanduwa,Uva,5202,8133,13335,208080,325320,533400
9/2/2024,Lakmini Ekanayake,Moneragala,Siyambalanduwa,Uva,5011,284,5295,200440,11360,211800
9/3/2024,Lakmini Ekanayake,Moneragala,Siyambalanduwa,Uva,1513,9703,11216,60520,388120,448640
9/4/2024,Lakmini Ekanayake,Moneragala,Siyambalanduwa,Uva,9655,4648,14303,386200,185920,572120
9/5/2024,Lakmini Ekanayake,Moneragala,Siyambalanduwa,Uva,6057,3961,10018,242280,158440,400720
9/6/2024,Lakmini Ekanayake,Moneragala,Siyambalanduwa,Uva,4889,1324,6213,195560,52960,248520
9/7/2024,Lakmini Ekanayake,Moneragala,Siyambalanduwa,Uva,8677,561,9238,347080,22440,369520
9/8/2024,Lakmini Ekanayake,Moneragala,Siyambalanduwa,Uva,3050,2725,5775,122000,109000,231000
9/9/2024,Lakmini Ekanayake,Moneragala,Siyambalanduwa,Uva,3128,7292,10420,125120,291680,416800
9/10/2024,Lakmini Ekanayake,Moneragala,Siyambalanduwa,Uva,8358,8929,17287,334320,357160,691480
9/11/2024,Lakmini Ekanayake,Moneragala,Siyambalanduwa,Uva,6390,5972,12362,255600,238880,494480
9/12/2024,Lakmini Ekanayake,Moneragala,Siyambalanduwa,Uva,1041,2283,3324,41640,91320,132960
9/13/2024,Lakmini Ekanayake,Moneragala,Siyambalanduwa,Uva,6708,6335,13043,268320,253400,521720
9/14/2024,Lakmini Ekanayake,Moneragala,Siyambalanduwa,Uva,8551,4863,13414,342040,194520,536560
9/15/2024,Lakmini Ekanayake,Moneragala,Siyambalanduwa,Uva,635,908,1543,25400,36320,61720
9/16/2024,Lakmini Ekanayake,Moneragala,Siyambalanduwa,Uva,5076,83,5159,203040,3320,206360
9/17/2024,Lakmini Ekanayake,Moneragala,Siyambalanduwa,Uva,9706,2935,12641,388240,117400,505640
9/18/2024,Lakmini Ekanayake,Moneragala,Siyambalanduwa,Uva,3144,7014,10158,125760,280560,406320
9/19/2024,Lakmini Ekanayake,Moneragala,Siyambalanduwa,Uva,1381,3953,5334,55240,158120,213360
9/20/2024,Lakmini Ekanayake,Moneragala,Siyambalanduwa,Uva,1942,1202,3144,77680,48080,125760
9/21/2024,Lakmini Ekanayake,Moneragala,Siyambalanduwa,Uva,2421,7546,9967,96840,301840,398680
9/22/2024,Lakmini Ekanayake,Moneragala,Siyambalanduwa,Uva,7515,837,8352,300600,33480,334080
9/23/2024,Lakmini Ekanayake,Moneragala,Siyambalanduwa,Uva,8387,8502,16889,335480,340080,675560
9/24/2024,Lakmini Ekanayake,Moneragala,Siyambalanduwa,Uva,5079,1709,6788,203160,68360,271520
9/25/2024,Lakmini Ekanayake,Moneragala,Siyambalanduwa,Uva,1872,7208,9080,74880,288320,363200
9/26/2024,Lakmini Ekanayake,Moneragala,Siyambalanduwa,Uva,9521,4941,14462,380840,197640,578480
9/27/2024,Lakmini Ekanayake,Moneragala,Siyambalanduwa,Uva,9119,2378,11497,364760,95120,459880
9/28/2024,Lakmini Ekanayake,Moneragala,Siyambalanduwa,Uva,7435,3334,10769,297400,133360,430760
9/29/2024,Lakmini Ekanayake,Moneragala,Siyambalanduwa,Uva,1227,7595,8822,49080,303800,352880
9/30/2024,Lakmini Ekanayake,Moneragala,Siyambalanduwa,Uva,871,534,1405,34840,21360,56200
10/1/2024,Lakmini Ekanayake,Moneragala,Siyambalanduwa,Uva,3928,1816,5744,157120,72640,229760
10/2/2024,Lakmini Ekanayake,Moneragala,Siyambalanduwa,Uva,2600,4211,6811,104000,168440,272440
10/3/2024,Lakmini Ekanayake,Moneragala,Siyambalanduwa,Uva,2701,4924,7625,108040,196960,305000
10/4/2024,Lakmini Ekanayake,Moneragala,Siyambalanduwa,Uva,5998,7159,13157,239920,286360,526280
10/5/2024,Lakmini Ekanayake,Moneragala,Siyambalanduwa,Uva,4680,9846,14526,187200,393840,581040
10/6/2024,Lakmini Ekanayake,Moneragala,Siyambalanduwa,Uva,6001,5979,11980,240040,239160,479200
10/7/2024,Lakmini Ekanayake,Moneragala,Siyambalanduwa,Uva,3420,851,4271,136800,34040,170840
10/8/2024,Lakmini Ekanayake,Moneragala,Siyambalanduwa,Uva,5500,5714,11214,220000,228560,448560
10/9/2024,Lakmini Ekanayake,Moneragala,Siyambalanduwa,Uva,3119,1526,4645,124760,61040,185800
10/10/2024,Lakmini Ekanayake,Moneragala,Siyambalanduwa,Uva,9511,82,9593,380440,3280,383720
10/11/2024,Lakmini Ekanayake,Moneragala,Siyambalanduwa,Uva,9865,1778,11643,394600,71120,465720
10/12/2024,Lakmini Ekanayake,Moneragala,Siyambalanduwa,Uva,8983,1522,10505,359320,60880,420200
10/13/2024,Lakmini Ekanayake,Moneragala,Siyambalanduwa,Uva,5320,3794,9114,212800,151760,364560
10/14/2024,Lakmini Ekanayake,Moneragala,Siyambalanduwa,Uva,3733,1713,5446,149320,68520,217840
10/15/2024,Lakmini Ekanayake,Moneragala,Siyambalanduwa,Uva,4459,766,5225,178360,30640,209000
10/16/2024,Lakmini Ekanayake,Moneragala,Siyambalanduwa,Uva,256,524,780,10240,20960,31200
10/17/2024,Lakmini Ekanayake,Moneragala,Siyambalanduwa,Uva,8637,1240,9877,345480,49600,395080
10/18/2024,Lakmini Ekanayake,Moneragala,Siyambalanduwa,Uva,2866,9855,12721,114640,394200,508840
10/19/2024,Lakmini Ekanayake,Moneragala,Siyambalanduwa,Uva,3407,1317,4724,136280,52680,188960
10/20/2024,Lakmini Ekanayake,Moneragala,Siyambalanduwa,Uva,6494,1142,7636,259760,45680,305440
10/21/2024,Lakmini Ekanayake,Moneragala,Siyambalanduwa,Uva,6482,114,6596,259280,4560,263840
10/22/2024,Lakmini Ekanayake,Moneragala,Siyambalanduwa,Uva,2899,6827,9726,115960,273080,389040
10/23/2024,Lakmini Ekanayake,Moneragala,Siyambalanduwa,Uva,314,400,714,12560,16000,28560
10/24/2024,Lakmini Ekanayake,Moneragala,Siyambalanduwa,Uva,5546,8573,14119,221840,342920,564760
10/25/2024,Lakmini Ekanayake,Moneragala,Siyambalanduwa,Uva,9467,5591,15058,378680,223640,602320
10/26/2024,Lakmini Ekanayake,Moneragala,Siyambalanduwa,Uva,9343,3481,12824,373720,139240,512960
10/27/2024,Lakmini Ekanayake,Moneragala,Siyambalanduwa,Uva,8406,9793,18199,336240,391720,727960
10/28/2024,Lakmini Ekanayake,Moneragala,Siyambalanduwa,Uva,2509,5811,8320,100360,232440,332800
10/29/2024,Lakmini Ekanayake,Moneragala,Siyambalanduwa,Uva,2628,7308,9936,105120,292320,397440
10/30/2024,Lakmini Ekanayake,Moneragala,Siyambalanduwa,Uva,4369,2912,7281,174760,116480,291240
10/31/2024,Lakmini Ekanayake,Moneragala,Siyambalanduwa,Uva,140,6588,6728,5600,263520,269120
11/1/2024,Lakmini Ekanayake,Moneragala,Siyambalanduwa,Uva,4498,4138,8636,179920,165520,345440
11/2/2024,Lakmini Ekanayake,Moneragala,Siyambalanduwa,Uva,441,9998,10439,17640,399920,417560
11/3/2024,Lakmini Ekanayake,Moneragala,Siyambalanduwa,Uva,334,3288,3622,13360,131520,144880
11/4/2024,Lakmini Ekanayake,Moneragala,Siyambalanduwa,Uva,4539,87,4626,181560,3480,185040
11/5/2024,Lakmini Ekanayake,Moneragala,Siyambalanduwa,Uva,7766,3010,10776,310640,120400,431040
11/6/2024,Lakmini Ekanayake,Moneragala,Siyambalanduwa,Uva,8055,2979,11034,322200,119160,441360
11/7/2024,Lakmini Ekanayake,Moneragala,Siyambalanduwa,Uva,3575,3535,7110,143000,141400,284400
11/8/2024,Lakmini Ekanayake,Moneragala,Siyambalanduwa,Uva,9187,3026,12213,367480,121040,488520
11/9/2024,Lakmini Ekanayake,Moneragala,Siyambalanduwa,Uva,8956,5340,14296,358240,213600,571840
11/10/2024,Lakmini Ekanayake,Moneragala,Siyambalanduwa,Uva,1635,9157,10792,65400,366280,431680
11/11/2024,Lakmini Ekanayake,Moneragala,Siyambalanduwa,Uva,4180,7694,11874,167200,307760,474960
11/12/2024,Lakmini Ekanayake,Moneragala,Siyambalanduwa,Uva,3357,1629,4986,134280,65160,199440
11/13/2024,Lakmini Ekanayake,Moneragala,Siyambalanduwa,Uva,6477,2368,8845,259080,94720,353800
11/14/2024,Lakmini Ekanayake,Moneragala,Siyambalanduwa,Uva,381,6094,6475,15240,243760,259000
11/15/2024,Lakmini Ekanayake,Moneragala,Siyambalanduwa,Uva,8413,4372,12785,336520,174880,511400
11/16/2024,Lakmini Ekanayake,Moneragala,Siyambalanduwa,Uva,5832,1107,6939,233280,44280,277560
11/17/2024,Lakmini Ekanayake,Moneragala,Siyambalanduwa,Uva,2644,9828,12472,105760,393120,498880
11/18/2024,Lakmini Ekanayake,Moneragala,Siyambalanduwa,Uva,4165,3803,7968,166600,152120,318720
11/19/2024,Lakmini Ekanayake,Moneragala,Siyambalanduwa,Uva,3439,7064,10503,137560,282560,420120
11/20/2024,Lakmini Ekanayake,Moneragala,Siyambalanduwa,Uva,269,4074,4343,10760,162960,173720
11/21/2024,Lakmini Ekanayake,Moneragala,Siyambalanduwa,Uva,3586,5045,8631,143440,201800,345240
11/22/2024,Lakmini Ekanayake,Moneragala,Siyambalanduwa,Uva,1467,6942,8409,58680,277680,336360
11/23/2024,Lakmini Ekanayake,Moneragala,Siyambalanduwa,Uva,9849,1911,11760,393960,76440,470400
11/24/2024,Lakmini Ekanayake,Moneragala,Siyambalanduwa,Uva,5382,1845,7227,215280,73800,289080
11/25/2024,Lakmini Ekanayake,Moneragala,Siyambalanduwa,Uva,2236,6258,8494,89440,250320,339760
11/26/2024,Lakmini Ekanayake,Moneragala,Siyambalanduwa,Uva,3284,5298,8582,131360,211920,343280
11/27/2024,Lakmini Ekanayake,Moneragala,Siyambalanduwa,Uva,8930,6618,15548,357200,264720,621920
11/28/2024,Lakmini Ekanayake,Moneragala,Siyambalanduwa,Uva,6189,2025,8214,247560,81000,328560
11/29/2024,Lakmini Ekanayake,Moneragala,Siyambalanduwa,Uva,6944,8979,15923,277760,359160,636920
11/30/2024,Lakmini Ekanayake,Moneragala,Siyambalanduwa,Uva,4032,8259,12291,161280,330360,491640
12/1/2024,Lakmini Ekanayake,Moneragala,Siyambalanduwa,Uva,774,7692,8466,30960,307680,338640
12/2/2024,Lakmini Ekanayake,Moneragala,Siyambalanduwa,Uva,1995,3140,5135,79800,125600,205400
12/3/2024,Lakmini Ekanayake,Moneragala,Siyambalanduwa,Uva,7121,3588,10709,284840,143520,428360
12/4/2024,Lakmini Ekanayake,Moneragala,Siyambalanduwa,Uva,3530,1328,4858,141200,53120,194320
12/5/2024,Lakmini Ekanayake,Moneragala,Siyambalanduwa,Uva,1615,4576,6191,64600,183040,247640
12/6/2024,Lakmini Ekanayake,Moneragala,Siyambalanduwa,Uva,21,5113,5134,840,204520,205360
12/7/2024,Lakmini Ekanayake,Moneragala,Siyambalanduwa,Uva,667,2405,3072,26680,96200,122880
12/8/2024,Lakmini Ekanayake,Moneragala,Siyambalanduwa,Uva,3986,2921,6907,159440,116840,276280
12/9/2024,Lakmini Ekanayake,Moneragala,Siyambalanduwa,Uva,7016,5429,12445,280640,217160,497800
12/10/2024,Lakmini Ekanayake,Moneragala,Siyambalanduwa,Uva,42,1313,1355,1680,52520,54200
12/11/2024,Lakmini Ekanayake,Moneragala,Siyambalanduwa,Uva,7424,617,8041,296960,24680,321640
12/12/2024,Lakmini Ekanayake,Moneragala,Siyambalanduwa,Uva,1799,9143,10942,71960,365720,437680
12/13/2024,Lakmini Ekanayake,Moneragala,Siyambalanduwa,Uva,4524,2383,6907,180960,95320,276280
12/14/2024,Lakmini Ekanayake,Moneragala,Siyambalanduwa,Uva,3641,7544,11185,145640,301760,447400
12/15/2024,Lakmini Ekanayake,Moneragala,Siyambalanduwa,Uva,7764,8774,16538,310560,350960,661520
12/16/2024,Lakmini Ekanayake,Moneragala,Siyambalanduwa,Uva,8451,3754,12205,338040,150160,488200
12/17/2024,Lakmini Ekanayake,Moneragala,Siyambalanduwa,Uva,6662,1522,8184,266480,60880,327360
12/18/2024,Lakmini Ekanayake,Moneragala,Siyambalanduwa,Uva,6445,1092,7537,257800,43680,301480
12/19/2024,Lakmini Ekanayake,Moneragala,Siyambalanduwa,Uva,4153,2842,6995,166120,113680,279800
12/20/2024,Lakmini Ekanayake,Moneragala,Siyambalanduwa,Uva,8867,469,9336,354680,18760,373440
12/21/2024,Lakmini Ekanayake,Moneragala,Siyambalanduwa,Uva,3076,5511,8587,123040,220440,343480
12/22/2024,Lakmini Ekanayake,Moneragala,Siyambalanduwa,Uva,1664,2013,3677,66560,80520,147080
12/23/2024,Lakmini Ekanayake,Moneragala,Siyambalanduwa,Uva,6364,6707,13071,254560,268280,522840
12/24/2024,Lakmini Ekanayake,Moneragala,Siyambalanduwa,Uva,1062,9529,10591,42480,381160,423640
12/25/2024,Lakmini Ekanayake,Moneragala,Siyambalanduwa,Uva,7758,7404,15162,310320,296160,606480
12/26/2024,Lakmini Ekanayake,Moneragala,Siyambalanduwa,Uva,652,335,987,26080,13400,39480
12/27/2024,Lakmini Ekanayake,Moneragala,Siyambalanduwa,Uva,3426,83,3509,137040,3320,140360
12/28/2024,Lakmini Ekanayake,Moneragala,Siyambalanduwa,Uva,6247,1904,8151,249880,76160,326040
12/29/2024,Lakmini Ekanayake,Moneragala,Siyambalanduwa,Uva,4710,4592,9302,188400,183680,372080
12/30/2024,Lakmini Ekanayake,Moneragala,Siyambalanduwa,Uva,833,8748,9581,33320,349920,383240
12/31/2024,Lakmini Ekanayake,Moneragala,Siyambalanduwa,Uva,1727,504,2231,69080,20160,89240
1/1/2025,Lakmini Ekanayake,Moneragala,Siyambalanduwa,Uva,4523,8770,13293,180920,350800,531720
1/2/2025,Lakmini Ekanayake,Moneragala,Siyambalanduwa,Uva,9967,4281,14248,398680,171240,569920
1/3/2025,Lakmini Ekanayake,Moneragala,Siyambalanduwa,Uva,1867,4245,6112,74680,169800,244480
1/4/2025,Lakmini Ekanayake,Moneragala,Siyambalanduwa,Uva,9186,4693,13879,367440,187720,555160
1/5/2025,Lakmini Ekanayake,Moneragala,Siyambalanduwa,Uva,8470,1238,9708,338800,49520,388320
1/6/2025,Lakmini Ekanayake,Moneragala,Siyambalanduwa,Uva,2064,1117,3181,82560,44680,127240
1/7/2025,Lakmini Ekanayake,Moneragala,Siyambalanduwa,Uva,6959,4159,11118,278360,166360,444720
1/8/2025,Lakmini Ekanayake,Moneragala,Siyambalanduwa,Uva,424,8615,9039,16960,344600,361560
1/9/2025,Lakmini Ekanayake,Moneragala,Siyambalanduwa,Uva,9028,5617,14645,361120,224680,585800
1/10/2025,Lakmini Ekanayake,Moneragala,Siyambalanduwa,Uva,1883,9048,10931,75320,361920,437240
1/11/2025,Lakmini Ekanayake,Moneragala,Siyambalanduwa,Uva,3300,4821,8121,132000,192840,324840
1/12/2025,Lakmini Ekanayake,Moneragala,Siyambalanduwa,Uva,7744,3415,11159,309760,136600,446360
1/13/2025,Lakmini Ekanayake,Moneragala,Siyambalanduwa,Uva,4619,5961,10580,184760,238440,423200
1/14/2025,Lakmini Ekanayake,Moneragala,Siyambalanduwa,Uva,9364,6794,16158,374560,271760,646320
1/15/2025,Lakmini Ekanayake,Moneragala,Siyambalanduwa,Uva,3170,4907,8077,126800,196280,323080
1/16/2025,Lakmini Ekanayake,Moneragala,Siyambalanduwa,Uva,2343,357,2700,93720,14280,108000
1/17/2025,Lakmini Ekanayake,Moneragala,Siyambalanduwa,Uva,5850,8623,14473,234000,344920,578920
1/18/2025,Lakmini Ekanayake,Moneragala,Siyambalanduwa,Uva,1753,9908,11661,70120,396320,466440
1/19/2025,Lakmini Ekanayake,Moneragala,Siyambalanduwa,Uva,7301,834,8135,292040,33360,325400
1/20/2025,Lakmini Ekanayake,Moneragala,Siyambalanduwa,Uva,8030,7929,15959,321200,317160,638360
1/21/2025,Lakmini Ekanayake,Moneragala,Siyambalanduwa,Uva,2605,7099,9704,104200,283960,388160
1/22/2025,Lakmini Ekanayake,Moneragala,Siyambalanduwa,Uva,1565,3591,5156,62600,143640,206240
1/23/2025,Lakmini Ekanayake,Moneragala,Siyambalanduwa,Uva,7548,9595,17143,301920,383800,685720
1/24/2025,Lakmini Ekanayake,Moneragala,Siyambalanduwa,Uva,2270,2641,4911,90800,105640,196440
1/25/2025,Lakmini Ekanayake,Moneragala,Siyambalanduwa,Uva,2767,2652,5419,110680,106080,216760
1/26/2025,Lakmini Ekanayake,Moneragala,Siyambalanduwa,Uva,3526,9794,13320,141040,391760,532800
1/27/2025,Lakmini Ekanayake,Moneragala,Siyambalanduwa,Uva,2138,9078,11216,85520,363120,448640
1/28/2025,Lakmini Ekanayake,Moneragala,Siyambalanduwa,Uva,4075,9466,13541,163000,378640,541640
1/29/2025,Lakmini Ekanayake,Moneragala,Siyambalanduwa,Uva,2284,8950,11234,91360,358000,449360
1/30/2025,Lakmini Ekanayake,Moneragala,Siyambalanduwa,Uva,4908,2322,7230,196320,92880,289200
1/31/2025,Lakmini Ekanayake,Moneragala,Siyambalanduwa,Uva,4115,4231,8346,164600,169240,333840
2/1/2025,Lakmini Ekanayake,Moneragala,Siyambalanduwa,Uva,1230,2341,3571,49200,93640,142840
2/2/2025,Lakmini Ekanayake,Moneragala,Siyambalanduwa,Uva,7655,9190,16845,306200,367600,673800
2/3/2025,Lakmini Ekanayake,Moneragala,Siyambalanduwa,Uva,8188,8311,16499,327520,332440,659960
2/4/2025,Lakmini Ekanayake,Moneragala,Siyambalanduwa,Uva,8868,4215,13083,354720,168600,523320
2/5/2025,Lakmini Ekanayake,Moneragala,Siyambalanduwa,Uva,5947,3595,9542,237880,143800,381680
2/6/2025,Lakmini Ekanayake,Moneragala,Siyambalanduwa,Uva,1566,5986,7552,62640,239440,302080
2/7/2025,Lakmini Ekanayake,Moneragala,Siyambalanduwa,Uva,5671,5068,10739,226840,202720,429560
2/8/2025,Lakmini Ekanayake,Moneragala,Siyambalanduwa,Uva,4783,3653,8436,191320,146120,337440
2/9/2025,Lakmini Ekanayake,Moneragala,Siyambalanduwa,Uva,8299,5540,13839,331960,221600,553560
2/10/2025,Lakmini Ekanayake,Moneragala,Siyambalanduwa,Uva,3211,4098,7309,128440,163920,292360
2/11/2025,Lakmini Ekanayake,Moneragala,Siyambalanduwa,Uva,9890,89,9979,395600,3560,399160
2/12/2025,Lakmini Ekanayake,Moneragala,Siyambalanduwa,Uva,6430,5999,12429,257200,239960,497160
2/13/2025,Lakmini Ekanayake,Moneragala,Siyambalanduwa,Uva,1339,7357,8696,53560,294280,347840
2/14/2025,Lakmini Ekanayake,Moneragala,Siyambalanduwa,Uva,2451,7155,9606,98040,286200,384240
2/15/2025,Lakmini Ekanayake,Moneragala,Siyambalanduwa,Uva,9593,9954,19547,383720,398160,781880
2/16/2025,Lakmini Ekanayake,Moneragala,Siyambalanduwa,Uva,5132,4382,9514,205280,175280,380560
2/17/2025,Lakmini Ekanayake,Moneragala,Siyambalanduwa,Uva,4652,9258,13910,186080,370320,556400
2/18/2025,Lakmini Ekanayake,Moneragala,Siyambalanduwa,Uva,327,9040,9367,13080,361600,374680
2/19/2025,Lakmini Ekanayake,Moneragala,Siyambalanduwa,Uva,8731,7731,16462,349240,309240,658480
2/20/2025,Lakmini Ekanayake,Moneragala,Siyambalanduwa,Uva,7908,2388,10296,316320,95520,411840
2/21/2025,Lakmini Ekanayake,Moneragala,Siyambalanduwa,Uva,9511,2149,11660,380440,85960,466400
2/22/2025,Lakmini Ekanayake,Moneragala,Siyambalanduwa,Uva,8783,5300,14083,351320,212000,563320
2/23/2025,Lakmini Ekanayake,Moneragala,Siyambalanduwa,Uva,6254,7580,13834,250160,303200,553360
2/24/2025,Lakmini Ekanayake,Moneragala,Siyambalanduwa,Uva,7848,3011,10859,313920,120440,434360
2/25/2025,Lakmini Ekanayake,Moneragala,Siyambalanduwa,Uva,1898,3499,5397,75920,139960,215880
2/26/2025,Lakmini Ekanayake,Moneragala,Siyambalanduwa,Uva,6717,7516,14233,268680,300640,569320
2/27/2025,Lakmini Ekanayake,Moneragala,Siyambalanduwa,Uva,5460,1662,7122,218400,66480,284880
2/28/2025,Lakmini Ekanayake,Moneragala,Siyambalanduwa,Uva,9555,4642,14197,382200,185680,567880
3/1/2025,Lakmini Ekanayake,Moneragala,Siyambalanduwa,Uva,7519,5826,13345,300760,233040,533800
3/2/2025,Lakmini Ekanayake,Moneragala,Siyambalanduwa,Uva,3055,3960,7015,122200,158400,280600
3/3/2025,Lakmini Ekanayake,Moneragala,Siyambalanduwa,Uva,1531,3867,5398,61240,154680,215920
3/4/2025,Lakmini Ekanayake,Moneragala,Siyambalanduwa,Uva,2146,2786,4932,85840,111440,197280
3/5/2025,Lakmini Ekanayake,Moneragala,Siyambalanduwa,Uva,1046,1014,2060,41840,40560,82400
3/6/2025,Lakmini Ekanayake,Moneragala,Siyambalanduwa,Uva,868,487,1355,34720,19480,54200
3/7/2025,Lakmini Ekanayake,Moneragala,Siyambalanduwa,Uva,1160,5652,6812,46400,226080,272480
3/8/2025,Lakmini Ekanayake,Moneragala,Siyambalanduwa,Uva,2270,7578,9848,90800,303120,393920
3/9/2025,Lakmini Ekanayake,Moneragala,Siyambalanduwa,Uva,3536,6098,9634,141440,243920,385360
3/10/2025,Lakmini Ekanayake,Moneragala,Siyambalanduwa,Uva,7905,1572,9477,316200,62880,379080
3/11/2025,Lakmini Ekanayake,Moneragala,Siyambalanduwa,Uva,3237,292,3529,129480,11680,141160
3/12/2025,Lakmini Ekanayake,Moneragala,Siyambalanduwa,Uva,7088,20,7108,283520,800,284320
3/13/2025,Lakmini Ekanayake,Moneragala,Siyambalanduwa,Uva,325,6572,6897,13000,262880,275880
3/14/2025,Lakmini Ekanayake,Moneragala,Siyambalanduwa,Uva,8031,6271,14302,321240,250840,572080
3/15/2025,Lakmini Ekanayake,Moneragala,Siyambalanduwa,Uva,3761,991,4752,150440,39640,190080
3/16/2025,Lakmini Ekanayake,Moneragala,Siyambalanduwa,Uva,4157,7626,11783,166280,305040,471320
3/17/2025,Lakmini Ekanayake,Moneragala,Siyambalanduwa,Uva,143,7660,7803,5720,306400,312120
3/18/2025,Lakmini Ekanayake,Moneragala,Siyambalanduwa,Uva,3439,1941,5380,137560,77640,215200
3/19/2025,Lakmini Ekanayake,Moneragala,Siyambalanduwa,Uva,9932,4634,14566,397280,185360,582640
3/20/2025,Lakmini Ekanayake,Moneragala,Siyambalanduwa,Uva,3822,6761,10583,152880,270440,423320
3/21/2025,Lakmini Ekanayake,Moneragala,Siyambalanduwa,Uva,2077,9029,11106,83080,361160,444240
3/22/2025,Lakmini Ekanayake,Moneragala,Siyambalanduwa,Uva,1309,3726,5035,52360,149040,201400
3/23/2025,Lakmini Ekanayake,Moneragala,Siyambalanduwa,Uva,8861,6119,14980,354440,244760,599200
3/25/2024,Shanika Mahadeva,Polonnaruwa,Maho,North Central,3562,4090,7652,142480,163600,306080
3/26/2024,Shanika Mahadeva,Polonnaruwa,Maho,North Central,2404,6244,8648,96160,249760,345920
3/27/2024,Shanika Mahadeva,Polonnaruwa,Maho,North Central,2671,1086,3757,106840,43440,150280
3/28/2024,Shanika Mahadeva,Polonnaruwa,Maho,North Central,3586,3400,6986,143440,136000,279440
3/29/2024,Shanika Mahadeva,Polonnaruwa,Maho,North Central,8123,8003,16126,324920,320120,645040
3/30/2024,Shanika Mahadeva,Polonnaruwa,Maho,North Central,6511,2365,8876,260440,94600,355040
3/31/2024,Shanika Mahadeva,Polonnaruwa,Maho,North Central,8789,6009,14798,351560,240360,591920
4/1/2024,Shanika Mahadeva,Polonnaruwa,Maho,North Central,4654,2712,7366,186160,108480,294640
4/2/2024,Shanika Mahadeva,Polonnaruwa,Maho,North Central,3788,7964,11752,151520,318560,470080
4/3/2024,Shanika Mahadeva,Polonnaruwa,Maho,North Central,3943,2313,6256,157720,92520,250240
4/4/2024,Shanika Mahadeva,Polonnaruwa,Maho,North Central,7452,4339,11791,298080,173560,471640
4/5/2024,Shanika Mahadeva,Polonnaruwa,Maho,North Central,9813,9832,19645,392520,393280,785800
4/6/2024,Shanika Mahadeva,Polonnaruwa,Maho,North Central,4697,2570,7267,187880,102800,290680
4/7/2024,Shanika Mahadeva,Polonnaruwa,Maho,North Central,9583,1981,11564,383320,79240,462560
4/8/2024,Shanika Mahadeva,Polonnaruwa,Maho,North Central,8687,8449,17136,347480,337960,685440
4/9/2024,Shanika Mahadeva,Polonnaruwa,Maho,North Central,6688,132,6820,267520,5280,272800
4/10/2024,Shanika Mahadeva,Polonnaruwa,Maho,North Central,9558,3948,13506,382320,157920,540240
4/11/2024,Shanika Mahadeva,Polonnaruwa,Maho,North Central,1754,4987,6741,70160,199480,269640
4/19/2024,Shanika Mahadeva,Polonnaruwa,Maho,North Central,9721,4139,13860,388840,165560,554400
4/20/2024,Shanika Mahadeva,Polonnaruwa,Maho,North Central,4958,5224,10182,198320,208960,407280
4/21/2024,Shanika Mahadeva,Polonnaruwa,Maho,North Central,6568,8322,14890,262720,332880,595600
4/22/2024,Shanika Mahadeva,Polonnaruwa,Maho,North Central,3211,5607,8818,128440,224280,352720
4/23/2024,Shanika Mahadeva,Polonnaruwa,Maho,North Central,826,5805,6631,33040,232200,265240
4/24/2024,Shanika Mahadeva,Polonnaruwa,Maho,North Central,461,5906,6367,18440,236240,254680
4/25/2024,Shanika Mahadeva,Polonnaruwa,Maho,North Central,5686,7610,13296,227440,304400,531840
4/26/2024,Shanika Mahadeva,Polonnaruwa,Maho,North Central,6221,222,6443,248840,8880,257720
4/27/2024,Shanika Mahadeva,Polonnaruwa,Maho,North Central,756,8090,8846,30240,323600,353840
4/28/2024,Shanika Mahadeva,Polonnaruwa,Maho,North Central,9722,1792,11514,388880,71680,460560
4/29/2024,Shanika Mahadeva,Polonnaruwa,Maho,North Central,1456,3897,5353,58240,155880,214120
4/30/2024,Shanika Mahadeva,Polonnaruwa,Maho,North Central,8517,60,8577,340680,2400,343080
5/1/2024,Shanika Mahadeva,Polonnaruwa,Maho,North Central,794,8361,9155,31760,334440,366200
5/2/2024,Shanika Mahadeva,Polonnaruwa,Maho,North Central,3908,3249,7157,156320,129960,286280
5/3/2024,Shanika Mahadeva,Polonnaruwa,Maho,North Central,1983,6110,8093,79320,244400,323720
5/4/2024,Shanika Mahadeva,Polonnaruwa,Maho,North Central,4692,8531,13223,187680,341240,528920
5/5/2024,Shanika Mahadeva,Polonnaruwa,Maho,North Central,8669,6833,15502,346760,273320,620080
5/6/2024,Shanika Mahadeva,Polonnaruwa,Maho,North Central,7906,3150,11056,316240,126000,442240
5/7/2024,Shanika Mahadeva,Polonnaruwa,Maho,North Central,7054,1985,9039,282160,79400,361560
5/8/2024,Shanika Mahadeva,Polonnaruwa,Maho,North Central,1567,7022,8589,62680,280880,343560
5/9/2024,Shanika Mahadeva,Polonnaruwa,Maho,North Central,4362,1883,6245,174480,75320,249800
5/10/2024,Shanika Mahadeva,Polonnaruwa,Maho,North Central,4108,5076,9184,164320,203040,367360
5/11/2024,Shanika Mahadeva,Polonnaruwa,Maho,North Central,14,2783,2797,560,111320,111880
5/12/2024,Shanika Mahadeva,Polonnaruwa,Maho,North Central,942,1428,2370,37680,57120,94800
5/13/2024,Shanika Mahadeva,Polonnaruwa,Maho,North Central,2422,5810,8232,96880,232400,329280
5/14/2024,Shanika Mahadeva,Polonnaruwa,Maho,North Central,1019,7896,8915,40760,315840,356600
5/15/2024,Shanika Mahadeva,Polonnaruwa,Maho,North Central,5614,1387,7001,224560,55480,280040
5/16/2024,Shanika Mahadeva,Polonnaruwa,Maho,North Central,9875,6199,16074,395000,247960,642960
5/17/2024,Shanika Mahadeva,Polonnaruwa,Maho,North Central,9965,9103,19068,398600,364120,762720
5/18/2024,Shanika Mahadeva,Polonnaruwa,Maho,North Central,7579,9777,17356,303160,391080,694240
5/19/2024,Shanika Mahadeva,Polonnaruwa,Maho,North Central,8266,7295,15561,330640,291800,622440
5/20/2024,Shanika Mahadeva,Polonnaruwa,Maho,North Central,3674,9398,13072,146960,375920,522880
5/21/2024,Shanika Mahadeva,Polonnaruwa,Maho,North Central,7676,4176,11852,307040,167040,474080
5/22/2024,Shanika Mahadeva,Polonnaruwa,Maho,North Central,6247,8525,14772,249880,341000,590880
5/24/2024,Shanika Mahadeva,Polonnaruwa,Maho,North Central,2637,5917,8554,105480,236680,342160
5/25/2024,Shanika Mahadeva,Polonnaruwa,Maho,North Central,449,1239,1688,17960,49560,67520
5/26/2024,Shanika Mahadeva,Polonnaruwa,Maho,North Central,691,8582,9273,27640,343280,370920
5/27/2024,Shanika Mahadeva,Polonnaruwa,Maho,North Central,27,3896,3923,1080,155840,156920
5/28/2024,Shanika Mahadeva,Polonnaruwa,Maho,North Central,1357,5516,6873,54280,220640,274920
5/29/2024,Shanika Mahadeva,Polonnaruwa,Maho,North Central,4283,4249,8532,171320,169960,341280
5/30/2024,Shanika Mahadeva,Polonnaruwa,Maho,North Central,8423,2115,10538,336920,84600,421520
5/31/2024,Shanika Mahadeva,Polonnaruwa,Maho,North Central,1069,615,1684,42760,24600,67360
6/1/2024,Shanika Mahadeva,Polonnaruwa,Maho,North Central,1835,8863,10698,73400,354520,427920
6/2/2024,Shanika Mahadeva,Polonnaruwa,Maho,North Central,20,9610,9630,800,384400,385200
6/3/2024,Shanika Mahadeva,Polonnaruwa,Maho,North Central,446,3007,3453,17840,120280,138120
6/4/2024,Shanika Mahadeva,Polonnaruwa,Maho,North Central,4041,9947,13988,161640,397880,559520
6/5/2024,Shanika Mahadeva,Polonnaruwa,Maho,North Central,1568,1456,3024,62720,58240,120960
6/6/2024,Shanika Mahadeva,Polonnaruwa,Maho,North Central,7010,3273,10283,280400,130920,411320
6/7/2024,Shanika Mahadeva,Polonnaruwa,Maho,North Central,8955,9319,18274,358200,372760,730960
6/8/2024,Shanika Mahadeva,Polonnaruwa,Maho,North Central,96,8364,8460,3840,334560,338400
6/9/2024,Shanika Mahadeva,Polonnaruwa,Maho,North Central,2761,6453,9214,110440,258120,368560
6/10/2024,Shanika Mahadeva,Polonnaruwa,Maho,North Central,5183,7386,12569,207320,295440,502760
6/11/2024,Shanika Mahadeva,Polonnaruwa,Maho,North Central,6016,7407,13423,240640,296280,536920
6/12/2024,Shanika Mahadeva,Polonnaruwa,Maho,North Central,7804,5904,13708,312160,236160,548320
6/13/2024,Shanika Mahadeva,Polonnaruwa,Maho,North Central,3628,1900,5528,145120,76000,221120
6/14/2024,Shanika Mahadeva,Polonnaruwa,Maho,North Central,6083,3724,9807,243320,148960,392280
6/15/2024,Shanika Mahadeva,Polonnaruwa,Maho,North Central,6537,8983,15520,261480,359320,620800
6/16/2024,Shanika Mahadeva,Polonnaruwa,Maho,North Central,9029,3990,13019,361160,159600,520760
6/17/2024,Shanika Mahadeva,Polonnaruwa,Maho,North Central,3278,6440,9718,131120,257600,388720
6/18/2024,Shanika Mahadeva,Polonnaruwa,Maho,North Central,8514,6001,14515,340560,240040,580600
6/19/2024,Shanika Mahadeva,Polonnaruwa,Maho,North Central,9937,9246,19183,397480,369840,767320
6/20/2024,Shanika Mahadeva,Polonnaruwa,Maho,North Central,3556,4374,7930,142240,174960,317200
6/21/2024,Shanika Mahadeva,Polonnaruwa,Maho,North Central,1852,169,2021,74080,6760,80840
6/22/2024,Shanika Mahadeva,Polonnaruwa,Maho,North Central,9351,8519,17870,374040,340760,714800
6/23/2024,Shanika Mahadeva,Polonnaruwa,Maho,North Central,532,6108,6640,21280,244320,265600
6/24/2024,Shanika Mahadeva,Polonnaruwa,Maho,North Central,4613,8687,13300,184520,347480,532000
6/25/2024,Shanika Mahadeva,Polonnaruwa,Maho,North Central,1807,4835,6642,72280,193400,265680
6/26/2024,Shanika Mahadeva,Polonnaruwa,Maho,North Central,1749,1063,2812,69960,42520,112480
6/27/2024,Shanika Mahadeva,Polonnaruwa,Maho,North Central,3795,1940,5735,151800,77600,229400
6/28/2024,Shanika Mahadeva,Polonnaruwa,Maho,North Central,1552,5055,6607,62080,202200,264280
6/29/2024,Shanika Mahadeva,Polonnaruwa,Maho,North Central,2519,1074,3593,100760,42960,143720
6/30/2024,Shanika Mahadeva,Polonnaruwa,Maho,North Central,3042,7623,10665,121680,304920,426600
7/1/2024,Shanika Mahadeva,Polonnaruwa,Maho,North Central,4853,7964,12817,194120,318560,512680
7/2/2024,Shanika Mahadeva,Polonnaruwa,Maho,North Central,6920,5987,12907,276800,239480,516280
7/3/2024,Shanika Mahadeva,Polonnaruwa,Maho,North Central,2747,8276,11023,109880,331040,440920
7/4/2024,Shanika Mahadeva,Polonnaruwa,Maho,North Central,7148,4052,11200,285920,162080,448000
7/5/2024,Shanika Mahadeva,Polonnaruwa,Maho,North Central,5777,1186,6963,231080,47440,278520
7/6/2024,Shanika Mahadeva,Polonnaruwa,Maho,North Central,3130,8178,11308,125200,327120,452320
7/7/2024,Shanika Mahadeva,Polonnaruwa,Maho,North Central,1863,2704,4567,74520,108160,182680
7/8/2024,Shanika Mahadeva,Polonnaruwa,Maho,North Central,8679,5325,14004,347160,213000,560160
7/9/2024,Shanika Mahadeva,Polonnaruwa,Maho,North Central,1143,7116,8259,45720,284640,330360
7/10/2024,Shanika Mahadeva,Polonnaruwa,Maho,North Central,8836,9519,18355,353440,380760,734200
7/11/2024,Shanika Mahadeva,Polonnaruwa,Maho,North Central,713,4561,5274,28520,182440,210960
7/12/2024,Shanika Mahadeva,Polonnaruwa,Maho,North Central,9782,4600,14382,391280,184000,575280
7/13/2024,Shanika Mahadeva,Polonnaruwa,Maho,North Central,5524,1840,7364,220960,73600,294560
7/14/2024,Shanika Mahadeva,Polonnaruwa,Maho,North Central,3445,9497,12942,137800,379880,517680
7/15/2024,Shanika Mahadeva,Polonnaruwa,Maho,North Central,9717,4501,14218,388680,180040,568720
7/16/2024,Shanika Mahadeva,Polonnaruwa,Maho,North Central,7410,8077,15487,296400,323080,619480
7/17/2024,Shanika Mahadeva,Polonnaruwa,Maho,North Central,1028,4990,6018,41120,199600,240720
7/18/2024,Shanika Mahadeva,Polonnaruwa,Maho,North Central,6984,7731,14715,279360,309240,588600
7/19/2024,Shanika Mahadeva,Polonnaruwa,Maho,North Central,7817,2334,10151,312680,93360,406040
7/20/2024,Shanika Mahadeva,Polonnaruwa,Maho,North Central,5725,6867,12592,229000,274680,503680
7/21/2024,Shanika Mahadeva,Polonnaruwa,Maho,North Central,1255,1503,2758,50200,60120,110320
7/22/2024,Shanika Mahadeva,Polonnaruwa,Maho,North Central,8134,1030,9164,325360,41200,366560
7/23/2024,Shanika Mahadeva,Polonnaruwa,Maho,North Central,8613,7409,16022,344520,296360,640880
7/24/2024,Shanika Mahadeva,Polonnaruwa,Maho,North Central,5727,7176,12903,229080,287040,516120
7/25/2024,Shanika Mahadeva,Polonnaruwa,Maho,North Central,9476,6949,16425,379040,277960,657000
7/26/2024,Shanika Mahadeva,Polonnaruwa,Maho,North Central,4910,5651,10561,196400,226040,422440
7/27/2024,Shanika Mahadeva,Polonnaruwa,Maho,North Central,5129,8395,13524,205160,335800,540960
7/28/2024,Shanika Mahadeva,Polonnaruwa,Maho,North Central,2563,524,3087,102520,20960,123480
7/29/2024,Shanika Mahadeva,Polonnaruwa,Maho,North Central,4850,5679,10529,194000,227160,421160
7/30/2024,Shanika Mahadeva,Polonnaruwa,Maho,North Central,9485,8739,18224,379400,349560,728960
7/31/2024,Shanika Mahadeva,Polonnaruwa,Maho,North Central,5509,2764,8273,220360,110560,330920
8/1/2024,Shanika Mahadeva,Polonnaruwa,Maho,North Central,5307,3545,8852,212280,141800,354080
8/2/2024,Shanika Mahadeva,Polonnaruwa,Maho,North Central,3347,5588,8935,133880,223520,357400
8/3/2024,Shanika Mahadeva,Polonnaruwa,Maho,North Central,9062,9900,18962,362480,396000,758480
8/4/2024,Shanika Mahadeva,Polonnaruwa,Maho,North Central,9613,1004,10617,384520,40160,424680
8/5/2024,Shanika Mahadeva,Polonnaruwa,Maho,North Central,892,7990,8882,35680,319600,355280
8/6/2024,Shanika Mahadeva,Polonnaruwa,Maho,North Central,6175,1247,7422,247000,49880,296880
8/7/2024,Shanika Mahadeva,Polonnaruwa,Maho,North Central,23,980,1003,920,39200,40120
8/8/2024,Shanika Mahadeva,Polonnaruwa,Maho,North Central,9897,8198,18095,395880,327920,723800
8/9/2024,Shanika Mahadeva,Polonnaruwa,Maho,North Central,5886,265,6151,235440,10600,246040
8/10/2024,Shanika Mahadeva,Polonnaruwa,Maho,North Central,6261,9801,16062,250440,392040,642480
8/11/2024,Shanika Mahadeva,Polonnaruwa,Maho,North Central,2180,4445,6625,87200,177800,265000
8/12/2024,Shanika Mahadeva,Polonnaruwa,Maho,North Central,6331,9928,16259,253240,397120,650360
8/13/2024,Shanika Mahadeva,Polonnaruwa,Maho,North Central,8577,619,9196,343080,24760,367840
8/14/2024,Shanika Mahadeva,Polonnaruwa,Maho,North Central,1644,9087,10731,65760,363480,429240
8/15/2024,Shanika Mahadeva,Polonnaruwa,Maho,North Central,376,5283,5659,15040,211320,226360
8/16/2024,Shanika Mahadeva,Polonnaruwa,Maho,North Central,9130,696,9826,365200,27840,393040
8/17/2024,Shanika Mahadeva,Polonnaruwa,Maho,North Central,3397,8106,11503,135880,324240,460120
8/18/2024,Shanika Mahadeva,Polonnaruwa,Maho,North Central,7221,6077,13298,288840,243080,531920
8/19/2024,Shanika Mahadeva,Polonnaruwa,Maho,North Central,6274,4387,10661,250960,175480,426440
8/20/2024,Shanika Mahadeva,Polonnaruwa,Maho,North Central,7394,7106,14500,295760,284240,580000
8/21/2024,Shanika Mahadeva,Polonnaruwa,Maho,North Central,5689,5556,11245,227560,222240,449800
8/22/2024,Shanika Mahadeva,Polonnaruwa,Maho,North Central,9324,2766,12090,372960,110640,483600
8/23/2024,Shanika Mahadeva,Polonnaruwa,Maho,North Central,1019,4801,5820,40760,192040,232800
8/24/2024,Shanika Mahadeva,Polonnaruwa,Maho,North Central,517,9719,10236,20680,388760,409440
8/25/2024,Shanika Mahadeva,Polonnaruwa,Maho,North Central,6111,4083,10194,244440,163320,407760
8/26/2024,Shanika Mahadeva,Polonnaruwa,Maho,North Central,9798,8947,18745,391920,357880,749800
8/27/2024,Shanika Mahadeva,Polonnaruwa,Maho,North Central,8408,7219,15627,336320,288760,625080
8/28/2024,Shanika Mahadeva,Polonnaruwa,Maho,North Central,3789,9731,13520,151560,389240,540800
8/29/2024,Shanika Mahadeva,Polonnaruwa,Maho,North Central,6418,7169,13587,256720,286760,543480
8/30/2024,Shanika Mahadeva,Polonnaruwa,Maho,North Central,2745,3178,5923,109800,127120,236920
8/31/2024,Shanika Mahadeva,Polonnaruwa,Maho,North Central,3277,5701,8978,131080,228040,359120
9/1/2024,Shanika Mahadeva,Polonnaruwa,Maho,North Central,5411,926,6337,216440,37040,253480
9/2/2024,Shanika Mahadeva,Polonnaruwa,Maho,North Central,5643,5265,10908,225720,210600,436320
9/3/2024,Shanika Mahadeva,Polonnaruwa,Maho,North Central,5881,6701,12582,235240,268040,503280
9/4/2024,Shanika Mahadeva,Polonnaruwa,Maho,North Central,1876,2277,4153,75040,91080,166120
9/5/2024,Shanika Mahadeva,Polonnaruwa,Maho,North Central,8918,711,9629,356720,28440,385160
9/6/2024,Shanika Mahadeva,Polonnaruwa,Maho,North Central,606,4002,4608,24240,160080,184320
9/7/2024,Shanika Mahadeva,Polonnaruwa,Maho,North Central,6359,7877,14236,254360,315080,569440
9/8/2024,Shanika Mahadeva,Polonnaruwa,Maho,North Central,6575,5093,11668,263000,203720,466720
9/9/2024,Shanika Mahadeva,Polonnaruwa,Maho,North Central,1029,577,1606,41160,23080,64240
9/10/2024,Shanika Mahadeva,Polonnaruwa,Maho,North Central,861,2111,2972,34440,84440,118880
9/11/2024,Shanika Mahadeva,Polonnaruwa,Maho,North Central,1758,1826,3584,70320,73040,143360
9/12/2024,Shanika Mahadeva,Polonnaruwa,Maho,North Central,281,9852,10133,11240,394080,405320
9/13/2024,Shanika Mahadeva,Polonnaruwa,Maho,North Central,1882,9470,11352,75280,378800,454080
9/14/2024,Shanika Mahadeva,Polonnaruwa,Maho,North Central,2000,5722,7722,80000,228880,308880
9/15/2024,Shanika Mahadeva,Polonnaruwa,Maho,North Central,2036,7704,9740,81440,308160,389600
9/16/2024,Shanika Mahadeva,Polonnaruwa,Maho,North Central,306,9973,10279,12240,398920,411160
9/17/2024,Shanika Mahadeva,Polonnaruwa,Maho,North Central,9989,9510,19499,399560,380400,779960
9/18/2024,Shanika Mahadeva,Polonnaruwa,Maho,North Central,979,3662,4641,39160,146480,185640
9/19/2024,Shanika Mahadeva,Polonnaruwa,Maho,North Central,1745,6936,8681,69800,277440,347240
9/20/2024,Shanika Mahadeva,Polonnaruwa,Maho,North Central,8232,53,8285,329280,2120,331400
9/21/2024,Shanika Mahadeva,Polonnaruwa,Maho,North Central,9605,4712,14317,384200,188480,572680
9/22/2024,Shanika Mahadeva,Polonnaruwa,Maho,North Central,7058,7912,14970,282320,316480,598800
9/23/2024,Shanika Mahadeva,Polonnaruwa,Maho,North Central,7119,9206,16325,284760,368240,653000
9/24/2024,Shanika Mahadeva,Polonnaruwa,Maho,North Central,6216,3522,9738,248640,140880,389520
9/25/2024,Shanika Mahadeva,Polonnaruwa,Maho,North Central,3037,1048,4085,121480,41920,163400
9/26/2024,Shanika Mahadeva,Polonnaruwa,Maho,North Central,1748,1653,3401,69920,66120,136040
9/27/2024,Shanika Mahadeva,Polonnaruwa,Maho,North Central,6756,334,7090,270240,13360,283600
9/28/2024,Shanika Mahadeva,Polonnaruwa,Maho,North Central,7731,5921,13652,309240,236840,546080
9/29/2024,Shanika Mahadeva,Polonnaruwa,Maho,North Central,9242,5529,14771,369680,221160,590840
9/30/2024,Shanika Mahadeva,Polonnaruwa,Maho,North Central,6292,1276,7568,251680,51040,302720
10/1/2024,Shanika Mahadeva,Polonnaruwa,Maho,North Central,8636,4622,13258,345440,184880,530320
10/2/2024,Shanika Mahadeva,Polonnaruwa,Maho,North Central,4810,7625,12435,192400,305000,497400
10/3/2024,Shanika Mahadeva,Polonnaruwa,Maho,North Central,8768,9291,18059,350720,371640,722360
10/4/2024,Shanika Mahadeva,Polonnaruwa,Maho,North Central,2605,7566,10171,104200,302640,406840
10/5/2024,Shanika Mahadeva,Polonnaruwa,Maho,North Central,4768,3847,8615,190720,153880,344600
10/6/2024,Shanika Mahadeva,Polonnaruwa,Maho,North Central,4981,3296,8277,199240,131840,331080
10/7/2024,Shanika Mahadeva,Polonnaruwa,Maho,North Central,1566,7986,9552,62640,319440,382080
10/8/2024,Shanika Mahadeva,Polonnaruwa,Maho,North Central,8083,3813,11896,323320,152520,475840
10/9/2024,Shanika Mahadeva,Polonnaruwa,Maho,North Central,6882,6741,13623,275280,269640,544920
10/10/2024,Shanika Mahadeva,Polonnaruwa,Maho,North Central,2238,3284,5522,89520,131360,220880
10/11/2024,Shanika Mahadeva,Polonnaruwa,Maho,North Central,5622,3068,8690,224880,122720,347600
10/12/2024,Shanika Mahadeva,Polonnaruwa,Maho,North Central,9203,2128,11331,368120,85120,453240
10/13/2024,Shanika Mahadeva,Polonnaruwa,Maho,North Central,4881,7327,12208,195240,293080,488320
10/14/2024,Shanika Mahadeva,Polonnaruwa,Maho,North Central,179,8257,8436,7160,330280,337440
10/15/2024,Shanika Mahadeva,Polonnaruwa,Maho,North Central,5392,7562,12954,215680,302480,518160
10/16/2024,Shanika Mahadeva,Polonnaruwa,Maho,North Central,7205,628,7833,288200,25120,313320
10/17/2024,Shanika Mahadeva,Polonnaruwa,Maho,North Central,4972,6781,11753,198880,271240,470120
10/18/2024,Shanika Mahadeva,Polonnaruwa,Maho,North Central,3486,1011,4497,139440,40440,179880
10/19/2024,Shanika Mahadeva,Polonnaruwa,Maho,North Central,1273,5436,6709,50920,217440,268360
10/20/2024,Shanika Mahadeva,Polonnaruwa,Maho,North Central,185,2205,2390,7400,88200,95600
10/21/2024,Shanika Mahadeva,Polonnaruwa,Maho,North Central,93,2454,2547,3720,98160,101880
10/22/2024,Shanika Mahadeva,Polonnaruwa,Maho,North Central,6863,2765,9628,274520,110600,385120
10/23/2024,Shanika Mahadeva,Polonnaruwa,Maho,North Central,8891,9435,18326,355640,377400,733040
10/24/2024,Shanika Mahadeva,Polonnaruwa,Maho,North Central,1240,5476,6716,49600,219040,268640
10/25/2024,Shanika Mahadeva,Polonnaruwa,Maho,North Central,7464,7322,14786,298560,292880,591440
10/26/2024,Shanika Mahadeva,Polonnaruwa,Maho,North Central,559,741,1300,22360,29640,52000
10/27/2024,Shanika Mahadeva,Polonnaruwa,Maho,North Central,2519,5487,8006,100760,219480,320240
10/28/2024,Shanika Mahadeva,Polonnaruwa,Maho,North Central,7772,6756,14528,310880,270240,581120
10/29/2024,Shanika Mahadeva,Polonnaruwa,Maho,North Central,905,7200,8105,36200,288000,324200
10/30/2024,Shanika Mahadeva,Polonnaruwa,Maho,North Central,247,8699,8946,9880,347960,357840
10/31/2024,Shanika Mahadeva,Polonnaruwa,Maho,North Central,4146,6736,10882,165840,269440,435280
11/1/2024,Shanika Mahadeva,Polonnaruwa,Maho,North Central,9101,9299,18400,364040,371960,736000
11/2/2024,Shanika Mahadeva,Polonnaruwa,Maho,North Central,5146,2010,7156,205840,80400,286240
11/3/2024,Shanika Mahadeva,Polonnaruwa,Maho,North Central,2385,8614,10999,95400,344560,439960
11/4/2024,Shanika Mahadeva,Polonnaruwa,Maho,North Central,16,9281,9297,640,371240,371880
11/5/2024,Shanika Mahadeva,Polonnaruwa,Maho,North Central,8278,6038,14316,331120,241520,572640
11/6/2024,Shanika Mahadeva,Polonnaruwa,Maho,North Central,5333,6017,11350,213320,240680,454000
11/7/2024,Shanika Mahadeva,Polonnaruwa,Maho,North Central,4814,7995,12809,192560,319800,512360
11/8/2024,Shanika Mahadeva,Polonnaruwa,Maho,North Central,2948,2837,5785,117920,113480,231400
11/9/2024,Shanika Mahadeva,Polonnaruwa,Maho,North Central,810,4231,5041,32400,169240,201640
11/10/2024,Shanika Mahadeva,Polonnaruwa,Maho,North Central,8115,2524,10639,324600,100960,425560
11/11/2024,Shanika Mahadeva,Polonnaruwa,Maho,North Central,2947,311,3258,117880,12440,130320
11/12/2024,Shanika Mahadeva,Polonnaruwa,Maho,North Central,9052,9095,18147,362080,363800,725880
11/13/2024,Shanika Mahadeva,Polonnaruwa,Maho,North Central,195,1267,1462,7800,50680,58480
11/14/2024,Shanika Mahadeva,Polonnaruwa,Maho,North Central,1746,7900,9646,69840,316000,385840
11/15/2024,Shanika Mahadeva,Polonnaruwa,Maho,North Central,5896,1755,7651,235840,70200,306040
11/16/2024,Shanika Mahadeva,Polonnaruwa,Maho,North Central,5783,1946,7729,231320,77840,309160
11/17/2024,Shanika Mahadeva,Polonnaruwa,Maho,North Central,9135,7268,16403,365400,290720,656120
11/18/2024,Shanika Mahadeva,Polonnaruwa,Maho,North Central,5480,8418,13898,219200,336720,555920
11/19/2024,Shanika Mahadeva,Polonnaruwa,Maho,North Central,6810,6380,13190,272400,255200,527600
11/20/2024,Shanika Mahadeva,Polonnaruwa,Maho,North Central,8333,3715,12048,333320,148600,481920
11/21/2024,Shanika Mahadeva,Polonnaruwa,Maho,North Central,2702,9577,12279,108080,383080,491160
11/22/2024,Shanika Mahadeva,Polonnaruwa,Maho,North Central,8031,95,8126,321240,3800,325040
11/23/2024,Shanika Mahadeva,Polonnaruwa,Maho,North Central,3401,7523,10924,136040,300920,436960
11/24/2024,Shanika Mahadeva,Polonnaruwa,Maho,North Central,2310,5715,8025,92400,228600,321000
11/25/2024,Shanika Mahadeva,Polonnaruwa,Maho,North Central,2704,5289,7993,108160,211560,319720
11/26/2024,Shanika Mahadeva,Polonnaruwa,Maho,North Central,429,4246,4675,17160,169840,187000
11/27/2024,Shanika Mahadeva,Polonnaruwa,Maho,North Central,7490,5587,13077,299600,223480,523080
11/28/2024,Shanika Mahadeva,Polonnaruwa,Maho,North Central,9821,7238,17059,392840,289520,682360
11/29/2024,Shanika Mahadeva,Polonnaruwa,Maho,North Central,504,2166,2670,20160,86640,106800
11/30/2024,Shanika Mahadeva,Polonnaruwa,Maho,North Central,2364,1984,4348,94560,79360,173920
12/1/2024,Shanika Mahadeva,Polonnaruwa,Maho,North Central,852,288,1140,34080,11520,45600
12/2/2024,Shanika Mahadeva,Polonnaruwa,Maho,North Central,7346,4715,12061,293840,188600,482440
12/3/2024,Shanika Mahadeva,Polonnaruwa,Maho,North Central,6815,6914,13729,272600,276560,549160
12/4/2024,Shanika Mahadeva,Polonnaruwa,Maho,North Central,5273,2,5275,210920,80,211000
12/5/2024,Shanika Mahadeva,Polonnaruwa,Maho,North Central,5567,482,6049,222680,19280,241960
12/6/2024,Shanika Mahadeva,Polonnaruwa,Maho,North Central,4536,7174,11710,181440,286960,468400
12/7/2024,Shanika Mahadeva,Polonnaruwa,Maho,North Central,2464,4340,6804,98560,173600,272160
12/8/2024,Shanika Mahadeva,Polonnaruwa,Maho,North Central,9136,1631,10767,365440,65240,430680
12/9/2024,Shanika Mahadeva,Polonnaruwa,Maho,North Central,790,1705,2495,31600,68200,99800
12/10/2024,Shanika Mahadeva,Polonnaruwa,Maho,North Central,5665,8583,14248,226600,343320,569920
12/11/2024,Shanika Mahadeva,Polonnaruwa,Maho,North Central,5383,8007,13390,215320,320280,535600
12/12/2024,Shanika Mahadeva,Polonnaruwa,Maho,North Central,275,1136,1411,11000,45440,56440
12/13/2024,Shanika Mahadeva,Polonnaruwa,Maho,North Central,7517,7822,15339,300680,312880,613560
12/14/2024,Shanika Mahadeva,Polonnaruwa,Maho,North Central,9450,225,9675,378000,9000,387000
12/15/2024,Shanika Mahadeva,Polonnaruwa,Maho,North Central,1711,264,1975,68440,10560,79000
12/16/2024,Shanika Mahadeva,Polonnaruwa,Maho,North Central,5589,765,6354,223560,30600,254160
12/17/2024,Shanika Mahadeva,Polonnaruwa,Maho,North Central,7693,3770,11463,307720,150800,458520
12/18/2024,Shanika Mahadeva,Polonnaruwa,Maho,North Central,6468,190,6658,258720,7600,266320
12/19/2024,Shanika Mahadeva,Polonnaruwa,Maho,North Central,3094,7133,10227,123760,285320,409080
12/20/2024,Shanika Mahadeva,Polonnaruwa,Maho,North Central,278,1170,1448,11120,46800,57920
12/21/2024,Shanika Mahadeva,Polonnaruwa,Maho,North Central,1360,3177,4537,54400,127080,181480
12/22/2024,Shanika Mahadeva,Polonnaruwa,Maho,North Central,4739,3197,7936,189560,127880,317440
12/23/2024,Shanika Mahadeva,Polonnaruwa,Maho,North Central,3161,5542,8703,126440,221680,348120
12/24/2024,Shanika Mahadeva,Polonnaruwa,Maho,North Central,2376,144,2520,95040,5760,100800
12/25/2024,Shanika Mahadeva,Polonnaruwa,Maho,North Central,2448,7448,9896,97920,297920,395840
12/26/2024,Shanika Mahadeva,Polonnaruwa,Maho,North Central,3349,7298,10647,133960,291920,425880
12/27/2024,Shanika Mahadeva,Polonnaruwa,Maho,North Central,3488,2048,5536,139520,81920,221440
12/28/2024,Shanika Mahadeva,Polonnaruwa,Maho,North Central,4133,2177,6310,165320,87080,252400
12/29/2024,Shanika Mahadeva,Polonnaruwa,Maho,North Central,5826,4615,10441,233040,184600,417640
12/30/2024,Shanika Mahadeva,Polonnaruwa,Maho,North Central,581,9995,10576,23240,399800,423040
12/31/2024,Shanika Mahadeva,Polonnaruwa,Maho,North Central,4614,7903,12517,184560,316120,500680
1/1/2025,Shanika Mahadeva,Polonnaruwa,Maho,North Central,7429,2000,9429,297160,80000,377160
1/2/2025,Shanika Mahadeva,Polonnaruwa,Maho,North Central,1314,2520,3834,52560,100800,153360
1/3/2025,Shanika Mahadeva,Polonnaruwa,Maho,North Central,8548,34,8582,341920,1360,343280
1/4/2025,Shanika Mahadeva,Polonnaruwa,Maho,North Central,6885,7522,14407,275400,300880,576280
1/5/2025,Shanika Mahadeva,Polonnaruwa,Maho,North Central,6645,1553,8198,265800,62120,327920
1/6/2025,Shanika Mahadeva,Polonnaruwa,Maho,North Central,1879,1005,2884,75160,40200,115360
1/7/2025,Shanika Mahadeva,Polonnaruwa,Maho,North Central,6893,3667,10560,275720,146680,422400
1/8/2025,Shanika Mahadeva,Polonnaruwa,Maho,North Central,8882,8903,17785,355280,356120,711400
1/9/2025,Shanika Mahadeva,Polonnaruwa,Maho,North Central,9650,2690,12340,386000,107600,493600
1/10/2025,Shanika Mahadeva,Polonnaruwa,Maho,North Central,7357,2170,9527,294280,86800,381080
1/11/2025,Shanika Mahadeva,Polonnaruwa,Maho,North Central,3894,397,4291,155760,15880,171640
1/12/2025,Shanika Mahadeva,Polonnaruwa,Maho,North Central,7259,5903,13162,290360,236120,526480
1/13/2025,Shanika Mahadeva,Polonnaruwa,Maho,North Central,8322,3920,12242,332880,156800,489680
1/14/2025,Shanika Mahadeva,Polonnaruwa,Maho,North Central,9344,6968,16312,373760,278720,652480
1/15/2025,Shanika Mahadeva,Polonnaruwa,Maho,North Central,2508,4428,6936,100320,177120,277440
1/16/2025,Shanika Mahadeva,Polonnaruwa,Maho,North Central,8660,9384,18044,346400,375360,721760
1/17/2025,Shanika Mahadeva,Polonnaruwa,Maho,North Central,6324,3509,9833,252960,140360,393320
1/18/2025,Shanika Mahadeva,Polonnaruwa,Maho,North Central,7468,6413,13881,298720,256520,555240
1/19/2025,Shanika Mahadeva,Polonnaruwa,Maho,North Central,1186,2127,3313,47440,85080,132520
1/20/2025,Shanika Mahadeva,Polonnaruwa,Maho,North Central,713,7899,8612,28520,315960,344480
1/21/2025,Shanika Mahadeva,Polonnaruwa,Maho,North Central,8961,376,9337,358440,15040,373480
1/22/2025,Shanika Mahadeva,Polonnaruwa,Maho,North Central,52,7236,7288,2080,289440,291520
1/23/2025,Shanika Mahadeva,Polonnaruwa,Maho,North Central,3228,7515,10743,129120,300600,429720
1/24/2025,Shanika Mahadeva,Polonnaruwa,Maho,North Central,1187,4298,5485,47480,171920,219400
1/25/2025,Shanika Mahadeva,Polonnaruwa,Maho,North Central,343,8812,9155,13720,352480,366200
1/26/2025,Shanika Mahadeva,Polonnaruwa,Maho,North Central,3219,4810,8029,128760,192400,321160
1/27/2025,Shanika Mahadeva,Polonnaruwa,Maho,North Central,5751,5315,11066,230040,212600,442640
1/28/2025,Shanika Mahadeva,Polonnaruwa,Maho,North Central,1938,4695,6633,77520,187800,265320
1/29/2025,Shanika Mahadeva,Polonnaruwa,Maho,North Central,7906,9983,17889,316240,399320,715560
1/30/2025,Shanika Mahadeva,Polonnaruwa,Maho,North Central,444,8750,9194,17760,350000,367760
1/31/2025,Shanika Mahadeva,Polonnaruwa,Maho,North Central,6847,3517,10364,273880,140680,414560
2/1/2025,Shanika Mahadeva,Polonnaruwa,Maho,North Central,62,472,534,2480,18880,21360
2/2/2025,Shanika Mahadeva,Polonnaruwa,Maho,North Central,7265,872,8137,290600,34880,325480
2/3/2025,Shanika Mahadeva,Polonnaruwa,Maho,North Central,1693,8952,10645,67720,358080,425800
2/4/2025,Shanika Mahadeva,Polonnaruwa,Maho,North Central,6134,5363,11497,245360,214520,459880
2/5/2025,Shanika Mahadeva,Polonnaruwa,Maho,North Central,4765,8522,13287,190600,340880,531480
2/6/2025,Shanika Mahadeva,Polonnaruwa,Maho,North Central,2358,9054,11412,94320,362160,456480
2/7/2025,Shanika Mahadeva,Polonnaruwa,Maho,North Central,7576,6793,14369,303040,271720,574760
2/8/2025,Shanika Mahadeva,Polonnaruwa,Maho,North Central,4916,2690,7606,196640,107600,304240
2/9/2025,Shanika Mahadeva,Polonnaruwa,Maho,North Central,6451,1487,7938,258040,59480,317520
2/10/2025,Shanika Mahadeva,Polonnaruwa,Maho,North Central,6359,8182,14541,254360,327280,581640
2/11/2025,Shanika Mahadeva,Polonnaruwa,Maho,North Central,6538,3340,9878,261520,133600,395120
2/12/2025,Shanika Mahadeva,Polonnaruwa,Maho,North Central,435,7104,7539,17400,284160,301560
2/13/2025,Shanika Mahadeva,Polonnaruwa,Maho,North Central,6414,6985,13399,256560,279400,535960
2/14/2025,Shanika Mahadeva,Polonnaruwa,Maho,North Central,6003,7376,13379,240120,295040,535160
2/15/2025,Shanika Mahadeva,Polonnaruwa,Maho,North Central,9020,4244,13264,360800,169760,530560
2/16/2025,Shanika Mahadeva,Polonnaruwa,Maho,North Central,3897,4686,8583,155880,187440,343320
2/17/2025,Shanika Mahadeva,Polonnaruwa,Maho,North Central,5896,241,6137,235840,9640,245480
2/18/2025,Shanika Mahadeva,Polonnaruwa,Maho,North Central,6244,4249,10493,249760,169960,419720
2/19/2025,Shanika Mahadeva,Polonnaruwa,Maho,North Central,4402,180,4582,176080,7200,183280
2/20/2025,Shanika Mahadeva,Polonnaruwa,Maho,North Central,5211,9255,14466,208440,370200,578640
2/21/2025,Shanika Mahadeva,Polonnaruwa,Maho,North Central,6793,8512,15305,271720,340480,612200
2/22/2025,Shanika Mahadeva,Polonnaruwa,Maho,North Central,3503,9614,13117,140120,384560,524680
2/23/2025,Shanika Mahadeva,Polonnaruwa,Maho,North Central,6630,5814,12444,265200,232560,497760
2/24/2025,Shanika Mahadeva,Polonnaruwa,Maho,North Central,1828,7984,9812,73120,319360,392480
2/25/2025,Shanika Mahadeva,Polonnaruwa,Maho,North Central,3717,3027,6744,148680,121080,269760
2/26/2025,Shanika Mahadeva,Polonnaruwa,Maho,North Central,5165,1089,6254,206600,43560,250160
2/27/2025,Shanika Mahadeva,Polonnaruwa,Maho,North Central,6948,6583,13531,277920,263320,541240
2/28/2025,Shanika Mahadeva,Polonnaruwa,Maho,North Central,915,743,1658,36600,29720,66320
3/1/2025,Shanika Mahadeva,Polonnaruwa,Maho,North Central,2683,5723,8406,107320,228920,336240
3/2/2025,Shanika Mahadeva,Polonnaruwa,Maho,North Central,4814,7113,11927,192560,284520,477080
3/3/2025,Shanika Mahadeva,Polonnaruwa,Maho,North Central,9497,4193,13690,379880,167720,547600
3/4/2025,Shanika Mahadeva,Polonnaruwa,Maho,North Central,7750,3117,10867,310000,124680,434680
3/5/2025,Shanika Mahadeva,Polonnaruwa,Maho,North Central,4673,3687,8360,186920,147480,334400
3/6/2025,Shanika Mahadeva,Polonnaruwa,Maho,North Central,6368,9164,15532,254720,366560,621280
3/7/2025,Shanika Mahadeva,Polonnaruwa,Maho,North Central,2231,8137,10368,89240,325480,414720
3/8/2025,Shanika Mahadeva,Polonnaruwa,Maho,North Central,4089,2904,6993,163560,116160,279720
3/9/2025,Shanika Mahadeva,Polonnaruwa,Maho,North Central,8224,3764,11988,328960,150560,479520
3/10/2025,Shanika Mahadeva,Polonnaruwa,Maho,North Central,2314,6698,9012,92560,267920,360480
3/11/2025,Shanika Mahadeva,Polonnaruwa,Maho,North Central,9444,3927,13371,377760,157080,534840
3/12/2025,Shanika Mahadeva,Polonnaruwa,Maho,North Central,8803,8952,17755,352120,358080,710200
3/13/2025,Shanika Mahadeva,Polonnaruwa,Maho,North Central,4214,1392,5606,168560,55680,224240
3/14/2025,Shanika Mahadeva,Polonnaruwa,Maho,North Central,7570,5974,13544,302800,238960,541760
3/15/2025,Shanika Mahadeva,Polonnaruwa,Maho,North Central,5582,6367,11949,223280,254680,477960
3/16/2025,Shanika Mahadeva,Polonnaruwa,Maho,North Central,5484,6511,11995,219360,260440,479800
3/17/2025,Shanika Mahadeva,Polonnaruwa,Maho,North Central,3428,669,4097,137120,26760,163880
3/18/2025,Shanika Mahadeva,Polonnaruwa,Maho,North Central,853,5359,6212,34120,214360,248480
3/19/2025,Shanika Mahadeva,Polonnaruwa,Maho,North Central,2504,6679,9183,100160,267160,367320
3/20/2025,Shanika Mahadeva,Polonnaruwa,Maho,North Central,4465,5815,10280,178600,232600,411200
3/21/2025,Shanika Mahadeva,Polonnaruwa,Maho,North Central,2264,6828,9092,90560,273120,363680
3/22/2025,Shanika Mahadeva,Polonnaruwa,Maho,North Central,2096,569,2665,83840,22760,106600
3/23/2025,Shanika Mahadeva,Polonnaruwa,Maho,North Central,9830,4241,14071,393200,169640,562840
3/25/2024,Janitha Perera,Anuradhapura,Medawachchiya,North Central,4427,1482,5909,177080,59280,236360
3/26/2024,Janitha Perera,Anuradhapura,Medawachchiya,North Central,2976,2456,5432,119040,98240,217280
3/27/2024,Janitha Perera,Anuradhapura,Medawachchiya,North Central,1704,6501,8205,68160,260040,328200
3/28/2024,Janitha Perera,Anuradhapura,Medawachchiya,North Central,486,9728,10214,19440,389120,408560
3/29/2024,Janitha Perera,Anuradhapura,Medawachchiya,North Central,4018,1261,5279,160720,50440,211160
3/30/2024,Janitha Perera,Anuradhapura,Medawachchiya,North Central,5983,8150,14133,239320,326000,565320
3/31/2024,Janitha Perera,Anuradhapura,Medawachchiya,North Central,1943,9485,11428,77720,379400,457120
4/1/2024,Janitha Perera,Anuradhapura,Medawachchiya,North Central,780,4897,5677,31200,195880,227080
4/2/2024,Janitha Perera,Anuradhapura,Medawachchiya,North Central,6039,8234,14273,241560,329360,570920
4/3/2024,Janitha Perera,Anuradhapura,Medawachchiya,North Central,1920,4748,6668,76800,189920,266720
4/4/2024,Janitha Perera,Anuradhapura,Medawachchiya,North Central,7510,7441,14951,300400,297640,598040
4/5/2024,Janitha Perera,Anuradhapura,Medawachchiya,North Central,219,7306,7525,8760,292240,301000
4/6/2024,Janitha Perera,Anuradhapura,Medawachchiya,North Central,5663,8344,14007,226520,333760,560280
4/7/2024,Janitha Perera,Anuradhapura,Medawachchiya,North Central,5092,1058,6150,203680,42320,246000
4/8/2024,Janitha Perera,Anuradhapura,Medawachchiya,North Central,8622,4460,13082,344880,178400,523280
4/9/2024,Janitha Perera,Anuradhapura,Medawachchiya,North Central,7912,5208,13120,316480,208320,524800
4/10/2024,Janitha Perera,Anuradhapura,Medawachchiya,North Central,2096,7608,9704,83840,304320,388160
4/11/2024,Janitha Perera,Anuradhapura,Medawachchiya,North Central,6380,7940,14320,255200,317600,572800
4/19/2024,Janitha Perera,Anuradhapura,Medawachchiya,North Central,687,3919,4606,27480,156760,184240
4/20/2024,Janitha Perera,Anuradhapura,Medawachchiya,North Central,336,3472,3808,13440,138880,152320
4/21/2024,Janitha Perera,Anuradhapura,Medawachchiya,North Central,4874,4601,9475,194960,184040,379000
4/22/2024,Janitha Perera,Anuradhapura,Medawachchiya,North Central,6,8110,8116,240,324400,324640
4/23/2024,Janitha Perera,Anuradhapura,Medawachchiya,North Central,883,4973,5856,35320,198920,234240
4/24/2024,Janitha Perera,Anuradhapura,Medawachchiya,North Central,7752,2600,10352,310080,104000,414080
4/25/2024,Janitha Perera,Anuradhapura,Medawachchiya,North Central,9803,1860,11663,392120,74400,466520
4/26/2024,Janitha Perera,Anuradhapura,Medawachchiya,North Central,4948,1681,6629,197920,67240,265160
4/27/2024,Janitha Perera,Anuradhapura,Medawachchiya,North Central,3943,5109,9052,157720,204360,362080
4/28/2024,Janitha Perera,Anuradhapura,Medawachchiya,North Central,4138,4869,9007,165520,194760,360280
4/29/2024,Janitha Perera,Anuradhapura,Medawachchiya,North Central,8827,1105,9932,353080,44200,397280
4/30/2024,Janitha Perera,Anuradhapura,Medawachchiya,North Central,1393,7881,9274,55720,315240,370960
5/1/2024,Janitha Perera,Anuradhapura,Medawachchiya,North Central,2439,1757,4196,97560,70280,167840
5/2/2024,Janitha Perera,Anuradhapura,Medawachchiya,North Central,9768,7195,16963,390720,287800,678520
5/3/2024,Janitha Perera,Anuradhapura,Medawachchiya,North Central,719,4473,5192,28760,178920,207680
5/4/2024,Janitha Perera,Anuradhapura,Medawachchiya,North Central,3158,1159,4317,126320,46360,172680
5/5/2024,Janitha Perera,Anuradhapura,Medawachchiya,North Central,8584,673,9257,343360,26920,370280
5/6/2024,Janitha Perera,Anuradhapura,Medawachchiya,North Central,5214,632,5846,208560,25280,233840
5/7/2024,Janitha Perera,Anuradhapura,Medawachchiya,North Central,4478,740,5218,179120,29600,208720
5/8/2024,Janitha Perera,Anuradhapura,Medawachchiya,North Central,8481,5715,14196,339240,228600,567840
5/9/2024,Janitha Perera,Anuradhapura,Medawachchiya,North Central,3963,9580,13543,158520,383200,541720
5/10/2024,Janitha Perera,Anuradhapura,Medawachchiya,North Central,2152,4759,6911,86080,190360,276440
5/11/2024,Janitha Perera,Anuradhapura,Medawachchiya,North Central,5349,2832,8181,213960,113280,327240
5/12/2024,Janitha Perera,Anuradhapura,Medawachchiya,North Central,1755,709,2464,70200,28360,98560
5/13/2024,Janitha Perera,Anuradhapura,Medawachchiya,North Central,6108,1068,7176,244320,42720,287040
5/14/2024,Janitha Perera,Anuradhapura,Medawachchiya,North Central,1177,4446,5623,47080,177840,224920
5/15/2024,Janitha Perera,Anuradhapura,Medawachchiya,North Central,8559,1407,9966,342360,56280,398640
5/16/2024,Janitha Perera,Anuradhapura,Medawachchiya,North Central,7356,5949,13305,294240,237960,532200
5/17/2024,Janitha Perera,Anuradhapura,Medawachchiya,North Central,8966,9694,18660,358640,387760,746400
5/18/2024,Janitha Perera,Anuradhapura,Medawachchiya,North Central,5784,5889,11673,231360,235560,466920
5/19/2024,Janitha Perera,Anuradhapura,Medawachchiya,North Central,284,5275,5559,11360,211000,222360
5/20/2024,Janitha Perera,Anuradhapura,Medawachchiya,North Central,3881,4055,7936,155240,162200,317440
5/21/2024,Janitha Perera,Anuradhapura,Medawachchiya,North Central,9498,7070,16568,379920,282800,662720
5/22/2024,Janitha Perera,Anuradhapura,Medawachchiya,North Central,5881,3534,9415,235240,141360,376600
5/24/2024,Janitha Perera,Anuradhapura,Medawachchiya,North Central,7783,3806,11589,311320,152240,463560
5/25/2024,Janitha Perera,Anuradhapura,Medawachchiya,North Central,970,3534,4504,38800,141360,180160
5/26/2024,Janitha Perera,Anuradhapura,Medawachchiya,North Central,5581,4992,10573,223240,199680,422920
5/27/2024,Janitha Perera,Anuradhapura,Medawachchiya,North Central,8897,9870,18767,355880,394800,750680
5/28/2024,Janitha Perera,Anuradhapura,Medawachchiya,North Central,1716,1848,3564,68640,73920,142560
5/29/2024,Janitha Perera,Anuradhapura,Medawachchiya,North Central,1561,3319,4880,62440,132760,195200
5/30/2024,Janitha Perera,Anuradhapura,Medawachchiya,North Central,8606,2905,11511,344240,116200,460440
5/31/2024,Janitha Perera,Anuradhapura,Medawachchiya,North Central,2,9896,9898,80,395840,395920
6/1/2024,Janitha Perera,Anuradhapura,Medawachchiya,North Central,9144,9899,19043,365760,395960,761720
6/2/2024,Janitha Perera,Anuradhapura,Medawachchiya,North Central,8833,9304,18137,353320,372160,725480
6/3/2024,Janitha Perera,Anuradhapura,Medawachchiya,North Central,570,4269,4839,22800,170760,193560
6/4/2024,Janitha Perera,Anuradhapura,Medawachchiya,North Central,248,9189,9437,9920,367560,377480
6/5/2024,Janitha Perera,Anuradhapura,Medawachchiya,North Central,3376,6685,10061,135040,267400,402440
6/6/2024,Janitha Perera,Anuradhapura,Medawachchiya,North Central,8887,5400,14287,355480,216000,571480
6/7/2024,Janitha Perera,Anuradhapura,Medawachchiya,North Central,8776,5118,13894,351040,204720,555760
6/8/2024,Janitha Perera,Anuradhapura,Medawachchiya,North Central,7785,8670,16455,311400,346800,658200
6/9/2024,Janitha Perera,Anuradhapura,Medawachchiya,North Central,8794,5143,13937,351760,205720,557480
6/10/2024,Janitha Perera,Anuradhapura,Medawachchiya,North Central,6580,5268,11848,263200,210720,473920
6/11/2024,Janitha Perera,Anuradhapura,Medawachchiya,North Central,1487,9199,10686,59480,367960,427440
6/12/2024,Janitha Perera,Anuradhapura,Medawachchiya,North Central,5868,4209,10077,234720,168360,403080
6/13/2024,Janitha Perera,Anuradhapura,Medawachchiya,North Central,9239,1716,10955,369560,68640,438200
6/14/2024,Janitha Perera,Anuradhapura,Medawachchiya,North Central,4411,8137,12548,176440,325480,501920
6/15/2024,Janitha Perera,Anuradhapura,Medawachchiya,North Central,4909,6335,11244,196360,253400,449760
6/16/2024,Janitha Perera,Anuradhapura,Medawachchiya,North Central,1177,4989,6166,47080,199560,246640
6/17/2024,Janitha Perera,Anuradhapura,Medawachchiya,North Central,5340,9141,14481,213600,365640,579240
6/18/2024,Janitha Perera,Anuradhapura,Medawachchiya,North Central,3529,8655,12184,141160,346200,487360
6/19/2024,Janitha Perera,Anuradhapura,Medawachchiya,North Central,1947,2051,3998,77880,82040,159920
6/20/2024,Janitha Perera,Anuradhapura,Medawachchiya,North Central,4078,4314,8392,163120,172560,335680
6/21/2024,Janitha Perera,Anuradhapura,Medawachchiya,North Central,8251,4778,13029,330040,191120,521160
6/22/2024,Janitha Perera,Anuradhapura,Medawachchiya,North Central,6400,1817,8217,256000,72680,328680
6/23/2024,Janitha Perera,Anuradhapura,Medawachchiya,North Central,5080,2170,7250,203200,86800,290000
6/24/2024,Janitha Perera,Anuradhapura,Medawachchiya,North Central,4965,6755,11720,198600,270200,468800
6/25/2024,Janitha Perera,Anuradhapura,Medawachchiya,North Central,6999,8364,15363,279960,334560,614520
6/26/2024,Janitha Perera,Anuradhapura,Medawachchiya,North Central,7157,8355,15512,286280,334200,620480
6/27/2024,Janitha Perera,Anuradhapura,Medawachchiya,North Central,7690,9000,16690,307600,360000,667600
6/28/2024,Janitha Perera,Anuradhapura,Medawachchiya,North Central,6560,1073,7633,262400,42920,305320
6/29/2024,Janitha Perera,Anuradhapura,Medawachchiya,North Central,5110,4615,9725,204400,184600,389000
6/30/2024,Janitha Perera,Anuradhapura,Medawachchiya,North Central,4036,3313,7349,161440,132520,293960
7/1/2024,Janitha Perera,Anuradhapura,Medawachchiya,North Central,1892,7559,9451,75680,302360,378040
7/2/2024,Janitha Perera,Anuradhapura,Medawachchiya,North Central,3659,5816,9475,146360,232640,379000
7/3/2024,Janitha Perera,Anuradhapura,Medawachchiya,North Central,8729,8262,16991,349160,330480,679640
7/4/2024,Janitha Perera,Anuradhapura,Medawachchiya,North Central,8048,3725,11773,321920,149000,470920
7/5/2024,Janitha Perera,Anuradhapura,Medawachchiya,North Central,3666,6821,10487,146640,272840,419480
7/6/2024,Janitha Perera,Anuradhapura,Medawachchiya,North Central,2399,2662,5061,95960,106480,202440
7/7/2024,Janitha Perera,Anuradhapura,Medawachchiya,North Central,6784,9498,16282,271360,379920,651280
7/8/2024,Janitha Perera,Anuradhapura,Medawachchiya,North Central,3266,4212,7478,130640,168480,299120
7/9/2024,Janitha Perera,Anuradhapura,Medawachchiya,North Central,3930,1538,5468,157200,61520,218720
7/10/2024,Janitha Perera,Anuradhapura,Medawachchiya,North Central,7076,4396,11472,283040,175840,458880
7/11/2024,Janitha Perera,Anuradhapura,Medawachchiya,North Central,4634,3639,8273,185360,145560,330920
7/12/2024,Janitha Perera,Anuradhapura,Medawachchiya,North Central,3386,5635,9021,135440,225400,360840
7/13/2024,Janitha Perera,Anuradhapura,Medawachchiya,North Central,5542,8105,13647,221680,324200,545880
7/14/2024,Janitha Perera,Anuradhapura,Medawachchiya,North Central,9684,8674,18358,387360,346960,734320
7/15/2024,Janitha Perera,Anuradhapura,Medawachchiya,North Central,7516,2159,9675,300640,86360,387000
7/16/2024,Janitha Perera,Anuradhapura,Medawachchiya,North Central,6119,4330,10449,244760,173200,417960
7/17/2024,Janitha Perera,Anuradhapura,Medawachchiya,North Central,8240,6445,14685,329600,257800,587400
7/18/2024,Janitha Perera,Anuradhapura,Medawachchiya,North Central,9064,3021,12085,362560,120840,483400
7/19/2024,Janitha Perera,Anuradhapura,Medawachchiya,North Central,603,4473,5076,24120,178920,203040
7/20/2024,Janitha Perera,Anuradhapura,Medawachchiya,North Central,6555,6915,13470,262200,276600,538800
7/21/2024,Janitha Perera,Anuradhapura,Medawachchiya,North Central,5580,6556,12136,223200,262240,485440
7/22/2024,Janitha Perera,Anuradhapura,Medawachchiya,North Central,4011,7416,11427,160440,296640,457080
7/23/2024,Janitha Perera,Anuradhapura,Medawachchiya,North Central,2546,8685,11231,101840,347400,449240
7/24/2024,Janitha Perera,Anuradhapura,Medawachchiya,North Central,6251,5629,11880,250040,225160,475200
7/25/2024,Janitha Perera,Anuradhapura,Medawachchiya,North Central,2154,3141,5295,86160,125640,211800
7/26/2024,Janitha Perera,Anuradhapura,Medawachchiya,North Central,1637,1959,3596,65480,78360,143840
7/27/2024,Janitha Perera,Anuradhapura,Medawachchiya,North Central,4084,8821,12905,163360,352840,516200
7/28/2024,Janitha Perera,Anuradhapura,Medawachchiya,North Central,8766,1934,10700,350640,77360,428000
7/29/2024,Janitha Perera,Anuradhapura,Medawachchiya,North Central,2591,8632,11223,103640,345280,448920
7/30/2024,Janitha Perera,Anuradhapura,Medawachchiya,North Central,3692,685,4377,147680,27400,175080
7/31/2024,Janitha Perera,Anuradhapura,Medawachchiya,North Central,1616,798,2414,64640,31920,96560
8/1/2024,Janitha Perera,Anuradhapura,Medawachchiya,North Central,6584,8808,15392,263360,352320,615680
8/2/2024,Janitha Perera,Anuradhapura,Medawachchiya,North Central,8196,4460,12656,327840,178400,506240
8/3/2024,Janitha Perera,Anuradhapura,Medawachchiya,North Central,6207,1270,7477,248280,50800,299080
8/4/2024,Janitha Perera,Anuradhapura,Medawachchiya,North Central,8458,7115,15573,338320,284600,622920
8/5/2024,Janitha Perera,Anuradhapura,Medawachchiya,North Central,3785,1111,4896,151400,44440,195840
8/6/2024,Janitha Perera,Anuradhapura,Medawachchiya,North Central,257,1498,1755,10280,59920,70200
8/7/2024,Janitha Perera,Anuradhapura,Medawachchiya,North Central,2844,5617,8461,113760,224680,338440
8/8/2024,Janitha Perera,Anuradhapura,Medawachchiya,North Central,3024,8756,11780,120960,350240,471200
8/9/2024,Janitha Perera,Anuradhapura,Medawachchiya,North Central,7445,5581,13026,297800,223240,521040
8/10/2024,Janitha Perera,Anuradhapura,Medawachchiya,North Central,3509,9861,13370,140360,394440,534800
8/11/2024,Janitha Perera,Anuradhapura,Medawachchiya,North Central,392,7857,8249,15680,314280,329960
8/12/2024,Janitha Perera,Anuradhapura,Medawachchiya,North Central,1336,2359,3695,53440,94360,147800
8/13/2024,Janitha Perera,Anuradhapura,Medawachchiya,North Central,7848,1387,9235,313920,55480,369400
8/14/2024,Janitha Perera,Anuradhapura,Medawachchiya,North Central,5965,8119,14084,238600,324760,563360
8/15/2024,Janitha Perera,Anuradhapura,Medawachchiya,North Central,220,7163,7383,8800,286520,295320
8/16/2024,Janitha Perera,Anuradhapura,Medawachchiya,North Central,4965,9167,14132,198600,366680,565280
8/17/2024,Janitha Perera,Anuradhapura,Medawachchiya,North Central,317,897,1214,12680,35880,48560
8/18/2024,Janitha Perera,Anuradhapura,Medawachchiya,North Central,5909,6050,11959,236360,242000,478360
8/19/2024,Janitha Perera,Anuradhapura,Medawachchiya,North Central,8293,1072,9365,331720,42880,374600
8/20/2024,Janitha Perera,Anuradhapura,Medawachchiya,North Central,4344,7596,11940,173760,303840,477600
8/21/2024,Janitha Perera,Anuradhapura,Medawachchiya,North Central,7385,2623,10008,295400,104920,400320
8/22/2024,Janitha Perera,Anuradhapura,Medawachchiya,North Central,4477,4037,8514,179080,161480,340560
8/23/2024,Janitha Perera,Anuradhapura,Medawachchiya,North Central,6248,5380,11628,249920,215200,465120
8/24/2024,Janitha Perera,Anuradhapura,Medawachchiya,North Central,2487,7104,9591,99480,284160,383640
8/25/2024,Janitha Perera,Anuradhapura,Medawachchiya,North Central,4388,9707,14095,175520,388280,563800
8/26/2024,Janitha Perera,Anuradhapura,Medawachchiya,North Central,3264,9753,13017,130560,390120,520680
8/27/2024,Janitha Perera,Anuradhapura,Medawachchiya,North Central,3068,5125,8193,122720,205000,327720
8/28/2024,Janitha Perera,Anuradhapura,Medawachchiya,North Central,5773,1581,7354,230920,63240,294160
8/29/2024,Janitha Perera,Anuradhapura,Medawachchiya,North Central,813,506,1319,32520,20240,52760
8/30/2024,Janitha Perera,Anuradhapura,Medawachchiya,North Central,8790,5478,14268,351600,219120,570720
8/31/2024,Janitha Perera,Anuradhapura,Medawachchiya,North Central,3383,9734,13117,135320,389360,524680
9/1/2024,Janitha Perera,Anuradhapura,Medawachchiya,North Central,4020,295,4315,160800,11800,172600
9/2/2024,Janitha Perera,Anuradhapura,Medawachchiya,North Central,1337,2493,3830,53480,99720,153200
9/3/2024,Janitha Perera,Anuradhapura,Medawachchiya,North Central,6604,3572,10176,264160,142880,407040
9/4/2024,Janitha Perera,Anuradhapura,Medawachchiya,North Central,3149,8260,11409,125960,330400,456360
9/5/2024,Janitha Perera,Anuradhapura,Medawachchiya,North Central,2173,1783,3956,86920,71320,158240
9/6/2024,Janitha Perera,Anuradhapura,Medawachchiya,North Central,8013,6020,14033,320520,240800,561320
9/7/2024,Janitha Perera,Anuradhapura,Medawachchiya,North Central,3842,9938,13780,153680,397520,551200
9/8/2024,Janitha Perera,Anuradhapura,Medawachchiya,North Central,6436,8049,14485,257440,321960,579400
9/9/2024,Janitha Perera,Anuradhapura,Medawachchiya,North Central,1972,6797,8769,78880,271880,350760
9/10/2024,Janitha Perera,Anuradhapura,Medawachchiya,North Central,8816,8569,17385,352640,342760,695400
9/11/2024,Janitha Perera,Anuradhapura,Medawachchiya,North Central,7837,5657,13494,313480,226280,539760
9/12/2024,Janitha Perera,Anuradhapura,Medawachchiya,North Central,3690,7304,10994,147600,292160,439760
9/13/2024,Janitha Perera,Anuradhapura,Medawachchiya,North Central,5769,7440,13209,230760,297600,528360
9/14/2024,Janitha Perera,Anuradhapura,Medawachchiya,North Central,5686,4369,10055,227440,174760,402200
9/15/2024,Janitha Perera,Anuradhapura,Medawachchiya,North Central,9601,9138,18739,384040,365520,749560
9/16/2024,Janitha Perera,Anuradhapura,Medawachchiya,North Central,942,4256,5198,37680,170240,207920
9/17/2024,Janitha Perera,Anuradhapura,Medawachchiya,North Central,492,8310,8802,19680,332400,352080
9/18/2024,Janitha Perera,Anuradhapura,Medawachchiya,North Central,9913,7066,16979,396520,282640,679160
9/19/2024,Janitha Perera,Anuradhapura,Medawachchiya,North Central,2590,7314,9904,103600,292560,396160
9/20/2024,Janitha Perera,Anuradhapura,Medawachchiya,North Central,200,7765,7965,8000,310600,318600
9/21/2024,Janitha Perera,Anuradhapura,Medawachchiya,North Central,1130,5699,6829,45200,227960,273160
9/22/2024,Janitha Perera,Anuradhapura,Medawachchiya,North Central,525,6658,7183,21000,266320,287320
9/23/2024,Janitha Perera,Anuradhapura,Medawachchiya,North Central,2718,3223,5941,108720,128920,237640
9/24/2024,Janitha Perera,Anuradhapura,Medawachchiya,North Central,9524,6124,15648,380960,244960,625920
9/25/2024,Janitha Perera,Anuradhapura,Medawachchiya,North Central,3090,4162,7252,123600,166480,290080
9/26/2024,Janitha Perera,Anuradhapura,Medawachchiya,North Central,3129,6244,9373,125160,249760,374920
9/27/2024,Janitha Perera,Anuradhapura,Medawachchiya,North Central,4712,4042,8754,188480,161680,350160
9/28/2024,Janitha Perera,Anuradhapura,Medawachchiya,North Central,8699,4598,13297,347960,183920,531880
9/29/2024,Janitha Perera,Anuradhapura,Medawachchiya,North Central,8466,3853,12319,338640,154120,492760
9/30/2024,Janitha Perera,Anuradhapura,Medawachchiya,North Central,2046,9522,11568,81840,380880,462720
10/1/2024,Janitha Perera,Anuradhapura,Medawachchiya,North Central,5156,5051,10207,206240,202040,408280
10/2/2024,Janitha Perera,Anuradhapura,Medawachchiya,North Central,500,7061,7561,20000,282440,302440
10/3/2024,Janitha Perera,Anuradhapura,Medawachchiya,North Central,5167,964,6131,206680,38560,245240
10/4/2024,Janitha Perera,Anuradhapura,Medawachchiya,North Central,1052,1094,2146,42080,43760,85840
10/5/2024,Janitha Perera,Anuradhapura,Medawachchiya,North Central,424,8815,9239,16960,352600,369560
10/6/2024,Janitha Perera,Anuradhapura,Medawachchiya,North Central,6316,4774,11090,252640,190960,443600
10/7/2024,Janitha Perera,Anuradhapura,Medawachchiya,North Central,6751,9454,16205,270040,378160,648200
10/8/2024,Janitha Perera,Anuradhapura,Medawachchiya,North Central,1653,781,2434,66120,31240,97360
10/9/2024,Janitha Perera,Anuradhapura,Medawachchiya,North Central,2628,9798,12426,105120,391920,497040
10/10/2024,Janitha Perera,Anuradhapura,Medawachchiya,North Central,2968,5539,8507,118720,221560,340280
10/11/2024,Janitha Perera,Anuradhapura,Medawachchiya,North Central,1817,203,2020,72680,8120,80800
10/12/2024,Janitha Perera,Anuradhapura,Medawachchiya,North Central,9198,4813,14011,367920,192520,560440
10/13/2024,Janitha Perera,Anuradhapura,Medawachchiya,North Central,5171,8694,13865,206840,347760,554600
10/14/2024,Janitha Perera,Anuradhapura,Medawachchiya,North Central,9604,4294,13898,384160,171760,555920
10/15/2024,Janitha Perera,Anuradhapura,Medawachchiya,North Central,5823,3170,8993,232920,126800,359720
10/16/2024,Janitha Perera,Anuradhapura,Medawachchiya,North Central,2393,1195,3588,95720,47800,143520
10/17/2024,Janitha Perera,Anuradhapura,Medawachchiya,North Central,9208,8367,17575,368320,334680,703000
10/18/2024,Janitha Perera,Anuradhapura,Medawachchiya,North Central,5950,6933,12883,238000,277320,515320
10/19/2024,Janitha Perera,Anuradhapura,Medawachchiya,North Central,5674,9379,15053,226960,375160,602120
10/20/2024,Janitha Perera,Anuradhapura,Medawachchiya,North Central,2551,4683,7234,102040,187320,289360
10/21/2024,Janitha Perera,Anuradhapura,Medawachchiya,North Central,7904,2015,9919,316160,80600,396760
10/22/2024,Janitha Perera,Anuradhapura,Medawachchiya,North Central,4818,8463,13281,192720,338520,531240
10/23/2024,Janitha Perera,Anuradhapura,Medawachchiya,North Central,2873,1003,3876,114920,40120,155040
10/24/2024,Janitha Perera,Anuradhapura,Medawachchiya,North Central,2923,5471,8394,116920,218840,335760
10/25/2024,Janitha Perera,Anuradhapura,Medawachchiya,North Central,2904,4145,7049,116160,165800,281960
10/26/2024,Janitha Perera,Anuradhapura,Medawachchiya,North Central,9510,9142,18652,380400,365680,746080
10/27/2024,Janitha Perera,Anuradhapura,Medawachchiya,North Central,6143,6868,13011,245720,274720,520440
10/28/2024,Janitha Perera,Anuradhapura,Medawachchiya,North Central,309,6420,6729,12360,256800,269160
10/29/2024,Janitha Perera,Anuradhapura,Medawachchiya,North Central,6373,2697,9070,254920,107880,362800
10/30/2024,Janitha Perera,Anuradhapura,Medawachchiya,North Central,5719,7881,13600,228760,315240,544000
10/31/2024,Janitha Perera,Anuradhapura,Medawachchiya,North Central,1666,7510,9176,66640,300400,367040
11/1/2024,Janitha Perera,Anuradhapura,Medawachchiya,North Central,3582,8067,11649,143280,322680,465960
11/2/2024,Janitha Perera,Anuradhapura,Medawachchiya,North Central,6509,2001,8510,260360,80040,340400
11/3/2024,Janitha Perera,Anuradhapura,Medawachchiya,North Central,8046,6652,14698,321840,266080,587920
11/4/2024,Janitha Perera,Anuradhapura,Medawachchiya,North Central,8956,1149,10105,358240,45960,404200
11/5/2024,Janitha Perera,Anuradhapura,Medawachchiya,North Central,7513,4579,12092,300520,183160,483680
11/6/2024,Janitha Perera,Anuradhapura,Medawachchiya,North Central,4776,5259,10035,191040,210360,401400
11/7/2024,Janitha Perera,Anuradhapura,Medawachchiya,North Central,4374,9190,13564,174960,367600,542560
11/8/2024,Janitha Perera,Anuradhapura,Medawachchiya,North Central,5815,3664,9479,232600,146560,379160
11/9/2024,Janitha Perera,Anuradhapura,Medawachchiya,North Central,4981,6521,11502,199240,260840,460080
11/10/2024,Janitha Perera,Anuradhapura,Medawachchiya,North Central,7085,6538,13623,283400,261520,544920
11/11/2024,Janitha Perera,Anuradhapura,Medawachchiya,North Central,1022,8500,9522,40880,340000,380880
11/12/2024,Janitha Perera,Anuradhapura,Medawachchiya,North Central,1173,9832,11005,46920,393280,440200
11/13/2024,Janitha Perera,Anuradhapura,Medawachchiya,North Central,3729,5323,9052,149160,212920,362080
11/14/2024,Janitha Perera,Anuradhapura,Medawachchiya,North Central,2276,9726,12002,91040,389040,480080
11/15/2024,Janitha Perera,Anuradhapura,Medawachchiya,North Central,4275,2988,7263,171000,119520,290520
11/16/2024,Janitha Perera,Anuradhapura,Medawachchiya,North Central,3231,5085,8316,129240,203400,332640
11/17/2024,Janitha Perera,Anuradhapura,Medawachchiya,North Central,167,2010,2177,6680,80400,87080
11/18/2024,Janitha Perera,Anuradhapura,Medawachchiya,North Central,8358,2672,11030,334320,106880,441200
11/19/2024,Janitha Perera,Anuradhapura,Medawachchiya,North Central,6335,6540,12875,253400,261600,515000
11/20/2024,Janitha Perera,Anuradhapura,Medawachchiya,North Central,2993,1608,4601,119720,64320,184040
11/21/2024,Janitha Perera,Anuradhapura,Medawachchiya,North Central,6384,4389,10773,255360,175560,430920
11/22/2024,Janitha Perera,Anuradhapura,Medawachchiya,North Central,313,4669,4982,12520,186760,199280
11/23/2024,Janitha Perera,Anuradhapura,Medawachchiya,North Central,9798,6064,15862,391920,242560,634480
11/24/2024,Janitha Perera,Anuradhapura,Medawachchiya,North Central,7839,8674,16513,313560,346960,660520
11/25/2024,Janitha Perera,Anuradhapura,Medawachchiya,North Central,6554,2876,9430,262160,115040,377200
11/26/2024,Janitha Perera,Anuradhapura,Medawachchiya,North Central,862,5353,6215,34480,214120,248600
11/27/2024,Janitha Perera,Anuradhapura,Medawachchiya,North Central,2928,6047,8975,117120,241880,359000
11/28/2024,Janitha Perera,Anuradhapura,Medawachchiya,North Central,3543,6884,10427,141720,275360,417080
11/29/2024,Janitha Perera,Anuradhapura,Medawachchiya,North Central,185,6504,6689,7400,260160,267560
11/30/2024,Janitha Perera,Anuradhapura,Medawachchiya,North Central,9449,9167,18616,377960,366680,744640
12/1/2024,Janitha Perera,Anuradhapura,Medawachchiya,North Central,3532,3963,7495,141280,158520,299800
12/2/2024,Janitha Perera,Anuradhapura,Medawachchiya,North Central,41,229,270,1640,9160,10800
12/3/2024,Janitha Perera,Anuradhapura,Medawachchiya,North Central,6222,2521,8743,248880,100840,349720
12/4/2024,Janitha Perera,Anuradhapura,Medawachchiya,North Central,3539,3239,6778,141560,129560,271120
12/5/2024,Janitha Perera,Anuradhapura,Medawachchiya,North Central,7079,3119,10198,283160,124760,407920
12/6/2024,Janitha Perera,Anuradhapura,Medawachchiya,North Central,1212,8136,9348,48480,325440,373920
12/7/2024,Janitha Perera,Anuradhapura,Medawachchiya,North Central,936,9678,10614,37440,387120,424560
12/8/2024,Janitha Perera,Anuradhapura,Medawachchiya,North Central,507,4799,5306,20280,191960,212240
12/9/2024,Janitha Perera,Anuradhapura,Medawachchiya,North Central,7335,2109,9444,293400,84360,377760
12/10/2024,Janitha Perera,Anuradhapura,Medawachchiya,North Central,6266,8008,14274,250640,320320,570960
12/11/2024,Janitha Perera,Anuradhapura,Medawachchiya,North Central,2487,5867,8354,99480,234680,334160
12/12/2024,Janitha Perera,Anuradhapura,Medawachchiya,North Central,5984,153,6137,239360,6120,245480
12/13/2024,Janitha Perera,Anuradhapura,Medawachchiya,North Central,8011,2084,10095,320440,83360,403800
12/14/2024,Janitha Perera,Anuradhapura,Medawachchiya,North Central,8630,5611,14241,345200,224440,569640
12/15/2024,Janitha Perera,Anuradhapura,Medawachchiya,North Central,8461,3460,11921,338440,138400,476840
12/16/2024,Janitha Perera,Anuradhapura,Medawachchiya,North Central,1017,3912,4929,40680,156480,197160
12/17/2024,Janitha Perera,Anuradhapura,Medawachchiya,North Central,9595,6419,16014,383800,256760,640560
12/18/2024,Janitha Perera,Anuradhapura,Medawachchiya,North Central,5046,8692,13738,201840,347680,549520
12/19/2024,Janitha Perera,Anuradhapura,Medawachchiya,North Central,9540,2648,12188,381600,105920,487520
12/20/2024,Janitha Perera,Anuradhapura,Medawachchiya,North Central,9047,238,9285,361880,9520,371400
12/21/2024,Janitha Perera,Anuradhapura,Medawachchiya,North Central,8200,8458,16658,328000,338320,666320
12/22/2024,Janitha Perera,Anuradhapura,Medawachchiya,North Central,8316,367,8683,332640,14680,347320
12/23/2024,Janitha Perera,Anuradhapura,Medawachchiya,North Central,3042,7415,10457,121680,296600,418280
12/24/2024,Janitha Perera,Anuradhapura,Medawachchiya,North Central,6603,4041,10644,264120,161640,425760
12/25/2024,Janitha Perera,Anuradhapura,Medawachchiya,North Central,4333,255,4588,173320,10200,183520
12/26/2024,Janitha Perera,Anuradhapura,Medawachchiya,North Central,6830,2149,8979,273200,85960,359160
12/27/2024,Janitha Perera,Anuradhapura,Medawachchiya,North Central,8412,2087,10499,336480,83480,419960
12/28/2024,Janitha Perera,Anuradhapura,Medawachchiya,North Central,1077,1290,2367,43080,51600,94680
12/29/2024,Janitha Perera,Anuradhapura,Medawachchiya,North Central,191,9785,9976,7640,391400,399040
12/30/2024,Janitha Perera,Anuradhapura,Medawachchiya,North Central,8306,5704,14010,332240,228160,560400
12/31/2024,Janitha Perera,Anuradhapura,Medawachchiya,North Central,7021,1599,8620,280840,63960,344800
1/1/2025,Janitha Perera,Anuradhapura,Medawachchiya,North Central,4635,2856,7491,185400,114240,299640
1/2/2025,Janitha Perera,Anuradhapura,Medawachchiya,North Central,8668,630,9298,346720,25200,371920
1/3/2025,Janitha Perera,Anuradhapura,Medawachchiya,North Central,8245,1801,10046,329800,72040,401840
1/4/2025,Janitha Perera,Anuradhapura,Medawachchiya,North Central,5926,2214,8140,237040,88560,325600
1/5/2025,Janitha Perera,Anuradhapura,Medawachchiya,North Central,4935,1920,6855,197400,76800,274200
1/6/2025,Janitha Perera,Anuradhapura,Medawachchiya,North Central,2874,2217,5091,114960,88680,203640
1/7/2025,Janitha Perera,Anuradhapura,Medawachchiya,North Central,9991,2382,12373,399640,95280,494920
1/8/2025,Janitha Perera,Anuradhapura,Medawachchiya,North Central,9696,426,10122,387840,17040,404880
1/9/2025,Janitha Perera,Anuradhapura,Medawachchiya,North Central,2761,5752,8513,110440,230080,340520
1/10/2025,Janitha Perera,Anuradhapura,Medawachchiya,North Central,5206,3388,8594,208240,135520,343760
1/11/2025,Janitha Perera,Anuradhapura,Medawachchiya,North Central,2014,3373,5387,80560,134920,215480
1/12/2025,Janitha Perera,Anuradhapura,Medawachchiya,North Central,4193,9127,13320,167720,365080,532800
1/13/2025,Janitha Perera,Anuradhapura,Medawachchiya,North Central,6742,5223,11965,269680,208920,478600
1/14/2025,Janitha Perera,Anuradhapura,Medawachchiya,North Central,9785,3817,13602,391400,152680,544080
1/15/2025,Janitha Perera,Anuradhapura,Medawachchiya,North Central,8897,7974,16871,355880,318960,674840
1/16/2025,Janitha Perera,Anuradhapura,Medawachchiya,North Central,9205,1054,10259,368200,42160,410360
1/17/2025,Janitha Perera,Anuradhapura,Medawachchiya,North Central,134,3188,3322,5360,127520,132880
1/18/2025,Janitha Perera,Anuradhapura,Medawachchiya,North Central,7120,5539,12659,284800,221560,506360
1/19/2025,Janitha Perera,Anuradhapura,Medawachchiya,North Central,217,883,1100,8680,35320,44000
1/20/2025,Janitha Perera,Anuradhapura,Medawachchiya,North Central,8427,4349,12776,337080,173960,511040
1/21/2025,Janitha Perera,Anuradhapura,Medawachchiya,North Central,1906,6495,8401,76240,259800,336040
1/22/2025,Janitha Perera,Anuradhapura,Medawachchiya,North Central,1224,4949,6173,48960,197960,246920
1/23/2025,Janitha Perera,Anuradhapura,Medawachchiya,North Central,7176,3336,10512,287040,133440,420480
1/24/2025,Janitha Perera,Anuradhapura,Medawachchiya,North Central,3258,4514,7772,130320,180560,310880
1/25/2025,Janitha Perera,Anuradhapura,Medawachchiya,North Central,9776,9218,18994,391040,368720,759760
1/26/2025,Janitha Perera,Anuradhapura,Medawachchiya,North Central,5776,4100,9876,231040,164000,395040
1/27/2025,Janitha Perera,Anuradhapura,Medawachchiya,North Central,6193,9254,15447,247720,370160,617880
1/28/2025,Janitha Perera,Anuradhapura,Medawachchiya,North Central,1131,2329,3460,45240,93160,138400
1/29/2025,Janitha Perera,Anuradhapura,Medawachchiya,North Central,4827,2524,7351,193080,100960,294040
1/30/2025,Janitha Perera,Anuradhapura,Medawachchiya,North Central,527,7766,8293,21080,310640,331720
1/31/2025,Janitha Perera,Anuradhapura,Medawachchiya,North Central,7980,2728,10708,319200,109120,428320
2/1/2025,Janitha Perera,Anuradhapura,Medawachchiya,North Central,3883,1891,5774,155320,75640,230960
2/2/2025,Janitha Perera,Anuradhapura,Medawachchiya,North Central,4737,7548,12285,189480,301920,491400
2/3/2025,Janitha Perera,Anuradhapura,Medawachchiya,North Central,9817,9935,19752,392680,397400,790080
2/4/2025,Janitha Perera,Anuradhapura,Medawachchiya,North Central,4600,1144,5744,184000,45760,229760
2/5/2025,Janitha Perera,Anuradhapura,Medawachchiya,North Central,4599,9071,13670,183960,362840,546800
2/6/2025,Janitha Perera,Anuradhapura,Medawachchiya,North Central,2887,6625,9512,115480,265000,380480
2/7/2025,Janitha Perera,Anuradhapura,Medawachchiya,North Central,4779,6990,11769,191160,279600,470760
2/8/2025,Janitha Perera,Anuradhapura,Medawachchiya,North Central,1271,669,1940,50840,26760,77600
2/9/2025,Janitha Perera,Anuradhapura,Medawachchiya,North Central,2457,1153,3610,98280,46120,144400
2/10/2025,Janitha Perera,Anuradhapura,Medawachchiya,North Central,1036,6900,7936,41440,276000,317440
2/11/2025,Janitha Perera,Anuradhapura,Medawachchiya,North Central,1288,2918,4206,51520,116720,168240
2/12/2025,Janitha Perera,Anuradhapura,Medawachchiya,North Central,5429,8868,14297,217160,354720,571880
2/13/2025,Janitha Perera,Anuradhapura,Medawachchiya,North Central,633,8189,8822,25320,327560,352880
2/14/2025,Janitha Perera,Anuradhapura,Medawachchiya,North Central,5110,9587,14697,204400,383480,587880
2/15/2025,Janitha Perera,Anuradhapura,Medawachchiya,North Central,3400,9681,13081,136000,387240,523240
2/16/2025,Janitha Perera,Anuradhapura,Medawachchiya,North Central,1875,1673,3548,75000,66920,141920
2/17/2025,Janitha Perera,Anuradhapura,Medawachchiya,North Central,5600,2337,7937,224000,93480,317480
2/18/2025,Janitha Perera,Anuradhapura,Medawachchiya,North Central,5271,1842,7113,210840,73680,284520
2/19/2025,Janitha Perera,Anuradhapura,Medawachchiya,North Central,7099,8634,15733,283960,345360,629320
2/20/2025,Janitha Perera,Anuradhapura,Medawachchiya,North Central,6579,917,7496,263160,36680,299840
2/21/2025,Janitha Perera,Anuradhapura,Medawachchiya,North Central,7589,4856,12445,303560,194240,497800
2/22/2025,Janitha Perera,Anuradhapura,Medawachchiya,North Central,6842,2829,9671,273680,113160,386840
2/23/2025,Janitha Perera,Anuradhapura,Medawachchiya,North Central,3839,6744,10583,153560,269760,423320
2/24/2025,Janitha Perera,Anuradhapura,Medawachchiya,North Central,6688,3872,10560,267520,154880,422400
2/25/2025,Janitha Perera,Anuradhapura,Medawachchiya,North Central,1354,6778,8132,54160,271120,325280
2/26/2025,Janitha Perera,Anuradhapura,Medawachchiya,North Central,2211,452,2663,88440,18080,106520
2/27/2025,Janitha Perera,Anuradhapura,Medawachchiya,North Central,5324,4457,9781,212960,178280,391240
2/28/2025,Janitha Perera,Anuradhapura,Medawachchiya,North Central,3899,2831,6730,155960,113240,269200
3/1/2025,Janitha Perera,Anuradhapura,Medawachchiya,North Central,7579,2075,9654,303160,83000,386160
3/2/2025,Janitha Perera,Anuradhapura,Medawachchiya,North Central,3960,299,4259,158400,11960,170360
3/3/2025,Janitha Perera,Anuradhapura,Medawachchiya,North Central,1468,1376,2844,58720,55040,113760
3/4/2025,Janitha Perera,Anuradhapura,Medawachchiya,North Central,2246,9506,11752,89840,380240,470080
3/5/2025,Janitha Perera,Anuradhapura,Medawachchiya,North Central,3628,7031,10659,145120,281240,426360
3/6/2025,Janitha Perera,Anuradhapura,Medawachchiya,North Central,9050,8734,17784,362000,349360,711360
3/7/2025,Janitha Perera,Anuradhapura,Medawachchiya,North Central,7455,520,7975,298200,20800,319000
3/8/2025,Janitha Perera,Anuradhapura,Medawachchiya,North Central,4847,1872,6719,193880,74880,268760
3/9/2025,Janitha Perera,Anuradhapura,Medawachchiya,North Central,3148,2123,5271,125920,84920,210840
3/10/2025,Janitha Perera,Anuradhapura,Medawachchiya,North Central,1075,6183,7258,43000,247320,290320
3/11/2025,Janitha Perera,Anuradhapura,Medawachchiya,North Central,935,3973,4908,37400,158920,196320
3/12/2025,Janitha Perera,Anuradhapura,Medawachchiya,North Central,2836,5690,8526,113440,227600,341040
3/13/2025,Janitha Perera,Anuradhapura,Medawachchiya,North Central,3693,3311,7004,147720,132440,280160
3/14/2025,Janitha Perera,Anuradhapura,Medawachchiya,North Central,8725,7681,16406,349000,307240,656240
3/15/2025,Janitha Perera,Anuradhapura,Medawachchiya,North Central,1623,88,1711,64920,3520,68440
3/16/2025,Janitha Perera,Anuradhapura,Medawachchiya,North Central,7230,8946,16176,289200,357840,647040
3/17/2025,Janitha Perera,Anuradhapura,Medawachchiya,North Central,1051,6392,7443,42040,255680,297720
3/18/2025,Janitha Perera,Anuradhapura,Medawachchiya,North Central,8298,4414,12712,331920,176560,508480
3/19/2025,Janitha Perera,Anuradhapura,Medawachchiya,North Central,4744,5797,10541,189760,231880,421640
3/20/2025,Janitha Perera,Anuradhapura,Medawachchiya,North Central,5381,7040,12421,215240,281600,496840
3/21/2025,Janitha Perera,Anuradhapura,Medawachchiya,North Central,2326,8390,10716,93040,335600,428640
3/22/2025,Janitha Perera,Anuradhapura,Medawachchiya,North Central,8466,4364,12830,338640,174560,513200
3/23/2025,Janitha Perera,Anuradhapura,Medawachchiya,North Central,5513,4290,9803,220520,171600,392120
3/25/2024,Sumanthini Devika,Kandy,Hunnasgiriya,Central,5245,2436,7681,209800,97440,307240
3/26/2024,Sumanthini Devika,Kandy,Hunnasgiriya,Central,4087,8623,12710,163480,344920,508400
3/27/2024,Sumanthini Devika,Kandy,Hunnasgiriya,Central,8754,737,9491,350160,29480,379640
3/28/2024,Sumanthini Devika,Kandy,Hunnasgiriya,Central,2521,6678,9199,100840,267120,367960
3/29/2024,Sumanthini Devika,Kandy,Hunnasgiriya,Central,7801,4503,12304,312040,180120,492160
3/30/2024,Sumanthini Devika,Kandy,Hunnasgiriya,Central,2092,7520,9612,83680,300800,384480
3/31/2024,Sumanthini Devika,Kandy,Hunnasgiriya,Central,6467,8759,15226,258680,350360,609040
4/1/2024,Sumanthini Devika,Kandy,Hunnasgiriya,Central,3743,3339,7082,149720,133560,283280
4/2/2024,Sumanthini Devika,Kandy,Hunnasgiriya,Central,5897,4393,10290,235880,175720,411600
4/3/2024,Sumanthini Devika,Kandy,Hunnasgiriya,Central,2136,2627,4763,85440,105080,190520
4/4/2024,Sumanthini Devika,Kandy,Hunnasgiriya,Central,9071,6618,15689,362840,264720,627560
4/5/2024,Sumanthini Devika,Kandy,Hunnasgiriya,Central,5277,2101,7378,211080,84040,295120
4/6/2024,Sumanthini Devika,Kandy,Hunnasgiriya,Central,239,3659,3898,9560,146360,155920
4/7/2024,Sumanthini Devika,Kandy,Hunnasgiriya,Central,305,614,919,12200,24560,36760
4/8/2024,Sumanthini Devika,Kandy,Hunnasgiriya,Central,1718,3893,5611,68720,155720,224440
4/9/2024,Sumanthini Devika,Kandy,Hunnasgiriya,Central,2042,5976,8018,81680,239040,320720
4/10/2024,Sumanthini Devika,Kandy,Hunnasgiriya,Central,2692,4300,6992,107680,172000,279680
4/11/2024,Sumanthini Devika,Kandy,Hunnasgiriya,Central,2747,2498,5245,109880,99920,209800
4/19/2024,Sumanthini Devika,Kandy,Hunnasgiriya,Central,6201,393,6594,248040,15720,263760
4/20/2024,Sumanthini Devika,Kandy,Hunnasgiriya,Central,3289,841,4130,131560,33640,165200
4/21/2024,Sumanthini Devika,Kandy,Hunnasgiriya,Central,8856,8136,16992,354240,325440,679680
4/22/2024,Sumanthini Devika,Kandy,Hunnasgiriya,Central,6672,608,7280,266880,24320,291200
4/23/2024,Sumanthini Devika,Kandy,Hunnasgiriya,Central,6951,5926,12877,278040,237040,515080
4/24/2024,Sumanthini Devika,Kandy,Hunnasgiriya,Central,9492,29,9521,379680,1160,380840
4/25/2024,Sumanthini Devika,Kandy,Hunnasgiriya,Central,6877,5567,12444,275080,222680,497760
4/26/2024,Sumanthini Devika,Kandy,Hunnasgiriya,Central,5368,9317,14685,214720,372680,587400
4/27/2024,Sumanthini Devika,Kandy,Hunnasgiriya,Central,8673,5626,14299,346920,225040,571960
4/28/2024,Sumanthini Devika,Kandy,Hunnasgiriya,Central,4090,9103,13193,163600,364120,527720
4/29/2024,Sumanthini Devika,Kandy,Hunnasgiriya,Central,2603,8923,11526,104120,356920,461040
4/30/2024,Sumanthini Devika,Kandy,Hunnasgiriya,Central,9237,5168,14405,369480,206720,576200
5/1/2024,Sumanthini Devika,Kandy,Hunnasgiriya,Central,3830,5500,9330,153200,220000,373200
5/2/2024,Sumanthini Devika,Kandy,Hunnasgiriya,Central,8189,8211,16400,327560,328440,656000
5/3/2024,Sumanthini Devika,Kandy,Hunnasgiriya,Central,8101,7887,15988,324040,315480,639520
5/4/2024,Sumanthini Devika,Kandy,Hunnasgiriya,Central,3210,7027,10237,128400,281080,409480
5/5/2024,Sumanthini Devika,Kandy,Hunnasgiriya,Central,5987,5480,11467,239480,219200,458680
5/6/2024,Sumanthini Devika,Kandy,Hunnasgiriya,Central,7518,1367,8885,300720,54680,355400
5/7/2024,Sumanthini Devika,Kandy,Hunnasgiriya,Central,4740,5373,10113,189600,214920,404520
5/8/2024,Sumanthini Devika,Kandy,Hunnasgiriya,Central,8928,5657,14585,357120,226280,583400
5/9/2024,Sumanthini Devika,Kandy,Hunnasgiriya,Central,510,8237,8747,20400,329480,349880
5/10/2024,Sumanthini Devika,Kandy,Hunnasgiriya,Central,75,9312,9387,3000,372480,375480
5/11/2024,Sumanthini Devika,Kandy,Hunnasgiriya,Central,6587,6966,13553,263480,278640,542120
5/12/2024,Sumanthini Devika,Kandy,Hunnasgiriya,Central,8686,2087,10773,347440,83480,430920
5/13/2024,Sumanthini Devika,Kandy,Hunnasgiriya,Central,5848,7577,13425,233920,303080,537000
5/14/2024,Sumanthini Devika,Kandy,Hunnasgiriya,Central,8582,6409,14991,343280,256360,599640
5/15/2024,Sumanthini Devika,Kandy,Hunnasgiriya,Central,6876,3224,10100,275040,128960,404000
5/16/2024,Sumanthini Devika,Kandy,Hunnasgiriya,Central,5767,918,6685,230680,36720,267400
5/17/2024,Sumanthini Devika,Kandy,Hunnasgiriya,Central,2445,7519,9964,97800,300760,398560
5/18/2024,Sumanthini Devika,Kandy,Hunnasgiriya,Central,1101,4106,5207,44040,164240,208280
5/19/2024,Sumanthini Devika,Kandy,Hunnasgiriya,Central,9726,1311,11037,389040,52440,441480
5/20/2024,Sumanthini Devika,Kandy,Hunnasgiriya,Central,4858,3008,7866,194320,120320,314640
5/21/2024,Sumanthini Devika,Kandy,Hunnasgiriya,Central,1883,8601,10484,75320,344040,419360
5/22/2024,Sumanthini Devika,Kandy,Hunnasgiriya,Central,5895,1417,7312,235800,56680,292480
5/24/2024,Sumanthini Devika,Kandy,Hunnasgiriya,Central,4841,9436,14277,193640,377440,571080
5/25/2024,Sumanthini Devika,Kandy,Hunnasgiriya,Central,8039,3084,11123,321560,123360,444920
5/26/2024,Sumanthini Devika,Kandy,Hunnasgiriya,Central,1961,5368,7329,78440,214720,293160
5/27/2024,Sumanthini Devika,Kandy,Hunnasgiriya,Central,1366,7022,8388,54640,280880,335520
5/28/2024,Sumanthini Devika,Kandy,Hunnasgiriya,Central,76,1056,1132,3040,42240,45280
5/29/2024,Sumanthini Devika,Kandy,Hunnasgiriya,Central,860,3159,4019,34400,126360,160760
5/30/2024,Sumanthini Devika,Kandy,Hunnasgiriya,Central,3053,8746,11799,122120,349840,471960
5/31/2024,Sumanthini Devika,Kandy,Hunnasgiriya,Central,2355,6318,8673,94200,252720,346920
6/1/2024,Sumanthini Devika,Kandy,Hunnasgiriya,Central,8980,5015,13995,359200,200600,559800
6/2/2024,Sumanthini Devika,Kandy,Hunnasgiriya,Central,4205,1116,5321,168200,44640,212840
6/3/2024,Sumanthini Devika,Kandy,Hunnasgiriya,Central,2786,2644,5430,111440,105760,217200
6/4/2024,Sumanthini Devika,Kandy,Hunnasgiriya,Central,3141,9475,12616,125640,379000,504640
6/5/2024,Sumanthini Devika,Kandy,Hunnasgiriya,Central,6638,8985,15623,265520,359400,624920
6/6/2024,Sumanthini Devika,Kandy,Hunnasgiriya,Central,8294,8817,17111,331760,352680,684440
6/7/2024,Sumanthini Devika,Kandy,Hunnasgiriya,Central,1459,2421,3880,58360,96840,155200
6/8/2024,Sumanthini Devika,Kandy,Hunnasgiriya,Central,9094,2960,12054,363760,118400,482160
6/9/2024,Sumanthini Devika,Kandy,Hunnasgiriya,Central,1731,5531,7262,69240,221240,290480
6/10/2024,Sumanthini Devika,Kandy,Hunnasgiriya,Central,9960,7651,17611,398400,306040,704440
6/11/2024,Sumanthini Devika,Kandy,Hunnasgiriya,Central,1436,1594,3030,57440,63760,121200
6/12/2024,Sumanthini Devika,Kandy,Hunnasgiriya,Central,642,8021,8663,25680,320840,346520
6/13/2024,Sumanthini Devika,Kandy,Hunnasgiriya,Central,8784,6268,15052,351360,250720,602080
6/14/2024,Sumanthini Devika,Kandy,Hunnasgiriya,Central,3999,1174,5173,159960,46960,206920
6/15/2024,Sumanthini Devika,Kandy,Hunnasgiriya,Central,6104,5385,11489,244160,215400,459560
6/16/2024,Sumanthini Devika,Kandy,Hunnasgiriya,Central,4351,2093,6444,174040,83720,257760
6/17/2024,Sumanthini Devika,Kandy,Hunnasgiriya,Central,6017,2630,8647,240680,105200,345880
6/18/2024,Sumanthini Devika,Kandy,Hunnasgiriya,Central,2798,405,3203,111920,16200,128120
6/19/2024,Sumanthini Devika,Kandy,Hunnasgiriya,Central,5247,4819,10066,209880,192760,402640
6/20/2024,Sumanthini Devika,Kandy,Hunnasgiriya,Central,9717,9830,19547,388680,393200,781880
6/21/2024,Sumanthini Devika,Kandy,Hunnasgiriya,Central,6501,7193,13694,260040,287720,547760
6/22/2024,Sumanthini Devika,Kandy,Hunnasgiriya,Central,6902,6859,13761,276080,274360,550440
6/23/2024,Sumanthini Devika,Kandy,Hunnasgiriya,Central,5947,4753,10700,237880,190120,428000
6/24/2024,Sumanthini Devika,Kandy,Hunnasgiriya,Central,6597,9183,15780,263880,367320,631200
6/25/2024,Sumanthini Devika,Kandy,Hunnasgiriya,Central,6420,3368,9788,256800,134720,391520
6/26/2024,Sumanthini Devika,Kandy,Hunnasgiriya,Central,3004,2528,5532,120160,101120,221280
6/27/2024,Sumanthini Devika,Kandy,Hunnasgiriya,Central,9488,4078,13566,379520,163120,542640
6/28/2024,Sumanthini Devika,Kandy,Hunnasgiriya,Central,3757,8300,12057,150280,332000,482280
6/29/2024,Sumanthini Devika,Kandy,Hunnasgiriya,Central,1959,2319,4278,78360,92760,171120
6/30/2024,Sumanthini Devika,Kandy,Hunnasgiriya,Central,8077,5484,13561,323080,219360,542440
7/1/2024,Sumanthini Devika,Kandy,Hunnasgiriya,Central,9471,869,10340,378840,34760,413600
7/2/2024,Sumanthini Devika,Kandy,Hunnasgiriya,Central,8611,6061,14672,344440,242440,586880
7/3/2024,Sumanthini Devika,Kandy,Hunnasgiriya,Central,5170,5049,10219,206800,201960,408760
7/4/2024,Sumanthini Devika,Kandy,Hunnasgiriya,Central,8393,8196,16589,335720,327840,663560
7/5/2024,Sumanthini Devika,Kandy,Hunnasgiriya,Central,4598,5377,9975,183920,215080,399000
7/6/2024,Sumanthini Devika,Kandy,Hunnasgiriya,Central,5945,9086,15031,237800,363440,601240
7/7/2024,Sumanthini Devika,Kandy,Hunnasgiriya,Central,9505,4742,14247,380200,189680,569880
7/8/2024,Sumanthini Devika,Kandy,Hunnasgiriya,Central,5304,5160,10464,212160,206400,418560
7/9/2024,Sumanthini Devika,Kandy,Hunnasgiriya,Central,4289,9585,13874,171560,383400,554960
7/10/2024,Sumanthini Devika,Kandy,Hunnasgiriya,Central,653,2745,3398,26120,109800,135920
7/11/2024,Sumanthini Devika,Kandy,Hunnasgiriya,Central,4209,2969,7178,168360,118760,287120
7/12/2024,Sumanthini Devika,Kandy,Hunnasgiriya,Central,3404,3938,7342,136160,157520,293680
7/13/2024,Sumanthini Devika,Kandy,Hunnasgiriya,Central,1391,5309,6700,55640,212360,268000
7/14/2024,Sumanthini Devika,Kandy,Hunnasgiriya,Central,8633,7217,15850,345320,288680,634000
7/15/2024,Sumanthini Devika,Kandy,Hunnasgiriya,Central,9362,9072,18434,374480,362880,737360
7/16/2024,Sumanthini Devika,Kandy,Hunnasgiriya,Central,7551,7022,14573,302040,280880,582920
7/17/2024,Sumanthini Devika,Kandy,Hunnasgiriya,Central,2861,7731,10592,114440,309240,423680
7/18/2024,Sumanthini Devika,Kandy,Hunnasgiriya,Central,5434,334,5768,217360,13360,230720
7/19/2024,Sumanthini Devika,Kandy,Hunnasgiriya,Central,3756,8167,11923,150240,326680,476920
7/20/2024,Sumanthini Devika,Kandy,Hunnasgiriya,Central,7940,5753,13693,317600,230120,547720
7/21/2024,Sumanthini Devika,Kandy,Hunnasgiriya,Central,9424,6063,15487,376960,242520,619480
7/22/2024,Sumanthini Devika,Kandy,Hunnasgiriya,Central,5919,1948,7867,236760,77920,314680
7/23/2024,Sumanthini Devika,Kandy,Hunnasgiriya,Central,1474,9311,10785,58960,372440,431400
7/24/2024,Sumanthini Devika,Kandy,Hunnasgiriya,Central,7357,326,7683,294280,13040,307320
7/25/2024,Sumanthini Devika,Kandy,Hunnasgiriya,Central,2869,7997,10866,114760,319880,434640
7/26/2024,Sumanthini Devika,Kandy,Hunnasgiriya,Central,1746,6198,7944,69840,247920,317760
7/27/2024,Sumanthini Devika,Kandy,Hunnasgiriya,Central,431,7503,7934,17240,300120,317360
7/28/2024,Sumanthini Devika,Kandy,Hunnasgiriya,Central,4109,8520,12629,164360,340800,505160
7/29/2024,Sumanthini Devika,Kandy,Hunnasgiriya,Central,449,3663,4112,17960,146520,164480
7/30/2024,Sumanthini Devika,Kandy,Hunnasgiriya,Central,9944,5163,15107,397760,206520,604280
7/31/2024,Sumanthini Devika,Kandy,Hunnasgiriya,Central,7490,6662,14152,299600,266480,566080
8/1/2024,Sumanthini Devika,Kandy,Hunnasgiriya,Central,5634,7865,13499,225360,314600,539960
8/2/2024,Sumanthini Devika,Kandy,Hunnasgiriya,Central,1450,2326,3776,58000,93040,151040
8/3/2024,Sumanthini Devika,Kandy,Hunnasgiriya,Central,1514,6963,8477,60560,278520,339080
8/4/2024,Sumanthini Devika,Kandy,Hunnasgiriya,Central,1118,2859,3977,44720,114360,159080
8/5/2024,Sumanthini Devika,Kandy,Hunnasgiriya,Central,5989,2457,8446,239560,98280,337840
8/6/2024,Sumanthini Devika,Kandy,Hunnasgiriya,Central,3625,3776,7401,145000,151040,296040
8/7/2024,Sumanthini Devika,Kandy,Hunnasgiriya,Central,3883,3531,7414,155320,141240,296560
8/8/2024,Sumanthini Devika,Kandy,Hunnasgiriya,Central,3021,3860,6881,120840,154400,275240
8/9/2024,Sumanthini Devika,Kandy,Hunnasgiriya,Central,3343,5341,8684,133720,213640,347360
8/10/2024,Sumanthini Devika,Kandy,Hunnasgiriya,Central,7123,9297,16420,284920,371880,656800
8/11/2024,Sumanthini Devika,Kandy,Hunnasgiriya,Central,3804,2916,6720,152160,116640,268800
8/12/2024,Sumanthini Devika,Kandy,Hunnasgiriya,Central,5763,3640,9403,230520,145600,376120
8/13/2024,Sumanthini Devika,Kandy,Hunnasgiriya,Central,4336,2939,7275,173440,117560,291000
8/14/2024,Sumanthini Devika,Kandy,Hunnasgiriya,Central,4151,7490,11641,166040,299600,465640
8/15/2024,Sumanthini Devika,Kandy,Hunnasgiriya,Central,5716,5503,11219,228640,220120,448760
8/16/2024,Sumanthini Devika,Kandy,Hunnasgiriya,Central,720,5694,6414,28800,227760,256560
8/17/2024,Sumanthini Devika,Kandy,Hunnasgiriya,Central,9130,9984,19114,365200,399360,764560
8/18/2024,Sumanthini Devika,Kandy,Hunnasgiriya,Central,377,8483,8860,15080,339320,354400
8/19/2024,Sumanthini Devika,Kandy,Hunnasgiriya,Central,1143,3366,4509,45720,134640,180360
8/20/2024,Sumanthini Devika,Kandy,Hunnasgiriya,Central,724,5946,6670,28960,237840,266800
8/21/2024,Sumanthini Devika,Kandy,Hunnasgiriya,Central,4169,333,4502,166760,13320,180080
8/22/2024,Sumanthini Devika,Kandy,Hunnasgiriya,Central,7631,644,8275,305240,25760,331000
8/23/2024,Sumanthini Devika,Kandy,Hunnasgiriya,Central,7876,7191,15067,315040,287640,602680
8/24/2024,Sumanthini Devika,Kandy,Hunnasgiriya,Central,5566,6917,12483,222640,276680,499320
8/25/2024,Sumanthini Devika,Kandy,Hunnasgiriya,Central,7851,9838,17689,314040,393520,707560
8/26/2024,Sumanthini Devika,Kandy,Hunnasgiriya,Central,6437,2770,9207,257480,110800,368280
8/27/2024,Sumanthini Devika,Kandy,Hunnasgiriya,Central,1948,6168,8116,77920,246720,324640
8/28/2024,Sumanthini Devika,Kandy,Hunnasgiriya,Central,1243,8790,10033,49720,351600,401320
8/29/2024,Sumanthini Devika,Kandy,Hunnasgiriya,Central,8067,2661,10728,322680,106440,429120
8/30/2024,Sumanthini Devika,Kandy,Hunnasgiriya,Central,9993,418,10411,399720,16720,416440
8/31/2024,Sumanthini Devika,Kandy,Hunnasgiriya,Central,5110,1385,6495,204400,55400,259800
9/1/2024,Sumanthini Devika,Kandy,Hunnasgiriya,Central,8043,5327,13370,321720,213080,534800
9/2/2024,Sumanthini Devika,Kandy,Hunnasgiriya,Central,5733,7079,12812,229320,283160,512480
9/3/2024,Sumanthini Devika,Kandy,Hunnasgiriya,Central,6970,4835,11805,278800,193400,472200
9/4/2024,Sumanthini Devika,Kandy,Hunnasgiriya,Central,6105,4600,10705,244200,184000,428200
9/5/2024,Sumanthini Devika,Kandy,Hunnasgiriya,Central,9504,807,10311,380160,32280,412440
9/6/2024,Sumanthini Devika,Kandy,Hunnasgiriya,Central,2072,5454,7526,82880,218160,301040
9/7/2024,Sumanthini Devika,Kandy,Hunnasgiriya,Central,4665,4263,8928,186600,170520,357120
9/8/2024,Sumanthini Devika,Kandy,Hunnasgiriya,Central,6506,6525,13031,260240,261000,521240
9/9/2024,Sumanthini Devika,Kandy,Hunnasgiriya,Central,8201,1599,9800,328040,63960,392000
9/10/2024,Sumanthini Devika,Kandy,Hunnasgiriya,Central,9619,9254,18873,384760,370160,754920
9/11/2024,Sumanthini Devika,Kandy,Hunnasgiriya,Central,8448,2108,10556,337920,84320,422240
9/12/2024,Sumanthini Devika,Kandy,Hunnasgiriya,Central,984,6627,7611,39360,265080,304440
9/13/2024,Sumanthini Devika,Kandy,Hunnasgiriya,Central,7545,6962,14507,301800,278480,580280
9/14/2024,Sumanthini Devika,Kandy,Hunnasgiriya,Central,7562,1761,9323,302480,70440,372920
9/15/2024,Sumanthini Devika,Kandy,Hunnasgiriya,Central,7819,8216,16035,312760,328640,641400
9/16/2024,Sumanthini Devika,Kandy,Hunnasgiriya,Central,6780,1865,8645,271200,74600,345800
9/17/2024,Sumanthini Devika,Kandy,Hunnasgiriya,Central,7696,9088,16784,307840,363520,671360
9/18/2024,Sumanthini Devika,Kandy,Hunnasgiriya,Central,3568,5316,8884,142720,212640,355360
9/19/2024,Sumanthini Devika,Kandy,Hunnasgiriya,Central,7770,5996,13766,310800,239840,550640
9/20/2024,Sumanthini Devika,Kandy,Hunnasgiriya,Central,568,5087,5655,22720,203480,226200
9/21/2024,Sumanthini Devika,Kandy,Hunnasgiriya,Central,7238,565,7803,289520,22600,312120
9/22/2024,Sumanthini Devika,Kandy,Hunnasgiriya,Central,6121,196,6317,244840,7840,252680
9/23/2024,Sumanthini Devika,Kandy,Hunnasgiriya,Central,236,9812,10048,9440,392480,401920
9/24/2024,Sumanthini Devika,Kandy,Hunnasgiriya,Central,1677,6924,8601,67080,276960,344040
9/25/2024,Sumanthini Devika,Kandy,Hunnasgiriya,Central,1113,6274,7387,44520,250960,295480
9/26/2024,Sumanthini Devika,Kandy,Hunnasgiriya,Central,4308,7578,11886,172320,303120,475440
9/27/2024,Sumanthini Devika,Kandy,Hunnasgiriya,Central,469,1528,1997,18760,61120,79880
9/28/2024,Sumanthini Devika,Kandy,Hunnasgiriya,Central,5738,9925,15663,229520,397000,626520
9/29/2024,Sumanthini Devika,Kandy,Hunnasgiriya,Central,4525,2865,7390,181000,114600,295600
9/30/2024,Sumanthini Devika,Kandy,Hunnasgiriya,Central,6517,6469,12986,260680,258760,519440
10/1/2024,Sumanthini Devika,Kandy,Hunnasgiriya,Central,2167,9531,11698,86680,381240,467920
10/2/2024,Sumanthini Devika,Kandy,Hunnasgiriya,Central,1316,1170,2486,52640,46800,99440
10/3/2024,Sumanthini Devika,Kandy,Hunnasgiriya,Central,220,5592,5812,8800,223680,232480
10/4/2024,Sumanthini Devika,Kandy,Hunnasgiriya,Central,9516,4716,14232,380640,188640,569280
10/5/2024,Sumanthini Devika,Kandy,Hunnasgiriya,Central,4567,1690,6257,182680,67600,250280
10/6/2024,Sumanthini Devika,Kandy,Hunnasgiriya,Central,649,274,923,25960,10960,36920
10/7/2024,Sumanthini Devika,Kandy,Hunnasgiriya,Central,6202,1794,7996,248080,71760,319840
10/8/2024,Sumanthini Devika,Kandy,Hunnasgiriya,Central,9585,9193,18778,383400,367720,751120
10/9/2024,Sumanthini Devika,Kandy,Hunnasgiriya,Central,3400,18,3418,136000,720,136720
10/10/2024,Sumanthini Devika,Kandy,Hunnasgiriya,Central,353,6453,6806,14120,258120,272240
10/11/2024,Sumanthini Devika,Kandy,Hunnasgiriya,Central,8960,5577,14537,358400,223080,581480
10/12/2024,Sumanthini Devika,Kandy,Hunnasgiriya,Central,7403,5343,12746,296120,213720,509840
10/13/2024,Sumanthini Devika,Kandy,Hunnasgiriya,Central,3362,1433,4795,134480,57320,191800
10/14/2024,Sumanthini Devika,Kandy,Hunnasgiriya,Central,3429,5922,9351,137160,236880,374040
10/15/2024,Sumanthini Devika,Kandy,Hunnasgiriya,Central,6102,4824,10926,244080,192960,437040
10/16/2024,Sumanthini Devika,Kandy,Hunnasgiriya,Central,4892,9104,13996,195680,364160,559840
10/17/2024,Sumanthini Devika,Kandy,Hunnasgiriya,Central,7129,907,8036,285160,36280,321440
10/18/2024,Sumanthini Devika,Kandy,Hunnasgiriya,Central,8055,6050,14105,322200,242000,564200
10/19/2024,Sumanthini Devika,Kandy,Hunnasgiriya,Central,2600,1444,4044,104000,57760,161760
10/20/2024,Sumanthini Devika,Kandy,Hunnasgiriya,Central,6799,3462,10261,271960,138480,410440
10/21/2024,Sumanthini Devika,Kandy,Hunnasgiriya,Central,8638,5174,13812,345520,206960,552480
10/22/2024,Sumanthini Devika,Kandy,Hunnasgiriya,Central,3810,7282,11092,152400,291280,443680
10/23/2024,Sumanthini Devika,Kandy,Hunnasgiriya,Central,8127,4433,12560,325080,177320,502400
10/24/2024,Sumanthini Devika,Kandy,Hunnasgiriya,Central,9822,693,10515,392880,27720,420600
10/25/2024,Sumanthini Devika,Kandy,Hunnasgiriya,Central,6336,7106,13442,253440,284240,537680
10/26/2024,Sumanthini Devika,Kandy,Hunnasgiriya,Central,6540,240,6780,261600,9600,271200
10/27/2024,Sumanthini Devika,Kandy,Hunnasgiriya,Central,3296,5572,8868,131840,222880,354720
10/28/2024,Sumanthini Devika,Kandy,Hunnasgiriya,Central,1487,1786,3273,59480,71440,130920
10/29/2024,Sumanthini Devika,Kandy,Hunnasgiriya,Central,1964,3571,5535,78560,142840,221400
10/30/2024,Sumanthini Devika,Kandy,Hunnasgiriya,Central,5849,8752,14601,233960,350080,584040
10/31/2024,Sumanthini Devika,Kandy,Hunnasgiriya,Central,812,6762,7574,32480,270480,302960
11/1/2024,Sumanthini Devika,Kandy,Hunnasgiriya,Central,844,7568,8412,33760,302720,336480
11/2/2024,Sumanthini Devika,Kandy,Hunnasgiriya,Central,2023,3071,5094,80920,122840,203760
11/3/2024,Sumanthini Devika,Kandy,Hunnasgiriya,Central,4897,4901,9798,195880,196040,391920
11/4/2024,Sumanthini Devika,Kandy,Hunnasgiriya,Central,4941,9118,14059,197640,364720,562360
11/5/2024,Sumanthini Devika,Kandy,Hunnasgiriya,Central,6526,4876,11402,261040,195040,456080
11/6/2024,Sumanthini Devika,Kandy,Hunnasgiriya,Central,4045,6393,10438,161800,255720,417520
11/7/2024,Sumanthini Devika,Kandy,Hunnasgiriya,Central,716,1864,2580,28640,74560,103200
11/8/2024,Sumanthini Devika,Kandy,Hunnasgiriya,Central,3465,6428,9893,138600,257120,395720
11/9/2024,Sumanthini Devika,Kandy,Hunnasgiriya,Central,7284,9599,16883,291360,383960,675320
11/10/2024,Sumanthini Devika,Kandy,Hunnasgiriya,Central,6220,4320,10540,248800,172800,421600
11/11/2024,Sumanthini Devika,Kandy,Hunnasgiriya,Central,8251,427,8678,330040,17080,347120
11/12/2024,Sumanthini Devika,Kandy,Hunnasgiriya,Central,4533,801,5334,181320,32040,213360
11/13/2024,Sumanthini Devika,Kandy,Hunnasgiriya,Central,2093,9625,11718,83720,385000,468720
11/14/2024,Sumanthini Devika,Kandy,Hunnasgiriya,Central,6972,1598,8570,278880,63920,342800
11/15/2024,Sumanthini Devika,Kandy,Hunnasgiriya,Central,5901,3858,9759,236040,154320,390360
11/16/2024,Sumanthini Devika,Kandy,Hunnasgiriya,Central,7777,3704,11481,311080,148160,459240
11/17/2024,Sumanthini Devika,Kandy,Hunnasgiriya,Central,9767,7347,17114,390680,293880,684560
11/18/2024,Sumanthini Devika,Kandy,Hunnasgiriya,Central,1546,8553,10099,61840,342120,403960
11/19/2024,Sumanthini Devika,Kandy,Hunnasgiriya,Central,8430,613,9043,337200,24520,361720
11/20/2024,Sumanthini Devika,Kandy,Hunnasgiriya,Central,1265,2346,3611,50600,93840,144440
11/21/2024,Sumanthini Devika,Kandy,Hunnasgiriya,Central,4654,5182,9836,186160,207280,393440
11/22/2024,Sumanthini Devika,Kandy,Hunnasgiriya,Central,8271,3674,11945,330840,146960,477800
11/23/2024,Sumanthini Devika,Kandy,Hunnasgiriya,Central,9763,6270,16033,390520,250800,641320
11/24/2024,Sumanthini Devika,Kandy,Hunnasgiriya,Central,2302,7073,9375,92080,282920,375000
11/25/2024,Sumanthini Devika,Kandy,Hunnasgiriya,Central,2826,8099,10925,113040,323960,437000
11/26/2024,Sumanthini Devika,Kandy,Hunnasgiriya,Central,1841,9757,11598,73640,390280,463920
11/27/2024,Sumanthini Devika,Kandy,Hunnasgiriya,Central,8626,5595,14221,345040,223800,568840
11/28/2024,Sumanthini Devika,Kandy,Hunnasgiriya,Central,5367,2573,7940,214680,102920,317600
11/29/2024,Sumanthini Devika,Kandy,Hunnasgiriya,Central,2659,1249,3908,106360,49960,156320
11/30/2024,Sumanthini Devika,Kandy,Hunnasgiriya,Central,3103,9348,12451,124120,373920,498040
12/1/2024,Sumanthini Devika,Kandy,Hunnasgiriya,Central,9192,2849,12041,367680,113960,481640
12/2/2024,Sumanthini Devika,Kandy,Hunnasgiriya,Central,8784,1935,10719,351360,77400,428760
12/3/2024,Sumanthini Devika,Kandy,Hunnasgiriya,Central,945,4688,5633,37800,187520,225320
12/4/2024,Sumanthini Devika,Kandy,Hunnasgiriya,Central,7395,5733,13128,295800,229320,525120
12/5/2024,Sumanthini Devika,Kandy,Hunnasgiriya,Central,5443,2437,7880,217720,97480,315200
12/6/2024,Sumanthini Devika,Kandy,Hunnasgiriya,Central,667,2907,3574,26680,116280,142960
12/7/2024,Sumanthini Devika,Kandy,Hunnasgiriya,Central,4609,4529,9138,184360,181160,365520
12/8/2024,Sumanthini Devika,Kandy,Hunnasgiriya,Central,648,3876,4524,25920,155040,180960
12/9/2024,Sumanthini Devika,Kandy,Hunnasgiriya,Central,6493,7304,13797,259720,292160,551880
12/10/2024,Sumanthini Devika,Kandy,Hunnasgiriya,Central,8661,6135,14796,346440,245400,591840
12/11/2024,Sumanthini Devika,Kandy,Hunnasgiriya,Central,6827,9745,16572,273080,389800,662880
12/12/2024,Sumanthini Devika,Kandy,Hunnasgiriya,Central,902,7031,7933,36080,281240,317320
12/13/2024,Sumanthini Devika,Kandy,Hunnasgiriya,Central,9382,1298,10680,375280,51920,427200
12/14/2024,Sumanthini Devika,Kandy,Hunnasgiriya,Central,5576,9008,14584,223040,360320,583360
12/15/2024,Sumanthini Devika,Kandy,Hunnasgiriya,Central,5276,8007,13283,211040,320280,531320
12/16/2024,Sumanthini Devika,Kandy,Hunnasgiriya,Central,2963,9773,12736,118520,390920,509440
12/17/2024,Sumanthini Devika,Kandy,Hunnasgiriya,Central,5849,3237,9086,233960,129480,363440
12/18/2024,Sumanthini Devika,Kandy,Hunnasgiriya,Central,9885,3360,13245,395400,134400,529800
12/19/2024,Sumanthini Devika,Kandy,Hunnasgiriya,Central,5094,3611,8705,203760,144440,348200
12/20/2024,Sumanthini Devika,Kandy,Hunnasgiriya,Central,3706,818,4524,148240,32720,180960
12/21/2024,Sumanthini Devika,Kandy,Hunnasgiriya,Central,8957,8155,17112,358280,326200,684480
12/22/2024,Sumanthini Devika,Kandy,Hunnasgiriya,Central,6537,5778,12315,261480,231120,492600
12/23/2024,Sumanthini Devika,Kandy,Hunnasgiriya,Central,9916,9402,19318,396640,376080,772720
12/24/2024,Sumanthini Devika,Kandy,Hunnasgiriya,Central,5957,4327,10284,238280,173080,411360
12/25/2024,Sumanthini Devika,Kandy,Hunnasgiriya,Central,1766,2651,4417,70640,106040,176680
12/26/2024,Sumanthini Devika,Kandy,Hunnasgiriya,Central,7142,3509,10651,285680,140360,426040
12/27/2024,Sumanthini Devika,Kandy,Hunnasgiriya,Central,1375,9332,10707,55000,373280,428280
12/28/2024,Sumanthini Devika,Kandy,Hunnasgiriya,Central,1819,1182,3001,72760,47280,120040
12/29/2024,Sumanthini Devika,Kandy,Hunnasgiriya,Central,720,849,1569,28800,33960,62760
12/30/2024,Sumanthini Devika,Kandy,Hunnasgiriya,Central,3165,7855,11020,126600,314200,440800
12/31/2024,Sumanthini Devika,Kandy,Hunnasgiriya,Central,4646,4747,9393,185840,189880,375720
1/1/2025,Sumanthini Devika,Kandy,Hunnasgiriya,Central,2607,8441,11048,104280,337640,441920
1/2/2025,Sumanthini Devika,Kandy,Hunnasgiriya,Central,1420,5460,6880,56800,218400,275200
1/3/2025,Sumanthini Devika,Kandy,Hunnasgiriya,Central,8733,5213,13946,349320,208520,557840
1/4/2025,Sumanthini Devika,Kandy,Hunnasgiriya,Central,7693,6275,13968,307720,251000,558720
1/5/2025,Sumanthini Devika,Kandy,Hunnasgiriya,Central,3375,1701,5076,135000,68040,203040
1/6/2025,Sumanthini Devika,Kandy,Hunnasgiriya,Central,9274,5300,14574,370960,212000,582960
1/7/2025,Sumanthini Devika,Kandy,Hunnasgiriya,Central,911,4567,5478,36440,182680,219120
1/8/2025,Sumanthini Devika,Kandy,Hunnasgiriya,Central,7665,7043,14708,306600,281720,588320
1/9/2025,Sumanthini Devika,Kandy,Hunnasgiriya,Central,9217,8738,17955,368680,349520,718200
1/10/2025,Sumanthini Devika,Kandy,Hunnasgiriya,Central,5491,1892,7383,219640,75680,295320
1/11/2025,Sumanthini Devika,Kandy,Hunnasgiriya,Central,7015,1939,8954,280600,77560,358160
1/12/2025,Sumanthini Devika,Kandy,Hunnasgiriya,Central,5619,987,6606,224760,39480,264240
1/13/2025,Sumanthini Devika,Kandy,Hunnasgiriya,Central,6525,1508,8033,261000,60320,321320
1/14/2025,Sumanthini Devika,Kandy,Hunnasgiriya,Central,3394,3223,6617,135760,128920,264680
1/15/2025,Sumanthini Devika,Kandy,Hunnasgiriya,Central,5278,3177,8455,211120,127080,338200
1/16/2025,Sumanthini Devika,Kandy,Hunnasgiriya,Central,8237,129,8366,329480,5160,334640
1/17/2025,Sumanthini Devika,Kandy,Hunnasgiriya,Central,3787,4642,8429,151480,185680,337160
1/18/2025,Sumanthini Devika,Kandy,Hunnasgiriya,Central,9042,3214,12256,361680,128560,490240
1/19/2025,Sumanthini Devika,Kandy,Hunnasgiriya,Central,1357,729,2086,54280,29160,83440
1/20/2025,Sumanthini Devika,Kandy,Hunnasgiriya,Central,4076,9851,13927,163040,394040,557080
1/21/2025,Sumanthini Devika,Kandy,Hunnasgiriya,Central,2831,4661,7492,113240,186440,299680
1/22/2025,Sumanthini Devika,Kandy,Hunnasgiriya,Central,989,6760,7749,39560,270400,309960
1/23/2025,Sumanthini Devika,Kandy,Hunnasgiriya,Central,3766,9335,13101,150640,373400,524040
1/24/2025,Sumanthini Devika,Kandy,Hunnasgiriya,Central,2476,5476,7952,99040,219040,318080
1/25/2025,Sumanthini Devika,Kandy,Hunnasgiriya,Central,6866,2082,8948,274640,83280,357920
1/26/2025,Sumanthini Devika,Kandy,Hunnasgiriya,Central,221,7330,7551,8840,293200,302040
1/27/2025,Sumanthini Devika,Kandy,Hunnasgiriya,Central,1605,1371,2976,64200,54840,119040
1/28/2025,Sumanthini Devika,Kandy,Hunnasgiriya,Central,8120,6205,14325,324800,248200,573000
1/29/2025,Sumanthini Devika,Kandy,Hunnasgiriya,Central,1106,5721,6827,44240,228840,273080
1/30/2025,Sumanthini Devika,Kandy,Hunnasgiriya,Central,1768,5315,7083,70720,212600,283320
1/31/2025,Sumanthini Devika,Kandy,Hunnasgiriya,Central,1623,8627,10250,64920,345080,410000
2/1/2025,Sumanthini Devika,Kandy,Hunnasgiriya,Central,1059,6188,7247,42360,247520,289880
2/2/2025,Sumanthini Devika,Kandy,Hunnasgiriya,Central,7521,2251,9772,300840,90040,390880
2/3/2025,Sumanthini Devika,Kandy,Hunnasgiriya,Central,728,1877,2605,29120,75080,104200
2/4/2025,Sumanthini Devika,Kandy,Hunnasgiriya,Central,174,2832,3006,6960,113280,120240
2/5/2025,Sumanthini Devika,Kandy,Hunnasgiriya,Central,869,1015,1884,34760,40600,75360
2/6/2025,Sumanthini Devika,Kandy,Hunnasgiriya,Central,7571,2282,9853,302840,91280,394120
2/7/2025,Sumanthini Devika,Kandy,Hunnasgiriya,Central,4909,1731,6640,196360,69240,265600
2/8/2025,Sumanthini Devika,Kandy,Hunnasgiriya,Central,1239,8699,9938,49560,347960,397520
2/9/2025,Sumanthini Devika,Kandy,Hunnasgiriya,Central,8908,3747,12655,356320,149880,506200
2/10/2025,Sumanthini Devika,Kandy,Hunnasgiriya,Central,7447,3326,10773,297880,133040,430920
2/11/2025,Sumanthini Devika,Kandy,Hunnasgiriya,Central,6750,3341,10091,270000,133640,403640
2/12/2025,Sumanthini Devika,Kandy,Hunnasgiriya,Central,965,3280,4245,38600,131200,169800
2/13/2025,Sumanthini Devika,Kandy,Hunnasgiriya,Central,6701,2354,9055,268040,94160,362200
2/14/2025,Sumanthini Devika,Kandy,Hunnasgiriya,Central,2194,1476,3670,87760,59040,146800
2/15/2025,Sumanthini Devika,Kandy,Hunnasgiriya,Central,7780,6288,14068,311200,251520,562720
2/16/2025,Sumanthini Devika,Kandy,Hunnasgiriya,Central,1139,4461,5600,45560,178440,224000
2/17/2025,Sumanthini Devika,Kandy,Hunnasgiriya,Central,8933,7945,16878,357320,317800,675120
2/18/2025,Sumanthini Devika,Kandy,Hunnasgiriya,Central,9346,6854,16200,373840,274160,648000
2/19/2025,Sumanthini Devika,Kandy,Hunnasgiriya,Central,5415,527,5942,216600,21080,237680
2/20/2025,Sumanthini Devika,Kandy,Hunnasgiriya,Central,5859,635,6494,234360,25400,259760
2/21/2025,Sumanthini Devika,Kandy,Hunnasgiriya,Central,6408,1012,7420,256320,40480,296800
2/22/2025,Sumanthini Devika,Kandy,Hunnasgiriya,Central,7778,6541,14319,311120,261640,572760
2/23/2025,Sumanthini Devika,Kandy,Hunnasgiriya,Central,6060,4723,10783,242400,188920,431320
2/24/2025,Sumanthini Devika,Kandy,Hunnasgiriya,Central,1389,8882,10271,55560,355280,410840
2/25/2025,Sumanthini Devika,Kandy,Hunnasgiriya,Central,2066,9336,11402,82640,373440,456080
2/26/2025,Sumanthini Devika,Kandy,Hunnasgiriya,Central,77,8168,8245,3080,326720,329800
2/27/2025,Sumanthini Devika,Kandy,Hunnasgiriya,Central,4841,3524,8365,193640,140960,334600
2/28/2025,Sumanthini Devika,Kandy,Hunnasgiriya,Central,7493,464,7957,299720,18560,318280
3/1/2025,Sumanthini Devika,Kandy,Hunnasgiriya,Central,3580,6890,10470,143200,275600,418800
3/2/2025,Sumanthini Devika,Kandy,Hunnasgiriya,Central,2140,4764,6904,85600,190560,276160
3/3/2025,Sumanthini Devika,Kandy,Hunnasgiriya,Central,6927,7448,14375,277080,297920,575000
3/4/2025,Sumanthini Devika,Kandy,Hunnasgiriya,Central,2610,5787,8397,104400,231480,335880
3/5/2025,Sumanthini Devika,Kandy,Hunnasgiriya,Central,5713,9639,15352,228520,385560,614080
3/6/2025,Sumanthini Devika,Kandy,Hunnasgiriya,Central,7578,1644,9222,303120,65760,368880
3/7/2025,Sumanthini Devika,Kandy,Hunnasgiriya,Central,7553,2059,9612,302120,82360,384480
3/8/2025,Sumanthini Devika,Kandy,Hunnasgiriya,Central,2100,8416,10516,84000,336640,420640
3/9/2025,Sumanthini Devika,Kandy,Hunnasgiriya,Central,9159,9779,18938,366360,391160,757520
3/10/2025,Sumanthini Devika,Kandy,Hunnasgiriya,Central,2773,3815,6588,110920,152600,263520
3/11/2025,Sumanthini Devika,Kandy,Hunnasgiriya,Central,5584,1383,6967,223360,55320,278680
3/12/2025,Sumanthini Devika,Kandy,Hunnasgiriya,Central,4950,335,5285,198000,13400,211400
3/13/2025,Sumanthini Devika,Kandy,Hunnasgiriya,Central,634,917,1551,25360,36680,62040
3/14/2025,Sumanthini Devika,Kandy,Hunnasgiriya,Central,5626,2752,8378,225040,110080,335120
3/15/2025,Sumanthini Devika,Kandy,Hunnasgiriya,Central,5705,7429,13134,228200,297160,525360
3/16/2025,Sumanthini Devika,Kandy,Hunnasgiriya,Central,2654,484,3138,106160,19360,125520
3/17/2025,Sumanthini Devika,Kandy,Hunnasgiriya,Central,5184,583,5767,207360,23320,230680
3/18/2025,Sumanthini Devika,Kandy,Hunnasgiriya,Central,8357,6533,14890,334280,261320,595600
3/19/2025,Sumanthini Devika,Kandy,Hunnasgiriya,Central,7307,9298,16605,292280,371920,664200
3/20/2025,Sumanthini Devika,Kandy,Hunnasgiriya,Central,676,5152,5828,27040,206080,233120
3/21/2025,Sumanthini Devika,Kandy,Hunnasgiriya,Central,4448,3458,7906,177920,138320,316240
3/22/2025,Sumanthini Devika,Kandy,Hunnasgiriya,Central,5040,3618,8658,201600,144720,346320
3/23/2025,Sumanthini Devika,Kandy,Hunnasgiriya,Central,9462,7267,16729,378480,290680,669160
3/25/2024,Lihini Hemanthika,Puttalam,Puttalam,North Western,5725,9996,15721,229000,399840,628840
3/26/2024,Lihini Hemanthika,Puttalam,Puttalam,North Western,7052,5498,12550,282080,219920,502000
3/27/2024,Lihini Hemanthika,Puttalam,Puttalam,North Western,8564,5111,13675,342560,204440,547000
3/28/2024,Lihini Hemanthika,Puttalam,Puttalam,North Western,9704,6057,15761,388160,242280,630440
3/29/2024,Lihini Hemanthika,Puttalam,Puttalam,North Western,5489,7507,12996,219560,300280,519840
3/30/2024,Lihini Hemanthika,Puttalam,Puttalam,North Western,4804,2684,7488,192160,107360,299520
3/31/2024,Lihini Hemanthika,Puttalam,Puttalam,North Western,9130,5160,14290,365200,206400,571600
4/1/2024,Lihini Hemanthika,Puttalam,Puttalam,North Western,4292,8542,12834,171680,341680,513360
4/2/2024,Lihini Hemanthika,Puttalam,Puttalam,North Western,3454,4236,7690,138160,169440,307600
4/3/2024,Lihini Hemanthika,Puttalam,Puttalam,North Western,2254,7118,9372,90160,284720,374880
4/4/2024,Lihini Hemanthika,Puttalam,Puttalam,North Western,2415,918,3333,96600,36720,133320
4/5/2024,Lihini Hemanthika,Puttalam,Puttalam,North Western,6992,2804,9796,279680,112160,391840
4/6/2024,Lihini Hemanthika,Puttalam,Puttalam,North Western,6227,5130,11357,249080,205200,454280
4/7/2024,Lihini Hemanthika,Puttalam,Puttalam,North Western,3158,1012,4170,126320,40480,166800
4/8/2024,Lihini Hemanthika,Puttalam,Puttalam,North Western,3774,8125,11899,150960,325000,475960
4/9/2024,Lihini Hemanthika,Puttalam,Puttalam,North Western,5956,6293,12249,238240,251720,489960
4/10/2024,Lihini Hemanthika,Puttalam,Puttalam,North Western,3258,2511,5769,130320,100440,230760
4/11/2024,Lihini Hemanthika,Puttalam,Puttalam,North Western,3015,6973,9988,120600,278920,399520
4/19/2024,Lihini Hemanthika,Puttalam,Puttalam,North Western,4608,7179,11787,184320,287160,471480
4/20/2024,Lihini Hemanthika,Puttalam,Puttalam,North Western,564,100,664,22560,4000,26560
4/21/2024,Lihini Hemanthika,Puttalam,Puttalam,North Western,1822,2069,3891,72880,82760,155640
4/22/2024,Lihini Hemanthika,Puttalam,Puttalam,North Western,5299,2976,8275,211960,119040,331000
4/23/2024,Lihini Hemanthika,Puttalam,Puttalam,North Western,1937,7778,9715,77480,311120,388600
4/24/2024,Lihini Hemanthika,Puttalam,Puttalam,North Western,6398,1030,7428,255920,41200,297120
4/25/2024,Lihini Hemanthika,Puttalam,Puttalam,North Western,4762,8045,12807,190480,321800,512280
4/26/2024,Lihini Hemanthika,Puttalam,Puttalam,North Western,3050,5099,8149,122000,203960,325960
4/27/2024,Lihini Hemanthika,Puttalam,Puttalam,North Western,1169,4528,5697,46760,181120,227880
4/28/2024,Lihini Hemanthika,Puttalam,Puttalam,North Western,6487,6625,13112,259480,265000,524480
4/29/2024,Lihini Hemanthika,Puttalam,Puttalam,North Western,797,2852,3649,31880,114080,145960
4/30/2024,Lihini Hemanthika,Puttalam,Puttalam,North Western,6351,967,7318,254040,38680,292720
5/1/2024,Lihini Hemanthika,Puttalam,Puttalam,North Western,6910,4671,11581,276400,186840,463240
5/2/2024,Lihini Hemanthika,Puttalam,Puttalam,North Western,2052,3658,5710,82080,146320,228400
5/3/2024,Lihini Hemanthika,Puttalam,Puttalam,North Western,8767,4601,13368,350680,184040,534720
5/4/2024,Lihini Hemanthika,Puttalam,Puttalam,North Western,7336,7522,14858,293440,300880,594320
5/5/2024,Lihini Hemanthika,Puttalam,Puttalam,North Western,2044,8128,10172,81760,325120,406880
5/6/2024,Lihini Hemanthika,Puttalam,Puttalam,North Western,1279,361,1640,51160,14440,65600
5/7/2024,Lihini Hemanthika,Puttalam,Puttalam,North Western,8664,5213,13877,346560,208520,555080
5/8/2024,Lihini Hemanthika,Puttalam,Puttalam,North Western,9545,5932,15477,381800,237280,619080
5/9/2024,Lihini Hemanthika,Puttalam,Puttalam,North Western,4702,9389,14091,188080,375560,563640
5/10/2024,Lihini Hemanthika,Puttalam,Puttalam,North Western,7338,3230,10568,293520,129200,422720
5/11/2024,Lihini Hemanthika,Puttalam,Puttalam,North Western,7164,9194,16358,286560,367760,654320
5/12/2024,Lihini Hemanthika,Puttalam,Puttalam,North Western,9804,9362,19166,392160,374480,766640
5/13/2024,Lihini Hemanthika,Puttalam,Puttalam,North Western,7249,1907,9156,289960,76280,366240
5/14/2024,Lihini Hemanthika,Puttalam,Puttalam,North Western,2567,2166,4733,102680,86640,189320
5/15/2024,Lihini Hemanthika,Puttalam,Puttalam,North Western,748,6190,6938,29920,247600,277520
5/16/2024,Lihini Hemanthika,Puttalam,Puttalam,North Western,5292,3653,8945,211680,146120,357800
5/17/2024,Lihini Hemanthika,Puttalam,Puttalam,North Western,362,1174,1536,14480,46960,61440
5/18/2024,Lihini Hemanthika,Puttalam,Puttalam,North Western,429,4149,4578,17160,165960,183120
5/19/2024,Lihini Hemanthika,Puttalam,Puttalam,North Western,133,8628,8761,5320,345120,350440
5/20/2024,Lihini Hemanthika,Puttalam,Puttalam,North Western,4083,373,4456,163320,14920,178240
5/21/2024,Lihini Hemanthika,Puttalam,Puttalam,North Western,7002,2682,9684,280080,107280,387360
5/22/2024,Lihini Hemanthika,Puttalam,Puttalam,North Western,2213,7851,10064,88520,314040,402560
5/24/2024,Lihini Hemanthika,Puttalam,Puttalam,North Western,7374,4845,12219,294960,193800,488760
5/25/2024,Lihini Hemanthika,Puttalam,Puttalam,North Western,9011,4499,13510,360440,179960,540400
5/26/2024,Lihini Hemanthika,Puttalam,Puttalam,North Western,7264,4109,11373,290560,164360,454920
5/27/2024,Lihini Hemanthika,Puttalam,Puttalam,North Western,9877,8669,18546,395080,346760,741840
5/28/2024,Lihini Hemanthika,Puttalam,Puttalam,North Western,2288,641,2929,91520,25640,117160
5/29/2024,Lihini Hemanthika,Puttalam,Puttalam,North Western,3308,2220,5528,132320,88800,221120
5/30/2024,Lihini Hemanthika,Puttalam,Puttalam,North Western,9838,2838,12676,393520,113520,507040
5/31/2024,Lihini Hemanthika,Puttalam,Puttalam,North Western,1061,4327,5388,42440,173080,215520
6/1/2024,Lihini Hemanthika,Puttalam,Puttalam,North Western,7471,809,8280,298840,32360,331200
6/2/2024,Lihini Hemanthika,Puttalam,Puttalam,North Western,7024,9998,17022,280960,399920,680880
6/3/2024,Lihini Hemanthika,Puttalam,Puttalam,North Western,9057,6712,15769,362280,268480,630760
6/4/2024,Lihini Hemanthika,Puttalam,Puttalam,North Western,3990,88,4078,159600,3520,163120
6/5/2024,Lihini Hemanthika,Puttalam,Puttalam,North Western,7911,3742,11653,316440,149680,466120
6/6/2024,Lihini Hemanthika,Puttalam,Puttalam,North Western,6718,9670,16388,268720,386800,655520
6/7/2024,Lihini Hemanthika,Puttalam,Puttalam,North Western,9788,5464,15252,391520,218560,610080
6/8/2024,Lihini Hemanthika,Puttalam,Puttalam,North Western,9220,733,9953,368800,29320,398120
6/9/2024,Lihini Hemanthika,Puttalam,Puttalam,North Western,3023,4913,7936,120920,196520,317440
6/10/2024,Lihini Hemanthika,Puttalam,Puttalam,North Western,1218,7520,8738,48720,300800,349520
6/11/2024,Lihini Hemanthika,Puttalam,Puttalam,North Western,4270,4917,9187,170800,196680,367480
6/12/2024,Lihini Hemanthika,Puttalam,Puttalam,North Western,3666,3432,7098,146640,137280,283920
6/13/2024,Lihini Hemanthika,Puttalam,Puttalam,North Western,8624,2499,11123,344960,99960,444920
6/14/2024,Lihini Hemanthika,Puttalam,Puttalam,North Western,3049,9719,12768,121960,388760,510720
6/15/2024,Lihini Hemanthika,Puttalam,Puttalam,North Western,2250,1928,4178,90000,77120,167120
6/16/2024,Lihini Hemanthika,Puttalam,Puttalam,North Western,3258,956,4214,130320,38240,168560
6/17/2024,Lihini Hemanthika,Puttalam,Puttalam,North Western,4134,9704,13838,165360,388160,553520
6/18/2024,Lihini Hemanthika,Puttalam,Puttalam,North Western,2357,6504,8861,94280,260160,354440
6/19/2024,Lihini Hemanthika,Puttalam,Puttalam,North Western,5761,7913,13674,230440,316520,546960
6/20/2024,Lihini Hemanthika,Puttalam,Puttalam,North Western,7434,1536,8970,297360,61440,358800
6/21/2024,Lihini Hemanthika,Puttalam,Puttalam,North Western,1878,2074,3952,75120,82960,158080
6/22/2024,Lihini Hemanthika,Puttalam,Puttalam,North Western,9155,4905,14060,366200,196200,562400
6/23/2024,Lihini Hemanthika,Puttalam,Puttalam,North Western,1772,6479,8251,70880,259160,330040
6/24/2024,Lihini Hemanthika,Puttalam,Puttalam,North Western,9604,1560,11164,384160,62400,446560
6/25/2024,Lihini Hemanthika,Puttalam,Puttalam,North Western,8755,3423,12178,350200,136920,487120
6/26/2024,Lihini Hemanthika,Puttalam,Puttalam,North Western,3684,9473,13157,147360,378920,526280
6/27/2024,Lihini Hemanthika,Puttalam,Puttalam,North Western,9794,2285,12079,391760,91400,483160
6/28/2024,Lihini Hemanthika,Puttalam,Puttalam,North Western,4398,7081,11479,175920,283240,459160
6/29/2024,Lihini Hemanthika,Puttalam,Puttalam,North Western,2288,119,2407,91520,4760,96280
6/30/2024,Lihini Hemanthika,Puttalam,Puttalam,North Western,6110,2478,8588,244400,99120,343520
7/1/2024,Lihini Hemanthika,Puttalam,Puttalam,North Western,2798,4837,7635,111920,193480,305400
7/2/2024,Lihini Hemanthika,Puttalam,Puttalam,North Western,5168,5979,11147,206720,239160,445880
7/3/2024,Lihini Hemanthika,Puttalam,Puttalam,North Western,8162,2596,10758,326480,103840,430320
7/4/2024,Lihini Hemanthika,Puttalam,Puttalam,North Western,5131,3536,8667,205240,141440,346680
7/5/2024,Lihini Hemanthika,Puttalam,Puttalam,North Western,1961,6108,8069,78440,244320,322760
7/6/2024,Lihini Hemanthika,Puttalam,Puttalam,North Western,2816,3789,6605,112640,151560,264200
7/7/2024,Lihini Hemanthika,Puttalam,Puttalam,North Western,6318,5790,12108,252720,231600,484320
7/8/2024,Lihini Hemanthika,Puttalam,Puttalam,North Western,9606,2172,11778,384240,86880,471120
7/9/2024,Lihini Hemanthika,Puttalam,Puttalam,North Western,7338,2149,9487,293520,85960,379480
7/10/2024,Lihini Hemanthika,Puttalam,Puttalam,North Western,4466,4318,8784,178640,172720,351360
7/11/2024,Lihini Hemanthika,Puttalam,Puttalam,North Western,812,8747,9559,32480,349880,382360
7/12/2024,Lihini Hemanthika,Puttalam,Puttalam,North Western,8842,436,9278,353680,17440,371120
7/13/2024,Lihini Hemanthika,Puttalam,Puttalam,North Western,8885,3678,12563,355400,147120,502520
7/14/2024,Lihini Hemanthika,Puttalam,Puttalam,North Western,2907,8880,11787,116280,355200,471480
7/15/2024,Lihini Hemanthika,Puttalam,Puttalam,North Western,9249,5992,15241,369960,239680,609640
7/16/2024,Lihini Hemanthika,Puttalam,Puttalam,North Western,4059,8005,12064,162360,320200,482560
7/17/2024,Lihini Hemanthika,Puttalam,Puttalam,North Western,1869,1891,3760,74760,75640,150400
7/18/2024,Lihini Hemanthika,Puttalam,Puttalam,North Western,7301,7364,14665,292040,294560,586600
7/19/2024,Lihini Hemanthika,Puttalam,Puttalam,North Western,8565,3949,12514,342600,157960,500560
7/20/2024,Lihini Hemanthika,Puttalam,Puttalam,North Western,1437,1381,2818,57480,55240,112720
7/21/2024,Lihini Hemanthika,Puttalam,Puttalam,North Western,6322,5381,11703,252880,215240,468120
7/22/2024,Lihini Hemanthika,Puttalam,Puttalam,North Western,1034,5809,6843,41360,232360,273720
7/23/2024,Lihini Hemanthika,Puttalam,Puttalam,North Western,2678,6280,8958,107120,251200,358320
7/24/2024,Lihini Hemanthika,Puttalam,Puttalam,North Western,7611,7883,15494,304440,315320,619760
7/25/2024,Lihini Hemanthika,Puttalam,Puttalam,North Western,3857,6989,10846,154280,279560,433840
7/26/2024,Lihini Hemanthika,Puttalam,Puttalam,North Western,3742,9602,13344,149680,384080,533760
7/27/2024,Lihini Hemanthika,Puttalam,Puttalam,North Western,5416,4555,9971,216640,182200,398840
7/28/2024,Lihini Hemanthika,Puttalam,Puttalam,North Western,8844,3078,11922,353760,123120,476880
7/29/2024,Lihini Hemanthika,Puttalam,Puttalam,North Western,2616,1742,4358,104640,69680,174320
7/30/2024,Lihini Hemanthika,Puttalam,Puttalam,North Western,8572,9372,17944,342880,374880,717760
7/31/2024,Lihini Hemanthika,Puttalam,Puttalam,North Western,9550,9670,19220,382000,386800,768800
8/1/2024,Lihini Hemanthika,Puttalam,Puttalam,North Western,6186,454,6640,247440,18160,265600
8/2/2024,Lihini Hemanthika,Puttalam,Puttalam,North Western,3404,208,3612,136160,8320,144480
8/3/2024,Lihini Hemanthika,Puttalam,Puttalam,North Western,8441,4987,13428,337640,199480,537120
8/4/2024,Lihini Hemanthika,Puttalam,Puttalam,North Western,1075,5148,6223,43000,205920,248920
8/5/2024,Lihini Hemanthika,Puttalam,Puttalam,North Western,8356,8032,16388,334240,321280,655520
8/6/2024,Lihini Hemanthika,Puttalam,Puttalam,North Western,362,1685,2047,14480,67400,81880
8/7/2024,Lihini Hemanthika,Puttalam,Puttalam,North Western,9479,2700,12179,379160,108000,487160
8/8/2024,Lihini Hemanthika,Puttalam,Puttalam,North Western,7974,2108,10082,318960,84320,403280
8/9/2024,Lihini Hemanthika,Puttalam,Puttalam,North Western,1487,4594,6081,59480,183760,243240
8/10/2024,Lihini Hemanthika,Puttalam,Puttalam,North Western,6241,7856,14097,249640,314240,563880
8/11/2024,Lihini Hemanthika,Puttalam,Puttalam,North Western,2077,5888,7965,83080,235520,318600
8/12/2024,Lihini Hemanthika,Puttalam,Puttalam,North Western,6446,4976,11422,257840,199040,456880
8/13/2024,Lihini Hemanthika,Puttalam,Puttalam,North Western,6146,9049,15195,245840,361960,607800
8/14/2024,Lihini Hemanthika,Puttalam,Puttalam,North Western,1465,9500,10965,58600,380000,438600
8/15/2024,Lihini Hemanthika,Puttalam,Puttalam,North Western,6866,4410,11276,274640,176400,451040
8/16/2024,Lihini Hemanthika,Puttalam,Puttalam,North Western,5959,3698,9657,238360,147920,386280
8/17/2024,Lihini Hemanthika,Puttalam,Puttalam,North Western,2107,3959,6066,84280,158360,242640
8/18/2024,Lihini Hemanthika,Puttalam,Puttalam,North Western,7778,4479,12257,311120,179160,490280
8/19/2024,Lihini Hemanthika,Puttalam,Puttalam,North Western,8396,1151,9547,335840,46040,381880
8/20/2024,Lihini Hemanthika,Puttalam,Puttalam,North Western,6691,1560,8251,267640,62400,330040
8/21/2024,Lihini Hemanthika,Puttalam,Puttalam,North Western,2104,6140,8244,84160,245600,329760
8/22/2024,Lihini Hemanthika,Puttalam,Puttalam,North Western,2854,8292,11146,114160,331680,445840
8/23/2024,Lihini Hemanthika,Puttalam,Puttalam,North Western,8240,844,9084,329600,33760,363360
8/24/2024,Lihini Hemanthika,Puttalam,Puttalam,North Western,4783,6517,11300,191320,260680,452000
8/25/2024,Lihini Hemanthika,Puttalam,Puttalam,North Western,9770,1515,11285,390800,60600,451400
8/26/2024,Lihini Hemanthika,Puttalam,Puttalam,North Western,5837,2989,8826,233480,119560,353040
8/27/2024,Lihini Hemanthika,Puttalam,Puttalam,North Western,9183,7374,16557,367320,294960,662280
8/28/2024,Lihini Hemanthika,Puttalam,Puttalam,North Western,6725,3648,10373,269000,145920,414920
8/29/2024,Lihini Hemanthika,Puttalam,Puttalam,North Western,9981,9937,19918,399240,397480,796720
8/30/2024,Lihini Hemanthika,Puttalam,Puttalam,North Western,9955,1171,11126,398200,46840,445040
8/31/2024,Lihini Hemanthika,Puttalam,Puttalam,North Western,2264,1571,3835,90560,62840,153400
9/1/2024,Lihini Hemanthika,Puttalam,Puttalam,North Western,5900,2024,7924,236000,80960,316960
9/2/2024,Lihini Hemanthika,Puttalam,Puttalam,North Western,1980,2737,4717,79200,109480,188680
9/3/2024,Lihini Hemanthika,Puttalam,Puttalam,North Western,1899,9138,11037,75960,365520,441480
9/4/2024,Lihini Hemanthika,Puttalam,Puttalam,North Western,8430,4763,13193,337200,190520,527720
9/5/2024,Lihini Hemanthika,Puttalam,Puttalam,North Western,2976,6803,9779,119040,272120,391160
9/6/2024,Lihini Hemanthika,Puttalam,Puttalam,North Western,7864,3653,11517,314560,146120,460680
9/7/2024,Lihini Hemanthika,Puttalam,Puttalam,North Western,9883,8206,18089,395320,328240,723560
9/8/2024,Lihini Hemanthika,Puttalam,Puttalam,North Western,5726,5409,11135,229040,216360,445400
9/9/2024,Lihini Hemanthika,Puttalam,Puttalam,North Western,4753,4627,9380,190120,185080,375200
9/10/2024,Lihini Hemanthika,Puttalam,Puttalam,North Western,5023,3426,8449,200920,137040,337960
9/11/2024,Lihini Hemanthika,Puttalam,Puttalam,North Western,9475,3898,13373,379000,155920,534920
9/12/2024,Lihini Hemanthika,Puttalam,Puttalam,North Western,3968,8290,12258,158720,331600,490320
9/13/2024,Lihini Hemanthika,Puttalam,Puttalam,North Western,1715,5625,7340,68600,225000,293600
9/14/2024,Lihini Hemanthika,Puttalam,Puttalam,North Western,7684,6226,13910,307360,249040,556400
9/15/2024,Lihini Hemanthika,Puttalam,Puttalam,North Western,5482,1816,7298,219280,72640,291920
9/16/2024,Lihini Hemanthika,Puttalam,Puttalam,North Western,2245,5744,7989,89800,229760,319560
9/17/2024,Lihini Hemanthika,Puttalam,Puttalam,North Western,8911,1963,10874,356440,78520,434960
9/18/2024,Lihini Hemanthika,Puttalam,Puttalam,North Western,7185,6788,13973,287400,271520,558920
9/19/2024,Lihini Hemanthika,Puttalam,Puttalam,North Western,7429,4791,12220,297160,191640,488800
9/20/2024,Lihini Hemanthika,Puttalam,Puttalam,North Western,6932,4677,11609,277280,187080,464360
9/21/2024,Lihini Hemanthika,Puttalam,Puttalam,North Western,341,2229,2570,13640,89160,102800
9/22/2024,Lihini Hemanthika,Puttalam,Puttalam,North Western,3307,1867,5174,132280,74680,206960
9/23/2024,Lihini Hemanthika,Puttalam,Puttalam,North Western,2064,6075,8139,82560,243000,325560
9/24/2024,Lihini Hemanthika,Puttalam,Puttalam,North Western,2993,9554,12547,119720,382160,501880
9/25/2024,Lihini Hemanthika,Puttalam,Puttalam,North Western,54,6225,6279,2160,249000,251160
9/26/2024,Lihini Hemanthika,Puttalam,Puttalam,North Western,4502,3498,8000,180080,139920,320000
9/27/2024,Lihini Hemanthika,Puttalam,Puttalam,North Western,4773,8370,13143,190920,334800,525720
9/28/2024,Lihini Hemanthika,Puttalam,Puttalam,North Western,1061,233,1294,42440,9320,51760
9/29/2024,Lihini Hemanthika,Puttalam,Puttalam,North Western,3285,4222,7507,131400,168880,300280
9/30/2024,Lihini Hemanthika,Puttalam,Puttalam,North Western,6361,55,6416,254440,2200,256640
10/1/2024,Lihini Hemanthika,Puttalam,Puttalam,North Western,6355,1625,7980,254200,65000,319200
10/2/2024,Lihini Hemanthika,Puttalam,Puttalam,North Western,9075,5174,14249,363000,206960,569960
10/3/2024,Lihini Hemanthika,Puttalam,Puttalam,North Western,4622,431,5053,184880,17240,202120
10/4/2024,Lihini Hemanthika,Puttalam,Puttalam,North Western,7026,3094,10120,281040,123760,404800
10/5/2024,Lihini Hemanthika,Puttalam,Puttalam,North Western,3109,2929,6038,124360,117160,241520
10/6/2024,Lihini Hemanthika,Puttalam,Puttalam,North Western,6882,4558,11440,275280,182320,457600
10/7/2024,Lihini Hemanthika,Puttalam,Puttalam,North Western,1934,3081,5015,77360,123240,200600
10/8/2024,Lihini Hemanthika,Puttalam,Puttalam,North Western,5387,409,5796,215480,16360,231840
10/9/2024,Lihini Hemanthika,Puttalam,Puttalam,North Western,5024,619,5643,200960,24760,225720
10/10/2024,Lihini Hemanthika,Puttalam,Puttalam,North Western,2711,8663,11374,108440,346520,454960
10/11/2024,Lihini Hemanthika,Puttalam,Puttalam,North Western,9231,4397,13628,369240,175880,545120
10/12/2024,Lihini Hemanthika,Puttalam,Puttalam,North Western,5002,3448,8450,200080,137920,338000
10/13/2024,Lihini Hemanthika,Puttalam,Puttalam,North Western,8307,8987,17294,332280,359480,691760
10/14/2024,Lihini Hemanthika,Puttalam,Puttalam,North Western,7607,2257,9864,304280,90280,394560
10/15/2024,Lihini Hemanthika,Puttalam,Puttalam,North Western,9134,7128,16262,365360,285120,650480
10/16/2024,Lihini Hemanthika,Puttalam,Puttalam,North Western,3884,5872,9756,155360,234880,390240
10/17/2024,Lihini Hemanthika,Puttalam,Puttalam,North Western,2047,5983,8030,81880,239320,321200
10/18/2024,Lihini Hemanthika,Puttalam,Puttalam,North Western,7705,4829,12534,308200,193160,501360
10/19/2024,Lihini Hemanthika,Puttalam,Puttalam,North Western,2389,346,2735,95560,13840,109400
10/20/2024,Lihini Hemanthika,Puttalam,Puttalam,North Western,6179,6476,12655,247160,259040,506200
10/21/2024,Lihini Hemanthika,Puttalam,Puttalam,North Western,7616,9356,16972,304640,374240,678880
10/22/2024,Lihini Hemanthika,Puttalam,Puttalam,North Western,1362,9464,10826,54480,378560,433040
10/23/2024,Lihini Hemanthika,Puttalam,Puttalam,North Western,9202,6785,15987,368080,271400,639480
10/24/2024,Lihini Hemanthika,Puttalam,Puttalam,North Western,6205,5810,12015,248200,232400,480600
10/25/2024,Lihini Hemanthika,Puttalam,Puttalam,North Western,5406,6200,11606,216240,248000,464240
10/26/2024,Lihini Hemanthika,Puttalam,Puttalam,North Western,3158,254,3412,126320,10160,136480
10/27/2024,Lihini Hemanthika,Puttalam,Puttalam,North Western,1809,8155,9964,72360,326200,398560
10/28/2024,Lihini Hemanthika,Puttalam,Puttalam,North Western,6491,4018,10509,259640,160720,420360
10/29/2024,Lihini Hemanthika,Puttalam,Puttalam,North Western,7062,2346,9408,282480,93840,376320
10/30/2024,Lihini Hemanthika,Puttalam,Puttalam,North Western,6220,244,6464,248800,9760,258560
10/31/2024,Lihini Hemanthika,Puttalam,Puttalam,North Western,5747,2372,8119,229880,94880,324760
11/1/2024,Lihini Hemanthika,Puttalam,Puttalam,North Western,8671,5895,14566,346840,235800,582640
11/2/2024,Lihini Hemanthika,Puttalam,Puttalam,North Western,2779,2459,5238,111160,98360,209520
11/3/2024,Lihini Hemanthika,Puttalam,Puttalam,North Western,5765,6875,12640,230600,275000,505600
11/4/2024,Lihini Hemanthika,Puttalam,Puttalam,North Western,6554,1127,7681,262160,45080,307240
11/5/2024,Lihini Hemanthika,Puttalam,Puttalam,North Western,2240,649,2889,89600,25960,115560
11/6/2024,Lihini Hemanthika,Puttalam,Puttalam,North Western,8041,740,8781,321640,29600,351240
11/7/2024,Lihini Hemanthika,Puttalam,Puttalam,North Western,706,657,1363,28240,26280,54520
11/8/2024,Lihini Hemanthika,Puttalam,Puttalam,North Western,2996,1604,4600,119840,64160,184000
11/9/2024,Lihini Hemanthika,Puttalam,Puttalam,North Western,6728,6802,13530,269120,272080,541200
11/10/2024,Lihini Hemanthika,Puttalam,Puttalam,North Western,7813,5416,13229,312520,216640,529160
11/11/2024,Lihini Hemanthika,Puttalam,Puttalam,North Western,139,2729,2868,5560,109160,114720
11/12/2024,Lihini Hemanthika,Puttalam,Puttalam,North Western,3663,7468,11131,146520,298720,445240
11/13/2024,Lihini Hemanthika,Puttalam,Puttalam,North Western,7979,8506,16485,319160,340240,659400
11/14/2024,Lihini Hemanthika,Puttalam,Puttalam,North Western,7062,8631,15693,282480,345240,627720
11/15/2024,Lihini Hemanthika,Puttalam,Puttalam,North Western,4459,4786,9245,178360,191440,369800
11/16/2024,Lihini Hemanthika,Puttalam,Puttalam,North Western,5621,3880,9501,224840,155200,380040
11/17/2024,Lihini Hemanthika,Puttalam,Puttalam,North Western,5811,447,6258,232440,17880,250320
11/18/2024,Lihini Hemanthika,Puttalam,Puttalam,North Western,8495,245,8740,339800,9800,349600
11/19/2024,Lihini Hemanthika,Puttalam,Puttalam,North Western,7024,1281,8305,280960,51240,332200
11/20/2024,Lihini Hemanthika,Puttalam,Puttalam,North Western,818,7984,8802,32720,319360,352080
11/21/2024,Lihini Hemanthika,Puttalam,Puttalam,North Western,4946,1973,6919,197840,78920,276760
11/22/2024,Lihini Hemanthika,Puttalam,Puttalam,North Western,3762,4377,8139,150480,175080,325560
11/23/2024,Lihini Hemanthika,Puttalam,Puttalam,North Western,6726,5792,12518,269040,231680,500720
11/24/2024,Lihini Hemanthika,Puttalam,Puttalam,North Western,3777,4144,7921,151080,165760,316840
11/25/2024,Lihini Hemanthika,Puttalam,Puttalam,North Western,213,9158,9371,8520,366320,374840
11/26/2024,Lihini Hemanthika,Puttalam,Puttalam,North Western,1876,853,2729,75040,34120,109160
11/27/2024,Lihini Hemanthika,Puttalam,Puttalam,North Western,5528,3520,9048,221120,140800,361920
11/28/2024,Lihini Hemanthika,Puttalam,Puttalam,North Western,7267,7268,14535,290680,290720,581400
11/29/2024,Lihini Hemanthika,Puttalam,Puttalam,North Western,5390,4299,9689,215600,171960,387560
11/30/2024,Lihini Hemanthika,Puttalam,Puttalam,North Western,1316,8256,9572,52640,330240,382880
12/1/2024,Lihini Hemanthika,Puttalam,Puttalam,North Western,5893,9182,15075,235720,367280,603000
12/2/2024,Lihini Hemanthika,Puttalam,Puttalam,North Western,4580,2144,6724,183200,85760,268960
12/3/2024,Lihini Hemanthika,Puttalam,Puttalam,North Western,1279,5142,6421,51160,205680,256840
12/4/2024,Lihini Hemanthika,Puttalam,Puttalam,North Western,6870,922,7792,274800,36880,311680
12/5/2024,Lihini Hemanthika,Puttalam,Puttalam,North Western,6433,3350,9783,257320,134000,391320
12/6/2024,Lihini Hemanthika,Puttalam,Puttalam,North Western,4004,9694,13698,160160,387760,547920
12/7/2024,Lihini Hemanthika,Puttalam,Puttalam,North Western,3677,2176,5853,147080,87040,234120
12/8/2024,Lihini Hemanthika,Puttalam,Puttalam,North Western,4745,6312,11057,189800,252480,442280
12/9/2024,Lihini Hemanthika,Puttalam,Puttalam,North Western,73,7600,7673,2920,304000,306920
12/10/2024,Lihini Hemanthika,Puttalam,Puttalam,North Western,869,44,913,34760,1760,36520
12/11/2024,Lihini Hemanthika,Puttalam,Puttalam,North Western,4124,7546,11670,164960,301840,466800
12/12/2024,Lihini Hemanthika,Puttalam,Puttalam,North Western,5650,4961,10611,226000,198440,424440
12/13/2024,Lihini Hemanthika,Puttalam,Puttalam,North Western,1444,8378,9822,57760,335120,392880
12/14/2024,Lihini Hemanthika,Puttalam,Puttalam,North Western,7223,8681,15904,288920,347240,636160
12/15/2024,Lihini Hemanthika,Puttalam,Puttalam,North Western,8604,2556,11160,344160,102240,446400
12/16/2024,Lihini Hemanthika,Puttalam,Puttalam,North Western,9242,6792,16034,369680,271680,641360
12/17/2024,Lihini Hemanthika,Puttalam,Puttalam,North Western,104,8280,8384,4160,331200,335360
12/18/2024,Lihini Hemanthika,Puttalam,Puttalam,North Western,9592,8044,17636,383680,321760,705440
12/19/2024,Lihini Hemanthika,Puttalam,Puttalam,North Western,9106,9678,18784,364240,387120,751360
12/20/2024,Lihini Hemanthika,Puttalam,Puttalam,North Western,5696,5122,10818,227840,204880,432720
12/21/2024,Lihini Hemanthika,Puttalam,Puttalam,North Western,761,902,1663,30440,36080,66520
12/22/2024,Lihini Hemanthika,Puttalam,Puttalam,North Western,9978,3601,13579,399120,144040,543160
12/23/2024,Lihini Hemanthika,Puttalam,Puttalam,North Western,1111,2360,3471,44440,94400,138840
12/24/2024,Lihini Hemanthika,Puttalam,Puttalam,North Western,474,4573,5047,18960,182920,201880
12/25/2024,Lihini Hemanthika,Puttalam,Puttalam,North Western,9706,8178,17884,388240,327120,715360
12/26/2024,Lihini Hemanthika,Puttalam,Puttalam,North Western,8248,2176,10424,329920,87040,416960
12/27/2024,Lihini Hemanthika,Puttalam,Puttalam,North Western,8240,7333,15573,329600,293320,622920
12/28/2024,Lihini Hemanthika,Puttalam,Puttalam,North Western,3540,7423,10963,141600,296920,438520
12/29/2024,Lihini Hemanthika,Puttalam,Puttalam,North Western,3481,1052,4533,139240,42080,181320
12/30/2024,Lihini Hemanthika,Puttalam,Puttalam,North Western,200,4552,4752,8000,182080,190080
12/31/2024,Lihini Hemanthika,Puttalam,Puttalam,North Western,9901,3548,13449,396040,141920,537960
1/1/2025,Lihini Hemanthika,Puttalam,Puttalam,North Western,6511,3829,10340,260440,153160,413600
1/2/2025,Lihini Hemanthika,Puttalam,Puttalam,North Western,9930,7078,17008,397200,283120,680320
1/3/2025,Lihini Hemanthika,Puttalam,Puttalam,North Western,8873,1155,10028,354920,46200,401120
1/4/2025,Lihini Hemanthika,Puttalam,Puttalam,North Western,9622,6134,15756,384880,245360,630240
1/5/2025,Lihini Hemanthika,Puttalam,Puttalam,North Western,2608,5617,8225,104320,224680,329000
1/6/2025,Lihini Hemanthika,Puttalam,Puttalam,North Western,7066,1181,8247,282640,47240,329880
1/7/2025,Lihini Hemanthika,Puttalam,Puttalam,North Western,7071,3056,10127,282840,122240,405080
1/8/2025,Lihini Hemanthika,Puttalam,Puttalam,North Western,4830,8484,13314,193200,339360,532560
1/9/2025,Lihini Hemanthika,Puttalam,Puttalam,North Western,7350,5992,13342,294000,239680,533680
1/10/2025,Lihini Hemanthika,Puttalam,Puttalam,North Western,7842,9508,17350,313680,380320,694000
1/11/2025,Lihini Hemanthika,Puttalam,Puttalam,North Western,9680,6082,15762,387200,243280,630480
1/12/2025,Lihini Hemanthika,Puttalam,Puttalam,North Western,4769,9177,13946,190760,367080,557840
1/13/2025,Lihini Hemanthika,Puttalam,Puttalam,North Western,6846,4916,11762,273840,196640,470480
1/14/2025,Lihini Hemanthika,Puttalam,Puttalam,North Western,1248,8680,9928,49920,347200,397120
1/15/2025,Lihini Hemanthika,Puttalam,Puttalam,North Western,4756,9087,13843,190240,363480,553720
1/16/2025,Lihini Hemanthika,Puttalam,Puttalam,North Western,6343,9135,15478,253720,365400,619120
1/17/2025,Lihini Hemanthika,Puttalam,Puttalam,North Western,1171,8378,9549,46840,335120,381960
1/18/2025,Lihini Hemanthika,Puttalam,Puttalam,North Western,7955,3731,11686,318200,149240,467440
1/19/2025,Lihini Hemanthika,Puttalam,Puttalam,North Western,8942,2417,11359,357680,96680,454360
1/20/2025,Lihini Hemanthika,Puttalam,Puttalam,North Western,5328,706,6034,213120,28240,241360
1/21/2025,Lihini Hemanthika,Puttalam,Puttalam,North Western,2642,1158,3800,105680,46320,152000
1/22/2025,Lihini Hemanthika,Puttalam,Puttalam,North Western,6553,1411,7964,262120,56440,318560
1/23/2025,Lihini Hemanthika,Puttalam,Puttalam,North Western,8637,9816,18453,345480,392640,738120
1/24/2025,Lihini Hemanthika,Puttalam,Puttalam,North Western,5429,2429,7858,217160,97160,314320
1/25/2025,Lihini Hemanthika,Puttalam,Puttalam,North Western,6118,5815,11933,244720,232600,477320
1/26/2025,Lihini Hemanthika,Puttalam,Puttalam,North Western,8368,7531,15899,334720,301240,635960
1/27/2025,Lihini Hemanthika,Puttalam,Puttalam,North Western,6380,6871,13251,255200,274840,530040
1/28/2025,Lihini Hemanthika,Puttalam,Puttalam,North Western,5862,2176,8038,234480,87040,321520
1/29/2025,Lihini Hemanthika,Puttalam,Puttalam,North Western,1199,3112,4311,47960,124480,172440
1/30/2025,Lihini Hemanthika,Puttalam,Puttalam,North Western,4239,7418,11657,169560,296720,466280
1/31/2025,Lihini Hemanthika,Puttalam,Puttalam,North Western,5306,1222,6528,212240,48880,261120
2/1/2025,Lihini Hemanthika,Puttalam,Puttalam,North Western,3374,2221,5595,134960,88840,223800
2/2/2025,Lihini Hemanthika,Puttalam,Puttalam,North Western,2013,675,2688,80520,27000,107520
2/3/2025,Lihini Hemanthika,Puttalam,Puttalam,North Western,4590,2874,7464,183600,114960,298560
2/4/2025,Lihini Hemanthika,Puttalam,Puttalam,North Western,7061,3660,10721,282440,146400,428840
2/5/2025,Lihini Hemanthika,Puttalam,Puttalam,North Western,3245,8389,11634,129800,335560,465360
2/6/2025,Lihini Hemanthika,Puttalam,Puttalam,North Western,2455,7784,10239,98200,311360,409560
2/7/2025,Lihini Hemanthika,Puttalam,Puttalam,North Western,5631,5044,10675,225240,201760,427000
2/8/2025,Lihini Hemanthika,Puttalam,Puttalam,North Western,1244,4323,5567,49760,172920,222680
2/9/2025,Lihini Hemanthika,Puttalam,Puttalam,North Western,3648,1303,4951,145920,52120,198040
2/10/2025,Lihini Hemanthika,Puttalam,Puttalam,North Western,3895,1711,5606,155800,68440,224240
2/11/2025,Lihini Hemanthika,Puttalam,Puttalam,North Western,3313,9288,12601,132520,371520,504040
2/12/2025,Lihini Hemanthika,Puttalam,Puttalam,North Western,5352,5358,10710,214080,214320,428400
2/13/2025,Lihini Hemanthika,Puttalam,Puttalam,North Western,5042,670,5712,201680,26800,228480
2/14/2025,Lihini Hemanthika,Puttalam,Puttalam,North Western,1834,6053,7887,73360,242120,315480
2/15/2025,Lihini Hemanthika,Puttalam,Puttalam,North Western,6655,9091,15746,266200,363640,629840
2/16/2025,Lihini Hemanthika,Puttalam,Puttalam,North Western,8511,4272,12783,340440,170880,511320
2/17/2025,Lihini Hemanthika,Puttalam,Puttalam,North Western,7305,5788,13093,292200,231520,523720
2/18/2025,Lihini Hemanthika,Puttalam,Puttalam,North Western,528,5828,6356,21120,233120,254240
2/19/2025,Lihini Hemanthika,Puttalam,Puttalam,North Western,1231,4194,5425,49240,167760,217000
2/20/2025,Lihini Hemanthika,Puttalam,Puttalam,North Western,2953,283,3236,118120,11320,129440
2/21/2025,Lihini Hemanthika,Puttalam,Puttalam,North Western,142,1672,1814,5680,66880,72560
2/22/2025,Lihini Hemanthika,Puttalam,Puttalam,North Western,4151,2229,6380,166040,89160,255200
2/23/2025,Lihini Hemanthika,Puttalam,Puttalam,North Western,6077,3225,9302,243080,129000,372080
2/24/2025,Lihini Hemanthika,Puttalam,Puttalam,North Western,8331,8726,17057,333240,349040,682280
2/25/2025,Lihini Hemanthika,Puttalam,Puttalam,North Western,2429,7665,10094,97160,306600,403760
2/26/2025,Lihini Hemanthika,Puttalam,Puttalam,North Western,8442,2363,10805,337680,94520,432200
2/27/2025,Lihini Hemanthika,Puttalam,Puttalam,North Western,4237,5673,9910,169480,226920,396400
2/28/2025,Lihini Hemanthika,Puttalam,Puttalam,North Western,6273,9415,15688,250920,376600,627520
3/1/2025,Lihini Hemanthika,Puttalam,Puttalam,North Western,4619,1116,5735,184760,44640,229400
3/2/2025,Lihini Hemanthika,Puttalam,Puttalam,North Western,1290,4092,5382,51600,163680,215280
3/3/2025,Lihini Hemanthika,Puttalam,Puttalam,North Western,3059,9453,12512,122360,378120,500480
3/4/2025,Lihini Hemanthika,Puttalam,Puttalam,North Western,5860,5023,10883,234400,200920,435320
3/5/2025,Lihini Hemanthika,Puttalam,Puttalam,North Western,1434,6087,7521,57360,243480,300840
3/6/2025,Lihini Hemanthika,Puttalam,Puttalam,North Western,3904,1975,5879,156160,79000,235160
3/7/2025,Lihini Hemanthika,Puttalam,Puttalam,North Western,4783,7541,12324,191320,301640,492960
3/8/2025,Lihini Hemanthika,Puttalam,Puttalam,North Western,1318,1517,2835,52720,60680,113400
3/9/2025,Lihini Hemanthika,Puttalam,Puttalam,North Western,8576,7379,15955,343040,295160,638200
3/10/2025,Lihini Hemanthika,Puttalam,Puttalam,North Western,8682,5238,13920,347280,209520,556800
3/11/2025,Lihini Hemanthika,Puttalam,Puttalam,North Western,2218,3560,5778,88720,142400,231120
3/12/2025,Lihini Hemanthika,Puttalam,Puttalam,North Western,5276,8546,13822,211040,341840,552880
3/13/2025,Lihini Hemanthika,Puttalam,Puttalam,North Western,7370,177,7547,294800,7080,301880
3/14/2025,Lihini Hemanthika,Puttalam,Puttalam,North Western,7097,8004,15101,283880,320160,604040
3/15/2025,Lihini Hemanthika,Puttalam,Puttalam,North Western,7969,2069,10038,318760,82760,401520
3/16/2025,Lihini Hemanthika,Puttalam,Puttalam,North Western,8636,9524,18160,345440,380960,726400
3/17/2025,Lihini Hemanthika,Puttalam,Puttalam,North Western,214,8616,8830,8560,344640,353200
3/18/2025,Lihini Hemanthika,Puttalam,Puttalam,North Western,2281,6917,9198,91240,276680,367920
3/19/2025,Lihini Hemanthika,Puttalam,Puttalam,North Western,8769,3258,12027,350760,130320,481080
3/20/2025,Lihini Hemanthika,Puttalam,Puttalam,North Western,2205,1865,4070,88200,74600,162800
3/21/2025,Lihini Hemanthika,Puttalam,Puttalam,North Western,787,1635,2422,31480,65400,96880
3/22/2025,Lihini Hemanthika,Puttalam,Puttalam,North Western,6363,3296,9659,254520,131840,386360
3/23/2025,Lihini Hemanthika,Puttalam,Puttalam,North Western,3689,6725,10414,147560,269000,416560
3/25/2024,Janaka Kularatne,Puttalam,Chilaw,North Western,3842,1337,5179,153680,53480,207160
3/26/2024,Janaka Kularatne,Puttalam,Chilaw,North Western,1691,7998,9689,67640,319920,387560
3/27/2024,Janaka Kularatne,Puttalam,Chilaw,North Western,8625,1524,10149,345000,60960,405960
3/28/2024,Janaka Kularatne,Puttalam,Chilaw,North Western,8826,5717,14543,353040,228680,581720
3/29/2024,Janaka Kularatne,Puttalam,Chilaw,North Western,2554,6117,8671,102160,244680,346840
3/30/2024,Janaka Kularatne,Puttalam,Chilaw,North Western,9517,8616,18133,380680,344640,725320
3/31/2024,Janaka Kularatne,Puttalam,Chilaw,North Western,4969,4703,9672,198760,188120,386880
4/1/2024,Janaka Kularatne,Puttalam,Chilaw,North Western,6939,9007,15946,277560,360280,637840
4/2/2024,Janaka Kularatne,Puttalam,Chilaw,North Western,5949,3063,9012,237960,122520,360480
4/3/2024,Janaka Kularatne,Puttalam,Chilaw,North Western,5455,8743,14198,218200,349720,567920
4/4/2024,Janaka Kularatne,Puttalam,Chilaw,North Western,3820,3837,7657,152800,153480,306280
4/5/2024,Janaka Kularatne,Puttalam,Chilaw,North Western,6743,6469,13212,269720,258760,528480
4/6/2024,Janaka Kularatne,Puttalam,Chilaw,North Western,3839,6697,10536,153560,267880,421440
4/7/2024,Janaka Kularatne,Puttalam,Chilaw,North Western,2034,5624,7658,81360,224960,306320
4/8/2024,Janaka Kularatne,Puttalam,Chilaw,North Western,7539,656,8195,301560,26240,327800
4/9/2024,Janaka Kularatne,Puttalam,Chilaw,North Western,9856,6809,16665,394240,272360,666600
4/10/2024,Janaka Kularatne,Puttalam,Chilaw,North Western,8548,6360,14908,341920,254400,596320
4/11/2024,Janaka Kularatne,Puttalam,Chilaw,North Western,9348,6873,16221,373920,274920,648840
4/19/2024,Janaka Kularatne,Puttalam,Chilaw,North Western,6951,6774,13725,278040,270960,549000
4/20/2024,Janaka Kularatne,Puttalam,Chilaw,North Western,4959,4771,9730,198360,190840,389200
4/21/2024,Janaka Kularatne,Puttalam,Chilaw,North Western,145,1300,1445,5800,52000,57800
4/22/2024,Janaka Kularatne,Puttalam,Chilaw,North Western,2069,2665,4734,82760,106600,189360
4/23/2024,Janaka Kularatne,Puttalam,Chilaw,North Western,6874,1518,8392,274960,60720,335680
4/24/2024,Janaka Kularatne,Puttalam,Chilaw,North Western,4955,4060,9015,198200,162400,360600
4/25/2024,Janaka Kularatne,Puttalam,Chilaw,North Western,4320,2333,6653,172800,93320,266120
4/26/2024,Janaka Kularatne,Puttalam,Chilaw,North Western,4940,7606,12546,197600,304240,501840
4/27/2024,Janaka Kularatne,Puttalam,Chilaw,North Western,2424,4423,6847,96960,176920,273880
4/28/2024,Janaka Kularatne,Puttalam,Chilaw,North Western,8667,2645,11312,346680,105800,452480
4/29/2024,Janaka Kularatne,Puttalam,Chilaw,North Western,3578,3809,7387,143120,152360,295480
4/30/2024,Janaka Kularatne,Puttalam,Chilaw,North Western,2235,3332,5567,89400,133280,222680
5/1/2024,Janaka Kularatne,Puttalam,Chilaw,North Western,309,4407,4716,12360,176280,188640
5/2/2024,Janaka Kularatne,Puttalam,Chilaw,North Western,344,5592,5936,13760,223680,237440
5/3/2024,Janaka Kularatne,Puttalam,Chilaw,North Western,7879,396,8275,315160,15840,331000
5/4/2024,Janaka Kularatne,Puttalam,Chilaw,North Western,5220,7757,12977,208800,310280,519080
5/5/2024,Janaka Kularatne,Puttalam,Chilaw,North Western,287,9962,10249,11480,398480,409960
5/6/2024,Janaka Kularatne,Puttalam,Chilaw,North Western,5908,5565,11473,236320,222600,458920
5/7/2024,Janaka Kularatne,Puttalam,Chilaw,North Western,2413,218,2631,96520,8720,105240
5/8/2024,Janaka Kularatne,Puttalam,Chilaw,North Western,3923,6655,10578,156920,266200,423120
5/9/2024,Janaka Kularatne,Puttalam,Chilaw,North Western,9971,9744,19715,398840,389760,788600
5/10/2024,Janaka Kularatne,Puttalam,Chilaw,North Western,8458,2638,11096,338320,105520,443840
5/11/2024,Janaka Kularatne,Puttalam,Chilaw,North Western,3938,3602,7540,157520,144080,301600
5/12/2024,Janaka Kularatne,Puttalam,Chilaw,North Western,339,8875,9214,13560,355000,368560
5/13/2024,Janaka Kularatne,Puttalam,Chilaw,North Western,4419,5664,10083,176760,226560,403320
5/14/2024,Janaka Kularatne,Puttalam,Chilaw,North Western,931,3185,4116,37240,127400,164640
5/15/2024,Janaka Kularatne,Puttalam,Chilaw,North Western,3938,1356,5294,157520,54240,211760
5/16/2024,Janaka Kularatne,Puttalam,Chilaw,North Western,7684,4487,12171,307360,179480,486840
5/17/2024,Janaka Kularatne,Puttalam,Chilaw,North Western,9493,4367,13860,379720,174680,554400
5/18/2024,Janaka Kularatne,Puttalam,Chilaw,North Western,6829,6395,13224,273160,255800,528960
5/19/2024,Janaka Kularatne,Puttalam,Chilaw,North Western,1399,4396,5795,55960,175840,231800
5/20/2024,Janaka Kularatne,Puttalam,Chilaw,North Western,2585,245,2830,103400,9800,113200
5/21/2024,Janaka Kularatne,Puttalam,Chilaw,North Western,3418,595,4013,136720,23800,160520
5/22/2024,Janaka Kularatne,Puttalam,Chilaw,North Western,4110,3043,7153,164400,121720,286120
5/24/2024,Janaka Kularatne,Puttalam,Chilaw,North Western,8489,3847,12336,339560,153880,493440
5/25/2024,Janaka Kularatne,Puttalam,Chilaw,North Western,3119,3345,6464,124760,133800,258560
5/26/2024,Janaka Kularatne,Puttalam,Chilaw,North Western,6337,6744,13081,253480,269760,523240
5/27/2024,Janaka Kularatne,Puttalam,Chilaw,North Western,37,6899,6936,1480,275960,277440
5/28/2024,Janaka Kularatne,Puttalam,Chilaw,North Western,7299,6517,13816,291960,260680,552640
5/29/2024,Janaka Kularatne,Puttalam,Chilaw,North Western,5138,8189,13327,205520,327560,533080
5/30/2024,Janaka Kularatne,Puttalam,Chilaw,North Western,4492,1116,5608,179680,44640,224320
5/31/2024,Janaka Kularatne,Puttalam,Chilaw,North Western,8935,7841,16776,357400,313640,671040
6/1/2024,Janaka Kularatne,Puttalam,Chilaw,North Western,4153,9177,13330,166120,367080,533200
6/2/2024,Janaka Kularatne,Puttalam,Chilaw,North Western,2988,6312,9300,119520,252480,372000
6/3/2024,Janaka Kularatne,Puttalam,Chilaw,North Western,9006,6723,15729,360240,268920,629160
6/4/2024,Janaka Kularatne,Puttalam,Chilaw,North Western,325,6486,6811,13000,259440,272440
6/5/2024,Janaka Kularatne,Puttalam,Chilaw,North Western,6421,7239,13660,256840,289560,546400
6/6/2024,Janaka Kularatne,Puttalam,Chilaw,North Western,9686,1085,10771,387440,43400,430840
6/7/2024,Janaka Kularatne,Puttalam,Chilaw,North Western,4075,1100,5175,163000,44000,207000
6/8/2024,Janaka Kularatne,Puttalam,Chilaw,North Western,3517,8993,12510,140680,359720,500400
6/9/2024,Janaka Kularatne,Puttalam,Chilaw,North Western,5341,9876,15217,213640,395040,608680
6/10/2024,Janaka Kularatne,Puttalam,Chilaw,North Western,556,6876,7432,22240,275040,297280
6/11/2024,Janaka Kularatne,Puttalam,Chilaw,North Western,6043,6796,12839,241720,271840,513560
6/12/2024,Janaka Kularatne,Puttalam,Chilaw,North Western,8131,2143,10274,325240,85720,410960
6/13/2024,Janaka Kularatne,Puttalam,Chilaw,North Western,1346,2629,3975,53840,105160,159000
6/14/2024,Janaka Kularatne,Puttalam,Chilaw,North Western,1405,1481,2886,56200,59240,115440
6/15/2024,Janaka Kularatne,Puttalam,Chilaw,North Western,6498,9787,16285,259920,391480,651400
6/16/2024,Janaka Kularatne,Puttalam,Chilaw,North Western,2001,5380,7381,80040,215200,295240
6/17/2024,Janaka Kularatne,Puttalam,Chilaw,North Western,7273,433,7706,290920,17320,308240
6/18/2024,Janaka Kularatne,Puttalam,Chilaw,North Western,5412,1503,6915,216480,60120,276600
6/19/2024,Janaka Kularatne,Puttalam,Chilaw,North Western,9643,1009,10652,385720,40360,426080
6/20/2024,Janaka Kularatne,Puttalam,Chilaw,North Western,6097,3861,9958,243880,154440,398320
6/21/2024,Janaka Kularatne,Puttalam,Chilaw,North Western,7052,6531,13583,282080,261240,543320
6/22/2024,Janaka Kularatne,Puttalam,Chilaw,North Western,240,3062,3302,9600,122480,132080
6/23/2024,Janaka Kularatne,Puttalam,Chilaw,North Western,3953,798,4751,158120,31920,190040
6/24/2024,Janaka Kularatne,Puttalam,Chilaw,North Western,5039,2555,7594,201560,102200,303760
6/25/2024,Janaka Kularatne,Puttalam,Chilaw,North Western,1343,7281,8624,53720,291240,344960
6/26/2024,Janaka Kularatne,Puttalam,Chilaw,North Western,1046,1628,2674,41840,65120,106960
6/27/2024,Janaka Kularatne,Puttalam,Chilaw,North Western,683,5462,6145,27320,218480,245800
6/28/2024,Janaka Kularatne,Puttalam,Chilaw,North Western,7289,8891,16180,291560,355640,647200
6/29/2024,Janaka Kularatne,Puttalam,Chilaw,North Western,7330,3051,10381,293200,122040,415240
6/30/2024,Janaka Kularatne,Puttalam,Chilaw,North Western,7178,1990,9168,287120,79600,366720
7/1/2024,Janaka Kularatne,Puttalam,Chilaw,North Western,7593,6548,14141,303720,261920,565640
7/2/2024,Janaka Kularatne,Puttalam,Chilaw,North Western,2393,6855,9248,95720,274200,369920
7/3/2024,Janaka Kularatne,Puttalam,Chilaw,North Western,3425,1824,5249,137000,72960,209960
7/4/2024,Janaka Kularatne,Puttalam,Chilaw,North Western,4392,2680,7072,175680,107200,282880
7/5/2024,Janaka Kularatne,Puttalam,Chilaw,North Western,2585,8909,11494,103400,356360,459760
7/6/2024,Janaka Kularatne,Puttalam,Chilaw,North Western,3609,8539,12148,144360,341560,485920
7/7/2024,Janaka Kularatne,Puttalam,Chilaw,North Western,1843,9241,11084,73720,369640,443360
7/8/2024,Janaka Kularatne,Puttalam,Chilaw,North Western,4339,9019,13358,173560,360760,534320
7/9/2024,Janaka Kularatne,Puttalam,Chilaw,North Western,7442,6491,13933,297680,259640,557320
7/10/2024,Janaka Kularatne,Puttalam,Chilaw,North Western,9027,1779,10806,361080,71160,432240
7/11/2024,Janaka Kularatne,Puttalam,Chilaw,North Western,1581,5516,7097,63240,220640,283880
7/12/2024,Janaka Kularatne,Puttalam,Chilaw,North Western,2613,3344,5957,104520,133760,238280
7/13/2024,Janaka Kularatne,Puttalam,Chilaw,North Western,9069,4617,13686,362760,184680,547440
7/14/2024,Janaka Kularatne,Puttalam,Chilaw,North Western,8084,17,8101,323360,680,324040
7/15/2024,Janaka Kularatne,Puttalam,Chilaw,North Western,6534,2799,9333,261360,111960,373320
7/16/2024,Janaka Kularatne,Puttalam,Chilaw,North Western,2068,3693,5761,82720,147720,230440
7/17/2024,Janaka Kularatne,Puttalam,Chilaw,North Western,1069,3952,5021,42760,158080,200840
7/18/2024,Janaka Kularatne,Puttalam,Chilaw,North Western,6162,7423,13585,246480,296920,543400
7/19/2024,Janaka Kularatne,Puttalam,Chilaw,North Western,7879,3165,11044,315160,126600,441760
7/20/2024,Janaka Kularatne,Puttalam,Chilaw,North Western,7222,6835,14057,288880,273400,562280
7/21/2024,Janaka Kularatne,Puttalam,Chilaw,North Western,4777,6414,11191,191080,256560,447640
7/22/2024,Janaka Kularatne,Puttalam,Chilaw,North Western,9102,1404,10506,364080,56160,420240
7/23/2024,Janaka Kularatne,Puttalam,Chilaw,North Western,9500,3512,13012,380000,140480,520480
7/24/2024,Janaka Kularatne,Puttalam,Chilaw,North Western,8292,744,9036,331680,29760,361440
7/25/2024,Janaka Kularatne,Puttalam,Chilaw,North Western,8095,9480,17575,323800,379200,703000
7/26/2024,Janaka Kularatne,Puttalam,Chilaw,North Western,5042,3041,8083,201680,121640,323320
7/27/2024,Janaka Kularatne,Puttalam,Chilaw,North Western,7563,7208,14771,302520,288320,590840
7/28/2024,Janaka Kularatne,Puttalam,Chilaw,North Western,4002,5800,9802,160080,232000,392080
7/29/2024,Janaka Kularatne,Puttalam,Chilaw,North Western,3582,3640,7222,143280,145600,288880
7/30/2024,Janaka Kularatne,Puttalam,Chilaw,North Western,3128,247,3375,125120,9880,135000
7/31/2024,Janaka Kularatne,Puttalam,Chilaw,North Western,8733,9993,18726,349320,399720,749040
8/1/2024,Janaka Kularatne,Puttalam,Chilaw,North Western,9566,2328,11894,382640,93120,475760
8/2/2024,Janaka Kularatne,Puttalam,Chilaw,North Western,8885,9788,18673,355400,391520,746920
8/3/2024,Janaka Kularatne,Puttalam,Chilaw,North Western,2689,9439,12128,107560,377560,485120
8/4/2024,Janaka Kularatne,Puttalam,Chilaw,North Western,1767,230,1997,70680,9200,79880
8/5/2024,Janaka Kularatne,Puttalam,Chilaw,North Western,7130,3417,10547,285200,136680,421880
8/6/2024,Janaka Kularatne,Puttalam,Chilaw,North Western,6283,1843,8126,251320,73720,325040
8/7/2024,Janaka Kularatne,Puttalam,Chilaw,North Western,2155,1830,3985,86200,73200,159400
8/8/2024,Janaka Kularatne,Puttalam,Chilaw,North Western,2574,3911,6485,102960,156440,259400
8/9/2024,Janaka Kularatne,Puttalam,Chilaw,North Western,1897,4786,6683,75880,191440,267320
8/10/2024,Janaka Kularatne,Puttalam,Chilaw,North Western,9010,7252,16262,360400,290080,650480
8/11/2024,Janaka Kularatne,Puttalam,Chilaw,North Western,4648,8167,12815,185920,326680,512600
8/12/2024,Janaka Kularatne,Puttalam,Chilaw,North Western,6904,524,7428,276160,20960,297120
8/13/2024,Janaka Kularatne,Puttalam,Chilaw,North Western,301,4176,4477,12040,167040,179080
8/14/2024,Janaka Kularatne,Puttalam,Chilaw,North Western,8623,4247,12870,344920,169880,514800
8/15/2024,Janaka Kularatne,Puttalam,Chilaw,North Western,2993,6293,9286,119720,251720,371440
8/16/2024,Janaka Kularatne,Puttalam,Chilaw,North Western,1998,6094,8092,79920,243760,323680
8/17/2024,Janaka Kularatne,Puttalam,Chilaw,North Western,5345,314,5659,213800,12560,226360
8/18/2024,Janaka Kularatne,Puttalam,Chilaw,North Western,9638,6737,16375,385520,269480,655000
8/19/2024,Janaka Kularatne,Puttalam,Chilaw,North Western,9661,438,10099,386440,17520,403960
8/20/2024,Janaka Kularatne,Puttalam,Chilaw,North Western,7707,2351,10058,308280,94040,402320
8/21/2024,Janaka Kularatne,Puttalam,Chilaw,North Western,9884,7319,17203,395360,292760,688120
8/22/2024,Janaka Kularatne,Puttalam,Chilaw,North Western,4678,969,5647,187120,38760,225880
8/23/2024,Janaka Kularatne,Puttalam,Chilaw,North Western,1103,923,2026,44120,36920,81040
8/24/2024,Janaka Kularatne,Puttalam,Chilaw,North Western,6254,2612,8866,250160,104480,354640
8/25/2024,Janaka Kularatne,Puttalam,Chilaw,North Western,250,2838,3088,10000,113520,123520
8/26/2024,Janaka Kularatne,Puttalam,Chilaw,North Western,4849,7340,12189,193960,293600,487560
8/27/2024,Janaka Kularatne,Puttalam,Chilaw,North Western,3936,7163,11099,157440,286520,443960
8/28/2024,Janaka Kularatne,Puttalam,Chilaw,North Western,3195,7996,11191,127800,319840,447640
8/29/2024,Janaka Kularatne,Puttalam,Chilaw,North Western,8537,9039,17576,341480,361560,703040
8/30/2024,Janaka Kularatne,Puttalam,Chilaw,North Western,6855,9445,16300,274200,377800,652000
8/31/2024,Janaka Kularatne,Puttalam,Chilaw,North Western,2412,5273,7685,96480,210920,307400
9/1/2024,Janaka Kularatne,Puttalam,Chilaw,North Western,1438,360,1798,57520,14400,71920
9/2/2024,Janaka Kularatne,Puttalam,Chilaw,North Western,4831,5426,10257,193240,217040,410280
9/3/2024,Janaka Kularatne,Puttalam,Chilaw,North Western,8594,6118,14712,343760,244720,588480
9/4/2024,Janaka Kularatne,Puttalam,Chilaw,North Western,7980,3312,11292,319200,132480,451680
9/5/2024,Janaka Kularatne,Puttalam,Chilaw,North Western,3277,8141,11418,131080,325640,456720
9/6/2024,Janaka Kularatne,Puttalam,Chilaw,North Western,5667,106,5773,226680,4240,230920
9/7/2024,Janaka Kularatne,Puttalam,Chilaw,North Western,6697,1450,8147,267880,58000,325880
9/8/2024,Janaka Kularatne,Puttalam,Chilaw,North Western,8087,3135,11222,323480,125400,448880
9/9/2024,Janaka Kularatne,Puttalam,Chilaw,North Western,6672,536,7208,266880,21440,288320
9/10/2024,Janaka Kularatne,Puttalam,Chilaw,North Western,3134,1030,4164,125360,41200,166560
9/11/2024,Janaka Kularatne,Puttalam,Chilaw,North Western,5123,4217,9340,204920,168680,373600
9/12/2024,Janaka Kularatne,Puttalam,Chilaw,North Western,9374,154,9528,374960,6160,381120
9/13/2024,Janaka Kularatne,Puttalam,Chilaw,North Western,5809,4332,10141,232360,173280,405640
9/14/2024,Janaka Kularatne,Puttalam,Chilaw,North Western,6848,7925,14773,273920,317000,590920
9/15/2024,Janaka Kularatne,Puttalam,Chilaw,North Western,2292,131,2423,91680,5240,96920
9/16/2024,Janaka Kularatne,Puttalam,Chilaw,North Western,6577,3691,10268,263080,147640,410720
9/17/2024,Janaka Kularatne,Puttalam,Chilaw,North Western,5267,3617,8884,210680,144680,355360
9/18/2024,Janaka Kularatne,Puttalam,Chilaw,North Western,6210,1054,7264,248400,42160,290560
9/19/2024,Janaka Kularatne,Puttalam,Chilaw,North Western,3403,7059,10462,136120,282360,418480
9/20/2024,Janaka Kularatne,Puttalam,Chilaw,North Western,6058,8315,14373,242320,332600,574920
9/21/2024,Janaka Kularatne,Puttalam,Chilaw,North Western,46,4844,4890,1840,193760,195600
9/22/2024,Janaka Kularatne,Puttalam,Chilaw,North Western,5792,6239,12031,231680,249560,481240
9/23/2024,Janaka Kularatne,Puttalam,Chilaw,North Western,2937,1003,3940,117480,40120,157600
9/24/2024,Janaka Kularatne,Puttalam,Chilaw,North Western,3272,9272,12544,130880,370880,501760
9/25/2024,Janaka Kularatne,Puttalam,Chilaw,North Western,6093,9932,16025,243720,397280,641000
9/26/2024,Janaka Kularatne,Puttalam,Chilaw,North Western,5374,1739,7113,214960,69560,284520
9/27/2024,Janaka Kularatne,Puttalam,Chilaw,North Western,999,4706,5705,39960,188240,228200
9/28/2024,Janaka Kularatne,Puttalam,Chilaw,North Western,9384,1725,11109,375360,69000,444360
9/29/2024,Janaka Kularatne,Puttalam,Chilaw,North Western,6247,629,6876,249880,25160,275040
9/30/2024,Janaka Kularatne,Puttalam,Chilaw,North Western,7082,1674,8756,283280,66960,350240
10/1/2024,Janaka Kularatne,Puttalam,Chilaw,North Western,7590,4335,11925,303600,173400,477000
10/2/2024,Janaka Kularatne,Puttalam,Chilaw,North Western,1938,7968,9906,77520,318720,396240
10/3/2024,Janaka Kularatne,Puttalam,Chilaw,North Western,9666,6215,15881,386640,248600,635240
10/4/2024,Janaka Kularatne,Puttalam,Chilaw,North Western,7134,9875,17009,285360,395000,680360
10/5/2024,Janaka Kularatne,Puttalam,Chilaw,North Western,5701,204,5905,228040,8160,236200
10/6/2024,Janaka Kularatne,Puttalam,Chilaw,North Western,6628,9502,16130,265120,380080,645200
10/7/2024,Janaka Kularatne,Puttalam,Chilaw,North Western,4960,5070,10030,198400,202800,401200
10/8/2024,Janaka Kularatne,Puttalam,Chilaw,North Western,2151,2550,4701,86040,102000,188040
10/9/2024,Janaka Kularatne,Puttalam,Chilaw,North Western,8689,7019,15708,347560,280760,628320
10/10/2024,Janaka Kularatne,Puttalam,Chilaw,North Western,1563,9386,10949,62520,375440,437960
10/11/2024,Janaka Kularatne,Puttalam,Chilaw,North Western,3969,4257,8226,158760,170280,329040
10/12/2024,Janaka Kularatne,Puttalam,Chilaw,North Western,369,8072,8441,14760,322880,337640
10/13/2024,Janaka Kularatne,Puttalam,Chilaw,North Western,947,4222,5169,37880,168880,206760
10/14/2024,Janaka Kularatne,Puttalam,Chilaw,North Western,5534,7390,12924,221360,295600,516960
10/15/2024,Janaka Kularatne,Puttalam,Chilaw,North Western,524,3772,4296,20960,150880,171840
10/16/2024,Janaka Kularatne,Puttalam,Chilaw,North Western,926,49,975,37040,1960,39000
10/17/2024,Janaka Kularatne,Puttalam,Chilaw,North Western,4682,9807,14489,187280,392280,579560
10/18/2024,Janaka Kularatne,Puttalam,Chilaw,North Western,3004,8564,11568,120160,342560,462720
10/19/2024,Janaka Kularatne,Puttalam,Chilaw,North Western,9224,5819,15043,368960,232760,601720
10/20/2024,Janaka Kularatne,Puttalam,Chilaw,North Western,8748,8282,17030,349920,331280,681200
10/21/2024,Janaka Kularatne,Puttalam,Chilaw,North Western,707,2849,3556,28280,113960,142240
10/22/2024,Janaka Kularatne,Puttalam,Chilaw,North Western,8706,2405,11111,348240,96200,444440
10/23/2024,Janaka Kularatne,Puttalam,Chilaw,North Western,5124,1892,7016,204960,75680,280640
10/24/2024,Janaka Kularatne,Puttalam,Chilaw,North Western,4730,7109,11839,189200,284360,473560
10/25/2024,Janaka Kularatne,Puttalam,Chilaw,North Western,9542,4787,14329,381680,191480,573160
10/26/2024,Janaka Kularatne,Puttalam,Chilaw,North Western,7983,1586,9569,319320,63440,382760
10/27/2024,Janaka Kularatne,Puttalam,Chilaw,North Western,8957,4807,13764,358280,192280,550560
10/28/2024,Janaka Kularatne,Puttalam,Chilaw,North Western,5833,6820,12653,233320,272800,506120
10/29/2024,Janaka Kularatne,Puttalam,Chilaw,North Western,1400,4320,5720,56000,172800,228800
10/30/2024,Janaka Kularatne,Puttalam,Chilaw,North Western,4612,5771,10383,184480,230840,415320
10/31/2024,Janaka Kularatne,Puttalam,Chilaw,North Western,3886,2403,6289,155440,96120,251560
11/1/2024,Janaka Kularatne,Puttalam,Chilaw,North Western,8544,6398,14942,341760,255920,597680
11/2/2024,Janaka Kularatne,Puttalam,Chilaw,North Western,7688,393,8081,307520,15720,323240
11/3/2024,Janaka Kularatne,Puttalam,Chilaw,North Western,29,753,782,1160,30120,31280
11/4/2024,Janaka Kularatne,Puttalam,Chilaw,North Western,8877,278,9155,355080,11120,366200
11/5/2024,Janaka Kularatne,Puttalam,Chilaw,North Western,4253,4206,8459,170120,168240,338360
11/6/2024,Janaka Kularatne,Puttalam,Chilaw,North Western,7708,7022,14730,308320,280880,589200
11/7/2024,Janaka Kularatne,Puttalam,Chilaw,North Western,1870,1033,2903,74800,41320,116120
11/8/2024,Janaka Kularatne,Puttalam,Chilaw,North Western,8076,7739,15815,323040,309560,632600
11/9/2024,Janaka Kularatne,Puttalam,Chilaw,North Western,2960,1782,4742,118400,71280,189680
11/10/2024,Janaka Kularatne,Puttalam,Chilaw,North Western,7962,2851,10813,318480,114040,432520
11/11/2024,Janaka Kularatne,Puttalam,Chilaw,North Western,8012,2135,10147,320480,85400,405880
11/12/2024,Janaka Kularatne,Puttalam,Chilaw,North Western,2966,2558,5524,118640,102320,220960
11/13/2024,Janaka Kularatne,Puttalam,Chilaw,North Western,7394,2965,10359,295760,118600,414360
11/14/2024,Janaka Kularatne,Puttalam,Chilaw,North Western,7957,608,8565,318280,24320,342600
11/15/2024,Janaka Kularatne,Puttalam,Chilaw,North Western,8164,4899,13063,326560,195960,522520
11/16/2024,Janaka Kularatne,Puttalam,Chilaw,North Western,3812,4796,8608,152480,191840,344320
11/17/2024,Janaka Kularatne,Puttalam,Chilaw,North Western,9307,2045,11352,372280,81800,454080
11/18/2024,Janaka Kularatne,Puttalam,Chilaw,North Western,3690,3960,7650,147600,158400,306000
11/19/2024,Janaka Kularatne,Puttalam,Chilaw,North Western,893,3356,4249,35720,134240,169960
11/20/2024,Janaka Kularatne,Puttalam,Chilaw,North Western,3852,1707,5559,154080,68280,222360
11/21/2024,Janaka Kularatne,Puttalam,Chilaw,North Western,5607,6635,12242,224280,265400,489680
11/22/2024,Janaka Kularatne,Puttalam,Chilaw,North Western,8615,8851,17466,344600,354040,698640
11/23/2024,Janaka Kularatne,Puttalam,Chilaw,North Western,9209,2556,11765,368360,102240,470600
11/24/2024,Janaka Kularatne,Puttalam,Chilaw,North Western,8011,5873,13884,320440,234920,555360
11/25/2024,Janaka Kularatne,Puttalam,Chilaw,North Western,1271,7979,9250,50840,319160,370000
11/26/2024,Janaka Kularatne,Puttalam,Chilaw,North Western,4971,4617,9588,198840,184680,383520
11/27/2024,Janaka Kularatne,Puttalam,Chilaw,North Western,3963,8297,12260,158520,331880,490400
11/28/2024,Janaka Kularatne,Puttalam,Chilaw,North Western,3117,5025,8142,124680,201000,325680
11/29/2024,Janaka Kularatne,Puttalam,Chilaw,North Western,7051,5302,12353,282040,212080,494120
11/30/2024,Janaka Kularatne,Puttalam,Chilaw,North Western,4468,9448,13916,178720,377920,556640
12/1/2024,Janaka Kularatne,Puttalam,Chilaw,North Western,1135,9483,10618,45400,379320,424720
12/2/2024,Janaka Kularatne,Puttalam,Chilaw,North Western,8929,4897,13826,357160,195880,553040
12/3/2024,Janaka Kularatne,Puttalam,Chilaw,North Western,1010,8062,9072,40400,322480,362880
12/4/2024,Janaka Kularatne,Puttalam,Chilaw,North Western,1952,8055,10007,78080,322200,400280
12/5/2024,Janaka Kularatne,Puttalam,Chilaw,North Western,8435,5715,14150,337400,228600,566000
12/6/2024,Janaka Kularatne,Puttalam,Chilaw,North Western,8682,8463,17145,347280,338520,685800
12/7/2024,Janaka Kularatne,Puttalam,Chilaw,North Western,9368,1237,10605,374720,49480,424200
12/8/2024,Janaka Kularatne,Puttalam,Chilaw,North Western,5791,6792,12583,231640,271680,503320
12/9/2024,Janaka Kularatne,Puttalam,Chilaw,North Western,1659,6946,8605,66360,277840,344200
12/10/2024,Janaka Kularatne,Puttalam,Chilaw,North Western,9837,5849,15686,393480,233960,627440
12/11/2024,Janaka Kularatne,Puttalam,Chilaw,North Western,1279,2990,4269,51160,119600,170760
12/12/2024,Janaka Kularatne,Puttalam,Chilaw,North Western,3227,806,4033,129080,32240,161320
12/13/2024,Janaka Kularatne,Puttalam,Chilaw,North Western,2036,422,2458,81440,16880,98320
12/14/2024,Janaka Kularatne,Puttalam,Chilaw,North Western,6836,4356,11192,273440,174240,447680
12/15/2024,Janaka Kularatne,Puttalam,Chilaw,North Western,2579,9604,12183,103160,384160,487320
12/16/2024,Janaka Kularatne,Puttalam,Chilaw,North Western,8613,9485,18098,344520,379400,723920
12/17/2024,Janaka Kularatne,Puttalam,Chilaw,North Western,445,131,576,17800,5240,23040
12/18/2024,Janaka Kularatne,Puttalam,Chilaw,North Western,5898,4098,9996,235920,163920,399840
12/19/2024,Janaka Kularatne,Puttalam,Chilaw,North Western,2648,5657,8305,105920,226280,332200
12/20/2024,Janaka Kularatne,Puttalam,Chilaw,North Western,3210,6187,9397,128400,247480,375880
12/21/2024,Janaka Kularatne,Puttalam,Chilaw,North Western,5134,4371,9505,205360,174840,380200
12/22/2024,Janaka Kularatne,Puttalam,Chilaw,North Western,6122,7998,14120,244880,319920,564800
12/23/2024,Janaka Kularatne,Puttalam,Chilaw,North Western,2091,4472,6563,83640,178880,262520
12/24/2024,Janaka Kularatne,Puttalam,Chilaw,North Western,8820,6513,15333,352800,260520,613320
12/25/2024,Janaka Kularatne,Puttalam,Chilaw,North Western,3760,8041,11801,150400,321640,472040
12/26/2024,Janaka Kularatne,Puttalam,Chilaw,North Western,6507,5734,12241,260280,229360,489640
12/27/2024,Janaka Kularatne,Puttalam,Chilaw,North Western,6548,8133,14681,261920,325320,587240
12/28/2024,Janaka Kularatne,Puttalam,Chilaw,North Western,7156,5823,12979,286240,232920,519160
12/29/2024,Janaka Kularatne,Puttalam,Chilaw,North Western,9862,9433,19295,394480,377320,771800
12/30/2024,Janaka Kularatne,Puttalam,Chilaw,North Western,8292,4331,12623,331680,173240,504920
12/31/2024,Janaka Kularatne,Puttalam,Chilaw,North Western,245,9816,10061,9800,392640,402440
1/1/2025,Janaka Kularatne,Puttalam,Chilaw,North Western,5941,2373,8314,237640,94920,332560
1/2/2025,Janaka Kularatne,Puttalam,Chilaw,North Western,2003,8790,10793,80120,351600,431720
1/3/2025,Janaka Kularatne,Puttalam,Chilaw,North Western,1871,2524,4395,74840,100960,175800
1/4/2025,Janaka Kularatne,Puttalam,Chilaw,North Western,9693,132,9825,387720,5280,393000
1/5/2025,Janaka Kularatne,Puttalam,Chilaw,North Western,2744,3948,6692,109760,157920,267680
1/6/2025,Janaka Kularatne,Puttalam,Chilaw,North Western,6562,4411,10973,262480,176440,438920
1/7/2025,Janaka Kularatne,Puttalam,Chilaw,North Western,798,7228,8026,31920,289120,321040
1/8/2025,Janaka Kularatne,Puttalam,Chilaw,North Western,4152,3174,7326,166080,126960,293040
1/9/2025,Janaka Kularatne,Puttalam,Chilaw,North Western,8498,1093,9591,339920,43720,383640
1/10/2025,Janaka Kularatne,Puttalam,Chilaw,North Western,9776,3260,13036,391040,130400,521440
1/11/2025,Janaka Kularatne,Puttalam,Chilaw,North Western,1497,7008,8505,59880,280320,340200
1/12/2025,Janaka Kularatne,Puttalam,Chilaw,North Western,2241,6646,8887,89640,265840,355480
1/13/2025,Janaka Kularatne,Puttalam,Chilaw,North Western,8800,3224,12024,352000,128960,480960
1/14/2025,Janaka Kularatne,Puttalam,Chilaw,North Western,5570,7483,13053,222800,299320,522120
1/15/2025,Janaka Kularatne,Puttalam,Chilaw,North Western,4428,1848,6276,177120,73920,251040
1/16/2025,Janaka Kularatne,Puttalam,Chilaw,North Western,9283,5852,15135,371320,234080,605400
1/17/2025,Janaka Kularatne,Puttalam,Chilaw,North Western,5628,4774,10402,225120,190960,416080
1/18/2025,Janaka Kularatne,Puttalam,Chilaw,North Western,3295,6604,9899,131800,264160,395960
1/19/2025,Janaka Kularatne,Puttalam,Chilaw,North Western,4943,5087,10030,197720,203480,401200
1/20/2025,Janaka Kularatne,Puttalam,Chilaw,North Western,6304,6343,12647,252160,253720,505880
1/21/2025,Janaka Kularatne,Puttalam,Chilaw,North Western,3432,3907,7339,137280,156280,293560
1/22/2025,Janaka Kularatne,Puttalam,Chilaw,North Western,9007,9323,18330,360280,372920,733200
1/23/2025,Janaka Kularatne,Puttalam,Chilaw,North Western,2887,8685,11572,115480,347400,462880
1/24/2025,Janaka Kularatne,Puttalam,Chilaw,North Western,22,555,577,880,22200,23080
1/25/2025,Janaka Kularatne,Puttalam,Chilaw,North Western,6289,3346,9635,251560,133840,385400
1/26/2025,Janaka Kularatne,Puttalam,Chilaw,North Western,6214,4145,10359,248560,165800,414360
1/27/2025,Janaka Kularatne,Puttalam,Chilaw,North Western,4016,1197,5213,160640,47880,208520
1/28/2025,Janaka Kularatne,Puttalam,Chilaw,North Western,8815,3668,12483,352600,146720,499320
1/29/2025,Janaka Kularatne,Puttalam,Chilaw,North Western,2640,255,2895,105600,10200,115800
1/30/2025,Janaka Kularatne,Puttalam,Chilaw,North Western,5650,1452,7102,226000,58080,284080
1/31/2025,Janaka Kularatne,Puttalam,Chilaw,North Western,3168,1440,4608,126720,57600,184320
2/1/2025,Janaka Kularatne,Puttalam,Chilaw,North Western,1303,7455,8758,52120,298200,350320
2/2/2025,Janaka Kularatne,Puttalam,Chilaw,North Western,7300,4585,11885,292000,183400,475400
2/3/2025,Janaka Kularatne,Puttalam,Chilaw,North Western,3274,3737,7011,130960,149480,280440
2/4/2025,Janaka Kularatne,Puttalam,Chilaw,North Western,3978,3054,7032,159120,122160,281280
2/5/2025,Janaka Kularatne,Puttalam,Chilaw,North Western,3572,3690,7262,142880,147600,290480
2/6/2025,Janaka Kularatne,Puttalam,Chilaw,North Western,7083,217,7300,283320,8680,292000
2/7/2025,Janaka Kularatne,Puttalam,Chilaw,North Western,7335,8449,15784,293400,337960,631360
2/8/2025,Janaka Kularatne,Puttalam,Chilaw,North Western,8847,8402,17249,353880,336080,689960
2/9/2025,Janaka Kularatne,Puttalam,Chilaw,North Western,1298,7640,8938,51920,305600,357520
2/10/2025,Janaka Kularatne,Puttalam,Chilaw,North Western,9315,3738,13053,372600,149520,522120
2/11/2025,Janaka Kularatne,Puttalam,Chilaw,North Western,1734,5894,7628,69360,235760,305120
2/12/2025,Janaka Kularatne,Puttalam,Chilaw,North Western,8709,4768,13477,348360,190720,539080
2/13/2025,Janaka Kularatne,Puttalam,Chilaw,North Western,3744,2502,6246,149760,100080,249840
2/14/2025,Janaka Kularatne,Puttalam,Chilaw,North Western,3138,961,4099,125520,38440,163960
2/15/2025,Janaka Kularatne,Puttalam,Chilaw,North Western,4178,3364,7542,167120,134560,301680
2/16/2025,Janaka Kularatne,Puttalam,Chilaw,North Western,5241,4276,9517,209640,171040,380680
2/17/2025,Janaka Kularatne,Puttalam,Chilaw,North Western,6913,419,7332,276520,16760,293280
2/18/2025,Janaka Kularatne,Puttalam,Chilaw,North Western,1211,1058,2269,48440,42320,90760
2/19/2025,Janaka Kularatne,Puttalam,Chilaw,North Western,119,9846,9965,4760,393840,398600
2/20/2025,Janaka Kularatne,Puttalam,Chilaw,North Western,822,7387,8209,32880,295480,328360
2/21/2025,Janaka Kularatne,Puttalam,Chilaw,North Western,9857,4216,14073,394280,168640,562920
2/22/2025,Janaka Kularatne,Puttalam,Chilaw,North Western,3306,5332,8638,132240,213280,345520
2/23/2025,Janaka Kularatne,Puttalam,Chilaw,North Western,1241,7196,8437,49640,287840,337480
2/24/2025,Janaka Kularatne,Puttalam,Chilaw,North Western,8407,9405,17812,336280,376200,712480
2/25/2025,Janaka Kularatne,Puttalam,Chilaw,North Western,4369,2188,6557,174760,87520,262280
2/26/2025,Janaka Kularatne,Puttalam,Chilaw,North Western,4892,7864,12756,195680,314560,510240
2/27/2025,Janaka Kularatne,Puttalam,Chilaw,North Western,2003,5885,7888,80120,235400,315520
2/28/2025,Janaka Kularatne,Puttalam,Chilaw,North Western,4676,5183,9859,187040,207320,394360
3/1/2025,Janaka Kularatne,Puttalam,Chilaw,North Western,5032,1946,6978,201280,77840,279120
3/2/2025,Janaka Kularatne,Puttalam,Chilaw,North Western,5339,2371,7710,213560,94840,308400
3/3/2025,Janaka Kularatne,Puttalam,Chilaw,North Western,8353,8313,16666,334120,332520,666640
3/4/2025,Janaka Kularatne,Puttalam,Chilaw,North Western,3255,2564,5819,130200,102560,232760
3/5/2025,Janaka Kularatne,Puttalam,Chilaw,North Western,8378,2529,10907,335120,101160,436280
3/6/2025,Janaka Kularatne,Puttalam,Chilaw,North Western,3901,122,4023,156040,4880,160920
3/7/2025,Janaka Kularatne,Puttalam,Chilaw,North Western,8526,2254,10780,341040,90160,431200
3/8/2025,Janaka Kularatne,Puttalam,Chilaw,North Western,4341,7077,11418,173640,283080,456720
3/9/2025,Janaka Kularatne,Puttalam,Chilaw,North Western,9625,3006,12631,385000,120240,505240
3/10/2025,Janaka Kularatne,Puttalam,Chilaw,North Western,1036,2580,3616,41440,103200,144640
3/11/2025,Janaka Kularatne,Puttalam,Chilaw,North Western,753,4950,5703,30120,198000,228120
3/12/2025,Janaka Kularatne,Puttalam,Chilaw,North Western,4736,5499,10235,189440,219960,409400
3/13/2025,Janaka Kularatne,Puttalam,Chilaw,North Western,3704,6066,9770,148160,242640,390800
3/14/2025,Janaka Kularatne,Puttalam,Chilaw,North Western,7795,5088,12883,311800,203520,515320
3/15/2025,Janaka Kularatne,Puttalam,Chilaw,North Western,4671,1365,6036,186840,54600,241440
3/16/2025,Janaka Kularatne,Puttalam,Chilaw,North Western,7774,7579,15353,310960,303160,614120
3/17/2025,Janaka Kularatne,Puttalam,Chilaw,North Western,8189,6242,14431,327560,249680,577240
3/18/2025,Janaka Kularatne,Puttalam,Chilaw,North Western,8079,9230,17309,323160,369200,692360
3/19/2025,Janaka Kularatne,Puttalam,Chilaw,North Western,3179,6169,9348,127160,246760,373920
3/20/2025,Janaka Kularatne,Puttalam,Chilaw,North Western,2784,7885,10669,111360,315400,426760
3/21/2025,Janaka Kularatne,Puttalam,Chilaw,North Western,8834,1250,10084,353360,50000,403360
3/22/2025,Janaka Kularatne,Puttalam,Chilaw,North Western,12,6838,6850,480,273520,274000
3/23/2025,Janaka Kularatne,Puttalam,Chilaw,North Western,593,1408,2001,23720,56320,80040
3/25/2024,Shanthi Perera,Ratnapura,Balangoda,Sabaragamuwa,3130,9904,13034,125200,396160,521360
3/26/2024,Shanthi Perera,Ratnapura,Balangoda,Sabaragamuwa,1080,2197,3277,43200,87880,131080
3/27/2024,Shanthi Perera,Ratnapura,Balangoda,Sabaragamuwa,6961,1109,8070,278440,44360,322800
3/28/2024,Shanthi Perera,Ratnapura,Balangoda,Sabaragamuwa,3362,2402,5764,134480,96080,230560
3/29/2024,Shanthi Perera,Ratnapura,Balangoda,Sabaragamuwa,125,9947,10072,5000,397880,402880
3/30/2024,Shanthi Perera,Ratnapura,Balangoda,Sabaragamuwa,6290,9277,15567,251600,371080,622680
3/31/2024,Shanthi Perera,Ratnapura,Balangoda,Sabaragamuwa,3986,2284,6270,159440,91360,250800
4/1/2024,Shanthi Perera,Ratnapura,Balangoda,Sabaragamuwa,5071,2159,7230,202840,86360,289200
4/2/2024,Shanthi Perera,Ratnapura,Balangoda,Sabaragamuwa,108,7295,7403,4320,291800,296120
4/3/2024,Shanthi Perera,Ratnapura,Balangoda,Sabaragamuwa,4878,909,5787,195120,36360,231480
4/4/2024,Shanthi Perera,Ratnapura,Balangoda,Sabaragamuwa,5229,3338,8567,209160,133520,342680
4/5/2024,Shanthi Perera,Ratnapura,Balangoda,Sabaragamuwa,3412,5045,8457,136480,201800,338280
4/6/2024,Shanthi Perera,Ratnapura,Balangoda,Sabaragamuwa,6176,2787,8963,247040,111480,358520
4/7/2024,Shanthi Perera,Ratnapura,Balangoda,Sabaragamuwa,2113,9708,11821,84520,388320,472840
4/8/2024,Shanthi Perera,Ratnapura,Balangoda,Sabaragamuwa,4546,686,5232,181840,27440,209280
4/9/2024,Shanthi Perera,Ratnapura,Balangoda,Sabaragamuwa,9704,3596,13300,388160,143840,532000
4/10/2024,Shanthi Perera,Ratnapura,Balangoda,Sabaragamuwa,9568,6466,16034,382720,258640,641360
4/11/2024,Shanthi Perera,Ratnapura,Balangoda,Sabaragamuwa,2878,6104,8982,115120,244160,359280
4/19/2024,Shanthi Perera,Ratnapura,Balangoda,Sabaragamuwa,1879,4361,6240,75160,174440,249600
4/20/2024,Shanthi Perera,Ratnapura,Balangoda,Sabaragamuwa,2266,7645,9911,90640,305800,396440
4/21/2024,Shanthi Perera,Ratnapura,Balangoda,Sabaragamuwa,1941,7643,9584,77640,305720,383360
4/22/2024,Shanthi Perera,Ratnapura,Balangoda,Sabaragamuwa,1586,5633,7219,63440,225320,288760
4/23/2024,Shanthi Perera,Ratnapura,Balangoda,Sabaragamuwa,4027,6350,10377,161080,254000,415080
4/24/2024,Shanthi Perera,Ratnapura,Balangoda,Sabaragamuwa,6970,3850,10820,278800,154000,432800
4/25/2024,Shanthi Perera,Ratnapura,Balangoda,Sabaragamuwa,6554,6231,12785,262160,249240,511400
4/26/2024,Shanthi Perera,Ratnapura,Balangoda,Sabaragamuwa,4504,4272,8776,180160,170880,351040
4/27/2024,Shanthi Perera,Ratnapura,Balangoda,Sabaragamuwa,1081,1407,2488,43240,56280,99520
4/28/2024,Shanthi Perera,Ratnapura,Balangoda,Sabaragamuwa,8816,924,9740,352640,36960,389600
4/29/2024,Shanthi Perera,Ratnapura,Balangoda,Sabaragamuwa,6694,1412,8106,267760,56480,324240
4/30/2024,Shanthi Perera,Ratnapura,Balangoda,Sabaragamuwa,9337,2666,12003,373480,106640,480120
5/1/2024,Shanthi Perera,Ratnapura,Balangoda,Sabaragamuwa,8233,3517,11750,329320,140680,470000
5/2/2024,Shanthi Perera,Ratnapura,Balangoda,Sabaragamuwa,4407,9579,13986,176280,383160,559440
5/3/2024,Shanthi Perera,Ratnapura,Balangoda,Sabaragamuwa,138,6232,6370,5520,249280,254800
5/4/2024,Shanthi Perera,Ratnapura,Balangoda,Sabaragamuwa,637,5102,5739,25480,204080,229560
5/5/2024,Shanthi Perera,Ratnapura,Balangoda,Sabaragamuwa,9881,7572,17453,395240,302880,698120
5/6/2024,Shanthi Perera,Ratnapura,Balangoda,Sabaragamuwa,7084,1554,8638,283360,62160,345520
5/7/2024,Shanthi Perera,Ratnapura,Balangoda,Sabaragamuwa,5567,3959,9526,222680,158360,381040
5/8/2024,Shanthi Perera,Ratnapura,Balangoda,Sabaragamuwa,109,7274,7383,4360,290960,295320
5/9/2024,Shanthi Perera,Ratnapura,Balangoda,Sabaragamuwa,4359,4294,8653,174360,171760,346120
5/10/2024,Shanthi Perera,Ratnapura,Balangoda,Sabaragamuwa,5490,3290,8780,219600,131600,351200
5/11/2024,Shanthi Perera,Ratnapura,Balangoda,Sabaragamuwa,5459,3367,8826,218360,134680,353040
5/12/2024,Shanthi Perera,Ratnapura,Balangoda,Sabaragamuwa,3513,3620,7133,140520,144800,285320
5/13/2024,Shanthi Perera,Ratnapura,Balangoda,Sabaragamuwa,5969,1063,7032,238760,42520,281280
5/14/2024,Shanthi Perera,Ratnapura,Balangoda,Sabaragamuwa,575,9987,10562,23000,399480,422480
5/15/2024,Shanthi Perera,Ratnapura,Balangoda,Sabaragamuwa,1105,1079,2184,44200,43160,87360
5/16/2024,Shanthi Perera,Ratnapura,Balangoda,Sabaragamuwa,5754,9035,14789,230160,361400,591560
5/17/2024,Shanthi Perera,Ratnapura,Balangoda,Sabaragamuwa,2037,6954,8991,81480,278160,359640
5/18/2024,Shanthi Perera,Ratnapura,Balangoda,Sabaragamuwa,9395,244,9639,375800,9760,385560
5/19/2024,Shanthi Perera,Ratnapura,Balangoda,Sabaragamuwa,7380,4080,11460,295200,163200,458400
5/20/2024,Shanthi Perera,Ratnapura,Balangoda,Sabaragamuwa,6016,4872,10888,240640,194880,435520
5/21/2024,Shanthi Perera,Ratnapura,Balangoda,Sabaragamuwa,2093,57,2150,83720,2280,86000
5/22/2024,Shanthi Perera,Ratnapura,Balangoda,Sabaragamuwa,955,8021,8976,38200,320840,359040
5/24/2024,Shanthi Perera,Ratnapura,Balangoda,Sabaragamuwa,225,171,396,9000,6840,15840
5/25/2024,Shanthi Perera,Ratnapura,Balangoda,Sabaragamuwa,3422,1537,4959,136880,61480,198360
5/26/2024,Shanthi Perera,Ratnapura,Balangoda,Sabaragamuwa,2413,3472,5885,96520,138880,235400
5/27/2024,Shanthi Perera,Ratnapura,Balangoda,Sabaragamuwa,9102,5825,14927,364080,233000,597080
5/28/2024,Shanthi Perera,Ratnapura,Balangoda,Sabaragamuwa,373,1886,2259,14920,75440,90360
5/29/2024,Shanthi Perera,Ratnapura,Balangoda,Sabaragamuwa,4200,2188,6388,168000,87520,255520
5/30/2024,Shanthi Perera,Ratnapura,Balangoda,Sabaragamuwa,5838,4317,10155,233520,172680,406200
5/31/2024,Shanthi Perera,Ratnapura,Balangoda,Sabaragamuwa,560,7947,8507,22400,317880,340280
6/1/2024,Shanthi Perera,Ratnapura,Balangoda,Sabaragamuwa,9331,2846,12177,373240,113840,487080
6/2/2024,Shanthi Perera,Ratnapura,Balangoda,Sabaragamuwa,7471,6163,13634,298840,246520,545360
6/3/2024,Shanthi Perera,Ratnapura,Balangoda,Sabaragamuwa,1607,7544,9151,64280,301760,366040
6/4/2024,Shanthi Perera,Ratnapura,Balangoda,Sabaragamuwa,8021,6970,14991,320840,278800,599640
6/5/2024,Shanthi Perera,Ratnapura,Balangoda,Sabaragamuwa,4994,5371,10365,199760,214840,414600
6/6/2024,Shanthi Perera,Ratnapura,Balangoda,Sabaragamuwa,1554,4117,5671,62160,164680,226840
6/7/2024,Shanthi Perera,Ratnapura,Balangoda,Sabaragamuwa,4300,4877,9177,172000,195080,367080
6/8/2024,Shanthi Perera,Ratnapura,Balangoda,Sabaragamuwa,7340,1653,8993,293600,66120,359720
6/9/2024,Shanthi Perera,Ratnapura,Balangoda,Sabaragamuwa,2016,8198,10214,80640,327920,408560
6/10/2024,Shanthi Perera,Ratnapura,Balangoda,Sabaragamuwa,9559,9030,18589,382360,361200,743560
6/11/2024,Shanthi Perera,Ratnapura,Balangoda,Sabaragamuwa,9408,8009,17417,376320,320360,696680
6/12/2024,Shanthi Perera,Ratnapura,Balangoda,Sabaragamuwa,9566,6790,16356,382640,271600,654240
6/13/2024,Shanthi Perera,Ratnapura,Balangoda,Sabaragamuwa,6120,187,6307,244800,7480,252280
6/14/2024,Shanthi Perera,Ratnapura,Balangoda,Sabaragamuwa,2598,7595,10193,103920,303800,407720
6/15/2024,Shanthi Perera,Ratnapura,Balangoda,Sabaragamuwa,8144,6455,14599,325760,258200,583960
6/16/2024,Shanthi Perera,Ratnapura,Balangoda,Sabaragamuwa,823,4024,4847,32920,160960,193880
6/17/2024,Shanthi Perera,Ratnapura,Balangoda,Sabaragamuwa,2527,5610,8137,101080,224400,325480
6/18/2024,Shanthi Perera,Ratnapura,Balangoda,Sabaragamuwa,7962,1319,9281,318480,52760,371240
6/19/2024,Shanthi Perera,Ratnapura,Balangoda,Sabaragamuwa,8910,8253,17163,356400,330120,686520
6/20/2024,Shanthi Perera,Ratnapura,Balangoda,Sabaragamuwa,1301,2454,3755,52040,98160,150200
6/21/2024,Shanthi Perera,Ratnapura,Balangoda,Sabaragamuwa,924,6357,7281,36960,254280,291240
6/22/2024,Shanthi Perera,Ratnapura,Balangoda,Sabaragamuwa,6736,3463,10199,269440,138520,407960
6/23/2024,Shanthi Perera,Ratnapura,Balangoda,Sabaragamuwa,5865,7661,13526,234600,306440,541040
6/24/2024,Shanthi Perera,Ratnapura,Balangoda,Sabaragamuwa,2344,9150,11494,93760,366000,459760
6/25/2024,Shanthi Perera,Ratnapura,Balangoda,Sabaragamuwa,5494,6420,11914,219760,256800,476560
6/26/2024,Shanthi Perera,Ratnapura,Balangoda,Sabaragamuwa,7664,8338,16002,306560,333520,640080
6/27/2024,Shanthi Perera,Ratnapura,Balangoda,Sabaragamuwa,9055,6849,15904,362200,273960,636160
6/28/2024,Shanthi Perera,Ratnapura,Balangoda,Sabaragamuwa,2618,7045,9663,104720,281800,386520
6/29/2024,Shanthi Perera,Ratnapura,Balangoda,Sabaragamuwa,177,6473,6650,7080,258920,266000
6/30/2024,Shanthi Perera,Ratnapura,Balangoda,Sabaragamuwa,9279,9421,18700,371160,376840,748000
7/1/2024,Shanthi Perera,Ratnapura,Balangoda,Sabaragamuwa,4117,5707,9824,164680,228280,392960
7/2/2024,Shanthi Perera,Ratnapura,Balangoda,Sabaragamuwa,1997,8677,10674,79880,347080,426960
7/3/2024,Shanthi Perera,Ratnapura,Balangoda,Sabaragamuwa,138,4472,4610,5520,178880,184400
7/4/2024,Shanthi Perera,Ratnapura,Balangoda,Sabaragamuwa,7995,3284,11279,319800,131360,451160
7/5/2024,Shanthi Perera,Ratnapura,Balangoda,Sabaragamuwa,3088,2513,5601,123520,100520,224040
7/6/2024,Shanthi Perera,Ratnapura,Balangoda,Sabaragamuwa,5516,4925,10441,220640,197000,417640
7/7/2024,Shanthi Perera,Ratnapura,Balangoda,Sabaragamuwa,5630,9111,14741,225200,364440,589640
7/8/2024,Shanthi Perera,Ratnapura,Balangoda,Sabaragamuwa,3850,8757,12607,154000,350280,504280
7/9/2024,Shanthi Perera,Ratnapura,Balangoda,Sabaragamuwa,6848,6211,13059,273920,248440,522360
7/10/2024,Shanthi Perera,Ratnapura,Balangoda,Sabaragamuwa,1518,2364,3882,60720,94560,155280
7/11/2024,Shanthi Perera,Ratnapura,Balangoda,Sabaragamuwa,3373,9917,13290,134920,396680,531600
7/12/2024,Shanthi Perera,Ratnapura,Balangoda,Sabaragamuwa,7007,145,7152,280280,5800,286080
7/13/2024,Shanthi Perera,Ratnapura,Balangoda,Sabaragamuwa,3075,5033,8108,123000,201320,324320
7/14/2024,Shanthi Perera,Ratnapura,Balangoda,Sabaragamuwa,7715,4009,11724,308600,160360,468960
7/15/2024,Shanthi Perera,Ratnapura,Balangoda,Sabaragamuwa,6926,3317,10243,277040,132680,409720
7/16/2024,Shanthi Perera,Ratnapura,Balangoda,Sabaragamuwa,9080,8412,17492,363200,336480,699680
7/17/2024,Shanthi Perera,Ratnapura,Balangoda,Sabaragamuwa,2217,9648,11865,88680,385920,474600
7/18/2024,Shanthi Perera,Ratnapura,Balangoda,Sabaragamuwa,6455,1074,7529,258200,42960,301160
7/19/2024,Shanthi Perera,Ratnapura,Balangoda,Sabaragamuwa,547,5794,6341,21880,231760,253640
7/20/2024,Shanthi Perera,Ratnapura,Balangoda,Sabaragamuwa,4596,3805,8401,183840,152200,336040
7/21/2024,Shanthi Perera,Ratnapura,Balangoda,Sabaragamuwa,2684,5725,8409,107360,229000,336360
7/22/2024,Shanthi Perera,Ratnapura,Balangoda,Sabaragamuwa,9071,7204,16275,362840,288160,651000
7/23/2024,Shanthi Perera,Ratnapura,Balangoda,Sabaragamuwa,95,6383,6478,3800,255320,259120
7/24/2024,Shanthi Perera,Ratnapura,Balangoda,Sabaragamuwa,7342,6845,14187,293680,273800,567480
7/25/2024,Shanthi Perera,Ratnapura,Balangoda,Sabaragamuwa,7216,5457,12673,288640,218280,506920
7/26/2024,Shanthi Perera,Ratnapura,Balangoda,Sabaragamuwa,5663,6312,11975,226520,252480,479000
7/27/2024,Shanthi Perera,Ratnapura,Balangoda,Sabaragamuwa,6763,4735,11498,270520,189400,459920
7/28/2024,Shanthi Perera,Ratnapura,Balangoda,Sabaragamuwa,447,3061,3508,17880,122440,140320
7/29/2024,Shanthi Perera,Ratnapura,Balangoda,Sabaragamuwa,7904,1479,9383,316160,59160,375320
7/30/2024,Shanthi Perera,Ratnapura,Balangoda,Sabaragamuwa,9857,3001,12858,394280,120040,514320
7/31/2024,Shanthi Perera,Ratnapura,Balangoda,Sabaragamuwa,1855,9387,11242,74200,375480,449680
8/1/2024,Shanthi Perera,Ratnapura,Balangoda,Sabaragamuwa,7877,6116,13993,315080,244640,559720
8/2/2024,Shanthi Perera,Ratnapura,Balangoda,Sabaragamuwa,4299,2048,6347,171960,81920,253880
8/3/2024,Shanthi Perera,Ratnapura,Balangoda,Sabaragamuwa,581,5852,6433,23240,234080,257320
8/4/2024,Shanthi Perera,Ratnapura,Balangoda,Sabaragamuwa,5320,3212,8532,212800,128480,341280
8/5/2024,Shanthi Perera,Ratnapura,Balangoda,Sabaragamuwa,8774,7602,16376,350960,304080,655040
8/6/2024,Shanthi Perera,Ratnapura,Balangoda,Sabaragamuwa,8670,3260,11930,346800,130400,477200
8/7/2024,Shanthi Perera,Ratnapura,Balangoda,Sabaragamuwa,1114,3748,4862,44560,149920,194480
8/8/2024,Shanthi Perera,Ratnapura,Balangoda,Sabaragamuwa,7265,4455,11720,290600,178200,468800
8/9/2024,Shanthi Perera,Ratnapura,Balangoda,Sabaragamuwa,8807,4252,13059,352280,170080,522360
8/10/2024,Shanthi Perera,Ratnapura,Balangoda,Sabaragamuwa,2501,4836,7337,100040,193440,293480
8/11/2024,Shanthi Perera,Ratnapura,Balangoda,Sabaragamuwa,8419,1609,10028,336760,64360,401120
8/12/2024,Shanthi Perera,Ratnapura,Balangoda,Sabaragamuwa,2138,7716,9854,85520,308640,394160
8/13/2024,Shanthi Perera,Ratnapura,Balangoda,Sabaragamuwa,9211,3594,12805,368440,143760,512200
8/14/2024,Shanthi Perera,Ratnapura,Balangoda,Sabaragamuwa,7344,9604,16948,293760,384160,677920
8/15/2024,Shanthi Perera,Ratnapura,Balangoda,Sabaragamuwa,5736,351,6087,229440,14040,243480
8/16/2024,Shanthi Perera,Ratnapura,Balangoda,Sabaragamuwa,1925,9622,11547,77000,384880,461880
8/17/2024,Shanthi Perera,Ratnapura,Balangoda,Sabaragamuwa,3675,4784,8459,147000,191360,338360
8/18/2024,Shanthi Perera,Ratnapura,Balangoda,Sabaragamuwa,6980,2203,9183,279200,88120,367320
8/19/2024,Shanthi Perera,Ratnapura,Balangoda,Sabaragamuwa,8519,1556,10075,340760,62240,403000
8/20/2024,Shanthi Perera,Ratnapura,Balangoda,Sabaragamuwa,4652,4094,8746,186080,163760,349840
8/21/2024,Shanthi Perera,Ratnapura,Balangoda,Sabaragamuwa,864,5166,6030,34560,206640,241200
8/22/2024,Shanthi Perera,Ratnapura,Balangoda,Sabaragamuwa,7957,5035,12992,318280,201400,519680
8/23/2024,Shanthi Perera,Ratnapura,Balangoda,Sabaragamuwa,482,3961,4443,19280,158440,177720
8/24/2024,Shanthi Perera,Ratnapura,Balangoda,Sabaragamuwa,5367,8610,13977,214680,344400,559080
8/25/2024,Shanthi Perera,Ratnapura,Balangoda,Sabaragamuwa,7661,7431,15092,306440,297240,603680
8/26/2024,Shanthi Perera,Ratnapura,Balangoda,Sabaragamuwa,4055,4816,8871,162200,192640,354840
8/27/2024,Shanthi Perera,Ratnapura,Balangoda,Sabaragamuwa,4485,1172,5657,179400,46880,226280
8/28/2024,Shanthi Perera,Ratnapura,Balangoda,Sabaragamuwa,4637,9331,13968,185480,373240,558720
8/29/2024,Shanthi Perera,Ratnapura,Balangoda,Sabaragamuwa,737,6272,7009,29480,250880,280360
8/30/2024,Shanthi Perera,Ratnapura,Balangoda,Sabaragamuwa,345,9504,9849,13800,380160,393960
8/31/2024,Shanthi Perera,Ratnapura,Balangoda,Sabaragamuwa,5463,1718,7181,218520,68720,287240
9/1/2024,Shanthi Perera,Ratnapura,Balangoda,Sabaragamuwa,9707,420,10127,388280,16800,405080
9/2/2024,Shanthi Perera,Ratnapura,Balangoda,Sabaragamuwa,6324,2177,8501,252960,87080,340040
9/3/2024,Shanthi Perera,Ratnapura,Balangoda,Sabaragamuwa,3464,4840,8304,138560,193600,332160
9/4/2024,Shanthi Perera,Ratnapura,Balangoda,Sabaragamuwa,811,9606,10417,32440,384240,416680
9/5/2024,Shanthi Perera,Ratnapura,Balangoda,Sabaragamuwa,7671,7605,15276,306840,304200,611040
9/6/2024,Shanthi Perera,Ratnapura,Balangoda,Sabaragamuwa,7822,8766,16588,312880,350640,663520
9/7/2024,Shanthi Perera,Ratnapura,Balangoda,Sabaragamuwa,8562,5689,14251,342480,227560,570040
9/8/2024,Shanthi Perera,Ratnapura,Balangoda,Sabaragamuwa,3090,4580,7670,123600,183200,306800
9/9/2024,Shanthi Perera,Ratnapura,Balangoda,Sabaragamuwa,2259,530,2789,90360,21200,111560
9/10/2024,Shanthi Perera,Ratnapura,Balangoda,Sabaragamuwa,9156,1887,11043,366240,75480,441720
9/11/2024,Shanthi Perera,Ratnapura,Balangoda,Sabaragamuwa,2744,2771,5515,109760,110840,220600
9/12/2024,Shanthi Perera,Ratnapura,Balangoda,Sabaragamuwa,3891,1047,4938,155640,41880,197520
9/13/2024,Shanthi Perera,Ratnapura,Balangoda,Sabaragamuwa,1737,6309,8046,69480,252360,321840
9/14/2024,Shanthi Perera,Ratnapura,Balangoda,Sabaragamuwa,3198,8437,11635,127920,337480,465400
9/15/2024,Shanthi Perera,Ratnapura,Balangoda,Sabaragamuwa,8146,3809,11955,325840,152360,478200
9/16/2024,Shanthi Perera,Ratnapura,Balangoda,Sabaragamuwa,7015,8330,15345,280600,333200,613800
9/17/2024,Shanthi Perera,Ratnapura,Balangoda,Sabaragamuwa,1700,3065,4765,68000,122600,190600
9/18/2024,Shanthi Perera,Ratnapura,Balangoda,Sabaragamuwa,1837,8026,9863,73480,321040,394520
9/19/2024,Shanthi Perera,Ratnapura,Balangoda,Sabaragamuwa,1922,4879,6801,76880,195160,272040
9/20/2024,Shanthi Perera,Ratnapura,Balangoda,Sabaragamuwa,2697,6122,8819,107880,244880,352760
9/21/2024,Shanthi Perera,Ratnapura,Balangoda,Sabaragamuwa,4546,4757,9303,181840,190280,372120
9/22/2024,Shanthi Perera,Ratnapura,Balangoda,Sabaragamuwa,2487,1486,3973,99480,59440,158920
9/23/2024,Shanthi Perera,Ratnapura,Balangoda,Sabaragamuwa,5367,5839,11206,214680,233560,448240
9/24/2024,Shanthi Perera,Ratnapura,Balangoda,Sabaragamuwa,8707,3256,11963,348280,130240,478520
9/25/2024,Shanthi Perera,Ratnapura,Balangoda,Sabaragamuwa,7686,9461,17147,307440,378440,685880
9/26/2024,Shanthi Perera,Ratnapura,Balangoda,Sabaragamuwa,2550,5868,8418,102000,234720,336720
9/27/2024,Shanthi Perera,Ratnapura,Balangoda,Sabaragamuwa,3534,1422,4956,141360,56880,198240
9/28/2024,Shanthi Perera,Ratnapura,Balangoda,Sabaragamuwa,6297,9816,16113,251880,392640,644520
9/29/2024,Shanthi Perera,Ratnapura,Balangoda,Sabaragamuwa,5532,2854,8386,221280,114160,335440
9/30/2024,Shanthi Perera,Ratnapura,Balangoda,Sabaragamuwa,5096,6079,11175,203840,243160,447000
10/1/2024,Shanthi Perera,Ratnapura,Balangoda,Sabaragamuwa,6699,1871,8570,267960,74840,342800
10/2/2024,Shanthi Perera,Ratnapura,Balangoda,Sabaragamuwa,9580,3758,13338,383200,150320,533520
10/3/2024,Shanthi Perera,Ratnapura,Balangoda,Sabaragamuwa,616,4240,4856,24640,169600,194240
10/4/2024,Shanthi Perera,Ratnapura,Balangoda,Sabaragamuwa,8595,5979,14574,343800,239160,582960
10/5/2024,Shanthi Perera,Ratnapura,Balangoda,Sabaragamuwa,5062,8264,13326,202480,330560,533040
10/6/2024,Shanthi Perera,Ratnapura,Balangoda,Sabaragamuwa,906,5787,6693,36240,231480,267720
10/7/2024,Shanthi Perera,Ratnapura,Balangoda,Sabaragamuwa,160,27,187,6400,1080,7480
10/8/2024,Shanthi Perera,Ratnapura,Balangoda,Sabaragamuwa,8514,7425,15939,340560,297000,637560
10/9/2024,Shanthi Perera,Ratnapura,Balangoda,Sabaragamuwa,4618,1412,6030,184720,56480,241200
10/10/2024,Shanthi Perera,Ratnapura,Balangoda,Sabaragamuwa,7993,495,8488,319720,19800,339520
10/11/2024,Shanthi Perera,Ratnapura,Balangoda,Sabaragamuwa,9971,4488,14459,398840,179520,578360
10/12/2024,Shanthi Perera,Ratnapura,Balangoda,Sabaragamuwa,1141,13,1154,45640,520,46160
10/13/2024,Shanthi Perera,Ratnapura,Balangoda,Sabaragamuwa,6155,3367,9522,246200,134680,380880
10/14/2024,Shanthi Perera,Ratnapura,Balangoda,Sabaragamuwa,8170,3683,11853,326800,147320,474120
10/15/2024,Shanthi Perera,Ratnapura,Balangoda,Sabaragamuwa,9762,1118,10880,390480,44720,435200
10/16/2024,Shanthi Perera,Ratnapura,Balangoda,Sabaragamuwa,5099,9273,14372,203960,370920,574880
10/17/2024,Shanthi Perera,Ratnapura,Balangoda,Sabaragamuwa,4533,7932,12465,181320,317280,498600
10/18/2024,Shanthi Perera,Ratnapura,Balangoda,Sabaragamuwa,7064,8478,15542,282560,339120,621680
10/19/2024,Shanthi Perera,Ratnapura,Balangoda,Sabaragamuwa,6206,3109,9315,248240,124360,372600
10/20/2024,Shanthi Perera,Ratnapura,Balangoda,Sabaragamuwa,7934,5686,13620,317360,227440,544800
10/21/2024,Shanthi Perera,Ratnapura,Balangoda,Sabaragamuwa,5260,8405,13665,210400,336200,546600
10/22/2024,Shanthi Perera,Ratnapura,Balangoda,Sabaragamuwa,388,8250,8638,15520,330000,345520
10/23/2024,Shanthi Perera,Ratnapura,Balangoda,Sabaragamuwa,4410,8156,12566,176400,326240,502640
10/24/2024,Shanthi Perera,Ratnapura,Balangoda,Sabaragamuwa,3932,8607,12539,157280,344280,501560
10/25/2024,Shanthi Perera,Ratnapura,Balangoda,Sabaragamuwa,5507,5242,10749,220280,209680,429960
10/26/2024,Shanthi Perera,Ratnapura,Balangoda,Sabaragamuwa,318,9482,9800,12720,379280,392000
10/27/2024,Shanthi Perera,Ratnapura,Balangoda,Sabaragamuwa,4096,2185,6281,163840,87400,251240
10/28/2024,Shanthi Perera,Ratnapura,Balangoda,Sabaragamuwa,9926,6937,16863,397040,277480,674520
10/29/2024,Shanthi Perera,Ratnapura,Balangoda,Sabaragamuwa,462,3119,3581,18480,124760,143240
10/30/2024,Shanthi Perera,Ratnapura,Balangoda,Sabaragamuwa,3511,2507,6018,140440,100280,240720
10/31/2024,Shanthi Perera,Ratnapura,Balangoda,Sabaragamuwa,2763,1701,4464,110520,68040,178560
11/1/2024,Shanthi Perera,Ratnapura,Balangoda,Sabaragamuwa,6019,843,6862,240760,33720,274480
11/2/2024,Shanthi Perera,Ratnapura,Balangoda,Sabaragamuwa,297,9879,10176,11880,395160,407040
11/3/2024,Shanthi Perera,Ratnapura,Balangoda,Sabaragamuwa,3570,9516,13086,142800,380640,523440
11/4/2024,Shanthi Perera,Ratnapura,Balangoda,Sabaragamuwa,7882,4463,12345,315280,178520,493800
11/5/2024,Shanthi Perera,Ratnapura,Balangoda,Sabaragamuwa,4823,368,5191,192920,14720,207640
11/6/2024,Shanthi Perera,Ratnapura,Balangoda,Sabaragamuwa,7034,2328,9362,281360,93120,374480
11/7/2024,Shanthi Perera,Ratnapura,Balangoda,Sabaragamuwa,6084,6648,12732,243360,265920,509280
11/8/2024,Shanthi Perera,Ratnapura,Balangoda,Sabaragamuwa,320,9390,9710,12800,375600,388400
11/9/2024,Shanthi Perera,Ratnapura,Balangoda,Sabaragamuwa,2418,6921,9339,96720,276840,373560
11/10/2024,Shanthi Perera,Ratnapura,Balangoda,Sabaragamuwa,4791,3474,8265,191640,138960,330600
11/11/2024,Shanthi Perera,Ratnapura,Balangoda,Sabaragamuwa,6217,7851,14068,248680,314040,562720
11/12/2024,Shanthi Perera,Ratnapura,Balangoda,Sabaragamuwa,8871,8060,16931,354840,322400,677240
11/13/2024,Shanthi Perera,Ratnapura,Balangoda,Sabaragamuwa,2433,9261,11694,97320,370440,467760
11/14/2024,Shanthi Perera,Ratnapura,Balangoda,Sabaragamuwa,4575,5770,10345,183000,230800,413800
11/15/2024,Shanthi Perera,Ratnapura,Balangoda,Sabaragamuwa,8247,2409,10656,329880,96360,426240
11/16/2024,Shanthi Perera,Ratnapura,Balangoda,Sabaragamuwa,9622,403,10025,384880,16120,401000
11/17/2024,Shanthi Perera,Ratnapura,Balangoda,Sabaragamuwa,4239,8533,12772,169560,341320,510880
11/18/2024,Shanthi Perera,Ratnapura,Balangoda,Sabaragamuwa,1915,426,2341,76600,17040,93640
11/19/2024,Shanthi Perera,Ratnapura,Balangoda,Sabaragamuwa,8069,5691,13760,322760,227640,550400
11/20/2024,Shanthi Perera,Ratnapura,Balangoda,Sabaragamuwa,4258,8687,12945,170320,347480,517800
11/21/2024,Shanthi Perera,Ratnapura,Balangoda,Sabaragamuwa,2030,4319,6349,81200,172760,253960
11/22/2024,Shanthi Perera,Ratnapura,Balangoda,Sabaragamuwa,5140,8547,13687,205600,341880,547480
11/23/2024,Shanthi Perera,Ratnapura,Balangoda,Sabaragamuwa,2141,9111,11252,85640,364440,450080
11/24/2024,Shanthi Perera,Ratnapura,Balangoda,Sabaragamuwa,1179,2002,3181,47160,80080,127240
11/25/2024,Shanthi Perera,Ratnapura,Balangoda,Sabaragamuwa,1610,7928,9538,64400,317120,381520
11/26/2024,Shanthi Perera,Ratnapura,Balangoda,Sabaragamuwa,2071,1599,3670,82840,63960,146800
11/27/2024,Shanthi Perera,Ratnapura,Balangoda,Sabaragamuwa,9908,7441,17349,396320,297640,693960
11/28/2024,Shanthi Perera,Ratnapura,Balangoda,Sabaragamuwa,3998,1328,5326,159920,53120,213040
11/29/2024,Shanthi Perera,Ratnapura,Balangoda,Sabaragamuwa,7001,9058,16059,280040,362320,642360
11/30/2024,Shanthi Perera,Ratnapura,Balangoda,Sabaragamuwa,246,82,328,9840,3280,13120
12/1/2024,Shanthi Perera,Ratnapura,Balangoda,Sabaragamuwa,3432,7030,10462,137280,281200,418480
12/2/2024,Shanthi Perera,Ratnapura,Balangoda,Sabaragamuwa,6534,6249,12783,261360,249960,511320
12/3/2024,Shanthi Perera,Ratnapura,Balangoda,Sabaragamuwa,9250,2456,11706,370000,98240,468240
12/4/2024,Shanthi Perera,Ratnapura,Balangoda,Sabaragamuwa,7600,1161,8761,304000,46440,350440
12/5/2024,Shanthi Perera,Ratnapura,Balangoda,Sabaragamuwa,3273,610,3883,130920,24400,155320
12/6/2024,Shanthi Perera,Ratnapura,Balangoda,Sabaragamuwa,6864,1268,8132,274560,50720,325280
12/7/2024,Shanthi Perera,Ratnapura,Balangoda,Sabaragamuwa,8455,3582,12037,338200,143280,481480
12/8/2024,Shanthi Perera,Ratnapura,Balangoda,Sabaragamuwa,5650,2819,8469,226000,112760,338760
12/9/2024,Shanthi Perera,Ratnapura,Balangoda,Sabaragamuwa,8440,859,9299,337600,34360,371960
12/10/2024,Shanthi Perera,Ratnapura,Balangoda,Sabaragamuwa,3519,2011,5530,140760,80440,221200
12/11/2024,Shanthi Perera,Ratnapura,Balangoda,Sabaragamuwa,1325,3740,5065,53000,149600,202600
12/12/2024,Shanthi Perera,Ratnapura,Balangoda,Sabaragamuwa,5524,2173,7697,220960,86920,307880
12/13/2024,Shanthi Perera,Ratnapura,Balangoda,Sabaragamuwa,7162,9218,16380,286480,368720,655200
12/14/2024,Shanthi Perera,Ratnapura,Balangoda,Sabaragamuwa,1959,3106,5065,78360,124240,202600
12/15/2024,Shanthi Perera,Ratnapura,Balangoda,Sabaragamuwa,6887,8989,15876,275480,359560,635040
12/16/2024,Shanthi Perera,Ratnapura,Balangoda,Sabaragamuwa,6760,8233,14993,270400,329320,599720
12/17/2024,Shanthi Perera,Ratnapura,Balangoda,Sabaragamuwa,9364,1125,10489,374560,45000,419560
12/18/2024,Shanthi Perera,Ratnapura,Balangoda,Sabaragamuwa,5162,416,5578,206480,16640,223120
12/19/2024,Shanthi Perera,Ratnapura,Balangoda,Sabaragamuwa,6645,7101,13746,265800,284040,549840
12/20/2024,Shanthi Perera,Ratnapura,Balangoda,Sabaragamuwa,7213,1748,8961,288520,69920,358440
12/21/2024,Shanthi Perera,Ratnapura,Balangoda,Sabaragamuwa,3371,3447,6818,134840,137880,272720
12/22/2024,Shanthi Perera,Ratnapura,Balangoda,Sabaragamuwa,1230,5318,6548,49200,212720,261920
12/23/2024,Shanthi Perera,Ratnapura,Balangoda,Sabaragamuwa,1819,548,2367,72760,21920,94680
12/24/2024,Shanthi Perera,Ratnapura,Balangoda,Sabaragamuwa,6,5570,5576,240,222800,223040
12/25/2024,Shanthi Perera,Ratnapura,Balangoda,Sabaragamuwa,9465,3986,13451,378600,159440,538040
12/26/2024,Shanthi Perera,Ratnapura,Balangoda,Sabaragamuwa,6163,3856,10019,246520,154240,400760
12/27/2024,Shanthi Perera,Ratnapura,Balangoda,Sabaragamuwa,2715,4575,7290,108600,183000,291600
12/28/2024,Shanthi Perera,Ratnapura,Balangoda,Sabaragamuwa,7043,424,7467,281720,16960,298680
12/29/2024,Shanthi Perera,Ratnapura,Balangoda,Sabaragamuwa,6918,8479,15397,276720,339160,615880
12/30/2024,Shanthi Perera,Ratnapura,Balangoda,Sabaragamuwa,8261,8683,16944,330440,347320,677760
12/31/2024,Shanthi Perera,Ratnapura,Balangoda,Sabaragamuwa,1765,5687,7452,70600,227480,298080
1/1/2025,Shanthi Perera,Ratnapura,Balangoda,Sabaragamuwa,176,5353,5529,7040,214120,221160
1/2/2025,Shanthi Perera,Ratnapura,Balangoda,Sabaragamuwa,4653,3751,8404,186120,150040,336160
1/3/2025,Shanthi Perera,Ratnapura,Balangoda,Sabaragamuwa,3447,1087,4534,137880,43480,181360
1/4/2025,Shanthi Perera,Ratnapura,Balangoda,Sabaragamuwa,7350,8139,15489,294000,325560,619560
1/5/2025,Shanthi Perera,Ratnapura,Balangoda,Sabaragamuwa,7659,7591,15250,306360,303640,610000
1/6/2025,Shanthi Perera,Ratnapura,Balangoda,Sabaragamuwa,8870,1910,10780,354800,76400,431200
1/7/2025,Shanthi Perera,Ratnapura,Balangoda,Sabaragamuwa,2740,9176,11916,109600,367040,476640
1/8/2025,Shanthi Perera,Ratnapura,Balangoda,Sabaragamuwa,292,5616,5908,11680,224640,236320
1/9/2025,Shanthi Perera,Ratnapura,Balangoda,Sabaragamuwa,4110,3594,7704,164400,143760,308160
1/10/2025,Shanthi Perera,Ratnapura,Balangoda,Sabaragamuwa,7937,8311,16248,317480,332440,649920
1/11/2025,Shanthi Perera,Ratnapura,Balangoda,Sabaragamuwa,6947,1198,8145,277880,47920,325800
1/12/2025,Shanthi Perera,Ratnapura,Balangoda,Sabaragamuwa,3102,5200,8302,124080,208000,332080
1/13/2025,Shanthi Perera,Ratnapura,Balangoda,Sabaragamuwa,2255,3545,5800,90200,141800,232000
1/14/2025,Shanthi Perera,Ratnapura,Balangoda,Sabaragamuwa,9591,1659,11250,383640,66360,450000
1/15/2025,Shanthi Perera,Ratnapura,Balangoda,Sabaragamuwa,2229,2871,5100,89160,114840,204000
1/16/2025,Shanthi Perera,Ratnapura,Balangoda,Sabaragamuwa,1164,500,1664,46560,20000,66560
1/17/2025,Shanthi Perera,Ratnapura,Balangoda,Sabaragamuwa,5735,4068,9803,229400,162720,392120
1/18/2025,Shanthi Perera,Ratnapura,Balangoda,Sabaragamuwa,1156,5405,6561,46240,216200,262440
1/19/2025,Shanthi Perera,Ratnapura,Balangoda,Sabaragamuwa,6316,7555,13871,252640,302200,554840
1/20/2025,Shanthi Perera,Ratnapura,Balangoda,Sabaragamuwa,5950,6090,12040,238000,243600,481600
1/21/2025,Shanthi Perera,Ratnapura,Balangoda,Sabaragamuwa,7259,4419,11678,290360,176760,467120
1/22/2025,Shanthi Perera,Ratnapura,Balangoda,Sabaragamuwa,4531,3459,7990,181240,138360,319600
1/23/2025,Shanthi Perera,Ratnapura,Balangoda,Sabaragamuwa,2400,1021,3421,96000,40840,136840
1/24/2025,Shanthi Perera,Ratnapura,Balangoda,Sabaragamuwa,647,6864,7511,25880,274560,300440
1/25/2025,Shanthi Perera,Ratnapura,Balangoda,Sabaragamuwa,9710,4261,13971,388400,170440,558840
1/26/2025,Shanthi Perera,Ratnapura,Balangoda,Sabaragamuwa,3210,3098,6308,128400,123920,252320
1/27/2025,Shanthi Perera,Ratnapura,Balangoda,Sabaragamuwa,3358,5881,9239,134320,235240,369560
1/28/2025,Shanthi Perera,Ratnapura,Balangoda,Sabaragamuwa,9788,7718,17506,391520,308720,700240
1/29/2025,Shanthi Perera,Ratnapura,Balangoda,Sabaragamuwa,899,375,1274,35960,15000,50960
1/30/2025,Shanthi Perera,Ratnapura,Balangoda,Sabaragamuwa,2452,5786,8238,98080,231440,329520
1/31/2025,Shanthi Perera,Ratnapura,Balangoda,Sabaragamuwa,7527,8409,15936,301080,336360,637440
2/1/2025,Shanthi Perera,Ratnapura,Balangoda,Sabaragamuwa,8311,6150,14461,332440,246000,578440
2/2/2025,Shanthi Perera,Ratnapura,Balangoda,Sabaragamuwa,7683,1859,9542,307320,74360,381680
2/3/2025,Shanthi Perera,Ratnapura,Balangoda,Sabaragamuwa,5689,5224,10913,227560,208960,436520
2/4/2025,Shanthi Perera,Ratnapura,Balangoda,Sabaragamuwa,1295,750,2045,51800,30000,81800
2/5/2025,Shanthi Perera,Ratnapura,Balangoda,Sabaragamuwa,6615,3355,9970,264600,134200,398800
2/6/2025,Shanthi Perera,Ratnapura,Balangoda,Sabaragamuwa,7776,9737,17513,311040,389480,700520
2/7/2025,Shanthi Perera,Ratnapura,Balangoda,Sabaragamuwa,6053,1677,7730,242120,67080,309200
2/8/2025,Shanthi Perera,Ratnapura,Balangoda,Sabaragamuwa,1213,5313,6526,48520,212520,261040
2/9/2025,Shanthi Perera,Ratnapura,Balangoda,Sabaragamuwa,4603,5973,10576,184120,238920,423040
2/10/2025,Shanthi Perera,Ratnapura,Balangoda,Sabaragamuwa,8480,1950,10430,339200,78000,417200
2/11/2025,Shanthi Perera,Ratnapura,Balangoda,Sabaragamuwa,4844,5849,10693,193760,233960,427720
2/12/2025,Shanthi Perera,Ratnapura,Balangoda,Sabaragamuwa,1050,3740,4790,42000,149600,191600
2/13/2025,Shanthi Perera,Ratnapura,Balangoda,Sabaragamuwa,5901,7293,13194,236040,291720,527760
2/14/2025,Shanthi Perera,Ratnapura,Balangoda,Sabaragamuwa,6464,9424,15888,258560,376960,635520
2/15/2025,Shanthi Perera,Ratnapura,Balangoda,Sabaragamuwa,4422,1275,5697,176880,51000,227880
2/16/2025,Shanthi Perera,Ratnapura,Balangoda,Sabaragamuwa,3076,8039,11115,123040,321560,444600
2/17/2025,Shanthi Perera,Ratnapura,Balangoda,Sabaragamuwa,2658,6911,9569,106320,276440,382760
2/18/2025,Shanthi Perera,Ratnapura,Balangoda,Sabaragamuwa,1079,8014,9093,43160,320560,363720
2/19/2025,Shanthi Perera,Ratnapura,Balangoda,Sabaragamuwa,5238,9414,14652,209520,376560,586080
2/20/2025,Shanthi Perera,Ratnapura,Balangoda,Sabaragamuwa,7347,7786,15133,293880,311440,605320
2/21/2025,Shanthi Perera,Ratnapura,Balangoda,Sabaragamuwa,7532,4009,11541,301280,160360,461640
2/22/2025,Shanthi Perera,Ratnapura,Balangoda,Sabaragamuwa,4693,4719,9412,187720,188760,376480
2/23/2025,Shanthi Perera,Ratnapura,Balangoda,Sabaragamuwa,890,8578,9468,35600,343120,378720
2/24/2025,Shanthi Perera,Ratnapura,Balangoda,Sabaragamuwa,9404,1287,10691,376160,51480,427640
2/25/2025,Shanthi Perera,Ratnapura,Balangoda,Sabaragamuwa,3230,2888,6118,129200,115520,244720
2/26/2025,Shanthi Perera,Ratnapura,Balangoda,Sabaragamuwa,13,7308,7321,520,292320,292840
2/27/2025,Shanthi Perera,Ratnapura,Balangoda,Sabaragamuwa,9993,2379,12372,399720,95160,494880
2/28/2025,Shanthi Perera,Ratnapura,Balangoda,Sabaragamuwa,4120,2945,7065,164800,117800,282600
3/1/2025,Shanthi Perera,Ratnapura,Balangoda,Sabaragamuwa,4705,5156,9861,188200,206240,394440
3/2/2025,Shanthi Perera,Ratnapura,Balangoda,Sabaragamuwa,6185,3947,10132,247400,157880,405280
3/3/2025,Shanthi Perera,Ratnapura,Balangoda,Sabaragamuwa,1928,3901,5829,77120,156040,233160
3/4/2025,Shanthi Perera,Ratnapura,Balangoda,Sabaragamuwa,3324,4761,8085,132960,190440,323400
3/5/2025,Shanthi Perera,Ratnapura,Balangoda,Sabaragamuwa,4031,6036,10067,161240,241440,402680
3/6/2025,Shanthi Perera,Ratnapura,Balangoda,Sabaragamuwa,9841,5064,14905,393640,202560,596200
3/7/2025,Shanthi Perera,Ratnapura,Balangoda,Sabaragamuwa,934,7350,8284,37360,294000,331360
3/8/2025,Shanthi Perera,Ratnapura,Balangoda,Sabaragamuwa,2901,4131,7032,116040,165240,281280
3/9/2025,Shanthi Perera,Ratnapura,Balangoda,Sabaragamuwa,2689,4935,7624,107560,197400,304960
3/10/2025,Shanthi Perera,Ratnapura,Balangoda,Sabaragamuwa,3354,4651,8005,134160,186040,320200
3/11/2025,Shanthi Perera,Ratnapura,Balangoda,Sabaragamuwa,1253,5630,6883,50120,225200,275320
3/12/2025,Shanthi Perera,Ratnapura,Balangoda,Sabaragamuwa,6733,7599,14332,269320,303960,573280
3/13/2025,Shanthi Perera,Ratnapura,Balangoda,Sabaragamuwa,7695,1717,9412,307800,68680,376480
3/14/2025,Shanthi Perera,Ratnapura,Balangoda,Sabaragamuwa,5941,4041,9982,237640,161640,399280
3/15/2025,Shanthi Perera,Ratnapura,Balangoda,Sabaragamuwa,8550,6846,15396,342000,273840,615840
3/16/2025,Shanthi Perera,Ratnapura,Balangoda,Sabaragamuwa,7828,5707,13535,313120,228280,541400
3/17/2025,Shanthi Perera,Ratnapura,Balangoda,Sabaragamuwa,461,7891,8352,18440,315640,334080
3/18/2025,Shanthi Perera,Ratnapura,Balangoda,Sabaragamuwa,1705,3407,5112,68200,136280,204480
3/19/2025,Shanthi Perera,Ratnapura,Balangoda,Sabaragamuwa,9345,739,10084,373800,29560,403360
3/20/2025,Shanthi Perera,Ratnapura,Balangoda,Sabaragamuwa,3870,7566,11436,154800,302640,457440
3/21/2025,Shanthi Perera,Ratnapura,Balangoda,Sabaragamuwa,9380,3558,12938,375200,142320,517520
3/22/2025,Shanthi Perera,Ratnapura,Balangoda,Sabaragamuwa,4988,790,5778,199520,31600,231120
3/23/2025,Shanthi Perera,Ratnapura,Balangoda,Sabaragamuwa,8126,7136,15262,325040,285440,610480
3/25/2024,Chathura Malewana,Ampara,Chenkaladi,Eastern,5737,8187,13924,229480,327480,556960
3/26/2024,Chathura Malewana,Ampara,Chenkaladi,Eastern,240,1627,1867,9600,65080,74680
3/27/2024,Chathura Malewana,Ampara,Chenkaladi,Eastern,1696,206,1902,67840,8240,76080
3/28/2024,Chathura Malewana,Ampara,Chenkaladi,Eastern,9938,9094,19032,397520,363760,761280
3/29/2024,Chathura Malewana,Ampara,Chenkaladi,Eastern,892,3979,4871,35680,159160,194840
3/30/2024,Chathura Malewana,Ampara,Chenkaladi,Eastern,1481,617,2098,59240,24680,83920
3/31/2024,Chathura Malewana,Ampara,Chenkaladi,Eastern,4179,9013,13192,167160,360520,527680
4/1/2024,Chathura Malewana,Ampara,Chenkaladi,Eastern,6327,1858,8185,253080,74320,327400
4/2/2024,Chathura Malewana,Ampara,Chenkaladi,Eastern,7466,6094,13560,298640,243760,542400
4/3/2024,Chathura Malewana,Ampara,Chenkaladi,Eastern,4766,5176,9942,190640,207040,397680
4/4/2024,Chathura Malewana,Ampara,Chenkaladi,Eastern,9876,7252,17128,395040,290080,685120
4/5/2024,Chathura Malewana,Ampara,Chenkaladi,Eastern,3037,4890,7927,121480,195600,317080
4/6/2024,Chathura Malewana,Ampara,Chenkaladi,Eastern,6489,1546,8035,259560,61840,321400
4/7/2024,Chathura Malewana,Ampara,Chenkaladi,Eastern,6026,1497,7523,241040,59880,300920
4/8/2024,Chathura Malewana,Ampara,Chenkaladi,Eastern,3446,3550,6996,137840,142000,279840
4/9/2024,Chathura Malewana,Ampara,Chenkaladi,Eastern,1165,2368,3533,46600,94720,141320
4/10/2024,Chathura Malewana,Ampara,Chenkaladi,Eastern,1078,4165,5243,43120,166600,209720
4/11/2024,Chathura Malewana,Ampara,Chenkaladi,Eastern,6407,4568,10975,256280,182720,439000
4/19/2024,Chathura Malewana,Ampara,Chenkaladi,Eastern,1883,9542,11425,75320,381680,457000
4/20/2024,Chathura Malewana,Ampara,Chenkaladi,Eastern,1827,9350,11177,73080,374000,447080
4/21/2024,Chathura Malewana,Ampara,Chenkaladi,Eastern,5452,9475,14927,218080,379000,597080
4/22/2024,Chathura Malewana,Ampara,Chenkaladi,Eastern,2390,190,2580,95600,7600,103200
4/23/2024,Chathura Malewana,Ampara,Chenkaladi,Eastern,8804,4158,12962,352160,166320,518480
4/24/2024,Chathura Malewana,Ampara,Chenkaladi,Eastern,8180,8089,16269,327200,323560,650760
4/25/2024,Chathura Malewana,Ampara,Chenkaladi,Eastern,1696,1531,3227,67840,61240,129080
4/26/2024,Chathura Malewana,Ampara,Chenkaladi,Eastern,2890,6605,9495,115600,264200,379800
4/27/2024,Chathura Malewana,Ampara,Chenkaladi,Eastern,6072,5056,11128,242880,202240,445120
4/28/2024,Chathura Malewana,Ampara,Chenkaladi,Eastern,7531,5054,12585,301240,202160,503400
4/29/2024,Chathura Malewana,Ampara,Chenkaladi,Eastern,3545,2087,5632,141800,83480,225280
4/30/2024,Chathura Malewana,Ampara,Chenkaladi,Eastern,4559,9697,14256,182360,387880,570240
5/1/2024,Chathura Malewana,Ampara,Chenkaladi,Eastern,9560,7781,17341,382400,311240,693640
5/2/2024,Chathura Malewana,Ampara,Chenkaladi,Eastern,5607,5430,11037,224280,217200,441480
5/3/2024,Chathura Malewana,Ampara,Chenkaladi,Eastern,5031,7492,12523,201240,299680,500920
5/4/2024,Chathura Malewana,Ampara,Chenkaladi,Eastern,8877,6353,15230,355080,254120,609200
5/5/2024,Chathura Malewana,Ampara,Chenkaladi,Eastern,76,9192,9268,3040,367680,370720
5/6/2024,Chathura Malewana,Ampara,Chenkaladi,Eastern,1209,8373,9582,48360,334920,383280
5/7/2024,Chathura Malewana,Ampara,Chenkaladi,Eastern,6184,9695,15879,247360,387800,635160
5/8/2024,Chathura Malewana,Ampara,Chenkaladi,Eastern,2533,6470,9003,101320,258800,360120
5/9/2024,Chathura Malewana,Ampara,Chenkaladi,Eastern,2180,2405,4585,87200,96200,183400
5/10/2024,Chathura Malewana,Ampara,Chenkaladi,Eastern,436,2783,3219,17440,111320,128760
5/11/2024,Chathura Malewana,Ampara,Chenkaladi,Eastern,1133,3599,4732,45320,143960,189280
5/12/2024,Chathura Malewana,Ampara,Chenkaladi,Eastern,5553,1804,7357,222120,72160,294280
5/13/2024,Chathura Malewana,Ampara,Chenkaladi,Eastern,8574,9784,18358,342960,391360,734320
5/14/2024,Chathura Malewana,Ampara,Chenkaladi,Eastern,8981,4552,13533,359240,182080,541320
5/15/2024,Chathura Malewana,Ampara,Chenkaladi,Eastern,9672,8022,17694,386880,320880,707760
5/16/2024,Chathura Malewana,Ampara,Chenkaladi,Eastern,2921,373,3294,116840,14920,131760
5/17/2024,Chathura Malewana,Ampara,Chenkaladi,Eastern,9497,4634,14131,379880,185360,565240
5/18/2024,Chathura Malewana,Ampara,Chenkaladi,Eastern,933,254,1187,37320,10160,47480
5/19/2024,Chathura Malewana,Ampara,Chenkaladi,Eastern,9752,8304,18056,390080,332160,722240
5/20/2024,Chathura Malewana,Ampara,Chenkaladi,Eastern,7230,4786,12016,289200,191440,480640
5/21/2024,Chathura Malewana,Ampara,Chenkaladi,Eastern,5000,8280,13280,200000,331200,531200
5/22/2024,Chathura Malewana,Ampara,Chenkaladi,Eastern,1523,8640,10163,60920,345600,406520
5/24/2024,Chathura Malewana,Ampara,Chenkaladi,Eastern,5033,5706,10739,201320,228240,429560
5/25/2024,Chathura Malewana,Ampara,Chenkaladi,Eastern,4727,4643,9370,189080,185720,374800
5/26/2024,Chathura Malewana,Ampara,Chenkaladi,Eastern,4062,1039,5101,162480,41560,204040
5/27/2024,Chathura Malewana,Ampara,Chenkaladi,Eastern,4751,1273,6024,190040,50920,240960
5/28/2024,Chathura Malewana,Ampara,Chenkaladi,Eastern,8715,3836,12551,348600,153440,502040
5/29/2024,Chathura Malewana,Ampara,Chenkaladi,Eastern,8277,2800,11077,331080,112000,443080
5/30/2024,Chathura Malewana,Ampara,Chenkaladi,Eastern,2605,5725,8330,104200,229000,333200
5/31/2024,Chathura Malewana,Ampara,Chenkaladi,Eastern,6281,8110,14391,251240,324400,575640
6/1/2024,Chathura Malewana,Ampara,Chenkaladi,Eastern,980,5875,6855,39200,235000,274200
6/2/2024,Chathura Malewana,Ampara,Chenkaladi,Eastern,574,312,886,22960,12480,35440
6/3/2024,Chathura Malewana,Ampara,Chenkaladi,Eastern,8041,9387,17428,321640,375480,697120
6/4/2024,Chathura Malewana,Ampara,Chenkaladi,Eastern,5102,8800,13902,204080,352000,556080
6/5/2024,Chathura Malewana,Ampara,Chenkaladi,Eastern,9776,7830,17606,391040,313200,704240
6/6/2024,Chathura Malewana,Ampara,Chenkaladi,Eastern,9729,2632,12361,389160,105280,494440
6/7/2024,Chathura Malewana,Ampara,Chenkaladi,Eastern,2083,2802,4885,83320,112080,195400
6/8/2024,Chathura Malewana,Ampara,Chenkaladi,Eastern,3894,9575,13469,155760,383000,538760
6/9/2024,Chathura Malewana,Ampara,Chenkaladi,Eastern,3669,227,3896,146760,9080,155840
6/10/2024,Chathura Malewana,Ampara,Chenkaladi,Eastern,7764,8385,16149,310560,335400,645960
6/11/2024,Chathura Malewana,Ampara,Chenkaladi,Eastern,1222,2243,3465,48880,89720,138600
6/12/2024,Chathura Malewana,Ampara,Chenkaladi,Eastern,1528,3560,5088,61120,142400,203520
6/13/2024,Chathura Malewana,Ampara,Chenkaladi,Eastern,7187,1709,8896,287480,68360,355840
6/14/2024,Chathura Malewana,Ampara,Chenkaladi,Eastern,5264,3155,8419,210560,126200,336760
6/15/2024,Chathura Malewana,Ampara,Chenkaladi,Eastern,7415,1205,8620,296600,48200,344800
6/16/2024,Chathura Malewana,Ampara,Chenkaladi,Eastern,6684,2818,9502,267360,112720,380080
6/17/2024,Chathura Malewana,Ampara,Chenkaladi,Eastern,5322,8570,13892,212880,342800,555680
6/18/2024,Chathura Malewana,Ampara,Chenkaladi,Eastern,764,1858,2622,30560,74320,104880
6/19/2024,Chathura Malewana,Ampara,Chenkaladi,Eastern,4452,5309,9761,178080,212360,390440
6/20/2024,Chathura Malewana,Ampara,Chenkaladi,Eastern,8834,7203,16037,353360,288120,641480
6/21/2024,Chathura Malewana,Ampara,Chenkaladi,Eastern,2834,5019,7853,113360,200760,314120
6/22/2024,Chathura Malewana,Ampara,Chenkaladi,Eastern,8955,8361,17316,358200,334440,692640
6/23/2024,Chathura Malewana,Ampara,Chenkaladi,Eastern,4727,2942,7669,189080,117680,306760
6/24/2024,Chathura Malewana,Ampara,Chenkaladi,Eastern,7190,4622,11812,287600,184880,472480
6/25/2024,Chathura Malewana,Ampara,Chenkaladi,Eastern,9173,3037,12210,366920,121480,488400
6/26/2024,Chathura Malewana,Ampara,Chenkaladi,Eastern,3016,1696,4712,120640,67840,188480
6/27/2024,Chathura Malewana,Ampara,Chenkaladi,Eastern,7301,4019,11320,292040,160760,452800
6/28/2024,Chathura Malewana,Ampara,Chenkaladi,Eastern,8348,6419,14767,333920,256760,590680
6/29/2024,Chathura Malewana,Ampara,Chenkaladi,Eastern,4201,3417,7618,168040,136680,304720
6/30/2024,Chathura Malewana,Ampara,Chenkaladi,Eastern,487,1696,2183,19480,67840,87320
7/1/2024,Chathura Malewana,Ampara,Chenkaladi,Eastern,6153,9715,15868,246120,388600,634720
7/2/2024,Chathura Malewana,Ampara,Chenkaladi,Eastern,7459,2253,9712,298360,90120,388480
7/3/2024,Chathura Malewana,Ampara,Chenkaladi,Eastern,7940,5738,13678,317600,229520,547120
7/4/2024,Chathura Malewana,Ampara,Chenkaladi,Eastern,2737,1886,4623,109480,75440,184920
7/5/2024,Chathura Malewana,Ampara,Chenkaladi,Eastern,4183,3557,7740,167320,142280,309600
7/6/2024,Chathura Malewana,Ampara,Chenkaladi,Eastern,3175,7546,10721,127000,301840,428840
7/7/2024,Chathura Malewana,Ampara,Chenkaladi,Eastern,8678,8855,17533,347120,354200,701320
7/8/2024,Chathura Malewana,Ampara,Chenkaladi,Eastern,5458,5050,10508,218320,202000,420320
7/9/2024,Chathura Malewana,Ampara,Chenkaladi,Eastern,5161,3406,8567,206440,136240,342680
7/10/2024,Chathura Malewana,Ampara,Chenkaladi,Eastern,5271,4119,9390,210840,164760,375600
7/11/2024,Chathura Malewana,Ampara,Chenkaladi,Eastern,9339,6024,15363,373560,240960,614520
7/12/2024,Chathura Malewana,Ampara,Chenkaladi,Eastern,6646,5928,12574,265840,237120,502960
7/13/2024,Chathura Malewana,Ampara,Chenkaladi,Eastern,482,7759,8241,19280,310360,329640
7/14/2024,Chathura Malewana,Ampara,Chenkaladi,Eastern,5317,6659,11976,212680,266360,479040
7/15/2024,Chathura Malewana,Ampara,Chenkaladi,Eastern,372,2199,2571,14880,87960,102840
7/16/2024,Chathura Malewana,Ampara,Chenkaladi,Eastern,9180,5557,14737,367200,222280,589480
7/17/2024,Chathura Malewana,Ampara,Chenkaladi,Eastern,1104,8390,9494,44160,335600,379760
7/18/2024,Chathura Malewana,Ampara,Chenkaladi,Eastern,7627,594,8221,305080,23760,328840
7/19/2024,Chathura Malewana,Ampara,Chenkaladi,Eastern,8377,9974,18351,335080,398960,734040
7/20/2024,Chathura Malewana,Ampara,Chenkaladi,Eastern,7581,9314,16895,303240,372560,675800
7/21/2024,Chathura Malewana,Ampara,Chenkaladi,Eastern,3817,9092,12909,152680,363680,516360
7/22/2024,Chathura Malewana,Ampara,Chenkaladi,Eastern,3069,7736,10805,122760,309440,432200
7/23/2024,Chathura Malewana,Ampara,Chenkaladi,Eastern,8925,6135,15060,357000,245400,602400
7/24/2024,Chathura Malewana,Ampara,Chenkaladi,Eastern,5320,2257,7577,212800,90280,303080
7/25/2024,Chathura Malewana,Ampara,Chenkaladi,Eastern,1064,7453,8517,42560,298120,340680
7/26/2024,Chathura Malewana,Ampara,Chenkaladi,Eastern,5151,3916,9067,206040,156640,362680
7/27/2024,Chathura Malewana,Ampara,Chenkaladi,Eastern,1671,4715,6386,66840,188600,255440
7/28/2024,Chathura Malewana,Ampara,Chenkaladi,Eastern,682,5648,6330,27280,225920,253200
7/29/2024,Chathura Malewana,Ampara,Chenkaladi,Eastern,6287,1480,7767,251480,59200,310680
7/30/2024,Chathura Malewana,Ampara,Chenkaladi,Eastern,5211,4712,9923,208440,188480,396920
7/31/2024,Chathura Malewana,Ampara,Chenkaladi,Eastern,3261,146,3407,130440,5840,136280
8/1/2024,Chathura Malewana,Ampara,Chenkaladi,Eastern,8680,9489,18169,347200,379560,726760
8/2/2024,Chathura Malewana,Ampara,Chenkaladi,Eastern,8991,8860,17851,359640,354400,714040
8/3/2024,Chathura Malewana,Ampara,Chenkaladi,Eastern,6112,3626,9738,244480,145040,389520
8/4/2024,Chathura Malewana,Ampara,Chenkaladi,Eastern,6329,8183,14512,253160,327320,580480
8/5/2024,Chathura Malewana,Ampara,Chenkaladi,Eastern,1261,4502,5763,50440,180080,230520
8/6/2024,Chathura Malewana,Ampara,Chenkaladi,Eastern,1378,9099,10477,55120,363960,419080
8/7/2024,Chathura Malewana,Ampara,Chenkaladi,Eastern,3380,6781,10161,135200,271240,406440
8/8/2024,Chathura Malewana,Ampara,Chenkaladi,Eastern,2519,7143,9662,100760,285720,386480
8/9/2024,Chathura Malewana,Ampara,Chenkaladi,Eastern,7070,7714,14784,282800,308560,591360
8/10/2024,Chathura Malewana,Ampara,Chenkaladi,Eastern,6153,8360,14513,246120,334400,580520
8/11/2024,Chathura Malewana,Ampara,Chenkaladi,Eastern,1368,6279,7647,54720,251160,305880
8/12/2024,Chathura Malewana,Ampara,Chenkaladi,Eastern,8437,7685,16122,337480,307400,644880
8/13/2024,Chathura Malewana,Ampara,Chenkaladi,Eastern,6698,1646,8344,267920,65840,333760
8/14/2024,Chathura Malewana,Ampara,Chenkaladi,Eastern,987,3418,4405,39480,136720,176200
8/15/2024,Chathura Malewana,Ampara,Chenkaladi,Eastern,2337,1447,3784,93480,57880,151360
8/16/2024,Chathura Malewana,Ampara,Chenkaladi,Eastern,7860,8783,16643,314400,351320,665720
8/17/2024,Chathura Malewana,Ampara,Chenkaladi,Eastern,8842,6559,15401,353680,262360,616040
8/18/2024,Chathura Malewana,Ampara,Chenkaladi,Eastern,5,392,397,200,15680,15880
8/19/2024,Chathura Malewana,Ampara,Chenkaladi,Eastern,5450,6898,12348,218000,275920,493920
8/20/2024,Chathura Malewana,Ampara,Chenkaladi,Eastern,1980,4360,6340,79200,174400,253600
8/21/2024,Chathura Malewana,Ampara,Chenkaladi,Eastern,9207,4390,13597,368280,175600,543880
8/22/2024,Chathura Malewana,Ampara,Chenkaladi,Eastern,8806,2080,10886,352240,83200,435440
8/23/2024,Chathura Malewana,Ampara,Chenkaladi,Eastern,2362,2102,4464,94480,84080,178560
8/24/2024,Chathura Malewana,Ampara,Chenkaladi,Eastern,3723,1032,4755,148920,41280,190200
8/25/2024,Chathura Malewana,Ampara,Chenkaladi,Eastern,4968,2758,7726,198720,110320,309040
8/26/2024,Chathura Malewana,Ampara,Chenkaladi,Eastern,3377,2383,5760,135080,95320,230400
8/27/2024,Chathura Malewana,Ampara,Chenkaladi,Eastern,3450,9964,13414,138000,398560,536560
8/28/2024,Chathura Malewana,Ampara,Chenkaladi,Eastern,7426,4803,12229,297040,192120,489160
8/29/2024,Chathura Malewana,Ampara,Chenkaladi,Eastern,942,9258,10200,37680,370320,408000
8/30/2024,Chathura Malewana,Ampara,Chenkaladi,Eastern,2881,8496,11377,115240,339840,455080
8/31/2024,Chathura Malewana,Ampara,Chenkaladi,Eastern,9346,3511,12857,373840,140440,514280
9/1/2024,Chathura Malewana,Ampara,Chenkaladi,Eastern,9410,6750,16160,376400,270000,646400
9/2/2024,Chathura Malewana,Ampara,Chenkaladi,Eastern,172,5809,5981,6880,232360,239240
9/3/2024,Chathura Malewana,Ampara,Chenkaladi,Eastern,1910,4798,6708,76400,191920,268320
9/4/2024,Chathura Malewana,Ampara,Chenkaladi,Eastern,3552,6805,10357,142080,272200,414280
9/5/2024,Chathura Malewana,Ampara,Chenkaladi,Eastern,5336,7742,13078,213440,309680,523120
9/6/2024,Chathura Malewana,Ampara,Chenkaladi,Eastern,7665,5348,13013,306600,213920,520520
9/7/2024,Chathura Malewana,Ampara,Chenkaladi,Eastern,604,7727,8331,24160,309080,333240
9/8/2024,Chathura Malewana,Ampara,Chenkaladi,Eastern,8475,5606,14081,339000,224240,563240
9/9/2024,Chathura Malewana,Ampara,Chenkaladi,Eastern,6526,3669,10195,261040,146760,407800
9/10/2024,Chathura Malewana,Ampara,Chenkaladi,Eastern,6852,302,7154,274080,12080,286160
9/11/2024,Chathura Malewana,Ampara,Chenkaladi,Eastern,1432,1381,2813,57280,55240,112520
9/12/2024,Chathura Malewana,Ampara,Chenkaladi,Eastern,4412,2021,6433,176480,80840,257320
9/13/2024,Chathura Malewana,Ampara,Chenkaladi,Eastern,4228,2806,7034,169120,112240,281360
9/14/2024,Chathura Malewana,Ampara,Chenkaladi,Eastern,9125,7161,16286,365000,286440,651440
9/15/2024,Chathura Malewana,Ampara,Chenkaladi,Eastern,8985,6000,14985,359400,240000,599400
9/16/2024,Chathura Malewana,Ampara,Chenkaladi,Eastern,2722,1083,3805,108880,43320,152200
9/17/2024,Chathura Malewana,Ampara,Chenkaladi,Eastern,2174,9977,12151,86960,399080,486040
9/18/2024,Chathura Malewana,Ampara,Chenkaladi,Eastern,9904,422,10326,396160,16880,413040
9/19/2024,Chathura Malewana,Ampara,Chenkaladi,Eastern,2934,6271,9205,117360,250840,368200
9/20/2024,Chathura Malewana,Ampara,Chenkaladi,Eastern,368,4333,4701,14720,173320,188040
9/21/2024,Chathura Malewana,Ampara,Chenkaladi,Eastern,9323,2602,11925,372920,104080,477000
9/22/2024,Chathura Malewana,Ampara,Chenkaladi,Eastern,1885,5474,7359,75400,218960,294360
9/23/2024,Chathura Malewana,Ampara,Chenkaladi,Eastern,9456,8407,17863,378240,336280,714520
9/24/2024,Chathura Malewana,Ampara,Chenkaladi,Eastern,3593,9236,12829,143720,369440,513160
9/25/2024,Chathura Malewana,Ampara,Chenkaladi,Eastern,1767,6406,8173,70680,256240,326920
9/26/2024,Chathura Malewana,Ampara,Chenkaladi,Eastern,1034,263,1297,41360,10520,51880
9/27/2024,Chathura Malewana,Ampara,Chenkaladi,Eastern,4551,2818,7369,182040,112720,294760
9/28/2024,Chathura Malewana,Ampara,Chenkaladi,Eastern,8317,2484,10801,332680,99360,432040
9/29/2024,Chathura Malewana,Ampara,Chenkaladi,Eastern,9422,6580,16002,376880,263200,640080
9/30/2024,Chathura Malewana,Ampara,Chenkaladi,Eastern,9872,1526,11398,394880,61040,455920
10/1/2024,Chathura Malewana,Ampara,Chenkaladi,Eastern,9800,6689,16489,392000,267560,659560
10/2/2024,Chathura Malewana,Ampara,Chenkaladi,Eastern,211,5832,6043,8440,233280,241720
10/3/2024,Chathura Malewana,Ampara,Chenkaladi,Eastern,7597,4364,11961,303880,174560,478440
10/4/2024,Chathura Malewana,Ampara,Chenkaladi,Eastern,7686,7961,15647,307440,318440,625880
10/5/2024,Chathura Malewana,Ampara,Chenkaladi,Eastern,1427,8707,10134,57080,348280,405360
10/6/2024,Chathura Malewana,Ampara,Chenkaladi,Eastern,4496,7802,12298,179840,312080,491920
10/7/2024,Chathura Malewana,Ampara,Chenkaladi,Eastern,1143,5855,6998,45720,234200,279920
10/8/2024,Chathura Malewana,Ampara,Chenkaladi,Eastern,4780,2561,7341,191200,102440,293640
10/9/2024,Chathura Malewana,Ampara,Chenkaladi,Eastern,6822,1732,8554,272880,69280,342160
10/10/2024,Chathura Malewana,Ampara,Chenkaladi,Eastern,2611,9288,11899,104440,371520,475960
10/11/2024,Chathura Malewana,Ampara,Chenkaladi,Eastern,1988,5688,7676,79520,227520,307040
10/12/2024,Chathura Malewana,Ampara,Chenkaladi,Eastern,334,21,355,13360,840,14200
10/13/2024,Chathura Malewana,Ampara,Chenkaladi,Eastern,135,6662,6797,5400,266480,271880
10/14/2024,Chathura Malewana,Ampara,Chenkaladi,Eastern,9311,6691,16002,372440,267640,640080
10/15/2024,Chathura Malewana,Ampara,Chenkaladi,Eastern,9426,6401,15827,377040,256040,633080
10/16/2024,Chathura Malewana,Ampara,Chenkaladi,Eastern,9773,1838,11611,390920,73520,464440
10/17/2024,Chathura Malewana,Ampara,Chenkaladi,Eastern,5774,9298,15072,230960,371920,602880
10/18/2024,Chathura Malewana,Ampara,Chenkaladi,Eastern,5628,7351,12979,225120,294040,519160
10/19/2024,Chathura Malewana,Ampara,Chenkaladi,Eastern,2806,7747,10553,112240,309880,422120
10/20/2024,Chathura Malewana,Ampara,Chenkaladi,Eastern,9507,2275,11782,380280,91000,471280
10/21/2024,Chathura Malewana,Ampara,Chenkaladi,Eastern,2632,6025,8657,105280,241000,346280
10/22/2024,Chathura Malewana,Ampara,Chenkaladi,Eastern,9272,9823,19095,370880,392920,763800
10/23/2024,Chathura Malewana,Ampara,Chenkaladi,Eastern,1989,4605,6594,79560,184200,263760
10/24/2024,Chathura Malewana,Ampara,Chenkaladi,Eastern,4465,3498,7963,178600,139920,318520
10/25/2024,Chathura Malewana,Ampara,Chenkaladi,Eastern,9714,2210,11924,388560,88400,476960
10/26/2024,Chathura Malewana,Ampara,Chenkaladi,Eastern,6222,6197,12419,248880,247880,496760
10/27/2024,Chathura Malewana,Ampara,Chenkaladi,Eastern,2775,4726,7501,111000,189040,300040
10/28/2024,Chathura Malewana,Ampara,Chenkaladi,Eastern,6232,3914,10146,249280,156560,405840
10/29/2024,Chathura Malewana,Ampara,Chenkaladi,Eastern,9977,7014,16991,399080,280560,679640
10/30/2024,Chathura Malewana,Ampara,Chenkaladi,Eastern,5802,9394,15196,232080,375760,607840
10/31/2024,Chathura Malewana,Ampara,Chenkaladi,Eastern,3826,7907,11733,153040,316280,469320
11/1/2024,Chathura Malewana,Ampara,Chenkaladi,Eastern,1380,7645,9025,55200,305800,361000
11/2/2024,Chathura Malewana,Ampara,Chenkaladi,Eastern,955,8807,9762,38200,352280,390480
11/3/2024,Chathura Malewana,Ampara,Chenkaladi,Eastern,3159,6617,9776,126360,264680,391040
11/4/2024,Chathura Malewana,Ampara,Chenkaladi,Eastern,1180,5044,6224,47200,201760,248960
11/5/2024,Chathura Malewana,Ampara,Chenkaladi,Eastern,2067,8889,10956,82680,355560,438240
11/6/2024,Chathura Malewana,Ampara,Chenkaladi,Eastern,5200,2186,7386,208000,87440,295440
11/7/2024,Chathura Malewana,Ampara,Chenkaladi,Eastern,6411,3058,9469,256440,122320,378760
11/8/2024,Chathura Malewana,Ampara,Chenkaladi,Eastern,3040,971,4011,121600,38840,160440
11/9/2024,Chathura Malewana,Ampara,Chenkaladi,Eastern,3192,1017,4209,127680,40680,168360
11/10/2024,Chathura Malewana,Ampara,Chenkaladi,Eastern,4606,2678,7284,184240,107120,291360
11/11/2024,Chathura Malewana,Ampara,Chenkaladi,Eastern,9701,7731,17432,388040,309240,697280
11/12/2024,Chathura Malewana,Ampara,Chenkaladi,Eastern,1168,3140,4308,46720,125600,172320
11/13/2024,Chathura Malewana,Ampara,Chenkaladi,Eastern,6304,5145,11449,252160,205800,457960
11/14/2024,Chathura Malewana,Ampara,Chenkaladi,Eastern,5156,4296,9452,206240,171840,378080
11/15/2024,Chathura Malewana,Ampara,Chenkaladi,Eastern,9936,2331,12267,397440,93240,490680
11/16/2024,Chathura Malewana,Ampara,Chenkaladi,Eastern,1370,1200,2570,54800,48000,102800
11/17/2024,Chathura Malewana,Ampara,Chenkaladi,Eastern,1496,4913,6409,59840,196520,256360
11/18/2024,Chathura Malewana,Ampara,Chenkaladi,Eastern,4102,465,4567,164080,18600,182680
11/19/2024,Chathura Malewana,Ampara,Chenkaladi,Eastern,7249,8034,15283,289960,321360,611320
11/20/2024,Chathura Malewana,Ampara,Chenkaladi,Eastern,6338,5601,11939,253520,224040,477560
11/21/2024,Chathura Malewana,Ampara,Chenkaladi,Eastern,2257,9681,11938,90280,387240,477520
11/22/2024,Chathura Malewana,Ampara,Chenkaladi,Eastern,8406,7755,16161,336240,310200,646440
11/23/2024,Chathura Malewana,Ampara,Chenkaladi,Eastern,5250,3676,8926,210000,147040,357040
11/24/2024,Chathura Malewana,Ampara,Chenkaladi,Eastern,7570,8263,15833,302800,330520,633320
11/25/2024,Chathura Malewana,Ampara,Chenkaladi,Eastern,8988,7453,16441,359520,298120,657640
11/26/2024,Chathura Malewana,Ampara,Chenkaladi,Eastern,3881,6388,10269,155240,255520,410760
11/27/2024,Chathura Malewana,Ampara,Chenkaladi,Eastern,1754,7709,9463,70160,308360,378520
11/28/2024,Chathura Malewana,Ampara,Chenkaladi,Eastern,3035,4493,7528,121400,179720,301120
11/29/2024,Chathura Malewana,Ampara,Chenkaladi,Eastern,9797,8144,17941,391880,325760,717640
11/30/2024,Chathura Malewana,Ampara,Chenkaladi,Eastern,3637,5175,8812,145480,207000,352480
12/1/2024,Chathura Malewana,Ampara,Chenkaladi,Eastern,3100,3460,6560,124000,138400,262400
12/2/2024,Chathura Malewana,Ampara,Chenkaladi,Eastern,862,7595,8457,34480,303800,338280
12/3/2024,Chathura Malewana,Ampara,Chenkaladi,Eastern,7141,9524,16665,285640,380960,666600
12/4/2024,Chathura Malewana,Ampara,Chenkaladi,Eastern,377,5999,6376,15080,239960,255040
12/5/2024,Chathura Malewana,Ampara,Chenkaladi,Eastern,1638,2533,4171,65520,101320,166840
12/6/2024,Chathura Malewana,Ampara,Chenkaladi,Eastern,9220,8812,18032,368800,352480,721280
12/7/2024,Chathura Malewana,Ampara,Chenkaladi,Eastern,1276,808,2084,51040,32320,83360
12/8/2024,Chathura Malewana,Ampara,Chenkaladi,Eastern,4210,6020,10230,168400,240800,409200
12/9/2024,Chathura Malewana,Ampara,Chenkaladi,Eastern,5830,1291,7121,233200,51640,284840
12/10/2024,Chathura Malewana,Ampara,Chenkaladi,Eastern,3761,6862,10623,150440,274480,424920
12/11/2024,Chathura Malewana,Ampara,Chenkaladi,Eastern,87,109,196,3480,4360,7840
12/12/2024,Chathura Malewana,Ampara,Chenkaladi,Eastern,7888,5068,12956,315520,202720,518240
12/13/2024,Chathura Malewana,Ampara,Chenkaladi,Eastern,657,1248,1905,26280,49920,76200
12/14/2024,Chathura Malewana,Ampara,Chenkaladi,Eastern,2523,1946,4469,100920,77840,178760
12/15/2024,Chathura Malewana,Ampara,Chenkaladi,Eastern,1243,3513,4756,49720,140520,190240
12/16/2024,Chathura Malewana,Ampara,Chenkaladi,Eastern,6564,4144,10708,262560,165760,428320
12/17/2024,Chathura Malewana,Ampara,Chenkaladi,Eastern,9083,5199,14282,363320,207960,571280
12/18/2024,Chathura Malewana,Ampara,Chenkaladi,Eastern,1721,3545,5266,68840,141800,210640
12/19/2024,Chathura Malewana,Ampara,Chenkaladi,Eastern,5832,4831,10663,233280,193240,426520
12/20/2024,Chathura Malewana,Ampara,Chenkaladi,Eastern,7819,5248,13067,312760,209920,522680
12/21/2024,Chathura Malewana,Ampara,Chenkaladi,Eastern,7173,9020,16193,286920,360800,647720
12/22/2024,Chathura Malewana,Ampara,Chenkaladi,Eastern,3380,9645,13025,135200,385800,521000
12/23/2024,Chathura Malewana,Ampara,Chenkaladi,Eastern,8546,5652,14198,341840,226080,567920
12/24/2024,Chathura Malewana,Ampara,Chenkaladi,Eastern,2249,2018,4267,89960,80720,170680
12/25/2024,Chathura Malewana,Ampara,Chenkaladi,Eastern,4820,5396,10216,192800,215840,408640
12/26/2024,Chathura Malewana,Ampara,Chenkaladi,Eastern,4059,4551,8610,162360,182040,344400
12/27/2024,Chathura Malewana,Ampara,Chenkaladi,Eastern,1986,5724,7710,79440,228960,308400
12/28/2024,Chathura Malewana,Ampara,Chenkaladi,Eastern,3379,5575,8954,135160,223000,358160
12/29/2024,Chathura Malewana,Ampara,Chenkaladi,Eastern,8385,2738,11123,335400,109520,444920
12/30/2024,Chathura Malewana,Ampara,Chenkaladi,Eastern,4559,9058,13617,182360,362320,544680
12/31/2024,Chathura Malewana,Ampara,Chenkaladi,Eastern,1430,7106,8536,57200,284240,341440
1/1/2025,Chathura Malewana,Ampara,Chenkaladi,Eastern,7809,6956,14765,312360,278240,590600
1/2/2025,Chathura Malewana,Ampara,Chenkaladi,Eastern,6775,3703,10478,271000,148120,419120
1/3/2025,Chathura Malewana,Ampara,Chenkaladi,Eastern,3426,8380,11806,137040,335200,472240
1/4/2025,Chathura Malewana,Ampara,Chenkaladi,Eastern,7448,6432,13880,297920,257280,555200
1/5/2025,Chathura Malewana,Ampara,Chenkaladi,Eastern,2842,2016,4858,113680,80640,194320
1/6/2025,Chathura Malewana,Ampara,Chenkaladi,Eastern,2437,8936,11373,97480,357440,454920
1/7/2025,Chathura Malewana,Ampara,Chenkaladi,Eastern,9031,1566,10597,361240,62640,423880
1/8/2025,Chathura Malewana,Ampara,Chenkaladi,Eastern,7670,9462,17132,306800,378480,685280
1/9/2025,Chathura Malewana,Ampara,Chenkaladi,Eastern,2995,4242,7237,119800,169680,289480
1/10/2025,Chathura Malewana,Ampara,Chenkaladi,Eastern,5255,8129,13384,210200,325160,535360
1/11/2025,Chathura Malewana,Ampara,Chenkaladi,Eastern,9253,8859,18112,370120,354360,724480
1/12/2025,Chathura Malewana,Ampara,Chenkaladi,Eastern,8745,4668,13413,349800,186720,536520
1/13/2025,Chathura Malewana,Ampara,Chenkaladi,Eastern,4829,46,4875,193160,1840,195000
1/14/2025,Chathura Malewana,Ampara,Chenkaladi,Eastern,731,5685,6416,29240,227400,256640
1/15/2025,Chathura Malewana,Ampara,Chenkaladi,Eastern,8569,2691,11260,342760,107640,450400
1/16/2025,Chathura Malewana,Ampara,Chenkaladi,Eastern,9962,6128,16090,398480,245120,643600
1/17/2025,Chathura Malewana,Ampara,Chenkaladi,Eastern,4519,6743,11262,180760,269720,450480
1/18/2025,Chathura Malewana,Ampara,Chenkaladi,Eastern,5151,6357,11508,206040,254280,460320
1/19/2025,Chathura Malewana,Ampara,Chenkaladi,Eastern,7323,4260,11583,292920,170400,463320
1/20/2025,Chathura Malewana,Ampara,Chenkaladi,Eastern,4243,5557,9800,169720,222280,392000
1/21/2025,Chathura Malewana,Ampara,Chenkaladi,Eastern,499,6451,6950,19960,258040,278000
1/22/2025,Chathura Malewana,Ampara,Chenkaladi,Eastern,7275,8203,15478,291000,328120,619120
1/23/2025,Chathura Malewana,Ampara,Chenkaladi,Eastern,3336,2198,5534,133440,87920,221360
1/24/2025,Chathura Malewana,Ampara,Chenkaladi,Eastern,5314,2184,7498,212560,87360,299920
1/25/2025,Chathura Malewana,Ampara,Chenkaladi,Eastern,1184,6022,7206,47360,240880,288240
1/26/2025,Chathura Malewana,Ampara,Chenkaladi,Eastern,173,9713,9886,6920,388520,395440
1/27/2025,Chathura Malewana,Ampara,Chenkaladi,Eastern,8431,8433,16864,337240,337320,674560
1/28/2025,Chathura Malewana,Ampara,Chenkaladi,Eastern,1658,1549,3207,66320,61960,128280
1/29/2025,Chathura Malewana,Ampara,Chenkaladi,Eastern,1877,6640,8517,75080,265600,340680
1/30/2025,Chathura Malewana,Ampara,Chenkaladi,Eastern,7424,8972,16396,296960,358880,655840
1/31/2025,Chathura Malewana,Ampara,Chenkaladi,Eastern,9232,9494,18726,369280,379760,749040
2/1/2025,Chathura Malewana,Ampara,Chenkaladi,Eastern,69,6677,6746,2760,267080,269840
2/2/2025,Chathura Malewana,Ampara,Chenkaladi,Eastern,3333,7162,10495,133320,286480,419800
2/3/2025,Chathura Malewana,Ampara,Chenkaladi,Eastern,5991,8836,14827,239640,353440,593080
2/4/2025,Chathura Malewana,Ampara,Chenkaladi,Eastern,4043,1968,6011,161720,78720,240440
2/5/2025,Chathura Malewana,Ampara,Chenkaladi,Eastern,9721,9150,18871,388840,366000,754840
2/6/2025,Chathura Malewana,Ampara,Chenkaladi,Eastern,7300,1411,8711,292000,56440,348440
2/7/2025,Chathura Malewana,Ampara,Chenkaladi,Eastern,439,2789,3228,17560,111560,129120
2/8/2025,Chathura Malewana,Ampara,Chenkaladi,Eastern,8651,4971,13622,346040,198840,544880
2/9/2025,Chathura Malewana,Ampara,Chenkaladi,Eastern,2648,4735,7383,105920,189400,295320
2/10/2025,Chathura Malewana,Ampara,Chenkaladi,Eastern,3602,2576,6178,144080,103040,247120
2/11/2025,Chathura Malewana,Ampara,Chenkaladi,Eastern,9206,8690,17896,368240,347600,715840
2/12/2025,Chathura Malewana,Ampara,Chenkaladi,Eastern,9022,4566,13588,360880,182640,543520
2/13/2025,Chathura Malewana,Ampara,Chenkaladi,Eastern,1609,6334,7943,64360,253360,317720
2/14/2025,Chathura Malewana,Ampara,Chenkaladi,Eastern,9479,6677,16156,379160,267080,646240
2/15/2025,Chathura Malewana,Ampara,Chenkaladi,Eastern,7905,8856,16761,316200,354240,670440
2/16/2025,Chathura Malewana,Ampara,Chenkaladi,Eastern,7146,6003,13149,285840,240120,525960
2/17/2025,Chathura Malewana,Ampara,Chenkaladi,Eastern,7349,6737,14086,293960,269480,563440
2/18/2025,Chathura Malewana,Ampara,Chenkaladi,Eastern,1286,9141,10427,51440,365640,417080
2/19/2025,Chathura Malewana,Ampara,Chenkaladi,Eastern,1987,6346,8333,79480,253840,333320
2/20/2025,Chathura Malewana,Ampara,Chenkaladi,Eastern,4145,7751,11896,165800,310040,475840
2/21/2025,Chathura Malewana,Ampara,Chenkaladi,Eastern,6585,2185,8770,263400,87400,350800
2/22/2025,Chathura Malewana,Ampara,Chenkaladi,Eastern,2033,2603,4636,81320,104120,185440
2/23/2025,Chathura Malewana,Ampara,Chenkaladi,Eastern,6567,2846,9413,262680,113840,376520
2/24/2025,Chathura Malewana,Ampara,Chenkaladi,Eastern,4171,9981,14152,166840,399240,566080
2/25/2025,Chathura Malewana,Ampara,Chenkaladi,Eastern,9272,4787,14059,370880,191480,562360
2/26/2025,Chathura Malewana,Ampara,Chenkaladi,Eastern,7323,6827,14150,292920,273080,566000
2/27/2025,Chathura Malewana,Ampara,Chenkaladi,Eastern,7247,4953,12200,289880,198120,488000
2/28/2025,Chathura Malewana,Ampara,Chenkaladi,Eastern,3983,7895,11878,159320,315800,475120
3/1/2025,Chathura Malewana,Ampara,Chenkaladi,Eastern,302,4278,4580,12080,171120,183200
3/2/2025,Chathura Malewana,Ampara,Chenkaladi,Eastern,1159,5,1164,46360,200,46560
3/3/2025,Chathura Malewana,Ampara,Chenkaladi,Eastern,8023,9641,17664,320920,385640,706560
3/4/2025,Chathura Malewana,Ampara,Chenkaladi,Eastern,6012,2266,8278,240480,90640,331120
3/5/2025,Chathura Malewana,Ampara,Chenkaladi,Eastern,5057,7679,12736,202280,307160,509440
3/6/2025,Chathura Malewana,Ampara,Chenkaladi,Eastern,8146,8119,16265,325840,324760,650600
3/7/2025,Chathura Malewana,Ampara,Chenkaladi,Eastern,4760,854,5614,190400,34160,224560
3/8/2025,Chathura Malewana,Ampara,Chenkaladi,Eastern,1054,5474,6528,42160,218960,261120
3/9/2025,Chathura Malewana,Ampara,Chenkaladi,Eastern,9607,7386,16993,384280,295440,679720
3/10/2025,Chathura Malewana,Ampara,Chenkaladi,Eastern,2870,7514,10384,114800,300560,415360
3/11/2025,Chathura Malewana,Ampara,Chenkaladi,Eastern,79,6420,6499,3160,256800,259960
3/12/2025,Chathura Malewana,Ampara,Chenkaladi,Eastern,6968,9549,16517,278720,381960,660680
3/13/2025,Chathura Malewana,Ampara,Chenkaladi,Eastern,7808,8544,16352,312320,341760,654080
3/14/2025,Chathura Malewana,Ampara,Chenkaladi,Eastern,3970,9515,13485,158800,380600,539400
3/15/2025,Chathura Malewana,Ampara,Chenkaladi,Eastern,4395,3467,7862,175800,138680,314480
3/16/2025,Chathura Malewana,Ampara,Chenkaladi,Eastern,4759,3449,8208,190360,137960,328320
3/17/2025,Chathura Malewana,Ampara,Chenkaladi,Eastern,9455,4936,14391,378200,197440,575640
3/18/2025,Chathura Malewana,Ampara,Chenkaladi,Eastern,160,2871,3031,6400,114840,121240
3/19/2025,Chathura Malewana,Ampara,Chenkaladi,Eastern,2087,4974,7061,83480,198960,282440
3/20/2025,Chathura Malewana,Ampara,Chenkaladi,Eastern,38,8418,8456,1520,336720,338240
3/21/2025,Chathura Malewana,Ampara,Chenkaladi,Eastern,174,7584,7758,6960,303360,310320
3/22/2025,Chathura Malewana,Ampara,Chenkaladi,Eastern,5998,2725,8723,239920,109000,348920
3/23/2025,Chathura Malewana,Ampara,Chenkaladi,Eastern,1861,7120,8981,74440,284800,359240
3/25/2024,Anushka Wijesuriya,Badulla,Haputale,Uva,8119,29,8148,324760,1160,325920
3/26/2024,Anushka Wijesuriya,Badulla,Haputale,Uva,4344,3266,7610,173760,130640,304400
3/27/2024,Anushka Wijesuriya,Badulla,Haputale,Uva,4724,2919,7643,188960,116760,305720
3/28/2024,Anushka Wijesuriya,Badulla,Haputale,Uva,5813,6722,12535,232520,268880,501400
3/29/2024,Anushka Wijesuriya,Badulla,Haputale,Uva,6728,275,7003,269120,11000,280120
3/30/2024,Anushka Wijesuriya,Badulla,Haputale,Uva,5448,171,5619,217920,6840,224760
3/31/2024,Anushka Wijesuriya,Badulla,Haputale,Uva,7699,7926,15625,307960,317040,625000
4/1/2024,Anushka Wijesuriya,Badulla,Haputale,Uva,3370,5606,8976,134800,224240,359040
4/2/2024,Anushka Wijesuriya,Badulla,Haputale,Uva,3100,6065,9165,124000,242600,366600
4/3/2024,Anushka Wijesuriya,Badulla,Haputale,Uva,3721,1822,5543,148840,72880,221720
4/4/2024,Anushka Wijesuriya,Badulla,Haputale,Uva,1207,1709,2916,48280,68360,116640
4/5/2024,Anushka Wijesuriya,Badulla,Haputale,Uva,9808,8217,18025,392320,328680,721000
4/6/2024,Anushka Wijesuriya,Badulla,Haputale,Uva,1083,4779,5862,43320,191160,234480
4/7/2024,Anushka Wijesuriya,Badulla,Haputale,Uva,2243,3197,5440,89720,127880,217600
4/8/2024,Anushka Wijesuriya,Badulla,Haputale,Uva,6597,6722,13319,263880,268880,532760
4/9/2024,Anushka Wijesuriya,Badulla,Haputale,Uva,3924,9576,13500,156960,383040,540000
4/10/2024,Anushka Wijesuriya,Badulla,Haputale,Uva,5263,8401,13664,210520,336040,546560
4/11/2024,Anushka Wijesuriya,Badulla,Haputale,Uva,7321,3116,10437,292840,124640,417480
4/19/2024,Anushka Wijesuriya,Badulla,Haputale,Uva,1622,5675,7297,64880,227000,291880
4/20/2024,Anushka Wijesuriya,Badulla,Haputale,Uva,9258,9581,18839,370320,383240,753560
4/21/2024,Anushka Wijesuriya,Badulla,Haputale,Uva,8898,7093,15991,355920,283720,639640
4/22/2024,Anushka Wijesuriya,Badulla,Haputale,Uva,8652,1008,9660,346080,40320,386400
4/23/2024,Anushka Wijesuriya,Badulla,Haputale,Uva,432,4653,5085,17280,186120,203400
4/24/2024,Anushka Wijesuriya,Badulla,Haputale,Uva,1583,2467,4050,63320,98680,162000
4/25/2024,Anushka Wijesuriya,Badulla,Haputale,Uva,9928,6013,15941,397120,240520,637640
4/26/2024,Anushka Wijesuriya,Badulla,Haputale,Uva,2494,2785,5279,99760,111400,211160
4/27/2024,Anushka Wijesuriya,Badulla,Haputale,Uva,1409,5169,6578,56360,206760,263120
4/28/2024,Anushka Wijesuriya,Badulla,Haputale,Uva,8398,9345,17743,335920,373800,709720
4/29/2024,Anushka Wijesuriya,Badulla,Haputale,Uva,8666,6351,15017,346640,254040,600680
4/30/2024,Anushka Wijesuriya,Badulla,Haputale,Uva,542,1696,2238,21680,67840,89520
5/1/2024,Anushka Wijesuriya,Badulla,Haputale,Uva,364,887,1251,14560,35480,50040
5/2/2024,Anushka Wijesuriya,Badulla,Haputale,Uva,9412,4388,13800,376480,175520,552000
5/3/2024,Anushka Wijesuriya,Badulla,Haputale,Uva,8003,1878,9881,320120,75120,395240
5/4/2024,Anushka Wijesuriya,Badulla,Haputale,Uva,9806,3651,13457,392240,146040,538280
5/5/2024,Anushka Wijesuriya,Badulla,Haputale,Uva,8868,4673,13541,354720,186920,541640
5/6/2024,Anushka Wijesuriya,Badulla,Haputale,Uva,6233,1898,8131,249320,75920,325240
5/7/2024,Anushka Wijesuriya,Badulla,Haputale,Uva,9673,4675,14348,386920,187000,573920
5/8/2024,Anushka Wijesuriya,Badulla,Haputale,Uva,9481,9844,19325,379240,393760,773000
5/9/2024,Anushka Wijesuriya,Badulla,Haputale,Uva,153,5544,5697,6120,221760,227880
5/10/2024,Anushka Wijesuriya,Badulla,Haputale,Uva,7276,4737,12013,291040,189480,480520
5/11/2024,Anushka Wijesuriya,Badulla,Haputale,Uva,8299,7141,15440,331960,285640,617600
5/12/2024,Anushka Wijesuriya,Badulla,Haputale,Uva,4804,8923,13727,192160,356920,549080
5/13/2024,Anushka Wijesuriya,Badulla,Haputale,Uva,607,7123,7730,24280,284920,309200
5/14/2024,Anushka Wijesuriya,Badulla,Haputale,Uva,2209,4213,6422,88360,168520,256880
5/15/2024,Anushka Wijesuriya,Badulla,Haputale,Uva,7517,616,8133,300680,24640,325320
5/16/2024,Anushka Wijesuriya,Badulla,Haputale,Uva,4677,1052,5729,187080,42080,229160
5/17/2024,Anushka Wijesuriya,Badulla,Haputale,Uva,1119,966,2085,44760,38640,83400
5/18/2024,Anushka Wijesuriya,Badulla,Haputale,Uva,5635,379,6014,225400,15160,240560
5/19/2024,Anushka Wijesuriya,Badulla,Haputale,Uva,4274,8097,12371,170960,323880,494840
5/20/2024,Anushka Wijesuriya,Badulla,Haputale,Uva,7056,9828,16884,282240,393120,675360
5/21/2024,Anushka Wijesuriya,Badulla,Haputale,Uva,6147,8643,14790,245880,345720,591600
5/22/2024,Anushka Wijesuriya,Badulla,Haputale,Uva,4067,1963,6030,162680,78520,241200
5/24/2024,Anushka Wijesuriya,Badulla,Haputale,Uva,9765,8943,18708,390600,357720,748320
5/25/2024,Anushka Wijesuriya,Badulla,Haputale,Uva,4125,7177,11302,165000,287080,452080
5/26/2024,Anushka Wijesuriya,Badulla,Haputale,Uva,4779,2327,7106,191160,93080,284240
5/27/2024,Anushka Wijesuriya,Badulla,Haputale,Uva,4365,6075,10440,174600,243000,417600
5/28/2024,Anushka Wijesuriya,Badulla,Haputale,Uva,4273,5918,10191,170920,236720,407640
5/29/2024,Anushka Wijesuriya,Badulla,Haputale,Uva,7741,9493,17234,309640,379720,689360
5/30/2024,Anushka Wijesuriya,Badulla,Haputale,Uva,3206,3556,6762,128240,142240,270480
5/31/2024,Anushka Wijesuriya,Badulla,Haputale,Uva,1854,370,2224,74160,14800,88960
6/1/2024,Anushka Wijesuriya,Badulla,Haputale,Uva,3826,8832,12658,153040,353280,506320
6/2/2024,Anushka Wijesuriya,Badulla,Haputale,Uva,1473,6886,8359,58920,275440,334360
6/3/2024,Anushka Wijesuriya,Badulla,Haputale,Uva,7809,4097,11906,312360,163880,476240
6/4/2024,Anushka Wijesuriya,Badulla,Haputale,Uva,9348,170,9518,373920,6800,380720
6/5/2024,Anushka Wijesuriya,Badulla,Haputale,Uva,2877,1003,3880,115080,40120,155200
6/6/2024,Anushka Wijesuriya,Badulla,Haputale,Uva,8159,6804,14963,326360,272160,598520
6/7/2024,Anushka Wijesuriya,Badulla,Haputale,Uva,4010,9798,13808,160400,391920,552320
6/8/2024,Anushka Wijesuriya,Badulla,Haputale,Uva,1190,7739,8929,47600,309560,357160
6/9/2024,Anushka Wijesuriya,Badulla,Haputale,Uva,3926,8132,12058,157040,325280,482320
6/10/2024,Anushka Wijesuriya,Badulla,Haputale,Uva,3466,2311,5777,138640,92440,231080
6/11/2024,Anushka Wijesuriya,Badulla,Haputale,Uva,3504,866,4370,140160,34640,174800
6/12/2024,Anushka Wijesuriya,Badulla,Haputale,Uva,4810,6874,11684,192400,274960,467360
6/13/2024,Anushka Wijesuriya,Badulla,Haputale,Uva,1875,1193,3068,75000,47720,122720
6/14/2024,Anushka Wijesuriya,Badulla,Haputale,Uva,1139,2125,3264,45560,85000,130560
6/15/2024,Anushka Wijesuriya,Badulla,Haputale,Uva,161,3903,4064,6440,156120,162560
6/16/2024,Anushka Wijesuriya,Badulla,Haputale,Uva,3284,6144,9428,131360,245760,377120
6/17/2024,Anushka Wijesuriya,Badulla,Haputale,Uva,556,5613,6169,22240,224520,246760
6/18/2024,Anushka Wijesuriya,Badulla,Haputale,Uva,4013,4678,8691,160520,187120,347640
6/19/2024,Anushka Wijesuriya,Badulla,Haputale,Uva,3199,6889,10088,127960,275560,403520
6/20/2024,Anushka Wijesuriya,Badulla,Haputale,Uva,7415,412,7827,296600,16480,313080
6/21/2024,Anushka Wijesuriya,Badulla,Haputale,Uva,9079,6766,15845,363160,270640,633800
6/22/2024,Anushka Wijesuriya,Badulla,Haputale,Uva,2646,6884,9530,105840,275360,381200
6/23/2024,Anushka Wijesuriya,Badulla,Haputale,Uva,6119,4845,10964,244760,193800,438560
6/24/2024,Anushka Wijesuriya,Badulla,Haputale,Uva,6221,2612,8833,248840,104480,353320
6/25/2024,Anushka Wijesuriya,Badulla,Haputale,Uva,2792,6214,9006,111680,248560,360240
6/26/2024,Anushka Wijesuriya,Badulla,Haputale,Uva,3457,1761,5218,138280,70440,208720
6/27/2024,Anushka Wijesuriya,Badulla,Haputale,Uva,581,5772,6353,23240,230880,254120
6/28/2024,Anushka Wijesuriya,Badulla,Haputale,Uva,4823,446,5269,192920,17840,210760
6/29/2024,Anushka Wijesuriya,Badulla,Haputale,Uva,6435,6126,12561,257400,245040,502440
6/30/2024,Anushka Wijesuriya,Badulla,Haputale,Uva,9548,2753,12301,381920,110120,492040
7/1/2024,Anushka Wijesuriya,Badulla,Haputale,Uva,9779,2613,12392,391160,104520,495680
7/2/2024,Anushka Wijesuriya,Badulla,Haputale,Uva,3137,6748,9885,125480,269920,395400
7/3/2024,Anushka Wijesuriya,Badulla,Haputale,Uva,9180,8752,17932,367200,350080,717280
7/4/2024,Anushka Wijesuriya,Badulla,Haputale,Uva,9093,5718,14811,363720,228720,592440
7/5/2024,Anushka Wijesuriya,Badulla,Haputale,Uva,9666,8496,18162,386640,339840,726480
7/6/2024,Anushka Wijesuriya,Badulla,Haputale,Uva,8906,2191,11097,356240,87640,443880
7/7/2024,Anushka Wijesuriya,Badulla,Haputale,Uva,1570,1740,3310,62800,69600,132400
7/8/2024,Anushka Wijesuriya,Badulla,Haputale,Uva,1491,6847,8338,59640,273880,333520
7/9/2024,Anushka Wijesuriya,Badulla,Haputale,Uva,8497,3805,12302,339880,152200,492080
7/10/2024,Anushka Wijesuriya,Badulla,Haputale,Uva,7344,1250,8594,293760,50000,343760
7/11/2024,Anushka Wijesuriya,Badulla,Haputale,Uva,3250,1461,4711,130000,58440,188440
7/12/2024,Anushka Wijesuriya,Badulla,Haputale,Uva,4550,3612,8162,182000,144480,326480
7/13/2024,Anushka Wijesuriya,Badulla,Haputale,Uva,8563,2328,10891,342520,93120,435640
7/14/2024,Anushka Wijesuriya,Badulla,Haputale,Uva,7035,7938,14973,281400,317520,598920
7/15/2024,Anushka Wijesuriya,Badulla,Haputale,Uva,904,816,1720,36160,32640,68800
7/16/2024,Anushka Wijesuriya,Badulla,Haputale,Uva,9535,9059,18594,381400,362360,743760
7/17/2024,Anushka Wijesuriya,Badulla,Haputale,Uva,265,9605,9870,10600,384200,394800
7/18/2024,Anushka Wijesuriya,Badulla,Haputale,Uva,3844,4738,8582,153760,189520,343280
7/19/2024,Anushka Wijesuriya,Badulla,Haputale,Uva,5815,8889,14704,232600,355560,588160
7/20/2024,Anushka Wijesuriya,Badulla,Haputale,Uva,3759,3542,7301,150360,141680,292040
7/21/2024,Anushka Wijesuriya,Badulla,Haputale,Uva,9700,2925,12625,388000,117000,505000
7/22/2024,Anushka Wijesuriya,Badulla,Haputale,Uva,6137,7775,13912,245480,311000,556480
7/23/2024,Anushka Wijesuriya,Badulla,Haputale,Uva,2945,4265,7210,117800,170600,288400
7/24/2024,Anushka Wijesuriya,Badulla,Haputale,Uva,70,1897,1967,2800,75880,78680
7/25/2024,Anushka Wijesuriya,Badulla,Haputale,Uva,9142,9021,18163,365680,360840,726520
7/26/2024,Anushka Wijesuriya,Badulla,Haputale,Uva,5153,7815,12968,206120,312600,518720
7/27/2024,Anushka Wijesuriya,Badulla,Haputale,Uva,3654,9260,12914,146160,370400,516560
7/28/2024,Anushka Wijesuriya,Badulla,Haputale,Uva,8564,5020,13584,342560,200800,543360
7/29/2024,Anushka Wijesuriya,Badulla,Haputale,Uva,704,9849,10553,28160,393960,422120
7/30/2024,Anushka Wijesuriya,Badulla,Haputale,Uva,6610,9108,15718,264400,364320,628720
7/31/2024,Anushka Wijesuriya,Badulla,Haputale,Uva,9928,5270,15198,397120,210800,607920
8/1/2024,Anushka Wijesuriya,Badulla,Haputale,Uva,1403,5995,7398,56120,239800,295920
8/2/2024,Anushka Wijesuriya,Badulla,Haputale,Uva,6338,804,7142,253520,32160,285680
8/3/2024,Anushka Wijesuriya,Badulla,Haputale,Uva,8994,7089,16083,359760,283560,643320
8/4/2024,Anushka Wijesuriya,Badulla,Haputale,Uva,4152,7981,12133,166080,319240,485320
8/5/2024,Anushka Wijesuriya,Badulla,Haputale,Uva,7011,6766,13777,280440,270640,551080
8/6/2024,Anushka Wijesuriya,Badulla,Haputale,Uva,2409,1157,3566,96360,46280,142640
8/7/2024,Anushka Wijesuriya,Badulla,Haputale,Uva,8565,6118,14683,342600,244720,587320
8/8/2024,Anushka Wijesuriya,Badulla,Haputale,Uva,4592,5979,10571,183680,239160,422840
8/9/2024,Anushka Wijesuriya,Badulla,Haputale,Uva,9758,7354,17112,390320,294160,684480
8/10/2024,Anushka Wijesuriya,Badulla,Haputale,Uva,2667,5911,8578,106680,236440,343120
8/11/2024,Anushka Wijesuriya,Badulla,Haputale,Uva,554,4957,5511,22160,198280,220440
8/12/2024,Anushka Wijesuriya,Badulla,Haputale,Uva,3532,3554,7086,141280,142160,283440
8/13/2024,Anushka Wijesuriya,Badulla,Haputale,Uva,74,7508,7582,2960,300320,303280
8/14/2024,Anushka Wijesuriya,Badulla,Haputale,Uva,3788,2558,6346,151520,102320,253840
8/15/2024,Anushka Wijesuriya,Badulla,Haputale,Uva,1680,2262,3942,67200,90480,157680
8/16/2024,Anushka Wijesuriya,Badulla,Haputale,Uva,3747,833,4580,149880,33320,183200
8/17/2024,Anushka Wijesuriya,Badulla,Haputale,Uva,6150,6789,12939,246000,271560,517560
8/18/2024,Anushka Wijesuriya,Badulla,Haputale,Uva,2608,4396,7004,104320,175840,280160
8/19/2024,Anushka Wijesuriya,Badulla,Haputale,Uva,2359,9165,11524,94360,366600,460960
8/20/2024,Anushka Wijesuriya,Badulla,Haputale,Uva,6215,6700,12915,248600,268000,516600
8/21/2024,Anushka Wijesuriya,Badulla,Haputale,Uva,6690,4363,11053,267600,174520,442120
8/22/2024,Anushka Wijesuriya,Badulla,Haputale,Uva,7286,3039,10325,291440,121560,413000
8/23/2024,Anushka Wijesuriya,Badulla,Haputale,Uva,548,1122,1670,21920,44880,66800
8/24/2024,Anushka Wijesuriya,Badulla,Haputale,Uva,9562,8259,17821,382480,330360,712840
8/25/2024,Anushka Wijesuriya,Badulla,Haputale,Uva,6080,3545,9625,243200,141800,385000
8/26/2024,Anushka Wijesuriya,Badulla,Haputale,Uva,5251,6087,11338,210040,243480,453520
8/27/2024,Anushka Wijesuriya,Badulla,Haputale,Uva,2958,1185,4143,118320,47400,165720
8/28/2024,Anushka Wijesuriya,Badulla,Haputale,Uva,4236,296,4532,169440,11840,181280
8/29/2024,Anushka Wijesuriya,Badulla,Haputale,Uva,5141,9893,15034,205640,395720,601360
8/30/2024,Anushka Wijesuriya,Badulla,Haputale,Uva,2713,1129,3842,108520,45160,153680
8/31/2024,Anushka Wijesuriya,Badulla,Haputale,Uva,5038,6757,11795,201520,270280,471800
9/1/2024,Anushka Wijesuriya,Badulla,Haputale,Uva,7080,1580,8660,283200,63200,346400
9/2/2024,Anushka Wijesuriya,Badulla,Haputale,Uva,9603,5250,14853,384120,210000,594120
9/3/2024,Anushka Wijesuriya,Badulla,Haputale,Uva,4699,7378,12077,187960,295120,483080
9/4/2024,Anushka Wijesuriya,Badulla,Haputale,Uva,487,9591,10078,19480,383640,403120
9/5/2024,Anushka Wijesuriya,Badulla,Haputale,Uva,461,1486,1947,18440,59440,77880
9/6/2024,Anushka Wijesuriya,Badulla,Haputale,Uva,2557,4954,7511,102280,198160,300440
9/7/2024,Anushka Wijesuriya,Badulla,Haputale,Uva,7736,2927,10663,309440,117080,426520
9/8/2024,Anushka Wijesuriya,Badulla,Haputale,Uva,5739,9268,15007,229560,370720,600280
9/9/2024,Anushka Wijesuriya,Badulla,Haputale,Uva,5690,4841,10531,227600,193640,421240
9/10/2024,Anushka Wijesuriya,Badulla,Haputale,Uva,5107,9918,15025,204280,396720,601000
9/11/2024,Anushka Wijesuriya,Badulla,Haputale,Uva,6618,3069,9687,264720,122760,387480
9/12/2024,Anushka Wijesuriya,Badulla,Haputale,Uva,3101,3383,6484,124040,135320,259360
9/13/2024,Anushka Wijesuriya,Badulla,Haputale,Uva,8417,8608,17025,336680,344320,681000
9/14/2024,Anushka Wijesuriya,Badulla,Haputale,Uva,8100,3907,12007,324000,156280,480280
9/15/2024,Anushka Wijesuriya,Badulla,Haputale,Uva,4953,9001,13954,198120,360040,558160
9/16/2024,Anushka Wijesuriya,Badulla,Haputale,Uva,8903,287,9190,356120,11480,367600
9/17/2024,Anushka Wijesuriya,Badulla,Haputale,Uva,261,6036,6297,10440,241440,251880
9/18/2024,Anushka Wijesuriya,Badulla,Haputale,Uva,5972,7661,13633,238880,306440,545320
9/19/2024,Anushka Wijesuriya,Badulla,Haputale,Uva,8252,7369,15621,330080,294760,624840
9/20/2024,Anushka Wijesuriya,Badulla,Haputale,Uva,8811,9527,18338,352440,381080,733520
9/21/2024,Anushka Wijesuriya,Badulla,Haputale,Uva,6137,8952,15089,245480,358080,603560
9/22/2024,Anushka Wijesuriya,Badulla,Haputale,Uva,3763,560,4323,150520,22400,172920
9/23/2024,Anushka Wijesuriya,Badulla,Haputale,Uva,4638,6364,11002,185520,254560,440080
9/24/2024,Anushka Wijesuriya,Badulla,Haputale,Uva,1276,5705,6981,51040,228200,279240
9/25/2024,Anushka Wijesuriya,Badulla,Haputale,Uva,5327,1068,6395,213080,42720,255800
9/26/2024,Anushka Wijesuriya,Badulla,Haputale,Uva,9428,184,9612,377120,7360,384480
9/27/2024,Anushka Wijesuriya,Badulla,Haputale,Uva,7972,3930,11902,318880,157200,476080
9/28/2024,Anushka Wijesuriya,Badulla,Haputale,Uva,6716,6719,13435,268640,268760,537400
9/29/2024,Anushka Wijesuriya,Badulla,Haputale,Uva,2852,2666,5518,114080,106640,220720
9/30/2024,Anushka Wijesuriya,Badulla,Haputale,Uva,7380,3857,11237,295200,154280,449480
10/1/2024,Anushka Wijesuriya,Badulla,Haputale,Uva,2445,563,3008,97800,22520,120320
10/2/2024,Anushka Wijesuriya,Badulla,Haputale,Uva,6657,6256,12913,266280,250240,516520
10/3/2024,Anushka Wijesuriya,Badulla,Haputale,Uva,2012,9970,11982,80480,398800,479280
10/4/2024,Anushka Wijesuriya,Badulla,Haputale,Uva,1032,1640,2672,41280,65600,106880
10/5/2024,Anushka Wijesuriya,Badulla,Haputale,Uva,9114,1554,10668,364560,62160,426720
10/6/2024,Anushka Wijesuriya,Badulla,Haputale,Uva,4754,4523,9277,190160,180920,371080
10/7/2024,Anushka Wijesuriya,Badulla,Haputale,Uva,8822,5668,14490,352880,226720,579600
10/8/2024,Anushka Wijesuriya,Badulla,Haputale,Uva,6030,3644,9674,241200,145760,386960
10/9/2024,Anushka Wijesuriya,Badulla,Haputale,Uva,4998,3553,8551,199920,142120,342040
10/10/2024,Anushka Wijesuriya,Badulla,Haputale,Uva,555,7153,7708,22200,286120,308320
10/11/2024,Anushka Wijesuriya,Badulla,Haputale,Uva,4753,855,5608,190120,34200,224320
10/12/2024,Anushka Wijesuriya,Badulla,Haputale,Uva,5224,8298,13522,208960,331920,540880
10/13/2024,Anushka Wijesuriya,Badulla,Haputale,Uva,9552,3522,13074,382080,140880,522960
10/14/2024,Anushka Wijesuriya,Badulla,Haputale,Uva,4785,9014,13799,191400,360560,551960
10/15/2024,Anushka Wijesuriya,Badulla,Haputale,Uva,2922,2401,5323,116880,96040,212920
10/16/2024,Anushka Wijesuriya,Badulla,Haputale,Uva,9159,7509,16668,366360,300360,666720
10/17/2024,Anushka Wijesuriya,Badulla,Haputale,Uva,3654,1731,5385,146160,69240,215400
10/18/2024,Anushka Wijesuriya,Badulla,Haputale,Uva,8541,9194,17735,341640,367760,709400
10/19/2024,Anushka Wijesuriya,Badulla,Haputale,Uva,5951,4788,10739,238040,191520,429560
10/20/2024,Anushka Wijesuriya,Badulla,Haputale,Uva,6371,6228,12599,254840,249120,503960
10/21/2024,Anushka Wijesuriya,Badulla,Haputale,Uva,1925,9294,11219,77000,371760,448760
10/22/2024,Anushka Wijesuriya,Badulla,Haputale,Uva,297,762,1059,11880,30480,42360
10/23/2024,Anushka Wijesuriya,Badulla,Haputale,Uva,3591,9021,12612,143640,360840,504480
10/24/2024,Anushka Wijesuriya,Badulla,Haputale,Uva,6524,757,7281,260960,30280,291240
10/25/2024,Anushka Wijesuriya,Badulla,Haputale,Uva,9854,2987,12841,394160,119480,513640
10/26/2024,Anushka Wijesuriya,Badulla,Haputale,Uva,4802,4851,9653,192080,194040,386120
10/27/2024,Anushka Wijesuriya,Badulla,Haputale,Uva,8187,7803,15990,327480,312120,639600
10/28/2024,Anushka Wijesuriya,Badulla,Haputale,Uva,8901,2448,11349,356040,97920,453960
10/29/2024,Anushka Wijesuriya,Badulla,Haputale,Uva,50,5299,5349,2000,211960,213960
10/30/2024,Anushka Wijesuriya,Badulla,Haputale,Uva,2555,8095,10650,102200,323800,426000
10/31/2024,Anushka Wijesuriya,Badulla,Haputale,Uva,2573,3088,5661,102920,123520,226440
11/1/2024,Anushka Wijesuriya,Badulla,Haputale,Uva,3010,9887,12897,120400,395480,515880
11/2/2024,Anushka Wijesuriya,Badulla,Haputale,Uva,5109,5307,10416,204360,212280,416640
11/3/2024,Anushka Wijesuriya,Badulla,Haputale,Uva,127,9028,9155,5080,361120,366200
11/4/2024,Anushka Wijesuriya,Badulla,Haputale,Uva,5848,9475,15323,233920,379000,612920
11/5/2024,Anushka Wijesuriya,Badulla,Haputale,Uva,8453,2090,10543,338120,83600,421720
11/6/2024,Anushka Wijesuriya,Badulla,Haputale,Uva,2419,4504,6923,96760,180160,276920
11/7/2024,Anushka Wijesuriya,Badulla,Haputale,Uva,7856,7640,15496,314240,305600,619840
11/8/2024,Anushka Wijesuriya,Badulla,Haputale,Uva,6949,4323,11272,277960,172920,450880
11/9/2024,Anushka Wijesuriya,Badulla,Haputale,Uva,7433,1686,9119,297320,67440,364760
11/10/2024,Anushka Wijesuriya,Badulla,Haputale,Uva,2431,3040,5471,97240,121600,218840
11/11/2024,Anushka Wijesuriya,Badulla,Haputale,Uva,8836,9393,18229,353440,375720,729160
11/12/2024,Anushka Wijesuriya,Badulla,Haputale,Uva,585,2121,2706,23400,84840,108240
11/13/2024,Anushka Wijesuriya,Badulla,Haputale,Uva,9811,1125,10936,392440,45000,437440
11/14/2024,Anushka Wijesuriya,Badulla,Haputale,Uva,5121,2532,7653,204840,101280,306120
11/15/2024,Anushka Wijesuriya,Badulla,Haputale,Uva,7940,3401,11341,317600,136040,453640
11/16/2024,Anushka Wijesuriya,Badulla,Haputale,Uva,861,2742,3603,34440,109680,144120
11/17/2024,Anushka Wijesuriya,Badulla,Haputale,Uva,5142,8192,13334,205680,327680,533360
11/18/2024,Anushka Wijesuriya,Badulla,Haputale,Uva,4957,3798,8755,198280,151920,350200
11/19/2024,Anushka Wijesuriya,Badulla,Haputale,Uva,642,2586,3228,25680,103440,129120
11/20/2024,Anushka Wijesuriya,Badulla,Haputale,Uva,7940,7990,15930,317600,319600,637200
11/21/2024,Anushka Wijesuriya,Badulla,Haputale,Uva,4729,9805,14534,189160,392200,581360
11/22/2024,Anushka Wijesuriya,Badulla,Haputale,Uva,671,3044,3715,26840,121760,148600
11/23/2024,Anushka Wijesuriya,Badulla,Haputale,Uva,2775,6057,8832,111000,242280,353280
11/24/2024,Anushka Wijesuriya,Badulla,Haputale,Uva,5444,718,6162,217760,28720,246480
11/25/2024,Anushka Wijesuriya,Badulla,Haputale,Uva,8848,2245,11093,353920,89800,443720
11/26/2024,Anushka Wijesuriya,Badulla,Haputale,Uva,6495,2629,9124,259800,105160,364960
11/27/2024,Anushka Wijesuriya,Badulla,Haputale,Uva,6104,5779,11883,244160,231160,475320
11/28/2024,Anushka Wijesuriya,Badulla,Haputale,Uva,1757,9253,11010,70280,370120,440400
11/29/2024,Anushka Wijesuriya,Badulla,Haputale,Uva,6952,2350,9302,278080,94000,372080
11/30/2024,Anushka Wijesuriya,Badulla,Haputale,Uva,1449,3626,5075,57960,145040,203000
12/1/2024,Anushka Wijesuriya,Badulla,Haputale,Uva,3883,2824,6707,155320,112960,268280
12/2/2024,Anushka Wijesuriya,Badulla,Haputale,Uva,9499,9463,18962,379960,378520,758480
12/3/2024,Anushka Wijesuriya,Badulla,Haputale,Uva,442,2293,2735,17680,91720,109400
12/4/2024,Anushka Wijesuriya,Badulla,Haputale,Uva,5275,7331,12606,211000,293240,504240
12/5/2024,Anushka Wijesuriya,Badulla,Haputale,Uva,6330,5932,12262,253200,237280,490480
12/6/2024,Anushka Wijesuriya,Badulla,Haputale,Uva,2308,819,3127,92320,32760,125080
12/7/2024,Anushka Wijesuriya,Badulla,Haputale,Uva,341,3106,3447,13640,124240,137880
12/8/2024,Anushka Wijesuriya,Badulla,Haputale,Uva,2783,7767,10550,111320,310680,422000
12/9/2024,Anushka Wijesuriya,Badulla,Haputale,Uva,5426,4702,10128,217040,188080,405120
12/10/2024,Anushka Wijesuriya,Badulla,Haputale,Uva,9226,5164,14390,369040,206560,575600
12/11/2024,Anushka Wijesuriya,Badulla,Haputale,Uva,8455,6905,15360,338200,276200,614400
12/12/2024,Anushka Wijesuriya,Badulla,Haputale,Uva,315,4338,4653,12600,173520,186120
12/13/2024,Anushka Wijesuriya,Badulla,Haputale,Uva,2145,4306,6451,85800,172240,258040
12/14/2024,Anushka Wijesuriya,Badulla,Haputale,Uva,1770,5428,7198,70800,217120,287920
12/15/2024,Anushka Wijesuriya,Badulla,Haputale,Uva,8068,7533,15601,322720,301320,624040
12/16/2024,Anushka Wijesuriya,Badulla,Haputale,Uva,949,4062,5011,37960,162480,200440
12/17/2024,Anushka Wijesuriya,Badulla,Haputale,Uva,5003,8897,13900,200120,355880,556000
12/18/2024,Anushka Wijesuriya,Badulla,Haputale,Uva,6270,6045,12315,250800,241800,492600
12/19/2024,Anushka Wijesuriya,Badulla,Haputale,Uva,5672,9514,15186,226880,380560,607440
12/20/2024,Anushka Wijesuriya,Badulla,Haputale,Uva,3753,6444,10197,150120,257760,407880
12/21/2024,Anushka Wijesuriya,Badulla,Haputale,Uva,6961,3113,10074,278440,124520,402960
12/22/2024,Anushka Wijesuriya,Badulla,Haputale,Uva,2215,1480,3695,88600,59200,147800
12/23/2024,Anushka Wijesuriya,Badulla,Haputale,Uva,399,827,1226,15960,33080,49040
12/24/2024,Anushka Wijesuriya,Badulla,Haputale,Uva,4666,9013,13679,186640,360520,547160
12/25/2024,Anushka Wijesuriya,Badulla,Haputale,Uva,3503,1479,4982,140120,59160,199280
12/26/2024,Anushka Wijesuriya,Badulla,Haputale,Uva,5511,9845,15356,220440,393800,614240
12/27/2024,Anushka Wijesuriya,Badulla,Haputale,Uva,7763,2215,9978,310520,88600,399120
12/28/2024,Anushka Wijesuriya,Badulla,Haputale,Uva,6489,1649,8138,259560,65960,325520
12/29/2024,Anushka Wijesuriya,Badulla,Haputale,Uva,2546,9611,12157,101840,384440,486280
12/30/2024,Anushka Wijesuriya,Badulla,Haputale,Uva,8530,368,8898,341200,14720,355920
12/31/2024,Anushka Wijesuriya,Badulla,Haputale,Uva,5447,843,6290,217880,33720,251600
1/1/2025,Anushka Wijesuriya,Badulla,Haputale,Uva,4706,6961,11667,188240,278440,466680
1/2/2025,Anushka Wijesuriya,Badulla,Haputale,Uva,356,2545,2901,14240,101800,116040
1/3/2025,Anushka Wijesuriya,Badulla,Haputale,Uva,3460,8788,12248,138400,351520,489920
1/4/2025,Anushka Wijesuriya,Badulla,Haputale,Uva,257,449,706,10280,17960,28240
1/5/2025,Anushka Wijesuriya,Badulla,Haputale,Uva,2835,3650,6485,113400,146000,259400
1/6/2025,Anushka Wijesuriya,Badulla,Haputale,Uva,3017,1651,4668,120680,66040,186720
1/7/2025,Anushka Wijesuriya,Badulla,Haputale,Uva,6266,2255,8521,250640,90200,340840
1/8/2025,Anushka Wijesuriya,Badulla,Haputale,Uva,8431,9877,18308,337240,395080,732320
1/9/2025,Anushka Wijesuriya,Badulla,Haputale,Uva,3431,9559,12990,137240,382360,519600
1/10/2025,Anushka Wijesuriya,Badulla,Haputale,Uva,4023,7525,11548,160920,301000,461920
1/11/2025,Anushka Wijesuriya,Badulla,Haputale,Uva,6328,9944,16272,253120,397760,650880
1/12/2025,Anushka Wijesuriya,Badulla,Haputale,Uva,46,4832,4878,1840,193280,195120
1/13/2025,Anushka Wijesuriya,Badulla,Haputale,Uva,2224,3608,5832,88960,144320,233280
1/14/2025,Anushka Wijesuriya,Badulla,Haputale,Uva,7240,2185,9425,289600,87400,377000
1/15/2025,Anushka Wijesuriya,Badulla,Haputale,Uva,8764,4362,13126,350560,174480,525040
1/16/2025,Anushka Wijesuriya,Badulla,Haputale,Uva,5876,8860,14736,235040,354400,589440
1/17/2025,Anushka Wijesuriya,Badulla,Haputale,Uva,7210,8683,15893,288400,347320,635720
1/18/2025,Anushka Wijesuriya,Badulla,Haputale,Uva,1290,2506,3796,51600,100240,151840
1/19/2025,Anushka Wijesuriya,Badulla,Haputale,Uva,4615,4659,9274,184600,186360,370960
1/20/2025,Anushka Wijesuriya,Badulla,Haputale,Uva,8724,7901,16625,348960,316040,665000
1/21/2025,Anushka Wijesuriya,Badulla,Haputale,Uva,9664,7224,16888,386560,288960,675520
1/22/2025,Anushka Wijesuriya,Badulla,Haputale,Uva,6275,7910,14185,251000,316400,567400
1/23/2025,Anushka Wijesuriya,Badulla,Haputale,Uva,732,9871,10603,29280,394840,424120
1/24/2025,Anushka Wijesuriya,Badulla,Haputale,Uva,4563,249,4812,182520,9960,192480
1/25/2025,Anushka Wijesuriya,Badulla,Haputale,Uva,7020,4649,11669,280800,185960,466760
1/26/2025,Anushka Wijesuriya,Badulla,Haputale,Uva,6047,4342,10389,241880,173680,415560
1/27/2025,Anushka Wijesuriya,Badulla,Haputale,Uva,1229,489,1718,49160,19560,68720
1/28/2025,Anushka Wijesuriya,Badulla,Haputale,Uva,6292,9508,15800,251680,380320,632000
1/29/2025,Anushka Wijesuriya,Badulla,Haputale,Uva,7220,2868,10088,288800,114720,403520
1/30/2025,Anushka Wijesuriya,Badulla,Haputale,Uva,4417,9196,13613,176680,367840,544520
1/31/2025,Anushka Wijesuriya,Badulla,Haputale,Uva,7559,7507,15066,302360,300280,602640
2/1/2025,Anushka Wijesuriya,Badulla,Haputale,Uva,5850,8901,14751,234000,356040,590040
2/2/2025,Anushka Wijesuriya,Badulla,Haputale,Uva,1790,6203,7993,71600,248120,319720
2/3/2025,Anushka Wijesuriya,Badulla,Haputale,Uva,4659,7286,11945,186360,291440,477800
2/4/2025,Anushka Wijesuriya,Badulla,Haputale,Uva,183,1888,2071,7320,75520,82840
2/5/2025,Anushka Wijesuriya,Badulla,Haputale,Uva,5061,5856,10917,202440,234240,436680
2/6/2025,Anushka Wijesuriya,Badulla,Haputale,Uva,3608,955,4563,144320,38200,182520
2/7/2025,Anushka Wijesuriya,Badulla,Haputale,Uva,1346,4184,5530,53840,167360,221200
2/8/2025,Anushka Wijesuriya,Badulla,Haputale,Uva,5789,3475,9264,231560,139000,370560
2/9/2025,Anushka Wijesuriya,Badulla,Haputale,Uva,731,3641,4372,29240,145640,174880
2/10/2025,Anushka Wijesuriya,Badulla,Haputale,Uva,3231,2578,5809,129240,103120,232360
2/11/2025,Anushka Wijesuriya,Badulla,Haputale,Uva,7440,8114,15554,297600,324560,622160
2/12/2025,Anushka Wijesuriya,Badulla,Haputale,Uva,5696,7603,13299,227840,304120,531960
2/13/2025,Anushka Wijesuriya,Badulla,Haputale,Uva,2387,1769,4156,95480,70760,166240
2/14/2025,Anushka Wijesuriya,Badulla,Haputale,Uva,1240,2008,3248,49600,80320,129920
2/15/2025,Anushka Wijesuriya,Badulla,Haputale,Uva,9391,6441,15832,375640,257640,633280
2/16/2025,Anushka Wijesuriya,Badulla,Haputale,Uva,9990,9908,19898,399600,396320,795920
2/17/2025,Anushka Wijesuriya,Badulla,Haputale,Uva,9611,2233,11844,384440,89320,473760
2/18/2025,Anushka Wijesuriya,Badulla,Haputale,Uva,9645,9504,19149,385800,380160,765960
2/19/2025,Anushka Wijesuriya,Badulla,Haputale,Uva,4626,926,5552,185040,37040,222080
2/20/2025,Anushka Wijesuriya,Badulla,Haputale,Uva,6202,9143,15345,248080,365720,613800
2/21/2025,Anushka Wijesuriya,Badulla,Haputale,Uva,7294,2750,10044,291760,110000,401760
2/22/2025,Anushka Wijesuriya,Badulla,Haputale,Uva,4896,3206,8102,195840,128240,324080
2/23/2025,Anushka Wijesuriya,Badulla,Haputale,Uva,6708,1830,8538,268320,73200,341520
2/24/2025,Anushka Wijesuriya,Badulla,Haputale,Uva,8589,3808,12397,343560,152320,495880
2/25/2025,Anushka Wijesuriya,Badulla,Haputale,Uva,6558,8038,14596,262320,321520,583840
2/26/2025,Anushka Wijesuriya,Badulla,Haputale,Uva,553,8193,8746,22120,327720,349840
2/27/2025,Anushka Wijesuriya,Badulla,Haputale,Uva,7530,6186,13716,301200,247440,548640
2/28/2025,Anushka Wijesuriya,Badulla,Haputale,Uva,8328,2316,10644,333120,92640,425760
3/1/2025,Anushka Wijesuriya,Badulla,Haputale,Uva,7479,5756,13235,299160,230240,529400
3/2/2025,Anushka Wijesuriya,Badulla,Haputale,Uva,599,4698,5297,23960,187920,211880
3/3/2025,Anushka Wijesuriya,Badulla,Haputale,Uva,4390,9778,14168,175600,391120,566720
3/4/2025,Anushka Wijesuriya,Badulla,Haputale,Uva,1991,5084,7075,79640,203360,283000
3/5/2025,Anushka Wijesuriya,Badulla,Haputale,Uva,7544,7542,15086,301760,301680,603440
3/6/2025,Anushka Wijesuriya,Badulla,Haputale,Uva,1264,5930,7194,50560,237200,287760
3/7/2025,Anushka Wijesuriya,Badulla,Haputale,Uva,1295,3448,4743,51800,137920,189720
3/8/2025,Anushka Wijesuriya,Badulla,Haputale,Uva,5522,138,5660,220880,5520,226400
3/9/2025,Anushka Wijesuriya,Badulla,Haputale,Uva,9396,5956,15352,375840,238240,614080
3/10/2025,Anushka Wijesuriya,Badulla,Haputale,Uva,9418,4944,14362,376720,197760,574480
3/11/2025,Anushka Wijesuriya,Badulla,Haputale,Uva,4432,8600,13032,177280,344000,521280
3/12/2025,Anushka Wijesuriya,Badulla,Haputale,Uva,7107,7518,14625,284280,300720,585000
3/13/2025,Anushka Wijesuriya,Badulla,Haputale,Uva,4510,4279,8789,180400,171160,351560
3/14/2025,Anushka Wijesuriya,Badulla,Haputale,Uva,8812,2622,11434,352480,104880,457360
3/15/2025,Anushka Wijesuriya,Badulla,Haputale,Uva,5133,5483,10616,205320,219320,424640
3/16/2025,Anushka Wijesuriya,Badulla,Haputale,Uva,7189,4949,12138,287560,197960,485520
3/17/2025,Anushka Wijesuriya,Badulla,Haputale,Uva,6270,1808,8078,250800,72320,323120
3/18/2025,Anushka Wijesuriya,Badulla,Haputale,Uva,1487,2658,4145,59480,106320,165800
3/19/2025,Anushka Wijesuriya,Badulla,Haputale,Uva,5054,4006,9060,202160,160240,362400
3/20/2025,Anushka Wijesuriya,Badulla,Haputale,Uva,9,8182,8191,360,327280,327640
3/21/2025,Anushka Wijesuriya,Badulla,Haputale,Uva,2187,8087,10274,87480,323480,410960
3/22/2025,Anushka Wijesuriya,Badulla,Haputale,Uva,318,6070,6388,12720,242800,255520
3/23/2025,Anushka Wijesuriya,Badulla,Haputale,Uva,677,7095,7772,27080,283800,310880
3/25/2024,Prabodha Fernando,Anuradhapura,Thissamaharama,North Central,2740,7956,10696,109600,318240,427840
3/26/2024,Prabodha Fernando,Anuradhapura,Thissamaharama,North Central,6201,1362,7563,248040,54480,302520
3/27/2024,Prabodha Fernando,Anuradhapura,Thissamaharama,North Central,5215,2697,7912,208600,107880,316480
3/28/2024,Prabodha Fernando,Anuradhapura,Thissamaharama,North Central,6647,9691,16338,265880,387640,653520
3/29/2024,Prabodha Fernando,Anuradhapura,Thissamaharama,North Central,3856,9980,13836,154240,399200,553440
3/30/2024,Prabodha Fernando,Anuradhapura,Thissamaharama,North Central,1778,4283,6061,71120,171320,242440
3/31/2024,Prabodha Fernando,Anuradhapura,Thissamaharama,North Central,2182,8918,11100,87280,356720,444000
4/1/2024,Prabodha Fernando,Anuradhapura,Thissamaharama,North Central,6142,6443,12585,245680,257720,503400
4/2/2024,Prabodha Fernando,Anuradhapura,Thissamaharama,North Central,412,4618,5030,16480,184720,201200
4/3/2024,Prabodha Fernando,Anuradhapura,Thissamaharama,North Central,2783,3842,6625,111320,153680,265000
4/4/2024,Prabodha Fernando,Anuradhapura,Thissamaharama,North Central,2861,7288,10149,114440,291520,405960
4/5/2024,Prabodha Fernando,Anuradhapura,Thissamaharama,North Central,924,6437,7361,36960,257480,294440
4/6/2024,Prabodha Fernando,Anuradhapura,Thissamaharama,North Central,5755,7165,12920,230200,286600,516800
4/7/2024,Prabodha Fernando,Anuradhapura,Thissamaharama,North Central,2610,4917,7527,104400,196680,301080
4/8/2024,Prabodha Fernando,Anuradhapura,Thissamaharama,North Central,7137,7400,14537,285480,296000,581480
4/9/2024,Prabodha Fernando,Anuradhapura,Thissamaharama,North Central,3692,879,4571,147680,35160,182840
4/10/2024,Prabodha Fernando,Anuradhapura,Thissamaharama,North Central,9905,6261,16166,396200,250440,646640
4/11/2024,Prabodha Fernando,Anuradhapura,Thissamaharama,North Central,3884,25,3909,155360,1000,156360
4/19/2024,Prabodha Fernando,Anuradhapura,Thissamaharama,North Central,2330,8596,10926,93200,343840,437040
4/20/2024,Prabodha Fernando,Anuradhapura,Thissamaharama,North Central,2203,6730,8933,88120,269200,357320
4/21/2024,Prabodha Fernando,Anuradhapura,Thissamaharama,North Central,5031,7651,12682,201240,306040,507280
4/22/2024,Prabodha Fernando,Anuradhapura,Thissamaharama,North Central,2192,9277,11469,87680,371080,458760
4/23/2024,Prabodha Fernando,Anuradhapura,Thissamaharama,North Central,9452,584,10036,378080,23360,401440
4/24/2024,Prabodha Fernando,Anuradhapura,Thissamaharama,North Central,4624,5575,10199,184960,223000,407960
4/25/2024,Prabodha Fernando,Anuradhapura,Thissamaharama,North Central,2545,5427,7972,101800,217080,318880
4/26/2024,Prabodha Fernando,Anuradhapura,Thissamaharama,North Central,9313,951,10264,372520,38040,410560
4/27/2024,Prabodha Fernando,Anuradhapura,Thissamaharama,North Central,6205,1207,7412,248200,48280,296480
4/28/2024,Prabodha Fernando,Anuradhapura,Thissamaharama,North Central,4056,7686,11742,162240,307440,469680
4/29/2024,Prabodha Fernando,Anuradhapura,Thissamaharama,North Central,969,7273,8242,38760,290920,329680
4/30/2024,Prabodha Fernando,Anuradhapura,Thissamaharama,North Central,5046,2965,8011,201840,118600,320440
5/1/2024,Prabodha Fernando,Anuradhapura,Thissamaharama,North Central,7077,652,7729,283080,26080,309160
5/2/2024,Prabodha Fernando,Anuradhapura,Thissamaharama,North Central,1072,9162,10234,42880,366480,409360
5/3/2024,Prabodha Fernando,Anuradhapura,Thissamaharama,North Central,4924,1599,6523,196960,63960,260920
5/4/2024,Prabodha Fernando,Anuradhapura,Thissamaharama,North Central,6370,9149,15519,254800,365960,620760
5/5/2024,Prabodha Fernando,Anuradhapura,Thissamaharama,North Central,5986,2263,8249,239440,90520,329960
5/6/2024,Prabodha Fernando,Anuradhapura,Thissamaharama,North Central,852,8523,9375,34080,340920,375000
5/7/2024,Prabodha Fernando,Anuradhapura,Thissamaharama,North Central,1371,8118,9489,54840,324720,379560
5/8/2024,Prabodha Fernando,Anuradhapura,Thissamaharama,North Central,6309,6490,12799,252360,259600,511960
5/9/2024,Prabodha Fernando,Anuradhapura,Thissamaharama,North Central,150,7788,7938,6000,311520,317520
5/10/2024,Prabodha Fernando,Anuradhapura,Thissamaharama,North Central,909,5951,6860,36360,238040,274400
5/11/2024,Prabodha Fernando,Anuradhapura,Thissamaharama,North Central,8420,1098,9518,336800,43920,380720
5/12/2024,Prabodha Fernando,Anuradhapura,Thissamaharama,North Central,6899,6569,13468,275960,262760,538720
5/13/2024,Prabodha Fernando,Anuradhapura,Thissamaharama,North Central,1472,6555,8027,58880,262200,321080
5/14/2024,Prabodha Fernando,Anuradhapura,Thissamaharama,North Central,3086,4533,7619,123440,181320,304760
5/15/2024,Prabodha Fernando,Anuradhapura,Thissamaharama,North Central,460,9565,10025,18400,382600,401000
5/16/2024,Prabodha Fernando,Anuradhapura,Thissamaharama,North Central,2902,3422,6324,116080,136880,252960
5/17/2024,Prabodha Fernando,Anuradhapura,Thissamaharama,North Central,681,235,916,27240,9400,36640
5/18/2024,Prabodha Fernando,Anuradhapura,Thissamaharama,North Central,846,8169,9015,33840,326760,360600
5/19/2024,Prabodha Fernando,Anuradhapura,Thissamaharama,North Central,3538,7765,11303,141520,310600,452120
5/20/2024,Prabodha Fernando,Anuradhapura,Thissamaharama,North Central,2227,2580,4807,89080,103200,192280
5/21/2024,Prabodha Fernando,Anuradhapura,Thissamaharama,North Central,4017,3139,7156,160680,125560,286240
5/22/2024,Prabodha Fernando,Anuradhapura,Thissamaharama,North Central,8169,4571,12740,326760,182840,509600
5/24/2024,Prabodha Fernando,Anuradhapura,Thissamaharama,North Central,8123,2958,11081,324920,118320,443240
5/25/2024,Prabodha Fernando,Anuradhapura,Thissamaharama,North Central,246,3823,4069,9840,152920,162760
5/26/2024,Prabodha Fernando,Anuradhapura,Thissamaharama,North Central,3953,1767,5720,158120,70680,228800
5/27/2024,Prabodha Fernando,Anuradhapura,Thissamaharama,North Central,3407,5409,8816,136280,216360,352640
5/28/2024,Prabodha Fernando,Anuradhapura,Thissamaharama,North Central,9981,4583,14564,399240,183320,582560
5/29/2024,Prabodha Fernando,Anuradhapura,Thissamaharama,North Central,9382,8633,18015,375280,345320,720600
5/30/2024,Prabodha Fernando,Anuradhapura,Thissamaharama,North Central,5887,6909,12796,235480,276360,511840
5/31/2024,Prabodha Fernando,Anuradhapura,Thissamaharama,North Central,9682,1160,10842,387280,46400,433680
6/1/2024,Prabodha Fernando,Anuradhapura,Thissamaharama,North Central,20,2388,2408,800,95520,96320
6/2/2024,Prabodha Fernando,Anuradhapura,Thissamaharama,North Central,2373,5938,8311,94920,237520,332440
6/3/2024,Prabodha Fernando,Anuradhapura,Thissamaharama,North Central,8317,9598,17915,332680,383920,716600
6/4/2024,Prabodha Fernando,Anuradhapura,Thissamaharama,North Central,891,135,1026,35640,5400,41040
6/5/2024,Prabodha Fernando,Anuradhapura,Thissamaharama,North Central,8318,5851,14169,332720,234040,566760
6/6/2024,Prabodha Fernando,Anuradhapura,Thissamaharama,North Central,4843,4867,9710,193720,194680,388400
6/7/2024,Prabodha Fernando,Anuradhapura,Thissamaharama,North Central,5699,6454,12153,227960,258160,486120
6/8/2024,Prabodha Fernando,Anuradhapura,Thissamaharama,North Central,4508,286,4794,180320,11440,191760
6/9/2024,Prabodha Fernando,Anuradhapura,Thissamaharama,North Central,4005,1268,5273,160200,50720,210920
6/10/2024,Prabodha Fernando,Anuradhapura,Thissamaharama,North Central,5680,9997,15677,227200,399880,627080
6/11/2024,Prabodha Fernando,Anuradhapura,Thissamaharama,North Central,1944,1394,3338,77760,55760,133520
6/12/2024,Prabodha Fernando,Anuradhapura,Thissamaharama,North Central,3454,6964,10418,138160,278560,416720
6/13/2024,Prabodha Fernando,Anuradhapura,Thissamaharama,North Central,2088,8874,10962,83520,354960,438480
6/14/2024,Prabodha Fernando,Anuradhapura,Thissamaharama,North Central,8744,7598,16342,349760,303920,653680
6/15/2024,Prabodha Fernando,Anuradhapura,Thissamaharama,North Central,6691,3022,9713,267640,120880,388520
6/16/2024,Prabodha Fernando,Anuradhapura,Thissamaharama,North Central,5962,1798,7760,238480,71920,310400
6/17/2024,Prabodha Fernando,Anuradhapura,Thissamaharama,North Central,579,9859,10438,23160,394360,417520
6/18/2024,Prabodha Fernando,Anuradhapura,Thissamaharama,North Central,5651,1470,7121,226040,58800,284840
6/19/2024,Prabodha Fernando,Anuradhapura,Thissamaharama,North Central,6952,8935,15887,278080,357400,635480
6/20/2024,Prabodha Fernando,Anuradhapura,Thissamaharama,North Central,9340,2088,11428,373600,83520,457120
6/21/2024,Prabodha Fernando,Anuradhapura,Thissamaharama,North Central,4712,7920,12632,188480,316800,505280
6/22/2024,Prabodha Fernando,Anuradhapura,Thissamaharama,North Central,5093,8300,13393,203720,332000,535720
6/23/2024,Prabodha Fernando,Anuradhapura,Thissamaharama,North Central,2888,4036,6924,115520,161440,276960
6/24/2024,Prabodha Fernando,Anuradhapura,Thissamaharama,North Central,3736,7306,11042,149440,292240,441680
6/25/2024,Prabodha Fernando,Anuradhapura,Thissamaharama,North Central,1014,8889,9903,40560,355560,396120
6/26/2024,Prabodha Fernando,Anuradhapura,Thissamaharama,North Central,7664,8428,16092,306560,337120,643680
6/27/2024,Prabodha Fernando,Anuradhapura,Thissamaharama,North Central,9914,147,10061,396560,5880,402440
6/28/2024,Prabodha Fernando,Anuradhapura,Thissamaharama,North Central,4160,1292,5452,166400,51680,218080
6/29/2024,Prabodha Fernando,Anuradhapura,Thissamaharama,North Central,2881,5287,8168,115240,211480,326720
6/30/2024,Prabodha Fernando,Anuradhapura,Thissamaharama,North Central,3463,295,3758,138520,11800,150320
7/1/2024,Prabodha Fernando,Anuradhapura,Thissamaharama,North Central,4987,5677,10664,199480,227080,426560
7/2/2024,Prabodha Fernando,Anuradhapura,Thissamaharama,North Central,7707,3918,11625,308280,156720,465000
7/3/2024,Prabodha Fernando,Anuradhapura,Thissamaharama,North Central,8868,3602,12470,354720,144080,498800
7/4/2024,Prabodha Fernando,Anuradhapura,Thissamaharama,North Central,9562,5185,14747,382480,207400,589880
7/5/2024,Prabodha Fernando,Anuradhapura,Thissamaharama,North Central,1373,7998,9371,54920,319920,374840
7/6/2024,Prabodha Fernando,Anuradhapura,Thissamaharama,North Central,2920,201,3121,116800,8040,124840
7/7/2024,Prabodha Fernando,Anuradhapura,Thissamaharama,North Central,6863,5492,12355,274520,219680,494200
7/8/2024,Prabodha Fernando,Anuradhapura,Thissamaharama,North Central,6217,5501,11718,248680,220040,468720
7/9/2024,Prabodha Fernando,Anuradhapura,Thissamaharama,North Central,9632,9011,18643,385280,360440,745720
7/10/2024,Prabodha Fernando,Anuradhapura,Thissamaharama,North Central,7156,5932,13088,286240,237280,523520
7/11/2024,Prabodha Fernando,Anuradhapura,Thissamaharama,North Central,3853,3308,7161,154120,132320,286440
7/12/2024,Prabodha Fernando,Anuradhapura,Thissamaharama,North Central,7880,5932,13812,315200,237280,552480
7/13/2024,Prabodha Fernando,Anuradhapura,Thissamaharama,North Central,4725,1026,5751,189000,41040,230040
7/14/2024,Prabodha Fernando,Anuradhapura,Thissamaharama,North Central,5307,7582,12889,212280,303280,515560
7/15/2024,Prabodha Fernando,Anuradhapura,Thissamaharama,North Central,2811,1881,4692,112440,75240,187680
7/16/2024,Prabodha Fernando,Anuradhapura,Thissamaharama,North Central,5414,8778,14192,216560,351120,567680
7/17/2024,Prabodha Fernando,Anuradhapura,Thissamaharama,North Central,8907,6978,15885,356280,279120,635400
7/18/2024,Prabodha Fernando,Anuradhapura,Thissamaharama,North Central,8371,6468,14839,334840,258720,593560
7/19/2024,Prabodha Fernando,Anuradhapura,Thissamaharama,North Central,1366,8244,9610,54640,329760,384400
7/20/2024,Prabodha Fernando,Anuradhapura,Thissamaharama,North Central,7160,3275,10435,286400,131000,417400
7/21/2024,Prabodha Fernando,Anuradhapura,Thissamaharama,North Central,2977,533,3510,119080,21320,140400
7/22/2024,Prabodha Fernando,Anuradhapura,Thissamaharama,North Central,7030,2164,9194,281200,86560,367760
7/23/2024,Prabodha Fernando,Anuradhapura,Thissamaharama,North Central,1368,4237,5605,54720,169480,224200
7/24/2024,Prabodha Fernando,Anuradhapura,Thissamaharama,North Central,6774,5129,11903,270960,205160,476120
7/25/2024,Prabodha Fernando,Anuradhapura,Thissamaharama,North Central,3029,2194,5223,121160,87760,208920
7/26/2024,Prabodha Fernando,Anuradhapura,Thissamaharama,North Central,813,1826,2639,32520,73040,105560
7/27/2024,Prabodha Fernando,Anuradhapura,Thissamaharama,North Central,2731,4976,7707,109240,199040,308280
7/28/2024,Prabodha Fernando,Anuradhapura,Thissamaharama,North Central,5623,3429,9052,224920,137160,362080
7/29/2024,Prabodha Fernando,Anuradhapura,Thissamaharama,North Central,2744,9351,12095,109760,374040,483800
7/30/2024,Prabodha Fernando,Anuradhapura,Thissamaharama,North Central,8900,7439,16339,356000,297560,653560
7/31/2024,Prabodha Fernando,Anuradhapura,Thissamaharama,North Central,7752,7330,15082,310080,293200,603280
8/1/2024,Prabodha Fernando,Anuradhapura,Thissamaharama,North Central,4022,7337,11359,160880,293480,454360
8/2/2024,Prabodha Fernando,Anuradhapura,Thissamaharama,North Central,8985,1811,10796,359400,72440,431840
8/3/2024,Prabodha Fernando,Anuradhapura,Thissamaharama,North Central,5477,4037,9514,219080,161480,380560
8/4/2024,Prabodha Fernando,Anuradhapura,Thissamaharama,North Central,4154,7615,11769,166160,304600,470760
8/5/2024,Prabodha Fernando,Anuradhapura,Thissamaharama,North Central,1924,7646,9570,76960,305840,382800
8/6/2024,Prabodha Fernando,Anuradhapura,Thissamaharama,North Central,9017,3739,12756,360680,149560,510240
8/7/2024,Prabodha Fernando,Anuradhapura,Thissamaharama,North Central,5121,8792,13913,204840,351680,556520
8/8/2024,Prabodha Fernando,Anuradhapura,Thissamaharama,North Central,4355,3852,8207,174200,154080,328280
8/9/2024,Prabodha Fernando,Anuradhapura,Thissamaharama,North Central,7394,1939,9333,295760,77560,373320
8/10/2024,Prabodha Fernando,Anuradhapura,Thissamaharama,North Central,6697,2928,9625,267880,117120,385000
8/11/2024,Prabodha Fernando,Anuradhapura,Thissamaharama,North Central,9117,5644,14761,364680,225760,590440
8/12/2024,Prabodha Fernando,Anuradhapura,Thissamaharama,North Central,1007,6172,7179,40280,246880,287160
8/13/2024,Prabodha Fernando,Anuradhapura,Thissamaharama,North Central,8060,7460,15520,322400,298400,620800
8/14/2024,Prabodha Fernando,Anuradhapura,Thissamaharama,North Central,3253,2082,5335,130120,83280,213400
8/15/2024,Prabodha Fernando,Anuradhapura,Thissamaharama,North Central,4296,4998,9294,171840,199920,371760
8/16/2024,Prabodha Fernando,Anuradhapura,Thissamaharama,North Central,5074,4824,9898,202960,192960,395920
8/17/2024,Prabodha Fernando,Anuradhapura,Thissamaharama,North Central,6626,1097,7723,265040,43880,308920
8/18/2024,Prabodha Fernando,Anuradhapura,Thissamaharama,North Central,2666,6629,9295,106640,265160,371800
8/19/2024,Prabodha Fernando,Anuradhapura,Thissamaharama,North Central,4689,1060,5749,187560,42400,229960
8/20/2024,Prabodha Fernando,Anuradhapura,Thissamaharama,North Central,2884,3269,6153,115360,130760,246120
8/21/2024,Prabodha Fernando,Anuradhapura,Thissamaharama,North Central,678,1954,2632,27120,78160,105280
8/22/2024,Prabodha Fernando,Anuradhapura,Thissamaharama,North Central,6835,1329,8164,273400,53160,326560
8/23/2024,Prabodha Fernando,Anuradhapura,Thissamaharama,North Central,8542,6738,15280,341680,269520,611200
8/24/2024,Prabodha Fernando,Anuradhapura,Thissamaharama,North Central,7548,4127,11675,301920,165080,467000
8/25/2024,Prabodha Fernando,Anuradhapura,Thissamaharama,North Central,4372,8272,12644,174880,330880,505760
8/26/2024,Prabodha Fernando,Anuradhapura,Thissamaharama,North Central,5568,9700,15268,222720,388000,610720
8/27/2024,Prabodha Fernando,Anuradhapura,Thissamaharama,North Central,4268,8419,12687,170720,336760,507480
8/28/2024,Prabodha Fernando,Anuradhapura,Thissamaharama,North Central,7671,4000,11671,306840,160000,466840
8/29/2024,Prabodha Fernando,Anuradhapura,Thissamaharama,North Central,1782,505,2287,71280,20200,91480
8/30/2024,Prabodha Fernando,Anuradhapura,Thissamaharama,North Central,5430,2107,7537,217200,84280,301480
8/31/2024,Prabodha Fernando,Anuradhapura,Thissamaharama,North Central,5589,237,5826,223560,9480,233040
9/1/2024,Prabodha Fernando,Anuradhapura,Thissamaharama,North Central,5318,5738,11056,212720,229520,442240
9/2/2024,Prabodha Fernando,Anuradhapura,Thissamaharama,North Central,4080,7015,11095,163200,280600,443800
9/3/2024,Prabodha Fernando,Anuradhapura,Thissamaharama,North Central,2387,7978,10365,95480,319120,414600
9/4/2024,Prabodha Fernando,Anuradhapura,Thissamaharama,North Central,2095,1103,3198,83800,44120,127920
9/5/2024,Prabodha Fernando,Anuradhapura,Thissamaharama,North Central,6816,7250,14066,272640,290000,562640
9/6/2024,Prabodha Fernando,Anuradhapura,Thissamaharama,North Central,9287,74,9361,371480,2960,374440
9/7/2024,Prabodha Fernando,Anuradhapura,Thissamaharama,North Central,4205,4690,8895,168200,187600,355800
9/8/2024,Prabodha Fernando,Anuradhapura,Thissamaharama,North Central,1982,5819,7801,79280,232760,312040
9/9/2024,Prabodha Fernando,Anuradhapura,Thissamaharama,North Central,2450,1444,3894,98000,57760,155760
9/10/2024,Prabodha Fernando,Anuradhapura,Thissamaharama,North Central,4619,2414,7033,184760,96560,281320
9/11/2024,Prabodha Fernando,Anuradhapura,Thissamaharama,North Central,7550,7413,14963,302000,296520,598520
9/12/2024,Prabodha Fernando,Anuradhapura,Thissamaharama,North Central,5379,556,5935,215160,22240,237400
9/13/2024,Prabodha Fernando,Anuradhapura,Thissamaharama,North Central,8863,4140,13003,354520,165600,520120
9/14/2024,Prabodha Fernando,Anuradhapura,Thissamaharama,North Central,4412,9096,13508,176480,363840,540320
9/15/2024,Prabodha Fernando,Anuradhapura,Thissamaharama,North Central,8275,2419,10694,331000,96760,427760
9/16/2024,Prabodha Fernando,Anuradhapura,Thissamaharama,North Central,8410,782,9192,336400,31280,367680
9/17/2024,Prabodha Fernando,Anuradhapura,Thissamaharama,North Central,5572,3552,9124,222880,142080,364960
9/18/2024,Prabodha Fernando,Anuradhapura,Thissamaharama,North Central,4330,4006,8336,173200,160240,333440
9/19/2024,Prabodha Fernando,Anuradhapura,Thissamaharama,North Central,7020,8063,15083,280800,322520,603320
9/20/2024,Prabodha Fernando,Anuradhapura,Thissamaharama,North Central,8784,3898,12682,351360,155920,507280
9/21/2024,Prabodha Fernando,Anuradhapura,Thissamaharama,North Central,3645,6580,10225,145800,263200,409000
9/22/2024,Prabodha Fernando,Anuradhapura,Thissamaharama,North Central,5517,8063,13580,220680,322520,543200
9/23/2024,Prabodha Fernando,Anuradhapura,Thissamaharama,North Central,8362,1569,9931,334480,62760,397240
9/24/2024,Prabodha Fernando,Anuradhapura,Thissamaharama,North Central,6687,3755,10442,267480,150200,417680
9/25/2024,Prabodha Fernando,Anuradhapura,Thissamaharama,North Central,2998,7292,10290,119920,291680,411600
9/26/2024,Prabodha Fernando,Anuradhapura,Thissamaharama,North Central,4816,8131,12947,192640,325240,517880
9/27/2024,Prabodha Fernando,Anuradhapura,Thissamaharama,North Central,7828,6601,14429,313120,264040,577160
9/28/2024,Prabodha Fernando,Anuradhapura,Thissamaharama,North Central,3135,2244,5379,125400,89760,215160
9/29/2024,Prabodha Fernando,Anuradhapura,Thissamaharama,North Central,6817,3822,10639,272680,152880,425560
9/30/2024,Prabodha Fernando,Anuradhapura,Thissamaharama,North Central,5697,120,5817,227880,4800,232680
10/1/2024,Prabodha Fernando,Anuradhapura,Thissamaharama,North Central,4546,5795,10341,181840,231800,413640
10/2/2024,Prabodha Fernando,Anuradhapura,Thissamaharama,North Central,2238,8424,10662,89520,336960,426480
10/3/2024,Prabodha Fernando,Anuradhapura,Thissamaharama,North Central,7482,5432,12914,299280,217280,516560
10/4/2024,Prabodha Fernando,Anuradhapura,Thissamaharama,North Central,824,8707,9531,32960,348280,381240
10/5/2024,Prabodha Fernando,Anuradhapura,Thissamaharama,North Central,4433,1947,6380,177320,77880,255200
10/6/2024,Prabodha Fernando,Anuradhapura,Thissamaharama,North Central,6681,2998,9679,267240,119920,387160
10/7/2024,Prabodha Fernando,Anuradhapura,Thissamaharama,North Central,3660,1151,4811,146400,46040,192440
10/8/2024,Prabodha Fernando,Anuradhapura,Thissamaharama,North Central,6966,828,7794,278640,33120,311760
10/9/2024,Prabodha Fernando,Anuradhapura,Thissamaharama,North Central,8100,2983,11083,324000,119320,443320
10/10/2024,Prabodha Fernando,Anuradhapura,Thissamaharama,North Central,1221,8485,9706,48840,339400,388240
10/11/2024,Prabodha Fernando,Anuradhapura,Thissamaharama,North Central,3854,7106,10960,154160,284240,438400
10/12/2024,Prabodha Fernando,Anuradhapura,Thissamaharama,North Central,6328,4711,11039,253120,188440,441560
10/13/2024,Prabodha Fernando,Anuradhapura,Thissamaharama,North Central,6406,3561,9967,256240,142440,398680
10/14/2024,Prabodha Fernando,Anuradhapura,Thissamaharama,North Central,5653,3031,8684,226120,121240,347360
10/15/2024,Prabodha Fernando,Anuradhapura,Thissamaharama,North Central,2169,7051,9220,86760,282040,368800
10/16/2024,Prabodha Fernando,Anuradhapura,Thissamaharama,North Central,4102,2554,6656,164080,102160,266240
10/17/2024,Prabodha Fernando,Anuradhapura,Thissamaharama,North Central,9350,2820,12170,374000,112800,486800
10/18/2024,Prabodha Fernando,Anuradhapura,Thissamaharama,North Central,8362,2193,10555,334480,87720,422200
10/19/2024,Prabodha Fernando,Anuradhapura,Thissamaharama,North Central,1361,4223,5584,54440,168920,223360
10/20/2024,Prabodha Fernando,Anuradhapura,Thissamaharama,North Central,3622,163,3785,144880,6520,151400
10/21/2024,Prabodha Fernando,Anuradhapura,Thissamaharama,North Central,7965,9494,17459,318600,379760,698360
10/22/2024,Prabodha Fernando,Anuradhapura,Thissamaharama,North Central,4920,3094,8014,196800,123760,320560
10/23/2024,Prabodha Fernando,Anuradhapura,Thissamaharama,North Central,1780,7581,9361,71200,303240,374440
10/24/2024,Prabodha Fernando,Anuradhapura,Thissamaharama,North Central,6957,6023,12980,278280,240920,519200
10/25/2024,Prabodha Fernando,Anuradhapura,Thissamaharama,North Central,6340,5398,11738,253600,215920,469520
10/26/2024,Prabodha Fernando,Anuradhapura,Thissamaharama,North Central,723,6972,7695,28920,278880,307800
10/27/2024,Prabodha Fernando,Anuradhapura,Thissamaharama,North Central,6952,2785,9737,278080,111400,389480
10/28/2024,Prabodha Fernando,Anuradhapura,Thissamaharama,North Central,8482,9535,18017,339280,381400,720680
10/29/2024,Prabodha Fernando,Anuradhapura,Thissamaharama,North Central,1965,6498,8463,78600,259920,338520
10/30/2024,Prabodha Fernando,Anuradhapura,Thissamaharama,North Central,3151,6394,9545,126040,255760,381800
10/31/2024,Prabodha Fernando,Anuradhapura,Thissamaharama,North Central,5865,1924,7789,234600,76960,311560
11/1/2024,Prabodha Fernando,Anuradhapura,Thissamaharama,North Central,9059,784,9843,362360,31360,393720
11/2/2024,Prabodha Fernando,Anuradhapura,Thissamaharama,North Central,7713,3142,10855,308520,125680,434200
11/3/2024,Prabodha Fernando,Anuradhapura,Thissamaharama,North Central,9404,7041,16445,376160,281640,657800
11/4/2024,Prabodha Fernando,Anuradhapura,Thissamaharama,North Central,1741,4119,5860,69640,164760,234400
11/5/2024,Prabodha Fernando,Anuradhapura,Thissamaharama,North Central,7508,1073,8581,300320,42920,343240
11/6/2024,Prabodha Fernando,Anuradhapura,Thissamaharama,North Central,1489,5422,6911,59560,216880,276440
11/7/2024,Prabodha Fernando,Anuradhapura,Thissamaharama,North Central,2943,9739,12682,117720,389560,507280
11/8/2024,Prabodha Fernando,Anuradhapura,Thissamaharama,North Central,686,6355,7041,27440,254200,281640
11/9/2024,Prabodha Fernando,Anuradhapura,Thissamaharama,North Central,4748,1686,6434,189920,67440,257360
11/10/2024,Prabodha Fernando,Anuradhapura,Thissamaharama,North Central,2500,900,3400,100000,36000,136000
11/11/2024,Prabodha Fernando,Anuradhapura,Thissamaharama,North Central,2182,5810,7992,87280,232400,319680
11/12/2024,Prabodha Fernando,Anuradhapura,Thissamaharama,North Central,7153,5338,12491,286120,213520,499640
11/13/2024,Prabodha Fernando,Anuradhapura,Thissamaharama,North Central,8057,2675,10732,322280,107000,429280
11/14/2024,Prabodha Fernando,Anuradhapura,Thissamaharama,North Central,4960,6514,11474,198400,260560,458960
11/15/2024,Prabodha Fernando,Anuradhapura,Thissamaharama,North Central,7843,365,8208,313720,14600,328320
11/16/2024,Prabodha Fernando,Anuradhapura,Thissamaharama,North Central,854,9026,9880,34160,361040,395200
11/17/2024,Prabodha Fernando,Anuradhapura,Thissamaharama,North Central,2839,9910,12749,113560,396400,509960
11/18/2024,Prabodha Fernando,Anuradhapura,Thissamaharama,North Central,9142,8039,17181,365680,321560,687240
11/19/2024,Prabodha Fernando,Anuradhapura,Thissamaharama,North Central,3046,8774,11820,121840,350960,472800
11/20/2024,Prabodha Fernando,Anuradhapura,Thissamaharama,North Central,9580,6957,16537,383200,278280,661480
11/21/2024,Prabodha Fernando,Anuradhapura,Thissamaharama,North Central,2769,8657,11426,110760,346280,457040
11/22/2024,Prabodha Fernando,Anuradhapura,Thissamaharama,North Central,1279,8440,9719,51160,337600,388760
11/23/2024,Prabodha Fernando,Anuradhapura,Thissamaharama,North Central,8154,2306,10460,326160,92240,418400
11/24/2024,Prabodha Fernando,Anuradhapura,Thissamaharama,North Central,171,2670,2841,6840,106800,113640
11/25/2024,Prabodha Fernando,Anuradhapura,Thissamaharama,North Central,5264,9370,14634,210560,374800,585360
11/26/2024,Prabodha Fernando,Anuradhapura,Thissamaharama,North Central,1792,5943,7735,71680,237720,309400
11/27/2024,Prabodha Fernando,Anuradhapura,Thissamaharama,North Central,1545,3329,4874,61800,133160,194960
11/28/2024,Prabodha Fernando,Anuradhapura,Thissamaharama,North Central,3283,4241,7524,131320,169640,300960
11/29/2024,Prabodha Fernando,Anuradhapura,Thissamaharama,North Central,6751,2558,9309,270040,102320,372360
11/30/2024,Prabodha Fernando,Anuradhapura,Thissamaharama,North Central,5059,4267,9326,202360,170680,373040
12/1/2024,Prabodha Fernando,Anuradhapura,Thissamaharama,North Central,2698,9410,12108,107920,376400,484320
12/2/2024,Prabodha Fernando,Anuradhapura,Thissamaharama,North Central,8633,4435,13068,345320,177400,522720
12/3/2024,Prabodha Fernando,Anuradhapura,Thissamaharama,North Central,4055,8664,12719,162200,346560,508760
12/4/2024,Prabodha Fernando,Anuradhapura,Thissamaharama,North Central,4953,1941,6894,198120,77640,275760
12/5/2024,Prabodha Fernando,Anuradhapura,Thissamaharama,North Central,6544,2780,9324,261760,111200,372960
12/6/2024,Prabodha Fernando,Anuradhapura,Thissamaharama,North Central,9205,8391,17596,368200,335640,703840
12/7/2024,Prabodha Fernando,Anuradhapura,Thissamaharama,North Central,9800,4430,14230,392000,177200,569200
12/8/2024,Prabodha Fernando,Anuradhapura,Thissamaharama,North Central,8284,2456,10740,331360,98240,429600
12/9/2024,Prabodha Fernando,Anuradhapura,Thissamaharama,North Central,2401,5685,8086,96040,227400,323440
12/10/2024,Prabodha Fernando,Anuradhapura,Thissamaharama,North Central,6458,2754,9212,258320,110160,368480
12/11/2024,Prabodha Fernando,Anuradhapura,Thissamaharama,North Central,8913,7890,16803,356520,315600,672120
12/12/2024,Prabodha Fernando,Anuradhapura,Thissamaharama,North Central,8005,9785,17790,320200,391400,711600
12/13/2024,Prabodha Fernando,Anuradhapura,Thissamaharama,North Central,6157,467,6624,246280,18680,264960
12/14/2024,Prabodha Fernando,Anuradhapura,Thissamaharama,North Central,3709,4512,8221,148360,180480,328840
12/15/2024,Prabodha Fernando,Anuradhapura,Thissamaharama,North Central,4866,1149,6015,194640,45960,240600
12/16/2024,Prabodha Fernando,Anuradhapura,Thissamaharama,North Central,3055,8140,11195,122200,325600,447800
12/17/2024,Prabodha Fernando,Anuradhapura,Thissamaharama,North Central,178,2986,3164,7120,119440,126560
12/18/2024,Prabodha Fernando,Anuradhapura,Thissamaharama,North Central,4931,4984,9915,197240,199360,396600
12/19/2024,Prabodha Fernando,Anuradhapura,Thissamaharama,North Central,7436,7197,14633,297440,287880,585320
12/20/2024,Prabodha Fernando,Anuradhapura,Thissamaharama,North Central,6406,8426,14832,256240,337040,593280
12/21/2024,Prabodha Fernando,Anuradhapura,Thissamaharama,North Central,4480,6124,10604,179200,244960,424160
12/22/2024,Prabodha Fernando,Anuradhapura,Thissamaharama,North Central,9440,3243,12683,377600,129720,507320
12/23/2024,Prabodha Fernando,Anuradhapura,Thissamaharama,North Central,4667,2279,6946,186680,91160,277840
12/24/2024,Prabodha Fernando,Anuradhapura,Thissamaharama,North Central,3867,5043,8910,154680,201720,356400
12/25/2024,Prabodha Fernando,Anuradhapura,Thissamaharama,North Central,6314,1036,7350,252560,41440,294000
12/26/2024,Prabodha Fernando,Anuradhapura,Thissamaharama,North Central,4576,4376,8952,183040,175040,358080
12/27/2024,Prabodha Fernando,Anuradhapura,Thissamaharama,North Central,3176,2202,5378,127040,88080,215120
12/28/2024,Prabodha Fernando,Anuradhapura,Thissamaharama,North Central,183,4780,4963,7320,191200,198520
12/29/2024,Prabodha Fernando,Anuradhapura,Thissamaharama,North Central,9598,156,9754,383920,6240,390160
12/30/2024,Prabodha Fernando,Anuradhapura,Thissamaharama,North Central,9281,5690,14971,371240,227600,598840
12/31/2024,Prabodha Fernando,Anuradhapura,Thissamaharama,North Central,6633,2463,9096,265320,98520,363840
1/1/2025,Prabodha Fernando,Anuradhapura,Thissamaharama,North Central,4833,6336,11169,193320,253440,446760
1/2/2025,Prabodha Fernando,Anuradhapura,Thissamaharama,North Central,4316,8526,12842,172640,341040,513680
1/3/2025,Prabodha Fernando,Anuradhapura,Thissamaharama,North Central,624,473,1097,24960,18920,43880
1/4/2025,Prabodha Fernando,Anuradhapura,Thissamaharama,North Central,6240,304,6544,249600,12160,261760
1/5/2025,Prabodha Fernando,Anuradhapura,Thissamaharama,North Central,1733,942,2675,69320,37680,107000
1/6/2025,Prabodha Fernando,Anuradhapura,Thissamaharama,North Central,2189,7133,9322,87560,285320,372880
1/7/2025,Prabodha Fernando,Anuradhapura,Thissamaharama,North Central,2659,4619,7278,106360,184760,291120
1/8/2025,Prabodha Fernando,Anuradhapura,Thissamaharama,North Central,6741,6052,12793,269640,242080,511720
1/9/2025,Prabodha Fernando,Anuradhapura,Thissamaharama,North Central,823,5186,6009,32920,207440,240360
1/10/2025,Prabodha Fernando,Anuradhapura,Thissamaharama,North Central,8090,7554,15644,323600,302160,625760
1/11/2025,Prabodha Fernando,Anuradhapura,Thissamaharama,North Central,6617,2807,9424,264680,112280,376960
1/12/2025,Prabodha Fernando,Anuradhapura,Thissamaharama,North Central,8801,5899,14700,352040,235960,588000
1/13/2025,Prabodha Fernando,Anuradhapura,Thissamaharama,North Central,3950,5574,9524,158000,222960,380960
1/14/2025,Prabodha Fernando,Anuradhapura,Thissamaharama,North Central,7492,9384,16876,299680,375360,675040
1/15/2025,Prabodha Fernando,Anuradhapura,Thissamaharama,North Central,1271,8070,9341,50840,322800,373640
1/16/2025,Prabodha Fernando,Anuradhapura,Thissamaharama,North Central,1035,6689,7724,41400,267560,308960
1/17/2025,Prabodha Fernando,Anuradhapura,Thissamaharama,North Central,6519,7302,13821,260760,292080,552840
1/18/2025,Prabodha Fernando,Anuradhapura,Thissamaharama,North Central,1647,621,2268,65880,24840,90720
1/19/2025,Prabodha Fernando,Anuradhapura,Thissamaharama,North Central,6975,2756,9731,279000,110240,389240
1/20/2025,Prabodha Fernando,Anuradhapura,Thissamaharama,North Central,1010,4080,5090,40400,163200,203600
1/21/2025,Prabodha Fernando,Anuradhapura,Thissamaharama,North Central,2236,1470,3706,89440,58800,148240
1/22/2025,Prabodha Fernando,Anuradhapura,Thissamaharama,North Central,8047,3227,11274,321880,129080,450960
1/23/2025,Prabodha Fernando,Anuradhapura,Thissamaharama,North Central,9419,925,10344,376760,37000,413760
1/24/2025,Prabodha Fernando,Anuradhapura,Thissamaharama,North Central,6391,286,6677,255640,11440,267080
1/25/2025,Prabodha Fernando,Anuradhapura,Thissamaharama,North Central,3192,7384,10576,127680,295360,423040
1/26/2025,Prabodha Fernando,Anuradhapura,Thissamaharama,North Central,2934,1917,4851,117360,76680,194040
1/27/2025,Prabodha Fernando,Anuradhapura,Thissamaharama,North Central,8104,6214,14318,324160,248560,572720
1/28/2025,Prabodha Fernando,Anuradhapura,Thissamaharama,North Central,4381,1626,6007,175240,65040,240280
1/29/2025,Prabodha Fernando,Anuradhapura,Thissamaharama,North Central,6668,2272,8940,266720,90880,357600
1/30/2025,Prabodha Fernando,Anuradhapura,Thissamaharama,North Central,6203,2097,8300,248120,83880,332000
1/31/2025,Prabodha Fernando,Anuradhapura,Thissamaharama,North Central,6465,6727,13192,258600,269080,527680
2/1/2025,Prabodha Fernando,Anuradhapura,Thissamaharama,North Central,8273,5274,13547,330920,210960,541880
2/2/2025,Prabodha Fernando,Anuradhapura,Thissamaharama,North Central,2003,400,2403,80120,16000,96120
2/3/2025,Prabodha Fernando,Anuradhapura,Thissamaharama,North Central,3495,3075,6570,139800,123000,262800
2/4/2025,Prabodha Fernando,Anuradhapura,Thissamaharama,North Central,6668,3896,10564,266720,155840,422560
2/5/2025,Prabodha Fernando,Anuradhapura,Thissamaharama,North Central,6575,9412,15987,263000,376480,639480
2/6/2025,Prabodha Fernando,Anuradhapura,Thissamaharama,North Central,620,1642,2262,24800,65680,90480
2/7/2025,Prabodha Fernando,Anuradhapura,Thissamaharama,North Central,4267,7572,11839,170680,302880,473560
2/8/2025,Prabodha Fernando,Anuradhapura,Thissamaharama,North Central,7049,3843,10892,281960,153720,435680
2/9/2025,Prabodha Fernando,Anuradhapura,Thissamaharama,North Central,4221,1372,5593,168840,54880,223720
2/10/2025,Prabodha Fernando,Anuradhapura,Thissamaharama,North Central,7297,7380,14677,291880,295200,587080
2/11/2025,Prabodha Fernando,Anuradhapura,Thissamaharama,North Central,1350,4060,5410,54000,162400,216400
2/12/2025,Prabodha Fernando,Anuradhapura,Thissamaharama,North Central,8442,1022,9464,337680,40880,378560
2/13/2025,Prabodha Fernando,Anuradhapura,Thissamaharama,North Central,3997,9095,13092,159880,363800,523680
2/14/2025,Prabodha Fernando,Anuradhapura,Thissamaharama,North Central,4390,270,4660,175600,10800,186400
2/15/2025,Prabodha Fernando,Anuradhapura,Thissamaharama,North Central,78,4816,4894,3120,192640,195760
2/16/2025,Prabodha Fernando,Anuradhapura,Thissamaharama,North Central,9169,9786,18955,366760,391440,758200
2/17/2025,Prabodha Fernando,Anuradhapura,Thissamaharama,North Central,4077,497,4574,163080,19880,182960
2/18/2025,Prabodha Fernando,Anuradhapura,Thissamaharama,North Central,6555,4131,10686,262200,165240,427440
2/19/2025,Prabodha Fernando,Anuradhapura,Thissamaharama,North Central,8133,6396,14529,325320,255840,581160
2/20/2025,Prabodha Fernando,Anuradhapura,Thissamaharama,North Central,9168,1098,10266,366720,43920,410640
2/21/2025,Prabodha Fernando,Anuradhapura,Thissamaharama,North Central,1886,1761,3647,75440,70440,145880
2/22/2025,Prabodha Fernando,Anuradhapura,Thissamaharama,North Central,5080,573,5653,203200,22920,226120
2/23/2025,Prabodha Fernando,Anuradhapura,Thissamaharama,North Central,2694,1356,4050,107760,54240,162000
2/24/2025,Prabodha Fernando,Anuradhapura,Thissamaharama,North Central,6872,6762,13634,274880,270480,545360
2/25/2025,Prabodha Fernando,Anuradhapura,Thissamaharama,North Central,1507,2393,3900,60280,95720,156000
2/26/2025,Prabodha Fernando,Anuradhapura,Thissamaharama,North Central,5975,4073,10048,239000,162920,401920
2/27/2025,Prabodha Fernando,Anuradhapura,Thissamaharama,North Central,4711,1479,6190,188440,59160,247600
2/28/2025,Prabodha Fernando,Anuradhapura,Thissamaharama,North Central,2058,4902,6960,82320,196080,278400
3/1/2025,Prabodha Fernando,Anuradhapura,Thissamaharama,North Central,4297,887,5184,171880,35480,207360
3/2/2025,Prabodha Fernando,Anuradhapura,Thissamaharama,North Central,1528,7137,8665,61120,285480,346600
3/3/2025,Prabodha Fernando,Anuradhapura,Thissamaharama,North Central,6245,8494,14739,249800,339760,589560
3/4/2025,Prabodha Fernando,Anuradhapura,Thissamaharama,North Central,1057,5141,6198,42280,205640,247920
3/5/2025,Prabodha Fernando,Anuradhapura,Thissamaharama,North Central,9519,2359,11878,380760,94360,475120
3/6/2025,Prabodha Fernando,Anuradhapura,Thissamaharama,North Central,500,4809,5309,20000,192360,212360
3/7/2025,Prabodha Fernando,Anuradhapura,Thissamaharama,North Central,5794,253,6047,231760,10120,241880
3/8/2025,Prabodha Fernando,Anuradhapura,Thissamaharama,North Central,5049,1977,7026,201960,79080,281040
3/9/2025,Prabodha Fernando,Anuradhapura,Thissamaharama,North Central,7897,748,8645,315880,29920,345800
3/10/2025,Prabodha Fernando,Anuradhapura,Thissamaharama,North Central,3268,4583,7851,130720,183320,314040
3/11/2025,Prabodha Fernando,Anuradhapura,Thissamaharama,North Central,29,392,421,1160,15680,16840
3/12/2025,Prabodha Fernando,Anuradhapura,Thissamaharama,North Central,7617,3166,10783,304680,126640,431320
3/13/2025,Prabodha Fernando,Anuradhapura,Thissamaharama,North Central,1560,7177,8737,62400,287080,349480
3/14/2025,Prabodha Fernando,Anuradhapura,Thissamaharama,North Central,835,5678,6513,33400,227120,260520
3/15/2025,Prabodha Fernando,Anuradhapura,Thissamaharama,North Central,5140,8063,13203,205600,322520,528120
3/16/2025,Prabodha Fernando,Anuradhapura,Thissamaharama,North Central,5258,1964,7222,210320,78560,288880
3/17/2025,Prabodha Fernando,Anuradhapura,Thissamaharama,North Central,2146,7644,9790,85840,305760,391600
3/18/2025,Prabodha Fernando,Anuradhapura,Thissamaharama,North Central,228,5298,5526,9120,211920,221040
3/19/2025,Prabodha Fernando,Anuradhapura,Thissamaharama,North Central,1579,5566,7145,63160,222640,285800
3/20/2025,Prabodha Fernando,Anuradhapura,Thissamaharama,North Central,427,9648,10075,17080,385920,403000
3/21/2025,Prabodha Fernando,Anuradhapura,Thissamaharama,North Central,5233,3596,8829,209320,143840,353160
3/22/2025,Prabodha Fernando,Anuradhapura,Thissamaharama,North Central,8018,5939,13957,320720,237560,558280
3/23/2025,Prabodha Fernando,Anuradhapura,Thissamaharama,North Central,2103,5299,7402,84120,211960,296080
3/25/2024,Roshan Weerasinghe,Nuwara Eliya,Ginigathhena,Central,2956,6353,9309,118240,254120,372360
3/26/2024,Roshan Weerasinghe,Nuwara Eliya,Ginigathhena,Central,518,4771,5289,20720,190840,211560
3/27/2024,Roshan Weerasinghe,Nuwara Eliya,Ginigathhena,Central,1752,1778,3530,70080,71120,141200
3/28/2024,Roshan Weerasinghe,Nuwara Eliya,Ginigathhena,Central,6533,2572,9105,261320,102880,364200
3/29/2024,Roshan Weerasinghe,Nuwara Eliya,Ginigathhena,Central,4002,9454,13456,160080,378160,538240
3/30/2024,Roshan Weerasinghe,Nuwara Eliya,Ginigathhena,Central,1305,1546,2851,52200,61840,114040
3/31/2024,Roshan Weerasinghe,Nuwara Eliya,Ginigathhena,Central,1121,6356,7477,44840,254240,299080
4/1/2024,Roshan Weerasinghe,Nuwara Eliya,Ginigathhena,Central,326,2510,2836,13040,100400,113440
4/2/2024,Roshan Weerasinghe,Nuwara Eliya,Ginigathhena,Central,9100,5045,14145,364000,201800,565800
4/3/2024,Roshan Weerasinghe,Nuwara Eliya,Ginigathhena,Central,1264,7769,9033,50560,310760,361320
4/4/2024,Roshan Weerasinghe,Nuwara Eliya,Ginigathhena,Central,35,3932,3967,1400,157280,158680
4/5/2024,Roshan Weerasinghe,Nuwara Eliya,Ginigathhena,Central,6877,4198,11075,275080,167920,443000
4/6/2024,Roshan Weerasinghe,Nuwara Eliya,Ginigathhena,Central,1047,6007,7054,41880,240280,282160
4/7/2024,Roshan Weerasinghe,Nuwara Eliya,Ginigathhena,Central,4402,7694,12096,176080,307760,483840
4/8/2024,Roshan Weerasinghe,Nuwara Eliya,Ginigathhena,Central,3705,4257,7962,148200,170280,318480
4/9/2024,Roshan Weerasinghe,Nuwara Eliya,Ginigathhena,Central,3234,7135,10369,129360,285400,414760
4/10/2024,Roshan Weerasinghe,Nuwara Eliya,Ginigathhena,Central,8135,1030,9165,325400,41200,366600
4/11/2024,Roshan Weerasinghe,Nuwara Eliya,Ginigathhena,Central,9639,4446,14085,385560,177840,563400
4/19/2024,Roshan Weerasinghe,Nuwara Eliya,Ginigathhena,Central,2085,1571,3656,83400,62840,146240
4/20/2024,Roshan Weerasinghe,Nuwara Eliya,Ginigathhena,Central,592,3415,4007,23680,136600,160280
4/21/2024,Roshan Weerasinghe,Nuwara Eliya,Ginigathhena,Central,4119,1025,5144,164760,41000,205760
4/22/2024,Roshan Weerasinghe,Nuwara Eliya,Ginigathhena,Central,9661,4381,14042,386440,175240,561680
4/23/2024,Roshan Weerasinghe,Nuwara Eliya,Ginigathhena,Central,6005,1427,7432,240200,57080,297280
4/24/2024,Roshan Weerasinghe,Nuwara Eliya,Ginigathhena,Central,634,9408,10042,25360,376320,401680
4/25/2024,Roshan Weerasinghe,Nuwara Eliya,Ginigathhena,Central,3694,1948,5642,147760,77920,225680
4/26/2024,Roshan Weerasinghe,Nuwara Eliya,Ginigathhena,Central,7921,5841,13762,316840,233640,550480
4/27/2024,Roshan Weerasinghe,Nuwara Eliya,Ginigathhena,Central,5679,9601,15280,227160,384040,611200
4/28/2024,Roshan Weerasinghe,Nuwara Eliya,Ginigathhena,Central,2353,2533,4886,94120,101320,195440
4/29/2024,Roshan Weerasinghe,Nuwara Eliya,Ginigathhena,Central,1091,1043,2134,43640,41720,85360
4/30/2024,Roshan Weerasinghe,Nuwara Eliya,Ginigathhena,Central,2646,5400,8046,105840,216000,321840
5/1/2024,Roshan Weerasinghe,Nuwara Eliya,Ginigathhena,Central,672,8181,8853,26880,327240,354120
5/2/2024,Roshan Weerasinghe,Nuwara Eliya,Ginigathhena,Central,2055,4193,6248,82200,167720,249920
5/3/2024,Roshan Weerasinghe,Nuwara Eliya,Ginigathhena,Central,8772,9676,18448,350880,387040,737920
5/4/2024,Roshan Weerasinghe,Nuwara Eliya,Ginigathhena,Central,5785,109,5894,231400,4360,235760
5/5/2024,Roshan Weerasinghe,Nuwara Eliya,Ginigathhena,Central,3552,5934,9486,142080,237360,379440
5/6/2024,Roshan Weerasinghe,Nuwara Eliya,Ginigathhena,Central,7891,5031,12922,315640,201240,516880
5/7/2024,Roshan Weerasinghe,Nuwara Eliya,Ginigathhena,Central,4420,7792,12212,176800,311680,488480
5/8/2024,Roshan Weerasinghe,Nuwara Eliya,Ginigathhena,Central,8048,5539,13587,321920,221560,543480
5/9/2024,Roshan Weerasinghe,Nuwara Eliya,Ginigathhena,Central,7674,4666,12340,306960,186640,493600
5/10/2024,Roshan Weerasinghe,Nuwara Eliya,Ginigathhena,Central,3042,7079,10121,121680,283160,404840
5/11/2024,Roshan Weerasinghe,Nuwara Eliya,Ginigathhena,Central,3765,1541,5306,150600,61640,212240
5/12/2024,Roshan Weerasinghe,Nuwara Eliya,Ginigathhena,Central,8863,6836,15699,354520,273440,627960
5/13/2024,Roshan Weerasinghe,Nuwara Eliya,Ginigathhena,Central,2405,8265,10670,96200,330600,426800
5/14/2024,Roshan Weerasinghe,Nuwara Eliya,Ginigathhena,Central,2467,5360,7827,98680,214400,313080
5/15/2024,Roshan Weerasinghe,Nuwara Eliya,Ginigathhena,Central,5863,4706,10569,234520,188240,422760
5/16/2024,Roshan Weerasinghe,Nuwara Eliya,Ginigathhena,Central,504,5654,6158,20160,226160,246320
5/17/2024,Roshan Weerasinghe,Nuwara Eliya,Ginigathhena,Central,5968,9101,15069,238720,364040,602760
5/18/2024,Roshan Weerasinghe,Nuwara Eliya,Ginigathhena,Central,6879,5353,12232,275160,214120,489280
5/19/2024,Roshan Weerasinghe,Nuwara Eliya,Ginigathhena,Central,606,4333,4939,24240,173320,197560
5/20/2024,Roshan Weerasinghe,Nuwara Eliya,Ginigathhena,Central,9802,458,10260,392080,18320,410400
5/21/2024,Roshan Weerasinghe,Nuwara Eliya,Ginigathhena,Central,5653,477,6130,226120,19080,245200
5/22/2024,Roshan Weerasinghe,Nuwara Eliya,Ginigathhena,Central,4097,7994,12091,163880,319760,483640
5/24/2024,Roshan Weerasinghe,Nuwara Eliya,Ginigathhena,Central,4764,956,5720,190560,38240,228800
5/25/2024,Roshan Weerasinghe,Nuwara Eliya,Ginigathhena,Central,9410,9254,18664,376400,370160,746560
5/26/2024,Roshan Weerasinghe,Nuwara Eliya,Ginigathhena,Central,2162,8970,11132,86480,358800,445280
5/27/2024,Roshan Weerasinghe,Nuwara Eliya,Ginigathhena,Central,4548,5546,10094,181920,221840,403760
5/28/2024,Roshan Weerasinghe,Nuwara Eliya,Ginigathhena,Central,883,6546,7429,35320,261840,297160
5/29/2024,Roshan Weerasinghe,Nuwara Eliya,Ginigathhena,Central,3649,1504,5153,145960,60160,206120
5/30/2024,Roshan Weerasinghe,Nuwara Eliya,Ginigathhena,Central,7696,1052,8748,307840,42080,349920
5/31/2024,Roshan Weerasinghe,Nuwara Eliya,Ginigathhena,Central,9213,6416,15629,368520,256640,625160
6/1/2024,Roshan Weerasinghe,Nuwara Eliya,Ginigathhena,Central,4985,8687,13672,199400,347480,546880
6/2/2024,Roshan Weerasinghe,Nuwara Eliya,Ginigathhena,Central,6103,3312,9415,244120,132480,376600
6/3/2024,Roshan Weerasinghe,Nuwara Eliya,Ginigathhena,Central,9227,399,9626,369080,15960,385040
6/4/2024,Roshan Weerasinghe,Nuwara Eliya,Ginigathhena,Central,8862,7824,16686,354480,312960,667440
6/5/2024,Roshan Weerasinghe,Nuwara Eliya,Ginigathhena,Central,6230,1445,7675,249200,57800,307000
6/6/2024,Roshan Weerasinghe,Nuwara Eliya,Ginigathhena,Central,7917,6546,14463,316680,261840,578520
6/7/2024,Roshan Weerasinghe,Nuwara Eliya,Ginigathhena,Central,764,4326,5090,30560,173040,203600
6/8/2024,Roshan Weerasinghe,Nuwara Eliya,Ginigathhena,Central,5456,6547,12003,218240,261880,480120
6/9/2024,Roshan Weerasinghe,Nuwara Eliya,Ginigathhena,Central,7131,3090,10221,285240,123600,408840
6/10/2024,Roshan Weerasinghe,Nuwara Eliya,Ginigathhena,Central,5510,7726,13236,220400,309040,529440
6/11/2024,Roshan Weerasinghe,Nuwara Eliya,Ginigathhena,Central,594,1475,2069,23760,59000,82760
6/12/2024,Roshan Weerasinghe,Nuwara Eliya,Ginigathhena,Central,2508,2216,4724,100320,88640,188960
6/13/2024,Roshan Weerasinghe,Nuwara Eliya,Ginigathhena,Central,5587,5972,11559,223480,238880,462360
6/14/2024,Roshan Weerasinghe,Nuwara Eliya,Ginigathhena,Central,7383,7571,14954,295320,302840,598160
6/15/2024,Roshan Weerasinghe,Nuwara Eliya,Ginigathhena,Central,3244,2383,5627,129760,95320,225080
6/16/2024,Roshan Weerasinghe,Nuwara Eliya,Ginigathhena,Central,4319,8580,12899,172760,343200,515960
6/17/2024,Roshan Weerasinghe,Nuwara Eliya,Ginigathhena,Central,8927,4646,13573,357080,185840,542920
6/18/2024,Roshan Weerasinghe,Nuwara Eliya,Ginigathhena,Central,1195,5590,6785,47800,223600,271400
6/19/2024,Roshan Weerasinghe,Nuwara Eliya,Ginigathhena,Central,1030,472,1502,41200,18880,60080
6/20/2024,Roshan Weerasinghe,Nuwara Eliya,Ginigathhena,Central,5612,7440,13052,224480,297600,522080
6/21/2024,Roshan Weerasinghe,Nuwara Eliya,Ginigathhena,Central,3261,1522,4783,130440,60880,191320
6/22/2024,Roshan Weerasinghe,Nuwara Eliya,Ginigathhena,Central,4672,2801,7473,186880,112040,298920
6/23/2024,Roshan Weerasinghe,Nuwara Eliya,Ginigathhena,Central,5100,9256,14356,204000,370240,574240
6/24/2024,Roshan Weerasinghe,Nuwara Eliya,Ginigathhena,Central,4083,7417,11500,163320,296680,460000
6/25/2024,Roshan Weerasinghe,Nuwara Eliya,Ginigathhena,Central,6464,1767,8231,258560,70680,329240
6/26/2024,Roshan Weerasinghe,Nuwara Eliya,Ginigathhena,Central,6489,266,6755,259560,10640,270200
6/27/2024,Roshan Weerasinghe,Nuwara Eliya,Ginigathhena,Central,3172,4597,7769,126880,183880,310760
6/28/2024,Roshan Weerasinghe,Nuwara Eliya,Ginigathhena,Central,8658,7529,16187,346320,301160,647480
6/29/2024,Roshan Weerasinghe,Nuwara Eliya,Ginigathhena,Central,1364,5510,6874,54560,220400,274960
6/30/2024,Roshan Weerasinghe,Nuwara Eliya,Ginigathhena,Central,6869,5730,12599,274760,229200,503960
7/1/2024,Roshan Weerasinghe,Nuwara Eliya,Ginigathhena,Central,7717,6607,14324,308680,264280,572960
7/2/2024,Roshan Weerasinghe,Nuwara Eliya,Ginigathhena,Central,2772,1700,4472,110880,68000,178880
7/3/2024,Roshan Weerasinghe,Nuwara Eliya,Ginigathhena,Central,4769,8747,13516,190760,349880,540640
7/4/2024,Roshan Weerasinghe,Nuwara Eliya,Ginigathhena,Central,3161,5716,8877,126440,228640,355080
7/5/2024,Roshan Weerasinghe,Nuwara Eliya,Ginigathhena,Central,3303,4494,7797,132120,179760,311880
7/6/2024,Roshan Weerasinghe,Nuwara Eliya,Ginigathhena,Central,7084,5240,12324,283360,209600,492960
7/7/2024,Roshan Weerasinghe,Nuwara Eliya,Ginigathhena,Central,7001,597,7598,280040,23880,303920
7/8/2024,Roshan Weerasinghe,Nuwara Eliya,Ginigathhena,Central,2711,3378,6089,108440,135120,243560
7/9/2024,Roshan Weerasinghe,Nuwara Eliya,Ginigathhena,Central,7355,4289,11644,294200,171560,465760
7/10/2024,Roshan Weerasinghe,Nuwara Eliya,Ginigathhena,Central,8343,2444,10787,333720,97760,431480
7/11/2024,Roshan Weerasinghe,Nuwara Eliya,Ginigathhena,Central,4838,8651,13489,193520,346040,539560
7/12/2024,Roshan Weerasinghe,Nuwara Eliya,Ginigathhena,Central,6850,8754,15604,274000,350160,624160
7/13/2024,Roshan Weerasinghe,Nuwara Eliya,Ginigathhena,Central,1056,3292,4348,42240,131680,173920
7/14/2024,Roshan Weerasinghe,Nuwara Eliya,Ginigathhena,Central,8251,2441,10692,330040,97640,427680
7/15/2024,Roshan Weerasinghe,Nuwara Eliya,Ginigathhena,Central,7651,4084,11735,306040,163360,469400
7/16/2024,Roshan Weerasinghe,Nuwara Eliya,Ginigathhena,Central,1382,4806,6188,55280,192240,247520
7/17/2024,Roshan Weerasinghe,Nuwara Eliya,Ginigathhena,Central,3091,193,3284,123640,7720,131360
7/18/2024,Roshan Weerasinghe,Nuwara Eliya,Ginigathhena,Central,3619,9379,12998,144760,375160,519920
7/19/2024,Roshan Weerasinghe,Nuwara Eliya,Ginigathhena,Central,9975,1707,11682,399000,68280,467280
7/20/2024,Roshan Weerasinghe,Nuwara Eliya,Ginigathhena,Central,6010,8814,14824,240400,352560,592960
7/21/2024,Roshan Weerasinghe,Nuwara Eliya,Ginigathhena,Central,9648,9908,19556,385920,396320,782240
7/22/2024,Roshan Weerasinghe,Nuwara Eliya,Ginigathhena,Central,9834,7348,17182,393360,293920,687280
7/23/2024,Roshan Weerasinghe,Nuwara Eliya,Ginigathhena,Central,2382,6853,9235,95280,274120,369400
7/24/2024,Roshan Weerasinghe,Nuwara Eliya,Ginigathhena,Central,7453,4744,12197,298120,189760,487880
7/25/2024,Roshan Weerasinghe,Nuwara Eliya,Ginigathhena,Central,5431,2825,8256,217240,113000,330240
7/26/2024,Roshan Weerasinghe,Nuwara Eliya,Ginigathhena,Central,6247,9453,15700,249880,378120,628000
7/27/2024,Roshan Weerasinghe,Nuwara Eliya,Ginigathhena,Central,1904,7133,9037,76160,285320,361480
7/28/2024,Roshan Weerasinghe,Nuwara Eliya,Ginigathhena,Central,8496,1326,9822,339840,53040,392880
7/29/2024,Roshan Weerasinghe,Nuwara Eliya,Ginigathhena,Central,3628,6401,10029,145120,256040,401160
7/30/2024,Roshan Weerasinghe,Nuwara Eliya,Ginigathhena,Central,6756,678,7434,270240,27120,297360
7/31/2024,Roshan Weerasinghe,Nuwara Eliya,Ginigathhena,Central,742,5942,6684,29680,237680,267360
8/1/2024,Roshan Weerasinghe,Nuwara Eliya,Ginigathhena,Central,6202,9822,16024,248080,392880,640960
8/2/2024,Roshan Weerasinghe,Nuwara Eliya,Ginigathhena,Central,8826,4152,12978,353040,166080,519120
8/3/2024,Roshan Weerasinghe,Nuwara Eliya,Ginigathhena,Central,8210,6231,14441,328400,249240,577640
8/4/2024,Roshan Weerasinghe,Nuwara Eliya,Ginigathhena,Central,6394,447,6841,255760,17880,273640
8/5/2024,Roshan Weerasinghe,Nuwara Eliya,Ginigathhena,Central,8670,221,8891,346800,8840,355640
8/6/2024,Roshan Weerasinghe,Nuwara Eliya,Ginigathhena,Central,6856,1017,7873,274240,40680,314920
8/7/2024,Roshan Weerasinghe,Nuwara Eliya,Ginigathhena,Central,6857,1028,7885,274280,41120,315400
8/8/2024,Roshan Weerasinghe,Nuwara Eliya,Ginigathhena,Central,1519,8890,10409,60760,355600,416360
8/9/2024,Roshan Weerasinghe,Nuwara Eliya,Ginigathhena,Central,9399,5651,15050,375960,226040,602000
8/10/2024,Roshan Weerasinghe,Nuwara Eliya,Ginigathhena,Central,2174,3315,5489,86960,132600,219560
8/11/2024,Roshan Weerasinghe,Nuwara Eliya,Ginigathhena,Central,7042,5960,13002,281680,238400,520080
8/12/2024,Roshan Weerasinghe,Nuwara Eliya,Ginigathhena,Central,2802,9326,12128,112080,373040,485120
8/13/2024,Roshan Weerasinghe,Nuwara Eliya,Ginigathhena,Central,8541,5178,13719,341640,207120,548760
8/14/2024,Roshan Weerasinghe,Nuwara Eliya,Ginigathhena,Central,8069,4934,13003,322760,197360,520120
8/15/2024,Roshan Weerasinghe,Nuwara Eliya,Ginigathhena,Central,6975,8128,15103,279000,325120,604120
8/16/2024,Roshan Weerasinghe,Nuwara Eliya,Ginigathhena,Central,1425,5100,6525,57000,204000,261000
8/17/2024,Roshan Weerasinghe,Nuwara Eliya,Ginigathhena,Central,8732,6459,15191,349280,258360,607640
8/18/2024,Roshan Weerasinghe,Nuwara Eliya,Ginigathhena,Central,2543,3263,5806,101720,130520,232240
8/19/2024,Roshan Weerasinghe,Nuwara Eliya,Ginigathhena,Central,2356,2378,4734,94240,95120,189360
8/20/2024,Roshan Weerasinghe,Nuwara Eliya,Ginigathhena,Central,3593,8858,12451,143720,354320,498040
8/21/2024,Roshan Weerasinghe,Nuwara Eliya,Ginigathhena,Central,525,6735,7260,21000,269400,290400
8/22/2024,Roshan Weerasinghe,Nuwara Eliya,Ginigathhena,Central,1479,9328,10807,59160,373120,432280
8/23/2024,Roshan Weerasinghe,Nuwara Eliya,Ginigathhena,Central,7703,3710,11413,308120,148400,456520
8/24/2024,Roshan Weerasinghe,Nuwara Eliya,Ginigathhena,Central,3752,9913,13665,150080,396520,546600
8/25/2024,Roshan Weerasinghe,Nuwara Eliya,Ginigathhena,Central,2512,5032,7544,100480,201280,301760
8/26/2024,Roshan Weerasinghe,Nuwara Eliya,Ginigathhena,Central,6578,8007,14585,263120,320280,583400
8/27/2024,Roshan Weerasinghe,Nuwara Eliya,Ginigathhena,Central,2269,8648,10917,90760,345920,436680
8/28/2024,Roshan Weerasinghe,Nuwara Eliya,Ginigathhena,Central,2349,224,2573,93960,8960,102920
8/29/2024,Roshan Weerasinghe,Nuwara Eliya,Ginigathhena,Central,7630,211,7841,305200,8440,313640
8/30/2024,Roshan Weerasinghe,Nuwara Eliya,Ginigathhena,Central,7513,9163,16676,300520,366520,667040
8/31/2024,Roshan Weerasinghe,Nuwara Eliya,Ginigathhena,Central,6314,2265,8579,252560,90600,343160
9/1/2024,Roshan Weerasinghe,Nuwara Eliya,Ginigathhena,Central,4901,57,4958,196040,2280,198320
9/2/2024,Roshan Weerasinghe,Nuwara Eliya,Ginigathhena,Central,5556,6467,12023,222240,258680,480920
9/3/2024,Roshan Weerasinghe,Nuwara Eliya,Ginigathhena,Central,3064,2549,5613,122560,101960,224520
9/4/2024,Roshan Weerasinghe,Nuwara Eliya,Ginigathhena,Central,8608,9741,18349,344320,389640,733960
9/5/2024,Roshan Weerasinghe,Nuwara Eliya,Ginigathhena,Central,7238,9920,17158,289520,396800,686320
9/6/2024,Roshan Weerasinghe,Nuwara Eliya,Ginigathhena,Central,9324,6951,16275,372960,278040,651000
9/7/2024,Roshan Weerasinghe,Nuwara Eliya,Ginigathhena,Central,6164,4406,10570,246560,176240,422800
9/8/2024,Roshan Weerasinghe,Nuwara Eliya,Ginigathhena,Central,9576,8181,17757,383040,327240,710280
9/9/2024,Roshan Weerasinghe,Nuwara Eliya,Ginigathhena,Central,2616,3654,6270,104640,146160,250800
9/10/2024,Roshan Weerasinghe,Nuwara Eliya,Ginigathhena,Central,2508,5963,8471,100320,238520,338840
9/11/2024,Roshan Weerasinghe,Nuwara Eliya,Ginigathhena,Central,8605,8764,17369,344200,350560,694760
9/12/2024,Roshan Weerasinghe,Nuwara Eliya,Ginigathhena,Central,146,2201,2347,5840,88040,93880
9/13/2024,Roshan Weerasinghe,Nuwara Eliya,Ginigathhena,Central,9815,3098,12913,392600,123920,516520
9/14/2024,Roshan Weerasinghe,Nuwara Eliya,Ginigathhena,Central,9178,2963,12141,367120,118520,485640
9/15/2024,Roshan Weerasinghe,Nuwara Eliya,Ginigathhena,Central,9393,8277,17670,375720,331080,706800
9/16/2024,Roshan Weerasinghe,Nuwara Eliya,Ginigathhena,Central,3679,4191,7870,147160,167640,314800
9/17/2024,Roshan Weerasinghe,Nuwara Eliya,Ginigathhena,Central,4112,6391,10503,164480,255640,420120
9/18/2024,Roshan Weerasinghe,Nuwara Eliya,Ginigathhena,Central,9606,706,10312,384240,28240,412480
9/19/2024,Roshan Weerasinghe,Nuwara Eliya,Ginigathhena,Central,5511,8504,14015,220440,340160,560600
9/20/2024,Roshan Weerasinghe,Nuwara Eliya,Ginigathhena,Central,4533,2851,7384,181320,114040,295360
9/21/2024,Roshan Weerasinghe,Nuwara Eliya,Ginigathhena,Central,4567,7791,12358,182680,311640,494320
9/22/2024,Roshan Weerasinghe,Nuwara Eliya,Ginigathhena,Central,2117,6743,8860,84680,269720,354400
9/23/2024,Roshan Weerasinghe,Nuwara Eliya,Ginigathhena,Central,8077,1638,9715,323080,65520,388600
9/24/2024,Roshan Weerasinghe,Nuwara Eliya,Ginigathhena,Central,1334,6349,7683,53360,253960,307320
9/25/2024,Roshan Weerasinghe,Nuwara Eliya,Ginigathhena,Central,8633,574,9207,345320,22960,368280
9/26/2024,Roshan Weerasinghe,Nuwara Eliya,Ginigathhena,Central,1149,8543,9692,45960,341720,387680
9/27/2024,Roshan Weerasinghe,Nuwara Eliya,Ginigathhena,Central,7682,3676,11358,307280,147040,454320
9/28/2024,Roshan Weerasinghe,Nuwara Eliya,Ginigathhena,Central,4955,5099,10054,198200,203960,402160
9/29/2024,Roshan Weerasinghe,Nuwara Eliya,Ginigathhena,Central,9151,1833,10984,366040,73320,439360
9/30/2024,Roshan Weerasinghe,Nuwara Eliya,Ginigathhena,Central,6363,8714,15077,254520,348560,603080
10/1/2024,Roshan Weerasinghe,Nuwara Eliya,Ginigathhena,Central,7631,6986,14617,305240,279440,584680
10/2/2024,Roshan Weerasinghe,Nuwara Eliya,Ginigathhena,Central,231,8106,8337,9240,324240,333480
10/3/2024,Roshan Weerasinghe,Nuwara Eliya,Ginigathhena,Central,9982,2341,12323,399280,93640,492920
10/4/2024,Roshan Weerasinghe,Nuwara Eliya,Ginigathhena,Central,4695,2851,7546,187800,114040,301840
10/5/2024,Roshan Weerasinghe,Nuwara Eliya,Ginigathhena,Central,1498,7735,9233,59920,309400,369320
10/6/2024,Roshan Weerasinghe,Nuwara Eliya,Ginigathhena,Central,1938,2369,4307,77520,94760,172280
10/7/2024,Roshan Weerasinghe,Nuwara Eliya,Ginigathhena,Central,6233,2952,9185,249320,118080,367400
10/8/2024,Roshan Weerasinghe,Nuwara Eliya,Ginigathhena,Central,6827,2486,9313,273080,99440,372520
10/9/2024,Roshan Weerasinghe,Nuwara Eliya,Ginigathhena,Central,12,2384,2396,480,95360,95840
10/10/2024,Roshan Weerasinghe,Nuwara Eliya,Ginigathhena,Central,1873,6822,8695,74920,272880,347800
10/11/2024,Roshan Weerasinghe,Nuwara Eliya,Ginigathhena,Central,4046,7381,11427,161840,295240,457080
10/12/2024,Roshan Weerasinghe,Nuwara Eliya,Ginigathhena,Central,4046,4760,8806,161840,190400,352240
10/13/2024,Roshan Weerasinghe,Nuwara Eliya,Ginigathhena,Central,813,989,1802,32520,39560,72080
10/14/2024,Roshan Weerasinghe,Nuwara Eliya,Ginigathhena,Central,5293,7625,12918,211720,305000,516720
10/15/2024,Roshan Weerasinghe,Nuwara Eliya,Ginigathhena,Central,6278,5256,11534,251120,210240,461360
10/16/2024,Roshan Weerasinghe,Nuwara Eliya,Ginigathhena,Central,2978,1123,4101,119120,44920,164040
10/17/2024,Roshan Weerasinghe,Nuwara Eliya,Ginigathhena,Central,890,8704,9594,35600,348160,383760
10/18/2024,Roshan Weerasinghe,Nuwara Eliya,Ginigathhena,Central,1361,1287,2648,54440,51480,105920
10/19/2024,Roshan Weerasinghe,Nuwara Eliya,Ginigathhena,Central,8831,1961,10792,353240,78440,431680
10/20/2024,Roshan Weerasinghe,Nuwara Eliya,Ginigathhena,Central,9352,7263,16615,374080,290520,664600
10/21/2024,Roshan Weerasinghe,Nuwara Eliya,Ginigathhena,Central,2043,390,2433,81720,15600,97320
10/22/2024,Roshan Weerasinghe,Nuwara Eliya,Ginigathhena,Central,8750,1019,9769,350000,40760,390760
10/23/2024,Roshan Weerasinghe,Nuwara Eliya,Ginigathhena,Central,8460,8615,17075,338400,344600,683000
10/24/2024,Roshan Weerasinghe,Nuwara Eliya,Ginigathhena,Central,9331,8718,18049,373240,348720,721960
10/25/2024,Roshan Weerasinghe,Nuwara Eliya,Ginigathhena,Central,3760,2092,5852,150400,83680,234080
10/26/2024,Roshan Weerasinghe,Nuwara Eliya,Ginigathhena,Central,8652,3076,11728,346080,123040,469120
10/27/2024,Roshan Weerasinghe,Nuwara Eliya,Ginigathhena,Central,1465,4164,5629,58600,166560,225160
10/28/2024,Roshan Weerasinghe,Nuwara Eliya,Ginigathhena,Central,5009,5385,10394,200360,215400,415760
10/29/2024,Roshan Weerasinghe,Nuwara Eliya,Ginigathhena,Central,1487,5949,7436,59480,237960,297440
10/30/2024,Roshan Weerasinghe,Nuwara Eliya,Ginigathhena,Central,6894,1598,8492,275760,63920,339680
10/31/2024,Roshan Weerasinghe,Nuwara Eliya,Ginigathhena,Central,4251,4526,8777,170040,181040,351080
11/1/2024,Roshan Weerasinghe,Nuwara Eliya,Ginigathhena,Central,4679,2306,6985,187160,92240,279400
11/2/2024,Roshan Weerasinghe,Nuwara Eliya,Ginigathhena,Central,9114,5271,14385,364560,210840,575400
11/3/2024,Roshan Weerasinghe,Nuwara Eliya,Ginigathhena,Central,5725,7110,12835,229000,284400,513400
11/4/2024,Roshan Weerasinghe,Nuwara Eliya,Ginigathhena,Central,8470,8689,17159,338800,347560,686360
11/5/2024,Roshan Weerasinghe,Nuwara Eliya,Ginigathhena,Central,6803,4810,11613,272120,192400,464520
11/6/2024,Roshan Weerasinghe,Nuwara Eliya,Ginigathhena,Central,3025,6003,9028,121000,240120,361120
11/7/2024,Roshan Weerasinghe,Nuwara Eliya,Ginigathhena,Central,6731,139,6870,269240,5560,274800
11/8/2024,Roshan Weerasinghe,Nuwara Eliya,Ginigathhena,Central,5004,4210,9214,200160,168400,368560
11/9/2024,Roshan Weerasinghe,Nuwara Eliya,Ginigathhena,Central,4323,9493,13816,172920,379720,552640
11/10/2024,Roshan Weerasinghe,Nuwara Eliya,Ginigathhena,Central,6951,4122,11073,278040,164880,442920
11/11/2024,Roshan Weerasinghe,Nuwara Eliya,Ginigathhena,Central,958,1404,2362,38320,56160,94480
11/12/2024,Roshan Weerasinghe,Nuwara Eliya,Ginigathhena,Central,5272,5162,10434,210880,206480,417360
11/13/2024,Roshan Weerasinghe,Nuwara Eliya,Ginigathhena,Central,7799,9214,17013,311960,368560,680520
11/14/2024,Roshan Weerasinghe,Nuwara Eliya,Ginigathhena,Central,223,475,698,8920,19000,27920
11/15/2024,Roshan Weerasinghe,Nuwara Eliya,Ginigathhena,Central,5350,845,6195,214000,33800,247800
11/16/2024,Roshan Weerasinghe,Nuwara Eliya,Ginigathhena,Central,6067,119,6186,242680,4760,247440
11/17/2024,Roshan Weerasinghe,Nuwara Eliya,Ginigathhena,Central,1859,7560,9419,74360,302400,376760
11/18/2024,Roshan Weerasinghe,Nuwara Eliya,Ginigathhena,Central,5496,517,6013,219840,20680,240520
11/19/2024,Roshan Weerasinghe,Nuwara Eliya,Ginigathhena,Central,146,1382,1528,5840,55280,61120
11/20/2024,Roshan Weerasinghe,Nuwara Eliya,Ginigathhena,Central,6676,8010,14686,267040,320400,587440
11/21/2024,Roshan Weerasinghe,Nuwara Eliya,Ginigathhena,Central,8931,8043,16974,357240,321720,678960
11/22/2024,Roshan Weerasinghe,Nuwara Eliya,Ginigathhena,Central,2231,2666,4897,89240,106640,195880
11/23/2024,Roshan Weerasinghe,Nuwara Eliya,Ginigathhena,Central,7877,8743,16620,315080,349720,664800
11/24/2024,Roshan Weerasinghe,Nuwara Eliya,Ginigathhena,Central,6843,2339,9182,273720,93560,367280
11/25/2024,Roshan Weerasinghe,Nuwara Eliya,Ginigathhena,Central,8717,9541,18258,348680,381640,730320
11/26/2024,Roshan Weerasinghe,Nuwara Eliya,Ginigathhena,Central,7936,5849,13785,317440,233960,551400
11/27/2024,Roshan Weerasinghe,Nuwara Eliya,Ginigathhena,Central,2462,6447,8909,98480,257880,356360
11/28/2024,Roshan Weerasinghe,Nuwara Eliya,Ginigathhena,Central,8047,1038,9085,321880,41520,363400
11/29/2024,Roshan Weerasinghe,Nuwara Eliya,Ginigathhena,Central,9361,1790,11151,374440,71600,446040
11/30/2024,Roshan Weerasinghe,Nuwara Eliya,Ginigathhena,Central,8266,4507,12773,330640,180280,510920
12/1/2024,Roshan Weerasinghe,Nuwara Eliya,Ginigathhena,Central,26,2086,2112,1040,83440,84480
12/2/2024,Roshan Weerasinghe,Nuwara Eliya,Ginigathhena,Central,7134,7861,14995,285360,314440,599800
12/3/2024,Roshan Weerasinghe,Nuwara Eliya,Ginigathhena,Central,9497,4310,13807,379880,172400,552280
12/4/2024,Roshan Weerasinghe,Nuwara Eliya,Ginigathhena,Central,82,90,172,3280,3600,6880
12/5/2024,Roshan Weerasinghe,Nuwara Eliya,Ginigathhena,Central,1660,7153,8813,66400,286120,352520
12/6/2024,Roshan Weerasinghe,Nuwara Eliya,Ginigathhena,Central,4909,4537,9446,196360,181480,377840
12/7/2024,Roshan Weerasinghe,Nuwara Eliya,Ginigathhena,Central,1386,2549,3935,55440,101960,157400
12/8/2024,Roshan Weerasinghe,Nuwara Eliya,Ginigathhena,Central,3497,1510,5007,139880,60400,200280
12/9/2024,Roshan Weerasinghe,Nuwara Eliya,Ginigathhena,Central,8318,4778,13096,332720,191120,523840
12/10/2024,Roshan Weerasinghe,Nuwara Eliya,Ginigathhena,Central,4739,1702,6441,189560,68080,257640
12/11/2024,Roshan Weerasinghe,Nuwara Eliya,Ginigathhena,Central,6466,1308,7774,258640,52320,310960
12/12/2024,Roshan Weerasinghe,Nuwara Eliya,Ginigathhena,Central,1443,9975,11418,57720,399000,456720
12/13/2024,Roshan Weerasinghe,Nuwara Eliya,Ginigathhena,Central,2483,5941,8424,99320,237640,336960
12/14/2024,Roshan Weerasinghe,Nuwara Eliya,Ginigathhena,Central,8529,4530,13059,341160,181200,522360
12/15/2024,Roshan Weerasinghe,Nuwara Eliya,Ginigathhena,Central,4698,4629,9327,187920,185160,373080
12/16/2024,Roshan Weerasinghe,Nuwara Eliya,Ginigathhena,Central,4730,4401,9131,189200,176040,365240
12/17/2024,Roshan Weerasinghe,Nuwara Eliya,Ginigathhena,Central,7489,3930,11419,299560,157200,456760
12/18/2024,Roshan Weerasinghe,Nuwara Eliya,Ginigathhena,Central,381,5025,5406,15240,201000,216240
12/19/2024,Roshan Weerasinghe,Nuwara Eliya,Ginigathhena,Central,2182,7314,9496,87280,292560,379840
12/20/2024,Roshan Weerasinghe,Nuwara Eliya,Ginigathhena,Central,1629,2883,4512,65160,115320,180480
12/21/2024,Roshan Weerasinghe,Nuwara Eliya,Ginigathhena,Central,3946,4966,8912,157840,198640,356480
12/22/2024,Roshan Weerasinghe,Nuwara Eliya,Ginigathhena,Central,5302,5558,10860,212080,222320,434400
12/23/2024,Roshan Weerasinghe,Nuwara Eliya,Ginigathhena,Central,6634,1320,7954,265360,52800,318160
12/24/2024,Roshan Weerasinghe,Nuwara Eliya,Ginigathhena,Central,555,2900,3455,22200,116000,138200
12/25/2024,Roshan Weerasinghe,Nuwara Eliya,Ginigathhena,Central,7706,4010,11716,308240,160400,468640
12/26/2024,Roshan Weerasinghe,Nuwara Eliya,Ginigathhena,Central,9109,1926,11035,364360,77040,441400
12/27/2024,Roshan Weerasinghe,Nuwara Eliya,Ginigathhena,Central,6764,6703,13467,270560,268120,538680
12/28/2024,Roshan Weerasinghe,Nuwara Eliya,Ginigathhena,Central,1524,9219,10743,60960,368760,429720
12/29/2024,Roshan Weerasinghe,Nuwara Eliya,Ginigathhena,Central,9865,7675,17540,394600,307000,701600
12/30/2024,Roshan Weerasinghe,Nuwara Eliya,Ginigathhena,Central,4522,6595,11117,180880,263800,444680
12/31/2024,Roshan Weerasinghe,Nuwara Eliya,Ginigathhena,Central,5254,193,5447,210160,7720,217880
1/1/2025,Roshan Weerasinghe,Nuwara Eliya,Ginigathhena,Central,2411,6050,8461,96440,242000,338440
1/2/2025,Roshan Weerasinghe,Nuwara Eliya,Ginigathhena,Central,1454,410,1864,58160,16400,74560
1/3/2025,Roshan Weerasinghe,Nuwara Eliya,Ginigathhena,Central,4217,668,4885,168680,26720,195400
1/4/2025,Roshan Weerasinghe,Nuwara Eliya,Ginigathhena,Central,7815,6048,13863,312600,241920,554520
1/5/2025,Roshan Weerasinghe,Nuwara Eliya,Ginigathhena,Central,7667,4515,12182,306680,180600,487280
1/6/2025,Roshan Weerasinghe,Nuwara Eliya,Ginigathhena,Central,8472,5500,13972,338880,220000,558880
1/7/2025,Roshan Weerasinghe,Nuwara Eliya,Ginigathhena,Central,1656,8490,10146,66240,339600,405840
1/8/2025,Roshan Weerasinghe,Nuwara Eliya,Ginigathhena,Central,6426,4152,10578,257040,166080,423120
1/9/2025,Roshan Weerasinghe,Nuwara Eliya,Ginigathhena,Central,4419,8618,13037,176760,344720,521480
1/10/2025,Roshan Weerasinghe,Nuwara Eliya,Ginigathhena,Central,8679,8327,17006,347160,333080,680240
1/11/2025,Roshan Weerasinghe,Nuwara Eliya,Ginigathhena,Central,1249,5430,6679,49960,217200,267160
1/12/2025,Roshan Weerasinghe,Nuwara Eliya,Ginigathhena,Central,1731,3811,5542,69240,152440,221680
1/13/2025,Roshan Weerasinghe,Nuwara Eliya,Ginigathhena,Central,8147,177,8324,325880,7080,332960
1/14/2025,Roshan Weerasinghe,Nuwara Eliya,Ginigathhena,Central,5321,9639,14960,212840,385560,598400
1/15/2025,Roshan Weerasinghe,Nuwara Eliya,Ginigathhena,Central,9522,2002,11524,380880,80080,460960
1/16/2025,Roshan Weerasinghe,Nuwara Eliya,Ginigathhena,Central,1862,9663,11525,74480,386520,461000
1/17/2025,Roshan Weerasinghe,Nuwara Eliya,Ginigathhena,Central,6528,3831,10359,261120,153240,414360
1/18/2025,Roshan Weerasinghe,Nuwara Eliya,Ginigathhena,Central,174,5585,5759,6960,223400,230360
1/19/2025,Roshan Weerasinghe,Nuwara Eliya,Ginigathhena,Central,376,7766,8142,15040,310640,325680
1/20/2025,Roshan Weerasinghe,Nuwara Eliya,Ginigathhena,Central,4306,2571,6877,172240,102840,275080
1/21/2025,Roshan Weerasinghe,Nuwara Eliya,Ginigathhena,Central,7950,6152,14102,318000,246080,564080
1/22/2025,Roshan Weerasinghe,Nuwara Eliya,Ginigathhena,Central,7251,7849,15100,290040,313960,604000
1/23/2025,Roshan Weerasinghe,Nuwara Eliya,Ginigathhena,Central,3892,8206,12098,155680,328240,483920
1/24/2025,Roshan Weerasinghe,Nuwara Eliya,Ginigathhena,Central,1025,9220,10245,41000,368800,409800
1/25/2025,Roshan Weerasinghe,Nuwara Eliya,Ginigathhena,Central,904,2302,3206,36160,92080,128240
1/26/2025,Roshan Weerasinghe,Nuwara Eliya,Ginigathhena,Central,3641,1506,5147,145640,60240,205880
1/27/2025,Roshan Weerasinghe,Nuwara Eliya,Ginigathhena,Central,8783,8740,17523,351320,349600,700920
1/28/2025,Roshan Weerasinghe,Nuwara Eliya,Ginigathhena,Central,8691,4034,12725,347640,161360,509000
1/29/2025,Roshan Weerasinghe,Nuwara Eliya,Ginigathhena,Central,2758,6987,9745,110320,279480,389800
1/30/2025,Roshan Weerasinghe,Nuwara Eliya,Ginigathhena,Central,1833,8124,9957,73320,324960,398280
1/31/2025,Roshan Weerasinghe,Nuwara Eliya,Ginigathhena,Central,6732,1815,8547,269280,72600,341880
2/1/2025,Roshan Weerasinghe,Nuwara Eliya,Ginigathhena,Central,6114,6976,13090,244560,279040,523600
2/2/2025,Roshan Weerasinghe,Nuwara Eliya,Ginigathhena,Central,5342,46,5388,213680,1840,215520
2/3/2025,Roshan Weerasinghe,Nuwara Eliya,Ginigathhena,Central,9483,4499,13982,379320,179960,559280
2/4/2025,Roshan Weerasinghe,Nuwara Eliya,Ginigathhena,Central,7404,7853,15257,296160,314120,610280
2/5/2025,Roshan Weerasinghe,Nuwara Eliya,Ginigathhena,Central,5030,6253,11283,201200,250120,451320
2/6/2025,Roshan Weerasinghe,Nuwara Eliya,Ginigathhena,Central,1705,6331,8036,68200,253240,321440
2/7/2025,Roshan Weerasinghe,Nuwara Eliya,Ginigathhena,Central,7428,7636,15064,297120,305440,602560
2/8/2025,Roshan Weerasinghe,Nuwara Eliya,Ginigathhena,Central,5124,6169,11293,204960,246760,451720
2/9/2025,Roshan Weerasinghe,Nuwara Eliya,Ginigathhena,Central,6990,405,7395,279600,16200,295800
2/10/2025,Roshan Weerasinghe,Nuwara Eliya,Ginigathhena,Central,2882,5048,7930,115280,201920,317200
2/11/2025,Roshan Weerasinghe,Nuwara Eliya,Ginigathhena,Central,5508,7357,12865,220320,294280,514600
2/12/2025,Roshan Weerasinghe,Nuwara Eliya,Ginigathhena,Central,4718,9116,13834,188720,364640,553360
2/13/2025,Roshan Weerasinghe,Nuwara Eliya,Ginigathhena,Central,6885,1194,8079,275400,47760,323160
2/14/2025,Roshan Weerasinghe,Nuwara Eliya,Ginigathhena,Central,7447,8366,15813,297880,334640,632520
2/15/2025,Roshan Weerasinghe,Nuwara Eliya,Ginigathhena,Central,1826,6807,8633,73040,272280,345320
2/16/2025,Roshan Weerasinghe,Nuwara Eliya,Ginigathhena,Central,1894,3036,4930,75760,121440,197200
2/17/2025,Roshan Weerasinghe,Nuwara Eliya,Ginigathhena,Central,4043,8890,12933,161720,355600,517320
2/18/2025,Roshan Weerasinghe,Nuwara Eliya,Ginigathhena,Central,7312,7515,14827,292480,300600,593080
2/19/2025,Roshan Weerasinghe,Nuwara Eliya,Ginigathhena,Central,7378,8510,15888,295120,340400,635520
2/20/2025,Roshan Weerasinghe,Nuwara Eliya,Ginigathhena,Central,8390,7935,16325,335600,317400,653000
2/21/2025,Roshan Weerasinghe,Nuwara Eliya,Ginigathhena,Central,61,2409,2470,2440,96360,98800
2/22/2025,Roshan Weerasinghe,Nuwara Eliya,Ginigathhena,Central,7211,9097,16308,288440,363880,652320
2/23/2025,Roshan Weerasinghe,Nuwara Eliya,Ginigathhena,Central,2484,5979,8463,99360,239160,338520
2/24/2025,Roshan Weerasinghe,Nuwara Eliya,Ginigathhena,Central,446,5517,5963,17840,220680,238520
2/25/2025,Roshan Weerasinghe,Nuwara Eliya,Ginigathhena,Central,9138,4334,13472,365520,173360,538880
2/26/2025,Roshan Weerasinghe,Nuwara Eliya,Ginigathhena,Central,7265,3993,11258,290600,159720,450320
2/27/2025,Roshan Weerasinghe,Nuwara Eliya,Ginigathhena,Central,8267,4724,12991,330680,188960,519640
2/28/2025,Roshan Weerasinghe,Nuwara Eliya,Ginigathhena,Central,3140,1913,5053,125600,76520,202120
3/1/2025,Roshan Weerasinghe,Nuwara Eliya,Ginigathhena,Central,6176,4183,10359,247040,167320,414360
3/2/2025,Roshan Weerasinghe,Nuwara Eliya,Ginigathhena,Central,88,3877,3965,3520,155080,158600
3/3/2025,Roshan Weerasinghe,Nuwara Eliya,Ginigathhena,Central,9686,2407,12093,387440,96280,483720
3/4/2025,Roshan Weerasinghe,Nuwara Eliya,Ginigathhena,Central,7955,7239,15194,318200,289560,607760
3/5/2025,Roshan Weerasinghe,Nuwara Eliya,Ginigathhena,Central,31,3575,3606,1240,143000,144240
3/6/2025,Roshan Weerasinghe,Nuwara Eliya,Ginigathhena,Central,2908,3729,6637,116320,149160,265480
3/7/2025,Roshan Weerasinghe,Nuwara Eliya,Ginigathhena,Central,8562,6117,14679,342480,244680,587160
3/8/2025,Roshan Weerasinghe,Nuwara Eliya,Ginigathhena,Central,9161,5668,14829,366440,226720,593160
3/9/2025,Roshan Weerasinghe,Nuwara Eliya,Ginigathhena,Central,3434,3813,7247,137360,152520,289880
3/10/2025,Roshan Weerasinghe,Nuwara Eliya,Ginigathhena,Central,257,55,312,10280,2200,12480
3/11/2025,Roshan Weerasinghe,Nuwara Eliya,Ginigathhena,Central,9460,592,10052,378400,23680,402080
3/12/2025,Roshan Weerasinghe,Nuwara Eliya,Ginigathhena,Central,6300,8863,15163,252000,354520,606520
3/13/2025,Roshan Weerasinghe,Nuwara Eliya,Ginigathhena,Central,9228,502,9730,369120,20080,389200
3/14/2025,Roshan Weerasinghe,Nuwara Eliya,Ginigathhena,Central,265,6321,6586,10600,252840,263440
3/15/2025,Roshan Weerasinghe,Nuwara Eliya,Ginigathhena,Central,2071,7511,9582,82840,300440,383280
3/16/2025,Roshan Weerasinghe,Nuwara Eliya,Ginigathhena,Central,9469,3574,13043,378760,142960,521720
3/17/2025,Roshan Weerasinghe,Nuwara Eliya,Ginigathhena,Central,2186,8427,10613,87440,337080,424520
3/18/2025,Roshan Weerasinghe,Nuwara Eliya,Ginigathhena,Central,8171,8929,17100,326840,357160,684000
3/19/2025,Roshan Weerasinghe,Nuwara Eliya,Ginigathhena,Central,6745,4747,11492,269800,189880,459680
3/20/2025,Roshan Weerasinghe,Nuwara Eliya,Ginigathhena,Central,2624,5083,7707,104960,203320,308280
3/21/2025,Roshan Weerasinghe,Nuwara Eliya,Ginigathhena,Central,4842,5728,10570,193680,229120,422800
3/22/2025,Roshan Weerasinghe,Nuwara Eliya,Ginigathhena,Central,7734,8267,16001,309360,330680,640040
3/23/2025,Roshan Weerasinghe,Nuwara Eliya,Ginigathhena,Central,6425,3515,9940,257000,140600,397600
3/25/2024,Duminda Kalubowila,Polonnaruwa,Maho,North Central,4194,4374,8568,167760,174960,342720
3/26/2024,Duminda Kalubowila,Polonnaruwa,Maho,North Central,4529,543,5072,181160,21720,202880
3/27/2024,Duminda Kalubowila,Polonnaruwa,Maho,North Central,799,7633,8432,31960,305320,337280
3/28/2024,Duminda Kalubowila,Polonnaruwa,Maho,North Central,2523,6548,9071,100920,261920,362840
3/29/2024,Duminda Kalubowila,Polonnaruwa,Maho,North Central,5152,4166,9318,206080,166640,372720
3/30/2024,Duminda Kalubowila,Polonnaruwa,Maho,North Central,2053,3698,5751,82120,147920,230040
3/31/2024,Duminda Kalubowila,Polonnaruwa,Maho,North Central,6432,4859,11291,257280,194360,451640
4/1/2024,Duminda Kalubowila,Polonnaruwa,Maho,North Central,1579,2585,4164,63160,103400,166560
4/2/2024,Duminda Kalubowila,Polonnaruwa,Maho,North Central,6875,895,7770,275000,35800,310800
4/3/2024,Duminda Kalubowila,Polonnaruwa,Maho,North Central,5914,6914,12828,236560,276560,513120
4/4/2024,Duminda Kalubowila,Polonnaruwa,Maho,North Central,5285,2598,7883,211400,103920,315320
4/5/2024,Duminda Kalubowila,Polonnaruwa,Maho,North Central,7224,9896,17120,288960,395840,684800
4/6/2024,Duminda Kalubowila,Polonnaruwa,Maho,North Central,6428,7351,13779,257120,294040,551160
4/7/2024,Duminda Kalubowila,Polonnaruwa,Maho,North Central,385,1835,2220,15400,73400,88800
4/8/2024,Duminda Kalubowila,Polonnaruwa,Maho,North Central,3244,7041,10285,129760,281640,411400
4/9/2024,Duminda Kalubowila,Polonnaruwa,Maho,North Central,6724,4140,10864,268960,165600,434560
4/10/2024,Duminda Kalubowila,Polonnaruwa,Maho,North Central,2813,5388,8201,112520,215520,328040
4/11/2024,Duminda Kalubowila,Polonnaruwa,Maho,North Central,8572,3068,11640,342880,122720,465600
4/19/2024,Duminda Kalubowila,Polonnaruwa,Maho,North Central,9323,225,9548,372920,9000,381920
4/20/2024,Duminda Kalubowila,Polonnaruwa,Maho,North Central,1430,6986,8416,57200,279440,336640
4/21/2024,Duminda Kalubowila,Polonnaruwa,Maho,North Central,2083,7793,9876,83320,311720,395040
4/22/2024,Duminda Kalubowila,Polonnaruwa,Maho,North Central,2726,1996,4722,109040,79840,188880
4/23/2024,Duminda Kalubowila,Polonnaruwa,Maho,North Central,369,317,686,14760,12680,27440
4/24/2024,Duminda Kalubowila,Polonnaruwa,Maho,North Central,4720,5010,9730,188800,200400,389200
4/25/2024,Duminda Kalubowila,Polonnaruwa,Maho,North Central,6777,6947,13724,271080,277880,548960
4/26/2024,Duminda Kalubowila,Polonnaruwa,Maho,North Central,4541,1538,6079,181640,61520,243160
4/27/2024,Duminda Kalubowila,Polonnaruwa,Maho,North Central,3517,4613,8130,140680,184520,325200
4/28/2024,Duminda Kalubowila,Polonnaruwa,Maho,North Central,6952,1828,8780,278080,73120,351200
4/29/2024,Duminda Kalubowila,Polonnaruwa,Maho,North Central,6696,4803,11499,267840,192120,459960
4/30/2024,Duminda Kalubowila,Polonnaruwa,Maho,North Central,8892,7565,16457,355680,302600,658280
5/1/2024,Duminda Kalubowila,Polonnaruwa,Maho,North Central,2125,1663,3788,85000,66520,151520
5/2/2024,Duminda Kalubowila,Polonnaruwa,Maho,North Central,8240,421,8661,329600,16840,346440
5/3/2024,Duminda Kalubowila,Polonnaruwa,Maho,North Central,4024,7329,11353,160960,293160,454120
5/4/2024,Duminda Kalubowila,Polonnaruwa,Maho,North Central,5009,4218,9227,200360,168720,369080
5/5/2024,Duminda Kalubowila,Polonnaruwa,Maho,North Central,8826,4271,13097,353040,170840,523880
5/6/2024,Duminda Kalubowila,Polonnaruwa,Maho,North Central,9437,14,9451,377480,560,378040
5/7/2024,Duminda Kalubowila,Polonnaruwa,Maho,North Central,2538,7302,9840,101520,292080,393600
5/8/2024,Duminda Kalubowila,Polonnaruwa,Maho,North Central,1865,2214,4079,74600,88560,163160
5/9/2024,Duminda Kalubowila,Polonnaruwa,Maho,North Central,4411,8854,13265,176440,354160,530600
5/10/2024,Duminda Kalubowila,Polonnaruwa,Maho,North Central,5848,9724,15572,233920,388960,622880
5/11/2024,Duminda Kalubowila,Polonnaruwa,Maho,North Central,1763,7798,9561,70520,311920,382440
5/12/2024,Duminda Kalubowila,Polonnaruwa,Maho,North Central,2990,807,3797,119600,32280,151880
5/13/2024,Duminda Kalubowila,Polonnaruwa,Maho,North Central,3981,392,4373,159240,15680,174920
5/14/2024,Duminda Kalubowila,Polonnaruwa,Maho,North Central,8440,7050,15490,337600,282000,619600
5/15/2024,Duminda Kalubowila,Polonnaruwa,Maho,North Central,1315,8480,9795,52600,339200,391800
5/16/2024,Duminda Kalubowila,Polonnaruwa,Maho,North Central,8551,8026,16577,342040,321040,663080
5/17/2024,Duminda Kalubowila,Polonnaruwa,Maho,North Central,7739,5447,13186,309560,217880,527440
5/18/2024,Duminda Kalubowila,Polonnaruwa,Maho,North Central,4060,1946,6006,162400,77840,240240
5/19/2024,Duminda Kalubowila,Polonnaruwa,Maho,North Central,9231,445,9676,369240,17800,387040
5/20/2024,Duminda Kalubowila,Polonnaruwa,Maho,North Central,7086,6659,13745,283440,266360,549800
5/21/2024,Duminda Kalubowila,Polonnaruwa,Maho,North Central,7174,1510,8684,286960,60400,347360
5/22/2024,Duminda Kalubowila,Polonnaruwa,Maho,North Central,8608,5100,13708,344320,204000,548320
5/24/2024,Duminda Kalubowila,Polonnaruwa,Maho,North Central,9419,7064,16483,376760,282560,659320
5/25/2024,Duminda Kalubowila,Polonnaruwa,Maho,North Central,2918,8776,11694,116720,351040,467760
5/26/2024,Duminda Kalubowila,Polonnaruwa,Maho,North Central,2791,7610,10401,111640,304400,416040
5/27/2024,Duminda Kalubowila,Polonnaruwa,Maho,North Central,8595,1628,10223,343800,65120,408920
5/28/2024,Duminda Kalubowila,Polonnaruwa,Maho,North Central,8513,5428,13941,340520,217120,557640
5/29/2024,Duminda Kalubowila,Polonnaruwa,Maho,North Central,3947,6819,10766,157880,272760,430640
5/30/2024,Duminda Kalubowila,Polonnaruwa,Maho,North Central,4370,1435,5805,174800,57400,232200
5/31/2024,Duminda Kalubowila,Polonnaruwa,Maho,North Central,3904,6527,10431,156160,261080,417240
6/1/2024,Duminda Kalubowila,Polonnaruwa,Maho,North Central,986,8001,8987,39440,320040,359480
6/2/2024,Duminda Kalubowila,Polonnaruwa,Maho,North Central,7370,9901,17271,294800,396040,690840
6/3/2024,Duminda Kalubowila,Polonnaruwa,Maho,North Central,7757,6590,14347,310280,263600,573880
6/4/2024,Duminda Kalubowila,Polonnaruwa,Maho,North Central,1741,1737,3478,69640,69480,139120
6/5/2024,Duminda Kalubowila,Polonnaruwa,Maho,North Central,9552,6303,15855,382080,252120,634200
6/6/2024,Duminda Kalubowila,Polonnaruwa,Maho,North Central,9536,9879,19415,381440,395160,776600
6/7/2024,Duminda Kalubowila,Polonnaruwa,Maho,North Central,1552,186,1738,62080,7440,69520
6/8/2024,Duminda Kalubowila,Polonnaruwa,Maho,North Central,1435,6062,7497,57400,242480,299880
6/9/2024,Duminda Kalubowila,Polonnaruwa,Maho,North Central,4294,4500,8794,171760,180000,351760
6/10/2024,Duminda Kalubowila,Polonnaruwa,Maho,North Central,872,3992,4864,34880,159680,194560
6/11/2024,Duminda Kalubowila,Polonnaruwa,Maho,North Central,9286,173,9459,371440,6920,378360
6/12/2024,Duminda Kalubowila,Polonnaruwa,Maho,North Central,2209,464,2673,88360,18560,106920
6/13/2024,Duminda Kalubowila,Polonnaruwa,Maho,North Central,4264,3719,7983,170560,148760,319320
6/14/2024,Duminda Kalubowila,Polonnaruwa,Maho,North Central,4339,2280,6619,173560,91200,264760
6/15/2024,Duminda Kalubowila,Polonnaruwa,Maho,North Central,9935,4110,14045,397400,164400,561800
6/16/2024,Duminda Kalubowila,Polonnaruwa,Maho,North Central,1383,2231,3614,55320,89240,144560
6/17/2024,Duminda Kalubowila,Polonnaruwa,Maho,North Central,5472,6087,11559,218880,243480,462360
6/18/2024,Duminda Kalubowila,Polonnaruwa,Maho,North Central,7857,1374,9231,314280,54960,369240
6/19/2024,Duminda Kalubowila,Polonnaruwa,Maho,North Central,7052,8,7060,282080,320,282400
6/20/2024,Duminda Kalubowila,Polonnaruwa,Maho,North Central,1069,35,1104,42760,1400,44160
6/21/2024,Duminda Kalubowila,Polonnaruwa,Maho,North Central,3885,5483,9368,155400,219320,374720
6/22/2024,Duminda Kalubowila,Polonnaruwa,Maho,North Central,346,2333,2679,13840,93320,107160
6/23/2024,Duminda Kalubowila,Polonnaruwa,Maho,North Central,1651,6242,7893,66040,249680,315720
6/24/2024,Duminda Kalubowila,Polonnaruwa,Maho,North Central,8928,5455,14383,357120,218200,575320
6/25/2024,Duminda Kalubowila,Polonnaruwa,Maho,North Central,4544,5614,10158,181760,224560,406320
6/26/2024,Duminda Kalubowila,Polonnaruwa,Maho,North Central,9236,8017,17253,369440,320680,690120
6/27/2024,Duminda Kalubowila,Polonnaruwa,Maho,North Central,6889,1219,8108,275560,48760,324320
6/28/2024,Duminda Kalubowila,Polonnaruwa,Maho,North Central,9792,8006,17798,391680,320240,711920
6/29/2024,Duminda Kalubowila,Polonnaruwa,Maho,North Central,9191,8910,18101,367640,356400,724040
6/30/2024,Duminda Kalubowila,Polonnaruwa,Maho,North Central,6245,8394,14639,249800,335760,585560
7/1/2024,Duminda Kalubowila,Polonnaruwa,Maho,North Central,3832,6342,10174,153280,253680,406960
7/2/2024,Duminda Kalubowila,Polonnaruwa,Maho,North Central,7200,6896,14096,288000,275840,563840
7/3/2024,Duminda Kalubowila,Polonnaruwa,Maho,North Central,7092,7975,15067,283680,319000,602680
7/4/2024,Duminda Kalubowila,Polonnaruwa,Maho,North Central,3884,9620,13504,155360,384800,540160
7/5/2024,Duminda Kalubowila,Polonnaruwa,Maho,North Central,5422,7147,12569,216880,285880,502760
7/6/2024,Duminda Kalubowila,Polonnaruwa,Maho,North Central,4215,1341,5556,168600,53640,222240
7/7/2024,Duminda Kalubowila,Polonnaruwa,Maho,North Central,1566,7623,9189,62640,304920,367560
7/8/2024,Duminda Kalubowila,Polonnaruwa,Maho,North Central,9373,2016,11389,374920,80640,455560
7/9/2024,Duminda Kalubowila,Polonnaruwa,Maho,North Central,3408,4881,8289,136320,195240,331560
7/10/2024,Duminda Kalubowila,Polonnaruwa,Maho,North Central,4449,8460,12909,177960,338400,516360
7/11/2024,Duminda Kalubowila,Polonnaruwa,Maho,North Central,8331,9920,18251,333240,396800,730040
7/12/2024,Duminda Kalubowila,Polonnaruwa,Maho,North Central,2098,7899,9997,83920,315960,399880
7/13/2024,Duminda Kalubowila,Polonnaruwa,Maho,North Central,8738,4150,12888,349520,166000,515520
7/14/2024,Duminda Kalubowila,Polonnaruwa,Maho,North Central,8196,3537,11733,327840,141480,469320
7/15/2024,Duminda Kalubowila,Polonnaruwa,Maho,North Central,2055,2903,4958,82200,116120,198320
7/16/2024,Duminda Kalubowila,Polonnaruwa,Maho,North Central,2400,4910,7310,96000,196400,292400
7/17/2024,Duminda Kalubowila,Polonnaruwa,Maho,North Central,2851,4772,7623,114040,190880,304920
7/18/2024,Duminda Kalubowila,Polonnaruwa,Maho,North Central,6217,8326,14543,248680,333040,581720
7/19/2024,Duminda Kalubowila,Polonnaruwa,Maho,North Central,7774,4631,12405,310960,185240,496200
7/20/2024,Duminda Kalubowila,Polonnaruwa,Maho,North Central,8688,2697,11385,347520,107880,455400
7/21/2024,Duminda Kalubowila,Polonnaruwa,Maho,North Central,5538,9212,14750,221520,368480,590000
7/22/2024,Duminda Kalubowila,Polonnaruwa,Maho,North Central,6736,7496,14232,269440,299840,569280
7/23/2024,Duminda Kalubowila,Polonnaruwa,Maho,North Central,4497,289,4786,179880,11560,191440
7/24/2024,Duminda Kalubowila,Polonnaruwa,Maho,North Central,2110,1027,3137,84400,41080,125480
7/25/2024,Duminda Kalubowila,Polonnaruwa,Maho,North Central,6731,7435,14166,269240,297400,566640
7/26/2024,Duminda Kalubowila,Polonnaruwa,Maho,North Central,1136,2060,3196,45440,82400,127840
7/27/2024,Duminda Kalubowila,Polonnaruwa,Maho,North Central,1111,9533,10644,44440,381320,425760
7/28/2024,Duminda Kalubowila,Polonnaruwa,Maho,North Central,1666,1019,2685,66640,40760,107400
7/29/2024,Duminda Kalubowila,Polonnaruwa,Maho,North Central,9994,2967,12961,399760,118680,518440
7/30/2024,Duminda Kalubowila,Polonnaruwa,Maho,North Central,4825,3131,7956,193000,125240,318240
7/31/2024,Duminda Kalubowila,Polonnaruwa,Maho,North Central,9745,14,9759,389800,560,390360
8/1/2024,Duminda Kalubowila,Polonnaruwa,Maho,North Central,561,8068,8629,22440,322720,345160
8/2/2024,Duminda Kalubowila,Polonnaruwa,Maho,North Central,6355,5209,11564,254200,208360,462560
8/3/2024,Duminda Kalubowila,Polonnaruwa,Maho,North Central,9763,8266,18029,390520,330640,721160
8/4/2024,Duminda Kalubowila,Polonnaruwa,Maho,North Central,8446,8923,17369,337840,356920,694760
8/5/2024,Duminda Kalubowila,Polonnaruwa,Maho,North Central,7225,5063,12288,289000,202520,491520
8/6/2024,Duminda Kalubowila,Polonnaruwa,Maho,North Central,2216,5562,7778,88640,222480,311120
8/7/2024,Duminda Kalubowila,Polonnaruwa,Maho,North Central,5142,5599,10741,205680,223960,429640
8/8/2024,Duminda Kalubowila,Polonnaruwa,Maho,North Central,2556,6544,9100,102240,261760,364000
8/9/2024,Duminda Kalubowila,Polonnaruwa,Maho,North Central,9769,4009,13778,390760,160360,551120
8/10/2024,Duminda Kalubowila,Polonnaruwa,Maho,North Central,1527,4070,5597,61080,162800,223880
8/11/2024,Duminda Kalubowila,Polonnaruwa,Maho,North Central,5413,7111,12524,216520,284440,500960
8/12/2024,Duminda Kalubowila,Polonnaruwa,Maho,North Central,6415,1646,8061,256600,65840,322440
8/13/2024,Duminda Kalubowila,Polonnaruwa,Maho,North Central,6398,1436,7834,255920,57440,313360
8/14/2024,Duminda Kalubowila,Polonnaruwa,Maho,North Central,5386,3445,8831,215440,137800,353240
8/15/2024,Duminda Kalubowila,Polonnaruwa,Maho,North Central,4622,4278,8900,184880,171120,356000
8/16/2024,Duminda Kalubowila,Polonnaruwa,Maho,North Central,3383,3050,6433,135320,122000,257320
8/17/2024,Duminda Kalubowila,Polonnaruwa,Maho,North Central,4452,7040,11492,178080,281600,459680
8/18/2024,Duminda Kalubowila,Polonnaruwa,Maho,North Central,6454,9089,15543,258160,363560,621720
8/19/2024,Duminda Kalubowila,Polonnaruwa,Maho,North Central,9553,8146,17699,382120,325840,707960
8/20/2024,Duminda Kalubowila,Polonnaruwa,Maho,North Central,5309,346,5655,212360,13840,226200
8/21/2024,Duminda Kalubowila,Polonnaruwa,Maho,North Central,5002,4635,9637,200080,185400,385480
8/22/2024,Duminda Kalubowila,Polonnaruwa,Maho,North Central,7626,3799,11425,305040,151960,457000
8/23/2024,Duminda Kalubowila,Polonnaruwa,Maho,North Central,6289,5833,12122,251560,233320,484880
8/24/2024,Duminda Kalubowila,Polonnaruwa,Maho,North Central,8844,9862,18706,353760,394480,748240
8/25/2024,Duminda Kalubowila,Polonnaruwa,Maho,North Central,3630,2259,5889,145200,90360,235560
8/26/2024,Duminda Kalubowila,Polonnaruwa,Maho,North Central,7549,6667,14216,301960,266680,568640
8/27/2024,Duminda Kalubowila,Polonnaruwa,Maho,North Central,5858,1804,7662,234320,72160,306480
8/28/2024,Duminda Kalubowila,Polonnaruwa,Maho,North Central,8614,74,8688,344560,2960,347520
8/29/2024,Duminda Kalubowila,Polonnaruwa,Maho,North Central,8906,9068,17974,356240,362720,718960
8/30/2024,Duminda Kalubowila,Polonnaruwa,Maho,North Central,9659,9573,19232,386360,382920,769280
8/31/2024,Duminda Kalubowila,Polonnaruwa,Maho,North Central,5943,1630,7573,237720,65200,302920
9/1/2024,Duminda Kalubowila,Polonnaruwa,Maho,North Central,9637,354,9991,385480,14160,399640
9/2/2024,Duminda Kalubowila,Polonnaruwa,Maho,North Central,2770,7102,9872,110800,284080,394880
9/3/2024,Duminda Kalubowila,Polonnaruwa,Maho,North Central,7842,2142,9984,313680,85680,399360
9/4/2024,Duminda Kalubowila,Polonnaruwa,Maho,North Central,3871,7729,11600,154840,309160,464000
9/5/2024,Duminda Kalubowila,Polonnaruwa,Maho,North Central,234,3569,3803,9360,142760,152120
9/6/2024,Duminda Kalubowila,Polonnaruwa,Maho,North Central,3614,5016,8630,144560,200640,345200
9/7/2024,Duminda Kalubowila,Polonnaruwa,Maho,North Central,9595,6800,16395,383800,272000,655800
9/8/2024,Duminda Kalubowila,Polonnaruwa,Maho,North Central,1906,7928,9834,76240,317120,393360
9/9/2024,Duminda Kalubowila,Polonnaruwa,Maho,North Central,8533,775,9308,341320,31000,372320
9/10/2024,Duminda Kalubowila,Polonnaruwa,Maho,North Central,4424,9684,14108,176960,387360,564320
9/11/2024,Duminda Kalubowila,Polonnaruwa,Maho,North Central,3883,3845,7728,155320,153800,309120
9/12/2024,Duminda Kalubowila,Polonnaruwa,Maho,North Central,2063,556,2619,82520,22240,104760
9/13/2024,Duminda Kalubowila,Polonnaruwa,Maho,North Central,7476,6896,14372,299040,275840,574880
9/14/2024,Duminda Kalubowila,Polonnaruwa,Maho,North Central,6881,4650,11531,275240,186000,461240
9/15/2024,Duminda Kalubowila,Polonnaruwa,Maho,North Central,7531,4238,11769,301240,169520,470760
9/16/2024,Duminda Kalubowila,Polonnaruwa,Maho,North Central,3028,1260,4288,121120,50400,171520
9/17/2024,Duminda Kalubowila,Polonnaruwa,Maho,North Central,9337,2043,11380,373480,81720,455200
9/18/2024,Duminda Kalubowila,Polonnaruwa,Maho,North Central,9410,6732,16142,376400,269280,645680
9/19/2024,Duminda Kalubowila,Polonnaruwa,Maho,North Central,2802,9471,12273,112080,378840,490920
9/20/2024,Duminda Kalubowila,Polonnaruwa,Maho,North Central,6296,8680,14976,251840,347200,599040
9/21/2024,Duminda Kalubowila,Polonnaruwa,Maho,North Central,5119,5383,10502,204760,215320,420080
9/22/2024,Duminda Kalubowila,Polonnaruwa,Maho,North Central,3657,6385,10042,146280,255400,401680
9/23/2024,Duminda Kalubowila,Polonnaruwa,Maho,North Central,8294,1915,10209,331760,76600,408360
9/24/2024,Duminda Kalubowila,Polonnaruwa,Maho,North Central,8868,5059,13927,354720,202360,557080
9/25/2024,Duminda Kalubowila,Polonnaruwa,Maho,North Central,3327,4421,7748,133080,176840,309920
9/26/2024,Duminda Kalubowila,Polonnaruwa,Maho,North Central,5852,7469,13321,234080,298760,532840
9/27/2024,Duminda Kalubowila,Polonnaruwa,Maho,North Central,5086,6782,11868,203440,271280,474720
9/28/2024,Duminda Kalubowila,Polonnaruwa,Maho,North Central,280,655,935,11200,26200,37400
9/29/2024,Duminda Kalubowila,Polonnaruwa,Maho,North Central,1455,9754,11209,58200,390160,448360
9/30/2024,Duminda Kalubowila,Polonnaruwa,Maho,North Central,5947,6716,12663,237880,268640,506520
10/1/2024,Duminda Kalubowila,Polonnaruwa,Maho,North Central,4626,5807,10433,185040,232280,417320
10/2/2024,Duminda Kalubowila,Polonnaruwa,Maho,North Central,3185,8037,11222,127400,321480,448880
10/3/2024,Duminda Kalubowila,Polonnaruwa,Maho,North Central,3464,330,3794,138560,13200,151760
10/4/2024,Duminda Kalubowila,Polonnaruwa,Maho,North Central,7105,5283,12388,284200,211320,495520
10/5/2024,Duminda Kalubowila,Polonnaruwa,Maho,North Central,6312,9336,15648,252480,373440,625920
10/6/2024,Duminda Kalubowila,Polonnaruwa,Maho,North Central,7622,8470,16092,304880,338800,643680
10/7/2024,Duminda Kalubowila,Polonnaruwa,Maho,North Central,7870,4400,12270,314800,176000,490800
10/8/2024,Duminda Kalubowila,Polonnaruwa,Maho,North Central,8463,1245,9708,338520,49800,388320
10/9/2024,Duminda Kalubowila,Polonnaruwa,Maho,North Central,8662,4756,13418,346480,190240,536720
10/10/2024,Duminda Kalubowila,Polonnaruwa,Maho,North Central,3409,195,3604,136360,7800,144160
10/11/2024,Duminda Kalubowila,Polonnaruwa,Maho,North Central,8169,8709,16878,326760,348360,675120
10/12/2024,Duminda Kalubowila,Polonnaruwa,Maho,North Central,8257,6852,15109,330280,274080,604360
10/13/2024,Duminda Kalubowila,Polonnaruwa,Maho,North Central,7061,2732,9793,282440,109280,391720
10/14/2024,Duminda Kalubowila,Polonnaruwa,Maho,North Central,585,6240,6825,23400,249600,273000
10/15/2024,Duminda Kalubowila,Polonnaruwa,Maho,North Central,4086,7491,11577,163440,299640,463080
10/16/2024,Duminda Kalubowila,Polonnaruwa,Maho,North Central,1716,8432,10148,68640,337280,405920
10/17/2024,Duminda Kalubowila,Polonnaruwa,Maho,North Central,7063,3919,10982,282520,156760,439280
10/18/2024,Duminda Kalubowila,Polonnaruwa,Maho,North Central,6798,5808,12606,271920,232320,504240
10/19/2024,Duminda Kalubowila,Polonnaruwa,Maho,North Central,5672,6008,11680,226880,240320,467200
10/20/2024,Duminda Kalubowila,Polonnaruwa,Maho,North Central,3346,6265,9611,133840,250600,384440
10/21/2024,Duminda Kalubowila,Polonnaruwa,Maho,North Central,5903,1417,7320,236120,56680,292800
10/22/2024,Duminda Kalubowila,Polonnaruwa,Maho,North Central,5749,4611,10360,229960,184440,414400
10/23/2024,Duminda Kalubowila,Polonnaruwa,Maho,North Central,9316,6163,15479,372640,246520,619160
10/24/2024,Duminda Kalubowila,Polonnaruwa,Maho,North Central,7790,1713,9503,311600,68520,380120
10/25/2024,Duminda Kalubowila,Polonnaruwa,Maho,North Central,8901,8207,17108,356040,328280,684320
10/26/2024,Duminda Kalubowila,Polonnaruwa,Maho,North Central,7182,1047,8229,287280,41880,329160
10/27/2024,Duminda Kalubowila,Polonnaruwa,Maho,North Central,2930,9662,12592,117200,386480,503680
10/28/2024,Duminda Kalubowila,Polonnaruwa,Maho,North Central,7234,7750,14984,289360,310000,599360
10/29/2024,Duminda Kalubowila,Polonnaruwa,Maho,North Central,7411,7231,14642,296440,289240,585680
10/30/2024,Duminda Kalubowila,Polonnaruwa,Maho,North Central,5048,6352,11400,201920,254080,456000
10/31/2024,Duminda Kalubowila,Polonnaruwa,Maho,North Central,2375,2021,4396,95000,80840,175840
11/1/2024,Duminda Kalubowila,Polonnaruwa,Maho,North Central,7792,5435,13227,311680,217400,529080
11/2/2024,Duminda Kalubowila,Polonnaruwa,Maho,North Central,8869,4611,13480,354760,184440,539200
11/3/2024,Duminda Kalubowila,Polonnaruwa,Maho,North Central,8679,1022,9701,347160,40880,388040
11/4/2024,Duminda Kalubowila,Polonnaruwa,Maho,North Central,2677,8621,11298,107080,344840,451920
11/5/2024,Duminda Kalubowila,Polonnaruwa,Maho,North Central,2775,1873,4648,111000,74920,185920
11/6/2024,Duminda Kalubowila,Polonnaruwa,Maho,North Central,4379,615,4994,175160,24600,199760
11/7/2024,Duminda Kalubowila,Polonnaruwa,Maho,North Central,1003,3433,4436,40120,137320,177440
11/8/2024,Duminda Kalubowila,Polonnaruwa,Maho,North Central,4486,5168,9654,179440,206720,386160
11/9/2024,Duminda Kalubowila,Polonnaruwa,Maho,North Central,4986,3778,8764,199440,151120,350560
11/10/2024,Duminda Kalubowila,Polonnaruwa,Maho,North Central,9788,5428,15216,391520,217120,608640
11/11/2024,Duminda Kalubowila,Polonnaruwa,Maho,North Central,8559,106,8665,342360,4240,346600
11/12/2024,Duminda Kalubowila,Polonnaruwa,Maho,North Central,6553,625,7178,262120,25000,287120
11/13/2024,Duminda Kalubowila,Polonnaruwa,Maho,North Central,9840,6829,16669,393600,273160,666760
11/14/2024,Duminda Kalubowila,Polonnaruwa,Maho,North Central,5857,6875,12732,234280,275000,509280
11/15/2024,Duminda Kalubowila,Polonnaruwa,Maho,North Central,1275,5638,6913,51000,225520,276520
11/16/2024,Duminda Kalubowila,Polonnaruwa,Maho,North Central,2561,1042,3603,102440,41680,144120
11/17/2024,Duminda Kalubowila,Polonnaruwa,Maho,North Central,992,4995,5987,39680,199800,239480
11/18/2024,Duminda Kalubowila,Polonnaruwa,Maho,North Central,4257,4320,8577,170280,172800,343080
11/19/2024,Duminda Kalubowila,Polonnaruwa,Maho,North Central,6206,3683,9889,248240,147320,395560
11/20/2024,Duminda Kalubowila,Polonnaruwa,Maho,North Central,2687,3462,6149,107480,138480,245960
11/21/2024,Duminda Kalubowila,Polonnaruwa,Maho,North Central,502,2452,2954,20080,98080,118160
11/22/2024,Duminda Kalubowila,Polonnaruwa,Maho,North Central,2954,811,3765,118160,32440,150600
11/23/2024,Duminda Kalubowila,Polonnaruwa,Maho,North Central,471,1778,2249,18840,71120,89960
11/24/2024,Duminda Kalubowila,Polonnaruwa,Maho,North Central,6125,1125,7250,245000,45000,290000
11/25/2024,Duminda Kalubowila,Polonnaruwa,Maho,North Central,442,1818,2260,17680,72720,90400
11/26/2024,Duminda Kalubowila,Polonnaruwa,Maho,North Central,2976,6636,9612,119040,265440,384480
11/27/2024,Duminda Kalubowila,Polonnaruwa,Maho,North Central,2402,7329,9731,96080,293160,389240
11/28/2024,Duminda Kalubowila,Polonnaruwa,Maho,North Central,9393,188,9581,375720,7520,383240
11/29/2024,Duminda Kalubowila,Polonnaruwa,Maho,North Central,8700,7002,15702,348000,280080,628080
11/30/2024,Duminda Kalubowila,Polonnaruwa,Maho,North Central,3277,1250,4527,131080,50000,181080
12/1/2024,Duminda Kalubowila,Polonnaruwa,Maho,North Central,7073,5673,12746,282920,226920,509840
12/2/2024,Duminda Kalubowila,Polonnaruwa,Maho,North Central,6659,4213,10872,266360,168520,434880
12/3/2024,Duminda Kalubowila,Polonnaruwa,Maho,North Central,2589,6582,9171,103560,263280,366840
12/4/2024,Duminda Kalubowila,Polonnaruwa,Maho,North Central,6180,300,6480,247200,12000,259200
12/5/2024,Duminda Kalubowila,Polonnaruwa,Maho,North Central,4871,8122,12993,194840,324880,519720
12/6/2024,Duminda Kalubowila,Polonnaruwa,Maho,North Central,1398,1969,3367,55920,78760,134680
12/7/2024,Duminda Kalubowila,Polonnaruwa,Maho,North Central,4998,5329,10327,199920,213160,413080
12/8/2024,Duminda Kalubowila,Polonnaruwa,Maho,North Central,1411,9167,10578,56440,366680,423120
12/9/2024,Duminda Kalubowila,Polonnaruwa,Maho,North Central,1423,3441,4864,56920,137640,194560
12/10/2024,Duminda Kalubowila,Polonnaruwa,Maho,North Central,5133,2969,8102,205320,118760,324080
12/11/2024,Duminda Kalubowila,Polonnaruwa,Maho,North Central,4313,6443,10756,172520,257720,430240
12/12/2024,Duminda Kalubowila,Polonnaruwa,Maho,North Central,2723,5749,8472,108920,229960,338880
12/13/2024,Duminda Kalubowila,Polonnaruwa,Maho,North Central,5349,4383,9732,213960,175320,389280
12/14/2024,Duminda Kalubowila,Polonnaruwa,Maho,North Central,8584,362,8946,343360,14480,357840
12/15/2024,Duminda Kalubowila,Polonnaruwa,Maho,North Central,8276,7337,15613,331040,293480,624520
12/16/2024,Duminda Kalubowila,Polonnaruwa,Maho,North Central,5138,2742,7880,205520,109680,315200
12/17/2024,Duminda Kalubowila,Polonnaruwa,Maho,North Central,9716,1050,10766,388640,42000,430640
12/18/2024,Duminda Kalubowila,Polonnaruwa,Maho,North Central,1216,2259,3475,48640,90360,139000
12/19/2024,Duminda Kalubowila,Polonnaruwa,Maho,North Central,8516,6885,15401,340640,275400,616040
12/20/2024,Duminda Kalubowila,Polonnaruwa,Maho,North Central,5890,5545,11435,235600,221800,457400
12/21/2024,Duminda Kalubowila,Polonnaruwa,Maho,North Central,1991,6695,8686,79640,267800,347440
12/22/2024,Duminda Kalubowila,Polonnaruwa,Maho,North Central,7979,9157,17136,319160,366280,685440
12/23/2024,Duminda Kalubowila,Polonnaruwa,Maho,North Central,8527,3218,11745,341080,128720,469800
12/24/2024,Duminda Kalubowila,Polonnaruwa,Maho,North Central,1818,2765,4583,72720,110600,183320
12/25/2024,Duminda Kalubowila,Polonnaruwa,Maho,North Central,5153,5147,10300,206120,205880,412000
12/26/2024,Duminda Kalubowila,Polonnaruwa,Maho,North Central,9109,6914,16023,364360,276560,640920
12/27/2024,Duminda Kalubowila,Polonnaruwa,Maho,North Central,505,5586,6091,20200,223440,243640
12/28/2024,Duminda Kalubowila,Polonnaruwa,Maho,North Central,6412,5945,12357,256480,237800,494280
12/29/2024,Duminda Kalubowila,Polonnaruwa,Maho,North Central,7682,9346,17028,307280,373840,681120
12/30/2024,Duminda Kalubowila,Polonnaruwa,Maho,North Central,9811,2677,12488,392440,107080,499520
12/31/2024,Duminda Kalubowila,Polonnaruwa,Maho,North Central,4755,3614,8369,190200,144560,334760
1/1/2025,Duminda Kalubowila,Polonnaruwa,Maho,North Central,3017,627,3644,120680,25080,145760
1/2/2025,Duminda Kalubowila,Polonnaruwa,Maho,North Central,2630,329,2959,105200,13160,118360
1/3/2025,Duminda Kalubowila,Polonnaruwa,Maho,North Central,6475,9050,15525,259000,362000,621000
1/4/2025,Duminda Kalubowila,Polonnaruwa,Maho,North Central,7176,1422,8598,287040,56880,343920
1/5/2025,Duminda Kalubowila,Polonnaruwa,Maho,North Central,9645,9197,18842,385800,367880,753680
1/6/2025,Duminda Kalubowila,Polonnaruwa,Maho,North Central,4629,4127,8756,185160,165080,350240
1/7/2025,Duminda Kalubowila,Polonnaruwa,Maho,North Central,9228,3298,12526,369120,131920,501040
1/8/2025,Duminda Kalubowila,Polonnaruwa,Maho,North Central,3539,6605,10144,141560,264200,405760
1/9/2025,Duminda Kalubowila,Polonnaruwa,Maho,North Central,9027,2254,11281,361080,90160,451240
1/10/2025,Duminda Kalubowila,Polonnaruwa,Maho,North Central,7173,7354,14527,286920,294160,581080
1/11/2025,Duminda Kalubowila,Polonnaruwa,Maho,North Central,4229,1555,5784,169160,62200,231360
1/12/2025,Duminda Kalubowila,Polonnaruwa,Maho,North Central,4670,1531,6201,186800,61240,248040
1/13/2025,Duminda Kalubowila,Polonnaruwa,Maho,North Central,2504,8858,11362,100160,354320,454480
1/14/2025,Duminda Kalubowila,Polonnaruwa,Maho,North Central,1612,1200,2812,64480,48000,112480
1/15/2025,Duminda Kalubowila,Polonnaruwa,Maho,North Central,5412,2255,7667,216480,90200,306680
1/16/2025,Duminda Kalubowila,Polonnaruwa,Maho,North Central,7937,6396,14333,317480,255840,573320
1/17/2025,Duminda Kalubowila,Polonnaruwa,Maho,North Central,8388,5993,14381,335520,239720,575240
1/18/2025,Duminda Kalubowila,Polonnaruwa,Maho,North Central,3796,2893,6689,151840,115720,267560
1/19/2025,Duminda Kalubowila,Polonnaruwa,Maho,North Central,2102,4067,6169,84080,162680,246760
1/20/2025,Duminda Kalubowila,Polonnaruwa,Maho,North Central,7923,6661,14584,316920,266440,583360
1/21/2025,Duminda Kalubowila,Polonnaruwa,Maho,North Central,9211,9785,18996,368440,391400,759840
1/22/2025,Duminda Kalubowila,Polonnaruwa,Maho,North Central,7221,2524,9745,288840,100960,389800
1/23/2025,Duminda Kalubowila,Polonnaruwa,Maho,North Central,5804,7914,13718,232160,316560,548720
1/24/2025,Duminda Kalubowila,Polonnaruwa,Maho,North Central,6070,3795,9865,242800,151800,394600
1/25/2025,Duminda Kalubowila,Polonnaruwa,Maho,North Central,9637,2070,11707,385480,82800,468280
1/26/2025,Duminda Kalubowila,Polonnaruwa,Maho,North Central,4215,5990,10205,168600,239600,408200
1/27/2025,Duminda Kalubowila,Polonnaruwa,Maho,North Central,8698,3410,12108,347920,136400,484320
1/28/2025,Duminda Kalubowila,Polonnaruwa,Maho,North Central,5022,2066,7088,200880,82640,283520
1/29/2025,Duminda Kalubowila,Polonnaruwa,Maho,North Central,1199,1702,2901,47960,68080,116040
1/30/2025,Duminda Kalubowila,Polonnaruwa,Maho,North Central,881,1522,2403,35240,60880,96120
1/31/2025,Duminda Kalubowila,Polonnaruwa,Maho,North Central,3900,172,4072,156000,6880,162880
2/1/2025,Duminda Kalubowila,Polonnaruwa,Maho,North Central,3074,94,3168,122960,3760,126720
2/2/2025,Duminda Kalubowila,Polonnaruwa,Maho,North Central,612,7118,7730,24480,284720,309200
2/3/2025,Duminda Kalubowila,Polonnaruwa,Maho,North Central,2399,3995,6394,95960,159800,255760
2/4/2025,Duminda Kalubowila,Polonnaruwa,Maho,North Central,2160,1041,3201,86400,41640,128040
2/5/2025,Duminda Kalubowila,Polonnaruwa,Maho,North Central,6489,7005,13494,259560,280200,539760
2/6/2025,Duminda Kalubowila,Polonnaruwa,Maho,North Central,5082,8714,13796,203280,348560,551840
2/7/2025,Duminda Kalubowila,Polonnaruwa,Maho,North Central,6133,3255,9388,245320,130200,375520
2/8/2025,Duminda Kalubowila,Polonnaruwa,Maho,North Central,4083,9210,13293,163320,368400,531720
2/9/2025,Duminda Kalubowila,Polonnaruwa,Maho,North Central,4215,1026,5241,168600,41040,209640
2/10/2025,Duminda Kalubowila,Polonnaruwa,Maho,North Central,5428,7216,12644,217120,288640,505760
2/11/2025,Duminda Kalubowila,Polonnaruwa,Maho,North Central,7338,4635,11973,293520,185400,478920
2/12/2025,Duminda Kalubowila,Polonnaruwa,Maho,North Central,8097,3796,11893,323880,151840,475720
2/13/2025,Duminda Kalubowila,Polonnaruwa,Maho,North Central,2542,6055,8597,101680,242200,343880
2/14/2025,Duminda Kalubowila,Polonnaruwa,Maho,North Central,7177,3529,10706,287080,141160,428240
2/15/2025,Duminda Kalubowila,Polonnaruwa,Maho,North Central,859,775,1634,34360,31000,65360
2/16/2025,Duminda Kalubowila,Polonnaruwa,Maho,North Central,2528,4022,6550,101120,160880,262000
2/17/2025,Duminda Kalubowila,Polonnaruwa,Maho,North Central,9809,4327,14136,392360,173080,565440
2/18/2025,Duminda Kalubowila,Polonnaruwa,Maho,North Central,1491,2901,4392,59640,116040,175680
2/19/2025,Duminda Kalubowila,Polonnaruwa,Maho,North Central,3196,9514,12710,127840,380560,508400
2/20/2025,Duminda Kalubowila,Polonnaruwa,Maho,North Central,4168,9464,13632,166720,378560,545280
2/21/2025,Duminda Kalubowila,Polonnaruwa,Maho,North Central,7342,911,8253,293680,36440,330120
2/22/2025,Duminda Kalubowila,Polonnaruwa,Maho,North Central,6384,261,6645,255360,10440,265800
2/23/2025,Duminda Kalubowila,Polonnaruwa,Maho,North Central,4518,3980,8498,180720,159200,339920
2/24/2025,Duminda Kalubowila,Polonnaruwa,Maho,North Central,8685,8824,17509,347400,352960,700360
2/25/2025,Duminda Kalubowila,Polonnaruwa,Maho,North Central,5974,4530,10504,238960,181200,420160
2/26/2025,Duminda Kalubowila,Polonnaruwa,Maho,North Central,9151,1686,10837,366040,67440,433480
2/27/2025,Duminda Kalubowila,Polonnaruwa,Maho,North Central,5745,5764,11509,229800,230560,460360
2/28/2025,Duminda Kalubowila,Polonnaruwa,Maho,North Central,3461,7069,10530,138440,282760,421200
3/1/2025,Duminda Kalubowila,Polonnaruwa,Maho,North Central,2908,863,3771,116320,34520,150840
3/2/2025,Duminda Kalubowila,Polonnaruwa,Maho,North Central,1154,1286,2440,46160,51440,97600
3/3/2025,Duminda Kalubowila,Polonnaruwa,Maho,North Central,9296,1218,10514,371840,48720,420560
3/4/2025,Duminda Kalubowila,Polonnaruwa,Maho,North Central,1282,4945,6227,51280,197800,249080
3/5/2025,Duminda Kalubowila,Polonnaruwa,Maho,North Central,9565,5114,14679,382600,204560,587160
3/6/2025,Duminda Kalubowila,Polonnaruwa,Maho,North Central,3078,8359,11437,123120,334360,457480
3/7/2025,Duminda Kalubowila,Polonnaruwa,Maho,North Central,2052,6945,8997,82080,277800,359880
3/8/2025,Duminda Kalubowila,Polonnaruwa,Maho,North Central,4556,9518,14074,182240,380720,562960
3/9/2025,Duminda Kalubowila,Polonnaruwa,Maho,North Central,1428,3879,5307,57120,155160,212280
3/10/2025,Duminda Kalubowila,Polonnaruwa,Maho,North Central,2707,2062,4769,108280,82480,190760
3/11/2025,Duminda Kalubowila,Polonnaruwa,Maho,North Central,2315,2283,4598,92600,91320,183920
3/12/2025,Duminda Kalubowila,Polonnaruwa,Maho,North Central,6977,2193,9170,279080,87720,366800
3/13/2025,Duminda Kalubowila,Polonnaruwa,Maho,North Central,7069,3371,10440,282760,134840,417600
3/14/2025,Duminda Kalubowila,Polonnaruwa,Maho,North Central,7216,5989,13205,288640,239560,528200
3/15/2025,Duminda Kalubowila,Polonnaruwa,Maho,North Central,8833,8311,17144,353320,332440,685760
3/16/2025,Duminda Kalubowila,Polonnaruwa,Maho,North Central,1425,1560,2985,57000,62400,119400
3/17/2025,Duminda Kalubowila,Polonnaruwa,Maho,North Central,5636,1016,6652,225440,40640,266080
3/18/2025,Duminda Kalubowila,Polonnaruwa,Maho,North Central,6455,3489,9944,258200,139560,397760
3/19/2025,Duminda Kalubowila,Polonnaruwa,Maho,North Central,8974,1274,10248,358960,50960,409920
3/20/2025,Duminda Kalubowila,Polonnaruwa,Maho,North Central,174,6742,6916,6960,269680,276640
3/21/2025,Duminda Kalubowila,Polonnaruwa,Maho,North Central,52,9982,10034,2080,399280,401360
3/22/2025,Duminda Kalubowila,Polonnaruwa,Maho,North Central,7938,531,8469,317520,21240,338760
3/23/2025,Duminda Kalubowila,Polonnaruwa,Maho,North Central,6125,6858,12983,245000,274320,519320
3/25/2024,Vishal Chandrasiri,Nuwara Eliya,Balangoda,Central,808,7703,8511,32320,308120,340440
3/26/2024,Vishal Chandrasiri,Nuwara Eliya,Balangoda,Central,2804,9436,12240,112160,377440,489600
3/27/2024,Vishal Chandrasiri,Nuwara Eliya,Balangoda,Central,5882,9748,15630,235280,389920,625200
3/28/2024,Vishal Chandrasiri,Nuwara Eliya,Balangoda,Central,6676,345,7021,267040,13800,280840
3/29/2024,Vishal Chandrasiri,Nuwara Eliya,Balangoda,Central,1196,9904,11100,47840,396160,444000
3/30/2024,Vishal Chandrasiri,Nuwara Eliya,Balangoda,Central,8554,1270,9824,342160,50800,392960
3/31/2024,Vishal Chandrasiri,Nuwara Eliya,Balangoda,Central,5564,5694,11258,222560,227760,450320
4/1/2024,Vishal Chandrasiri,Nuwara Eliya,Balangoda,Central,8128,2223,10351,325120,88920,414040
4/2/2024,Vishal Chandrasiri,Nuwara Eliya,Balangoda,Central,8546,3019,11565,341840,120760,462600
4/3/2024,Vishal Chandrasiri,Nuwara Eliya,Balangoda,Central,2732,9287,12019,109280,371480,480760
4/4/2024,Vishal Chandrasiri,Nuwara Eliya,Balangoda,Central,2098,4913,7011,83920,196520,280440
4/5/2024,Vishal Chandrasiri,Nuwara Eliya,Balangoda,Central,2116,5506,7622,84640,220240,304880
4/6/2024,Vishal Chandrasiri,Nuwara Eliya,Balangoda,Central,5616,8123,13739,224640,324920,549560
4/7/2024,Vishal Chandrasiri,Nuwara Eliya,Balangoda,Central,4462,6952,11414,178480,278080,456560
4/8/2024,Vishal Chandrasiri,Nuwara Eliya,Balangoda,Central,5576,6561,12137,223040,262440,485480
4/9/2024,Vishal Chandrasiri,Nuwara Eliya,Balangoda,Central,1140,5374,6514,45600,214960,260560
4/10/2024,Vishal Chandrasiri,Nuwara Eliya,Balangoda,Central,7564,9749,17313,302560,389960,692520
4/11/2024,Vishal Chandrasiri,Nuwara Eliya,Balangoda,Central,8281,5228,13509,331240,209120,540360
4/19/2024,Vishal Chandrasiri,Nuwara Eliya,Balangoda,Central,1591,5018,6609,63640,200720,264360
4/20/2024,Vishal Chandrasiri,Nuwara Eliya,Balangoda,Central,8815,7160,15975,352600,286400,639000
4/21/2024,Vishal Chandrasiri,Nuwara Eliya,Balangoda,Central,5671,8903,14574,226840,356120,582960
4/22/2024,Vishal Chandrasiri,Nuwara Eliya,Balangoda,Central,1885,6261,8146,75400,250440,325840
4/23/2024,Vishal Chandrasiri,Nuwara Eliya,Balangoda,Central,5488,5493,10981,219520,219720,439240
4/24/2024,Vishal Chandrasiri,Nuwara Eliya,Balangoda,Central,2229,6582,8811,89160,263280,352440
4/25/2024,Vishal Chandrasiri,Nuwara Eliya,Balangoda,Central,5358,7358,12716,214320,294320,508640
4/26/2024,Vishal Chandrasiri,Nuwara Eliya,Balangoda,Central,7527,2797,10324,301080,111880,412960
4/27/2024,Vishal Chandrasiri,Nuwara Eliya,Balangoda,Central,1076,3520,4596,43040,140800,183840
4/28/2024,Vishal Chandrasiri,Nuwara Eliya,Balangoda,Central,6474,4389,10863,258960,175560,434520
4/29/2024,Vishal Chandrasiri,Nuwara Eliya,Balangoda,Central,6846,1593,8439,273840,63720,337560
4/30/2024,Vishal Chandrasiri,Nuwara Eliya,Balangoda,Central,5826,425,6251,233040,17000,250040
5/1/2024,Vishal Chandrasiri,Nuwara Eliya,Balangoda,Central,6145,5689,11834,245800,227560,473360
5/2/2024,Vishal Chandrasiri,Nuwara Eliya,Balangoda,Central,7882,1467,9349,315280,58680,373960
5/3/2024,Vishal Chandrasiri,Nuwara Eliya,Balangoda,Central,5462,6905,12367,218480,276200,494680
5/4/2024,Vishal Chandrasiri,Nuwara Eliya,Balangoda,Central,9762,3135,12897,390480,125400,515880
5/5/2024,Vishal Chandrasiri,Nuwara Eliya,Balangoda,Central,5306,7797,13103,212240,311880,524120
5/6/2024,Vishal Chandrasiri,Nuwara Eliya,Balangoda,Central,7829,2326,10155,313160,93040,406200
5/7/2024,Vishal Chandrasiri,Nuwara Eliya,Balangoda,Central,5435,6576,12011,217400,263040,480440
5/8/2024,Vishal Chandrasiri,Nuwara Eliya,Balangoda,Central,8825,8166,16991,353000,326640,679640
5/9/2024,Vishal Chandrasiri,Nuwara Eliya,Balangoda,Central,5214,9084,14298,208560,363360,571920
5/10/2024,Vishal Chandrasiri,Nuwara Eliya,Balangoda,Central,9490,9736,19226,379600,389440,769040
5/11/2024,Vishal Chandrasiri,Nuwara Eliya,Balangoda,Central,5564,7499,13063,222560,299960,522520
5/12/2024,Vishal Chandrasiri,Nuwara Eliya,Balangoda,Central,7395,6966,14361,295800,278640,574440
5/13/2024,Vishal Chandrasiri,Nuwara Eliya,Balangoda,Central,8931,9048,17979,357240,361920,719160
5/14/2024,Vishal Chandrasiri,Nuwara Eliya,Balangoda,Central,7868,1302,9170,314720,52080,366800
5/15/2024,Vishal Chandrasiri,Nuwara Eliya,Balangoda,Central,39,9251,9290,1560,370040,371600
5/16/2024,Vishal Chandrasiri,Nuwara Eliya,Balangoda,Central,1389,209,1598,55560,8360,63920
5/17/2024,Vishal Chandrasiri,Nuwara Eliya,Balangoda,Central,9818,5665,15483,392720,226600,619320
5/18/2024,Vishal Chandrasiri,Nuwara Eliya,Balangoda,Central,3368,7190,10558,134720,287600,422320
5/19/2024,Vishal Chandrasiri,Nuwara Eliya,Balangoda,Central,8940,9897,18837,357600,395880,753480
5/20/2024,Vishal Chandrasiri,Nuwara Eliya,Balangoda,Central,805,3763,4568,32200,150520,182720
5/21/2024,Vishal Chandrasiri,Nuwara Eliya,Balangoda,Central,9652,4072,13724,386080,162880,548960
5/22/2024,Vishal Chandrasiri,Nuwara Eliya,Balangoda,Central,578,3844,4422,23120,153760,176880
5/24/2024,Vishal Chandrasiri,Nuwara Eliya,Balangoda,Central,5485,6800,12285,219400,272000,491400
5/25/2024,Vishal Chandrasiri,Nuwara Eliya,Balangoda,Central,2947,8901,11848,117880,356040,473920
5/26/2024,Vishal Chandrasiri,Nuwara Eliya,Balangoda,Central,6583,2211,8794,263320,88440,351760
5/27/2024,Vishal Chandrasiri,Nuwara Eliya,Balangoda,Central,5575,5961,11536,223000,238440,461440
5/28/2024,Vishal Chandrasiri,Nuwara Eliya,Balangoda,Central,4442,8323,12765,177680,332920,510600
5/29/2024,Vishal Chandrasiri,Nuwara Eliya,Balangoda,Central,3064,7298,10362,122560,291920,414480
5/30/2024,Vishal Chandrasiri,Nuwara Eliya,Balangoda,Central,9341,695,10036,373640,27800,401440
5/31/2024,Vishal Chandrasiri,Nuwara Eliya,Balangoda,Central,6574,1047,7621,262960,41880,304840
6/1/2024,Vishal Chandrasiri,Nuwara Eliya,Balangoda,Central,2311,9866,12177,92440,394640,487080
6/2/2024,Vishal Chandrasiri,Nuwara Eliya,Balangoda,Central,5648,5801,11449,225920,232040,457960
6/3/2024,Vishal Chandrasiri,Nuwara Eliya,Balangoda,Central,9476,2176,11652,379040,87040,466080
6/4/2024,Vishal Chandrasiri,Nuwara Eliya,Balangoda,Central,9999,3041,13040,399960,121640,521600
6/5/2024,Vishal Chandrasiri,Nuwara Eliya,Balangoda,Central,2399,8987,11386,95960,359480,455440
6/6/2024,Vishal Chandrasiri,Nuwara Eliya,Balangoda,Central,2337,919,3256,93480,36760,130240
6/7/2024,Vishal Chandrasiri,Nuwara Eliya,Balangoda,Central,3054,1570,4624,122160,62800,184960
6/8/2024,Vishal Chandrasiri,Nuwara Eliya,Balangoda,Central,1860,6070,7930,74400,242800,317200
6/9/2024,Vishal Chandrasiri,Nuwara Eliya,Balangoda,Central,2889,545,3434,115560,21800,137360
6/10/2024,Vishal Chandrasiri,Nuwara Eliya,Balangoda,Central,1591,8846,10437,63640,353840,417480
6/11/2024,Vishal Chandrasiri,Nuwara Eliya,Balangoda,Central,1027,6983,8010,41080,279320,320400
6/12/2024,Vishal Chandrasiri,Nuwara Eliya,Balangoda,Central,9257,3168,12425,370280,126720,497000
6/13/2024,Vishal Chandrasiri,Nuwara Eliya,Balangoda,Central,9855,5475,15330,394200,219000,613200
6/14/2024,Vishal Chandrasiri,Nuwara Eliya,Balangoda,Central,8071,3594,11665,322840,143760,466600
6/15/2024,Vishal Chandrasiri,Nuwara Eliya,Balangoda,Central,9510,4051,13561,380400,162040,542440
6/16/2024,Vishal Chandrasiri,Nuwara Eliya,Balangoda,Central,9944,6071,16015,397760,242840,640600
6/17/2024,Vishal Chandrasiri,Nuwara Eliya,Balangoda,Central,7591,8524,16115,303640,340960,644600
6/18/2024,Vishal Chandrasiri,Nuwara Eliya,Balangoda,Central,3406,6066,9472,136240,242640,378880
6/19/2024,Vishal Chandrasiri,Nuwara Eliya,Balangoda,Central,5752,1913,7665,230080,76520,306600
6/20/2024,Vishal Chandrasiri,Nuwara Eliya,Balangoda,Central,2269,7126,9395,90760,285040,375800
6/21/2024,Vishal Chandrasiri,Nuwara Eliya,Balangoda,Central,7779,6811,14590,311160,272440,583600
6/22/2024,Vishal Chandrasiri,Nuwara Eliya,Balangoda,Central,7697,9549,17246,307880,381960,689840
6/23/2024,Vishal Chandrasiri,Nuwara Eliya,Balangoda,Central,9389,8349,17738,375560,333960,709520
6/24/2024,Vishal Chandrasiri,Nuwara Eliya,Balangoda,Central,7083,3086,10169,283320,123440,406760
6/25/2024,Vishal Chandrasiri,Nuwara Eliya,Balangoda,Central,2447,4538,6985,97880,181520,279400
6/26/2024,Vishal Chandrasiri,Nuwara Eliya,Balangoda,Central,620,9094,9714,24800,363760,388560
6/27/2024,Vishal Chandrasiri,Nuwara Eliya,Balangoda,Central,2756,4817,7573,110240,192680,302920
6/28/2024,Vishal Chandrasiri,Nuwara Eliya,Balangoda,Central,6832,2529,9361,273280,101160,374440
6/29/2024,Vishal Chandrasiri,Nuwara Eliya,Balangoda,Central,47,1793,1840,1880,71720,73600
6/30/2024,Vishal Chandrasiri,Nuwara Eliya,Balangoda,Central,6657,6753,13410,266280,270120,536400
7/1/2024,Vishal Chandrasiri,Nuwara Eliya,Balangoda,Central,8527,3106,11633,341080,124240,465320
7/2/2024,Vishal Chandrasiri,Nuwara Eliya,Balangoda,Central,986,2758,3744,39440,110320,149760
7/3/2024,Vishal Chandrasiri,Nuwara Eliya,Balangoda,Central,5008,7566,12574,200320,302640,502960
7/4/2024,Vishal Chandrasiri,Nuwara Eliya,Balangoda,Central,7601,1988,9589,304040,79520,383560
7/5/2024,Vishal Chandrasiri,Nuwara Eliya,Balangoda,Central,6838,688,7526,273520,27520,301040
7/6/2024,Vishal Chandrasiri,Nuwara Eliya,Balangoda,Central,2866,1394,4260,114640,55760,170400
7/7/2024,Vishal Chandrasiri,Nuwara Eliya,Balangoda,Central,5485,5602,11087,219400,224080,443480
7/8/2024,Vishal Chandrasiri,Nuwara Eliya,Balangoda,Central,9507,3524,13031,380280,140960,521240
7/9/2024,Vishal Chandrasiri,Nuwara Eliya,Balangoda,Central,9905,2555,12460,396200,102200,498400
7/10/2024,Vishal Chandrasiri,Nuwara Eliya,Balangoda,Central,6036,3981,10017,241440,159240,400680
7/11/2024,Vishal Chandrasiri,Nuwara Eliya,Balangoda,Central,8496,7249,15745,339840,289960,629800
7/12/2024,Vishal Chandrasiri,Nuwara Eliya,Balangoda,Central,5358,4955,10313,214320,198200,412520
7/13/2024,Vishal Chandrasiri,Nuwara Eliya,Balangoda,Central,6305,1425,7730,252200,57000,309200
7/14/2024,Vishal Chandrasiri,Nuwara Eliya,Balangoda,Central,6956,5424,12380,278240,216960,495200
7/15/2024,Vishal Chandrasiri,Nuwara Eliya,Balangoda,Central,1366,2057,3423,54640,82280,136920
7/16/2024,Vishal Chandrasiri,Nuwara Eliya,Balangoda,Central,8456,5823,14279,338240,232920,571160
7/17/2024,Vishal Chandrasiri,Nuwara Eliya,Balangoda,Central,6518,1566,8084,260720,62640,323360
7/18/2024,Vishal Chandrasiri,Nuwara Eliya,Balangoda,Central,3729,7151,10880,149160,286040,435200
7/19/2024,Vishal Chandrasiri,Nuwara Eliya,Balangoda,Central,8368,1608,9976,334720,64320,399040
7/20/2024,Vishal Chandrasiri,Nuwara Eliya,Balangoda,Central,2840,2789,5629,113600,111560,225160
7/21/2024,Vishal Chandrasiri,Nuwara Eliya,Balangoda,Central,4667,6536,11203,186680,261440,448120
7/22/2024,Vishal Chandrasiri,Nuwara Eliya,Balangoda,Central,6031,3750,9781,241240,150000,391240
7/23/2024,Vishal Chandrasiri,Nuwara Eliya,Balangoda,Central,3436,1026,4462,137440,41040,178480
7/24/2024,Vishal Chandrasiri,Nuwara Eliya,Balangoda,Central,2491,5143,7634,99640,205720,305360
7/25/2024,Vishal Chandrasiri,Nuwara Eliya,Balangoda,Central,2520,7412,9932,100800,296480,397280
7/26/2024,Vishal Chandrasiri,Nuwara Eliya,Balangoda,Central,2771,2909,5680,110840,116360,227200
7/27/2024,Vishal Chandrasiri,Nuwara Eliya,Balangoda,Central,5543,7745,13288,221720,309800,531520
7/28/2024,Vishal Chandrasiri,Nuwara Eliya,Balangoda,Central,9541,9025,18566,381640,361000,742640
7/29/2024,Vishal Chandrasiri,Nuwara Eliya,Balangoda,Central,8839,3835,12674,353560,153400,506960
7/30/2024,Vishal Chandrasiri,Nuwara Eliya,Balangoda,Central,6227,9770,15997,249080,390800,639880
7/31/2024,Vishal Chandrasiri,Nuwara Eliya,Balangoda,Central,2400,1274,3674,96000,50960,146960
8/1/2024,Vishal Chandrasiri,Nuwara Eliya,Balangoda,Central,2809,6749,9558,112360,269960,382320
8/2/2024,Vishal Chandrasiri,Nuwara Eliya,Balangoda,Central,612,9691,10303,24480,387640,412120
8/3/2024,Vishal Chandrasiri,Nuwara Eliya,Balangoda,Central,2329,5450,7779,93160,218000,311160
8/4/2024,Vishal Chandrasiri,Nuwara Eliya,Balangoda,Central,2315,784,3099,92600,31360,123960
8/5/2024,Vishal Chandrasiri,Nuwara Eliya,Balangoda,Central,6043,8632,14675,241720,345280,587000
8/6/2024,Vishal Chandrasiri,Nuwara Eliya,Balangoda,Central,7443,9026,16469,297720,361040,658760
8/7/2024,Vishal Chandrasiri,Nuwara Eliya,Balangoda,Central,2320,8126,10446,92800,325040,417840
8/8/2024,Vishal Chandrasiri,Nuwara Eliya,Balangoda,Central,3273,9284,12557,130920,371360,502280
8/9/2024,Vishal Chandrasiri,Nuwara Eliya,Balangoda,Central,2819,4360,7179,112760,174400,287160
8/10/2024,Vishal Chandrasiri,Nuwara Eliya,Balangoda,Central,5845,9414,15259,233800,376560,610360
8/11/2024,Vishal Chandrasiri,Nuwara Eliya,Balangoda,Central,5566,3648,9214,222640,145920,368560
8/12/2024,Vishal Chandrasiri,Nuwara Eliya,Balangoda,Central,2568,1369,3937,102720,54760,157480
8/13/2024,Vishal Chandrasiri,Nuwara Eliya,Balangoda,Central,2479,4047,6526,99160,161880,261040
8/14/2024,Vishal Chandrasiri,Nuwara Eliya,Balangoda,Central,9766,4732,14498,390640,189280,579920
8/15/2024,Vishal Chandrasiri,Nuwara Eliya,Balangoda,Central,6111,1467,7578,244440,58680,303120
8/16/2024,Vishal Chandrasiri,Nuwara Eliya,Balangoda,Central,3434,8819,12253,137360,352760,490120
8/17/2024,Vishal Chandrasiri,Nuwara Eliya,Balangoda,Central,7650,8551,16201,306000,342040,648040
8/18/2024,Vishal Chandrasiri,Nuwara Eliya,Balangoda,Central,4023,8880,12903,160920,355200,516120
8/19/2024,Vishal Chandrasiri,Nuwara Eliya,Balangoda,Central,412,8796,9208,16480,351840,368320
8/20/2024,Vishal Chandrasiri,Nuwara Eliya,Balangoda,Central,2088,4883,6971,83520,195320,278840
8/21/2024,Vishal Chandrasiri,Nuwara Eliya,Balangoda,Central,5953,2298,8251,238120,91920,330040
8/22/2024,Vishal Chandrasiri,Nuwara Eliya,Balangoda,Central,3799,4615,8414,151960,184600,336560
8/23/2024,Vishal Chandrasiri,Nuwara Eliya,Balangoda,Central,36,5025,5061,1440,201000,202440
8/24/2024,Vishal Chandrasiri,Nuwara Eliya,Balangoda,Central,5572,7786,13358,222880,311440,534320
8/25/2024,Vishal Chandrasiri,Nuwara Eliya,Balangoda,Central,9285,8830,18115,371400,353200,724600
8/26/2024,Vishal Chandrasiri,Nuwara Eliya,Balangoda,Central,5714,6415,12129,228560,256600,485160
8/27/2024,Vishal Chandrasiri,Nuwara Eliya,Balangoda,Central,72,1603,1675,2880,64120,67000
8/28/2024,Vishal Chandrasiri,Nuwara Eliya,Balangoda,Central,4105,5942,10047,164200,237680,401880
8/29/2024,Vishal Chandrasiri,Nuwara Eliya,Balangoda,Central,7647,3489,11136,305880,139560,445440
8/30/2024,Vishal Chandrasiri,Nuwara Eliya,Balangoda,Central,8712,4727,13439,348480,189080,537560
8/31/2024,Vishal Chandrasiri,Nuwara Eliya,Balangoda,Central,9561,6924,16485,382440,276960,659400
9/1/2024,Vishal Chandrasiri,Nuwara Eliya,Balangoda,Central,4507,7506,12013,180280,300240,480520
9/2/2024,Vishal Chandrasiri,Nuwara Eliya,Balangoda,Central,7212,235,7447,288480,9400,297880
9/3/2024,Vishal Chandrasiri,Nuwara Eliya,Balangoda,Central,1089,6376,7465,43560,255040,298600
9/4/2024,Vishal Chandrasiri,Nuwara Eliya,Balangoda,Central,8807,2575,11382,352280,103000,455280
9/5/2024,Vishal Chandrasiri,Nuwara Eliya,Balangoda,Central,3681,7200,10881,147240,288000,435240
9/6/2024,Vishal Chandrasiri,Nuwara Eliya,Balangoda,Central,3977,8561,12538,159080,342440,501520
9/7/2024,Vishal Chandrasiri,Nuwara Eliya,Balangoda,Central,8605,8437,17042,344200,337480,681680
9/8/2024,Vishal Chandrasiri,Nuwara Eliya,Balangoda,Central,3712,4491,8203,148480,179640,328120
9/9/2024,Vishal Chandrasiri,Nuwara Eliya,Balangoda,Central,7352,3208,10560,294080,128320,422400
9/10/2024,Vishal Chandrasiri,Nuwara Eliya,Balangoda,Central,7837,3045,10882,313480,121800,435280
9/11/2024,Vishal Chandrasiri,Nuwara Eliya,Balangoda,Central,2308,5429,7737,92320,217160,309480
9/12/2024,Vishal Chandrasiri,Nuwara Eliya,Balangoda,Central,1518,945,2463,60720,37800,98520
9/13/2024,Vishal Chandrasiri,Nuwara Eliya,Balangoda,Central,7910,902,8812,316400,36080,352480
9/14/2024,Vishal Chandrasiri,Nuwara Eliya,Balangoda,Central,8219,2842,11061,328760,113680,442440
9/15/2024,Vishal Chandrasiri,Nuwara Eliya,Balangoda,Central,4175,4047,8222,167000,161880,328880
9/16/2024,Vishal Chandrasiri,Nuwara Eliya,Balangoda,Central,4380,6257,10637,175200,250280,425480
9/17/2024,Vishal Chandrasiri,Nuwara Eliya,Balangoda,Central,1953,4453,6406,78120,178120,256240
9/18/2024,Vishal Chandrasiri,Nuwara Eliya,Balangoda,Central,4822,5389,10211,192880,215560,408440
9/19/2024,Vishal Chandrasiri,Nuwara Eliya,Balangoda,Central,3398,2509,5907,135920,100360,236280
9/20/2024,Vishal Chandrasiri,Nuwara Eliya,Balangoda,Central,3238,628,3866,129520,25120,154640
9/21/2024,Vishal Chandrasiri,Nuwara Eliya,Balangoda,Central,5736,8095,13831,229440,323800,553240
9/22/2024,Vishal Chandrasiri,Nuwara Eliya,Balangoda,Central,4519,2340,6859,180760,93600,274360
9/23/2024,Vishal Chandrasiri,Nuwara Eliya,Balangoda,Central,4732,5445,10177,189280,217800,407080
9/24/2024,Vishal Chandrasiri,Nuwara Eliya,Balangoda,Central,4661,9883,14544,186440,395320,581760
9/25/2024,Vishal Chandrasiri,Nuwara Eliya,Balangoda,Central,1646,6731,8377,65840,269240,335080
9/26/2024,Vishal Chandrasiri,Nuwara Eliya,Balangoda,Central,1670,4642,6312,66800,185680,252480
9/27/2024,Vishal Chandrasiri,Nuwara Eliya,Balangoda,Central,5594,6896,12490,223760,275840,499600
9/28/2024,Vishal Chandrasiri,Nuwara Eliya,Balangoda,Central,5726,9084,14810,229040,363360,592400
9/29/2024,Vishal Chandrasiri,Nuwara Eliya,Balangoda,Central,3525,6557,10082,141000,262280,403280
9/30/2024,Vishal Chandrasiri,Nuwara Eliya,Balangoda,Central,662,7218,7880,26480,288720,315200
10/1/2024,Vishal Chandrasiri,Nuwara Eliya,Balangoda,Central,6711,9722,16433,268440,388880,657320
10/2/2024,Vishal Chandrasiri,Nuwara Eliya,Balangoda,Central,928,852,1780,37120,34080,71200
10/3/2024,Vishal Chandrasiri,Nuwara Eliya,Balangoda,Central,3148,9894,13042,125920,395760,521680
10/4/2024,Vishal Chandrasiri,Nuwara Eliya,Balangoda,Central,9450,8971,18421,378000,358840,736840
10/5/2024,Vishal Chandrasiri,Nuwara Eliya,Balangoda,Central,5043,4492,9535,201720,179680,381400
10/6/2024,Vishal Chandrasiri,Nuwara Eliya,Balangoda,Central,990,4293,5283,39600,171720,211320
10/7/2024,Vishal Chandrasiri,Nuwara Eliya,Balangoda,Central,7411,3323,10734,296440,132920,429360
10/8/2024,Vishal Chandrasiri,Nuwara Eliya,Balangoda,Central,26,5468,5494,1040,218720,219760
10/9/2024,Vishal Chandrasiri,Nuwara Eliya,Balangoda,Central,8323,3579,11902,332920,143160,476080
10/10/2024,Vishal Chandrasiri,Nuwara Eliya,Balangoda,Central,8248,2412,10660,329920,96480,426400
10/11/2024,Vishal Chandrasiri,Nuwara Eliya,Balangoda,Central,6546,6520,13066,261840,260800,522640
10/12/2024,Vishal Chandrasiri,Nuwara Eliya,Balangoda,Central,4110,7401,11511,164400,296040,460440
10/13/2024,Vishal Chandrasiri,Nuwara Eliya,Balangoda,Central,9407,6984,16391,376280,279360,655640
10/14/2024,Vishal Chandrasiri,Nuwara Eliya,Balangoda,Central,1144,5932,7076,45760,237280,283040
10/15/2024,Vishal Chandrasiri,Nuwara Eliya,Balangoda,Central,6391,7467,13858,255640,298680,554320
10/16/2024,Vishal Chandrasiri,Nuwara Eliya,Balangoda,Central,5519,3021,8540,220760,120840,341600
10/17/2024,Vishal Chandrasiri,Nuwara Eliya,Balangoda,Central,9034,1843,10877,361360,73720,435080
10/18/2024,Vishal Chandrasiri,Nuwara Eliya,Balangoda,Central,7667,5133,12800,306680,205320,512000
10/19/2024,Vishal Chandrasiri,Nuwara Eliya,Balangoda,Central,4174,7020,11194,166960,280800,447760
10/20/2024,Vishal Chandrasiri,Nuwara Eliya,Balangoda,Central,1020,479,1499,40800,19160,59960
10/21/2024,Vishal Chandrasiri,Nuwara Eliya,Balangoda,Central,882,9224,10106,35280,368960,404240
10/22/2024,Vishal Chandrasiri,Nuwara Eliya,Balangoda,Central,3863,5312,9175,154520,212480,367000
10/23/2024,Vishal Chandrasiri,Nuwara Eliya,Balangoda,Central,7586,5346,12932,303440,213840,517280
10/24/2024,Vishal Chandrasiri,Nuwara Eliya,Balangoda,Central,3726,6647,10373,149040,265880,414920
10/25/2024,Vishal Chandrasiri,Nuwara Eliya,Balangoda,Central,3141,4842,7983,125640,193680,319320
10/26/2024,Vishal Chandrasiri,Nuwara Eliya,Balangoda,Central,292,604,896,11680,24160,35840
10/27/2024,Vishal Chandrasiri,Nuwara Eliya,Balangoda,Central,8525,4554,13079,341000,182160,523160
10/28/2024,Vishal Chandrasiri,Nuwara Eliya,Balangoda,Central,9791,9837,19628,391640,393480,785120
10/29/2024,Vishal Chandrasiri,Nuwara Eliya,Balangoda,Central,1013,8748,9761,40520,349920,390440
10/30/2024,Vishal Chandrasiri,Nuwara Eliya,Balangoda,Central,6715,2510,9225,268600,100400,369000
10/31/2024,Vishal Chandrasiri,Nuwara Eliya,Balangoda,Central,2655,8124,10779,106200,324960,431160
11/1/2024,Vishal Chandrasiri,Nuwara Eliya,Balangoda,Central,4110,7559,11669,164400,302360,466760
11/2/2024,Vishal Chandrasiri,Nuwara Eliya,Balangoda,Central,6072,6458,12530,242880,258320,501200
11/3/2024,Vishal Chandrasiri,Nuwara Eliya,Balangoda,Central,1390,755,2145,55600,30200,85800
11/4/2024,Vishal Chandrasiri,Nuwara Eliya,Balangoda,Central,6860,6965,13825,274400,278600,553000
11/5/2024,Vishal Chandrasiri,Nuwara Eliya,Balangoda,Central,8971,3365,12336,358840,134600,493440
11/6/2024,Vishal Chandrasiri,Nuwara Eliya,Balangoda,Central,6937,3810,10747,277480,152400,429880
11/7/2024,Vishal Chandrasiri,Nuwara Eliya,Balangoda,Central,4423,967,5390,176920,38680,215600
11/8/2024,Vishal Chandrasiri,Nuwara Eliya,Balangoda,Central,2858,1553,4411,114320,62120,176440
11/9/2024,Vishal Chandrasiri,Nuwara Eliya,Balangoda,Central,3646,7575,11221,145840,303000,448840
11/10/2024,Vishal Chandrasiri,Nuwara Eliya,Balangoda,Central,3965,1763,5728,158600,70520,229120
11/11/2024,Vishal Chandrasiri,Nuwara Eliya,Balangoda,Central,8592,8214,16806,343680,328560,672240
11/12/2024,Vishal Chandrasiri,Nuwara Eliya,Balangoda,Central,7812,6148,13960,312480,245920,558400
11/13/2024,Vishal Chandrasiri,Nuwara Eliya,Balangoda,Central,1309,2045,3354,52360,81800,134160
11/14/2024,Vishal Chandrasiri,Nuwara Eliya,Balangoda,Central,5498,1355,6853,219920,54200,274120
11/15/2024,Vishal Chandrasiri,Nuwara Eliya,Balangoda,Central,7917,9669,17586,316680,386760,703440
11/16/2024,Vishal Chandrasiri,Nuwara Eliya,Balangoda,Central,1130,3345,4475,45200,133800,179000
11/17/2024,Vishal Chandrasiri,Nuwara Eliya,Balangoda,Central,671,582,1253,26840,23280,50120
11/18/2024,Vishal Chandrasiri,Nuwara Eliya,Balangoda,Central,2229,6839,9068,89160,273560,362720
11/19/2024,Vishal Chandrasiri,Nuwara Eliya,Balangoda,Central,8173,7710,15883,326920,308400,635320
11/20/2024,Vishal Chandrasiri,Nuwara Eliya,Balangoda,Central,6190,134,6324,247600,5360,252960
11/21/2024,Vishal Chandrasiri,Nuwara Eliya,Balangoda,Central,5163,7371,12534,206520,294840,501360
11/22/2024,Vishal Chandrasiri,Nuwara Eliya,Balangoda,Central,7415,7652,15067,296600,306080,602680
11/23/2024,Vishal Chandrasiri,Nuwara Eliya,Balangoda,Central,6913,1831,8744,276520,73240,349760
11/24/2024,Vishal Chandrasiri,Nuwara Eliya,Balangoda,Central,1552,7177,8729,62080,287080,349160
11/25/2024,Vishal Chandrasiri,Nuwara Eliya,Balangoda,Central,2809,3926,6735,112360,157040,269400
11/26/2024,Vishal Chandrasiri,Nuwara Eliya,Balangoda,Central,1208,2174,3382,48320,86960,135280
11/27/2024,Vishal Chandrasiri,Nuwara Eliya,Balangoda,Central,2616,8726,11342,104640,349040,453680
11/28/2024,Vishal Chandrasiri,Nuwara Eliya,Balangoda,Central,1270,3588,4858,50800,143520,194320
11/29/2024,Vishal Chandrasiri,Nuwara Eliya,Balangoda,Central,5499,2696,8195,219960,107840,327800
11/30/2024,Vishal Chandrasiri,Nuwara Eliya,Balangoda,Central,2009,6922,8931,80360,276880,357240
12/1/2024,Vishal Chandrasiri,Nuwara Eliya,Balangoda,Central,7176,3787,10963,287040,151480,438520
12/2/2024,Vishal Chandrasiri,Nuwara Eliya,Balangoda,Central,6169,9798,15967,246760,391920,638680
12/3/2024,Vishal Chandrasiri,Nuwara Eliya,Balangoda,Central,5952,6369,12321,238080,254760,492840
12/4/2024,Vishal Chandrasiri,Nuwara Eliya,Balangoda,Central,6761,7689,14450,270440,307560,578000
12/5/2024,Vishal Chandrasiri,Nuwara Eliya,Balangoda,Central,4751,8805,13556,190040,352200,542240
12/6/2024,Vishal Chandrasiri,Nuwara Eliya,Balangoda,Central,3442,4713,8155,137680,188520,326200
12/7/2024,Vishal Chandrasiri,Nuwara Eliya,Balangoda,Central,1435,8768,10203,57400,350720,408120
12/8/2024,Vishal Chandrasiri,Nuwara Eliya,Balangoda,Central,4008,438,4446,160320,17520,177840
12/9/2024,Vishal Chandrasiri,Nuwara Eliya,Balangoda,Central,9265,9126,18391,370600,365040,735640
12/10/2024,Vishal Chandrasiri,Nuwara Eliya,Balangoda,Central,7430,1933,9363,297200,77320,374520
12/11/2024,Vishal Chandrasiri,Nuwara Eliya,Balangoda,Central,3644,8540,12184,145760,341600,487360
12/12/2024,Vishal Chandrasiri,Nuwara Eliya,Balangoda,Central,4564,392,4956,182560,15680,198240
12/13/2024,Vishal Chandrasiri,Nuwara Eliya,Balangoda,Central,8497,7219,15716,339880,288760,628640
12/14/2024,Vishal Chandrasiri,Nuwara Eliya,Balangoda,Central,1652,588,2240,66080,23520,89600
12/15/2024,Vishal Chandrasiri,Nuwara Eliya,Balangoda,Central,6809,8887,15696,272360,355480,627840
12/16/2024,Vishal Chandrasiri,Nuwara Eliya,Balangoda,Central,3369,1617,4986,134760,64680,199440
12/17/2024,Vishal Chandrasiri,Nuwara Eliya,Balangoda,Central,3462,8017,11479,138480,320680,459160
12/18/2024,Vishal Chandrasiri,Nuwara Eliya,Balangoda,Central,7563,8175,15738,302520,327000,629520
12/19/2024,Vishal Chandrasiri,Nuwara Eliya,Balangoda,Central,7730,585,8315,309200,23400,332600
12/20/2024,Vishal Chandrasiri,Nuwara Eliya,Balangoda,Central,6899,5442,12341,275960,217680,493640
12/21/2024,Vishal Chandrasiri,Nuwara Eliya,Balangoda,Central,6258,6432,12690,250320,257280,507600
12/22/2024,Vishal Chandrasiri,Nuwara Eliya,Balangoda,Central,3344,5494,8838,133760,219760,353520
12/23/2024,Vishal Chandrasiri,Nuwara Eliya,Balangoda,Central,1612,9196,10808,64480,367840,432320
12/24/2024,Vishal Chandrasiri,Nuwara Eliya,Balangoda,Central,5810,1623,7433,232400,64920,297320
12/25/2024,Vishal Chandrasiri,Nuwara Eliya,Balangoda,Central,7583,1064,8647,303320,42560,345880
12/26/2024,Vishal Chandrasiri,Nuwara Eliya,Balangoda,Central,5492,2016,7508,219680,80640,300320
12/27/2024,Vishal Chandrasiri,Nuwara Eliya,Balangoda,Central,7591,8389,15980,303640,335560,639200
12/28/2024,Vishal Chandrasiri,Nuwara Eliya,Balangoda,Central,1009,4720,5729,40360,188800,229160
12/29/2024,Vishal Chandrasiri,Nuwara Eliya,Balangoda,Central,5378,2927,8305,215120,117080,332200
12/30/2024,Vishal Chandrasiri,Nuwara Eliya,Balangoda,Central,9916,1640,11556,396640,65600,462240
12/31/2024,Vishal Chandrasiri,Nuwara Eliya,Balangoda,Central,1291,8405,9696,51640,336200,387840
1/1/2025,Vishal Chandrasiri,Nuwara Eliya,Balangoda,Central,6542,1794,8336,261680,71760,333440
1/2/2025,Vishal Chandrasiri,Nuwara Eliya,Balangoda,Central,8485,7502,15987,339400,300080,639480
1/3/2025,Vishal Chandrasiri,Nuwara Eliya,Balangoda,Central,9178,2859,12037,367120,114360,481480
1/4/2025,Vishal Chandrasiri,Nuwara Eliya,Balangoda,Central,235,9242,9477,9400,369680,379080
1/5/2025,Vishal Chandrasiri,Nuwara Eliya,Balangoda,Central,8702,9055,17757,348080,362200,710280
1/6/2025,Vishal Chandrasiri,Nuwara Eliya,Balangoda,Central,1610,7009,8619,64400,280360,344760
1/7/2025,Vishal Chandrasiri,Nuwara Eliya,Balangoda,Central,9369,8563,17932,374760,342520,717280
1/8/2025,Vishal Chandrasiri,Nuwara Eliya,Balangoda,Central,2793,6711,9504,111720,268440,380160
1/9/2025,Vishal Chandrasiri,Nuwara Eliya,Balangoda,Central,5136,9212,14348,205440,368480,573920
1/10/2025,Vishal Chandrasiri,Nuwara Eliya,Balangoda,Central,6130,8022,14152,245200,320880,566080
1/11/2025,Vishal Chandrasiri,Nuwara Eliya,Balangoda,Central,9148,504,9652,365920,20160,386080
1/12/2025,Vishal Chandrasiri,Nuwara Eliya,Balangoda,Central,1065,7853,8918,42600,314120,356720
1/13/2025,Vishal Chandrasiri,Nuwara Eliya,Balangoda,Central,7560,1775,9335,302400,71000,373400
1/14/2025,Vishal Chandrasiri,Nuwara Eliya,Balangoda,Central,2100,7912,10012,84000,316480,400480
1/15/2025,Vishal Chandrasiri,Nuwara Eliya,Balangoda,Central,1161,5663,6824,46440,226520,272960
1/16/2025,Vishal Chandrasiri,Nuwara Eliya,Balangoda,Central,154,2893,3047,6160,115720,121880
1/17/2025,Vishal Chandrasiri,Nuwara Eliya,Balangoda,Central,777,8101,8878,31080,324040,355120
1/18/2025,Vishal Chandrasiri,Nuwara Eliya,Balangoda,Central,7828,6896,14724,313120,275840,588960
1/19/2025,Vishal Chandrasiri,Nuwara Eliya,Balangoda,Central,3699,9850,13549,147960,394000,541960
1/20/2025,Vishal Chandrasiri,Nuwara Eliya,Balangoda,Central,5534,6839,12373,221360,273560,494920
1/21/2025,Vishal Chandrasiri,Nuwara Eliya,Balangoda,Central,8065,8163,16228,322600,326520,649120
1/22/2025,Vishal Chandrasiri,Nuwara Eliya,Balangoda,Central,9528,3329,12857,381120,133160,514280
1/23/2025,Vishal Chandrasiri,Nuwara Eliya,Balangoda,Central,1667,939,2606,66680,37560,104240
1/24/2025,Vishal Chandrasiri,Nuwara Eliya,Balangoda,Central,7011,3197,10208,280440,127880,408320
1/25/2025,Vishal Chandrasiri,Nuwara Eliya,Balangoda,Central,9006,5186,14192,360240,207440,567680
1/26/2025,Vishal Chandrasiri,Nuwara Eliya,Balangoda,Central,4852,7426,12278,194080,297040,491120
1/27/2025,Vishal Chandrasiri,Nuwara Eliya,Balangoda,Central,7852,7000,14852,314080,280000,594080
1/28/2025,Vishal Chandrasiri,Nuwara Eliya,Balangoda,Central,7387,8892,16279,295480,355680,651160
1/29/2025,Vishal Chandrasiri,Nuwara Eliya,Balangoda,Central,8299,9467,17766,331960,378680,710640
1/30/2025,Vishal Chandrasiri,Nuwara Eliya,Balangoda,Central,4008,1594,5602,160320,63760,224080
1/31/2025,Vishal Chandrasiri,Nuwara Eliya,Balangoda,Central,1668,6331,7999,66720,253240,319960
2/1/2025,Vishal Chandrasiri,Nuwara Eliya,Balangoda,Central,2705,176,2881,108200,7040,115240
2/2/2025,Vishal Chandrasiri,Nuwara Eliya,Balangoda,Central,1599,1424,3023,63960,56960,120920
2/3/2025,Vishal Chandrasiri,Nuwara Eliya,Balangoda,Central,5205,5495,10700,208200,219800,428000
2/4/2025,Vishal Chandrasiri,Nuwara Eliya,Balangoda,Central,6029,2732,8761,241160,109280,350440
2/5/2025,Vishal Chandrasiri,Nuwara Eliya,Balangoda,Central,1445,7153,8598,57800,286120,343920
2/6/2025,Vishal Chandrasiri,Nuwara Eliya,Balangoda,Central,5361,5706,11067,214440,228240,442680
2/7/2025,Vishal Chandrasiri,Nuwara Eliya,Balangoda,Central,6928,4769,11697,277120,190760,467880
2/8/2025,Vishal Chandrasiri,Nuwara Eliya,Balangoda,Central,7470,2714,10184,298800,108560,407360
2/9/2025,Vishal Chandrasiri,Nuwara Eliya,Balangoda,Central,996,9428,10424,39840,377120,416960
2/10/2025,Vishal Chandrasiri,Nuwara Eliya,Balangoda,Central,3862,9557,13419,154480,382280,536760
2/11/2025,Vishal Chandrasiri,Nuwara Eliya,Balangoda,Central,1932,4968,6900,77280,198720,276000
2/12/2025,Vishal Chandrasiri,Nuwara Eliya,Balangoda,Central,5729,7869,13598,229160,314760,543920
2/13/2025,Vishal Chandrasiri,Nuwara Eliya,Balangoda,Central,5752,1464,7216,230080,58560,288640
2/14/2025,Vishal Chandrasiri,Nuwara Eliya,Balangoda,Central,8107,588,8695,324280,23520,347800
2/15/2025,Vishal Chandrasiri,Nuwara Eliya,Balangoda,Central,1581,1348,2929,63240,53920,117160
2/16/2025,Vishal Chandrasiri,Nuwara Eliya,Balangoda,Central,1402,41,1443,56080,1640,57720
2/17/2025,Vishal Chandrasiri,Nuwara Eliya,Balangoda,Central,1731,9138,10869,69240,365520,434760
2/18/2025,Vishal Chandrasiri,Nuwara Eliya,Balangoda,Central,6907,9721,16628,276280,388840,665120
2/19/2025,Vishal Chandrasiri,Nuwara Eliya,Balangoda,Central,5423,4475,9898,216920,179000,395920
2/20/2025,Vishal Chandrasiri,Nuwara Eliya,Balangoda,Central,2026,5319,7345,81040,212760,293800
2/21/2025,Vishal Chandrasiri,Nuwara Eliya,Balangoda,Central,1719,8269,9988,68760,330760,399520
2/22/2025,Vishal Chandrasiri,Nuwara Eliya,Balangoda,Central,1774,8074,9848,70960,322960,393920
2/23/2025,Vishal Chandrasiri,Nuwara Eliya,Balangoda,Central,1924,2032,3956,76960,81280,158240
2/24/2025,Vishal Chandrasiri,Nuwara Eliya,Balangoda,Central,6650,8088,14738,266000,323520,589520
2/25/2025,Vishal Chandrasiri,Nuwara Eliya,Balangoda,Central,6426,3368,9794,257040,134720,391760
2/26/2025,Vishal Chandrasiri,Nuwara Eliya,Balangoda,Central,9988,1065,11053,399520,42600,442120
2/27/2025,Vishal Chandrasiri,Nuwara Eliya,Balangoda,Central,5475,3080,8555,219000,123200,342200
2/28/2025,Vishal Chandrasiri,Nuwara Eliya,Balangoda,Central,93,1119,1212,3720,44760,48480
3/1/2025,Vishal Chandrasiri,Nuwara Eliya,Balangoda,Central,4611,3120,7731,184440,124800,309240
3/2/2025,Vishal Chandrasiri,Nuwara Eliya,Balangoda,Central,2216,5690,7906,88640,227600,316240
3/3/2025,Vishal Chandrasiri,Nuwara Eliya,Balangoda,Central,7217,3190,10407,288680,127600,416280
3/4/2025,Vishal Chandrasiri,Nuwara Eliya,Balangoda,Central,1219,4557,5776,48760,182280,231040
3/5/2025,Vishal Chandrasiri,Nuwara Eliya,Balangoda,Central,878,1975,2853,35120,79000,114120
3/6/2025,Vishal Chandrasiri,Nuwara Eliya,Balangoda,Central,8417,1851,10268,336680,74040,410720
3/7/2025,Vishal Chandrasiri,Nuwara Eliya,Balangoda,Central,7657,8990,16647,306280,359600,665880
3/8/2025,Vishal Chandrasiri,Nuwara Eliya,Balangoda,Central,7641,5454,13095,305640,218160,523800
3/9/2025,Vishal Chandrasiri,Nuwara Eliya,Balangoda,Central,8826,6727,15553,353040,269080,622120
3/10/2025,Vishal Chandrasiri,Nuwara Eliya,Balangoda,Central,8909,6520,15429,356360,260800,617160
3/11/2025,Vishal Chandrasiri,Nuwara Eliya,Balangoda,Central,5880,1588,7468,235200,63520,298720
3/12/2025,Vishal Chandrasiri,Nuwara Eliya,Balangoda,Central,3372,6295,9667,134880,251800,386680
3/13/2025,Vishal Chandrasiri,Nuwara Eliya,Balangoda,Central,1746,3450,5196,69840,138000,207840
3/14/2025,Vishal Chandrasiri,Nuwara Eliya,Balangoda,Central,4020,1975,5995,160800,79000,239800
3/15/2025,Vishal Chandrasiri,Nuwara Eliya,Balangoda,Central,3844,5121,8965,153760,204840,358600
3/16/2025,Vishal Chandrasiri,Nuwara Eliya,Balangoda,Central,9853,3745,13598,394120,149800,543920
3/17/2025,Vishal Chandrasiri,Nuwara Eliya,Balangoda,Central,5608,7368,12976,224320,294720,519040
3/18/2025,Vishal Chandrasiri,Nuwara Eliya,Balangoda,Central,337,8101,8438,13480,324040,337520
3/19/2025,Vishal Chandrasiri,Nuwara Eliya,Balangoda,Central,8996,1094,10090,359840,43760,403600
3/20/2025,Vishal Chandrasiri,Nuwara Eliya,Balangoda,Central,5519,9448,14967,220760,377920,598680
3/21/2025,Vishal Chandrasiri,Nuwara Eliya,Balangoda,Central,9611,2232,11843,384440,89280,473720
3/22/2025,Vishal Chandrasiri,Nuwara Eliya,Balangoda,Central,5462,872,6334,218480,34880,253360
3/23/2025,Vishal Chandrasiri,Nuwara Eliya,Balangoda,Central,1525,2812,4337,61000,112480,173480
3/25/2024,Nadeesha Gunaratne,Kalutara,Dodangoda,Western,3959,9250,13209,158360,370000,528360
3/26/2024,Nadeesha Gunaratne,Kalutara,Dodangoda,Western,6309,9071,15380,252360,362840,615200
3/27/2024,Nadeesha Gunaratne,Kalutara,Dodangoda,Western,9710,7448,17158,388400,297920,686320
3/28/2024,Nadeesha Gunaratne,Kalutara,Dodangoda,Western,3709,5820,9529,148360,232800,381160
3/29/2024,Nadeesha Gunaratne,Kalutara,Dodangoda,Western,9122,6709,15831,364880,268360,633240
3/30/2024,Nadeesha Gunaratne,Kalutara,Dodangoda,Western,1991,5487,7478,79640,219480,299120
3/31/2024,Nadeesha Gunaratne,Kalutara,Dodangoda,Western,6608,1505,8113,264320,60200,324520
4/1/2024,Nadeesha Gunaratne,Kalutara,Dodangoda,Western,179,4774,4953,7160,190960,198120
4/2/2024,Nadeesha Gunaratne,Kalutara,Dodangoda,Western,4384,4457,8841,175360,178280,353640
4/3/2024,Nadeesha Gunaratne,Kalutara,Dodangoda,Western,6390,4536,10926,255600,181440,437040
4/4/2024,Nadeesha Gunaratne,Kalutara,Dodangoda,Western,1927,1397,3324,77080,55880,132960
4/5/2024,Nadeesha Gunaratne,Kalutara,Dodangoda,Western,1145,2855,4000,45800,114200,160000
4/6/2024,Nadeesha Gunaratne,Kalutara,Dodangoda,Western,7409,4433,11842,296360,177320,473680
4/7/2024,Nadeesha Gunaratne,Kalutara,Dodangoda,Western,3331,7934,11265,133240,317360,450600
4/8/2024,Nadeesha Gunaratne,Kalutara,Dodangoda,Western,2458,969,3427,98320,38760,137080
4/9/2024,Nadeesha Gunaratne,Kalutara,Dodangoda,Western,8540,5895,14435,341600,235800,577400
4/10/2024,Nadeesha Gunaratne,Kalutara,Dodangoda,Western,4157,6308,10465,166280,252320,418600
4/11/2024,Nadeesha Gunaratne,Kalutara,Dodangoda,Western,2700,4528,7228,108000,181120,289120
4/19/2024,Nadeesha Gunaratne,Kalutara,Dodangoda,Western,5172,5972,11144,206880,238880,445760
4/20/2024,Nadeesha Gunaratne,Kalutara,Dodangoda,Western,5464,8494,13958,218560,339760,558320
4/21/2024,Nadeesha Gunaratne,Kalutara,Dodangoda,Western,9685,2043,11728,387400,81720,469120
4/22/2024,Nadeesha Gunaratne,Kalutara,Dodangoda,Western,1591,5558,7149,63640,222320,285960
4/23/2024,Nadeesha Gunaratne,Kalutara,Dodangoda,Western,4929,3085,8014,197160,123400,320560
4/24/2024,Nadeesha Gunaratne,Kalutara,Dodangoda,Western,8630,3028,11658,345200,121120,466320
4/25/2024,Nadeesha Gunaratne,Kalutara,Dodangoda,Western,4153,7222,11375,166120,288880,455000
4/26/2024,Nadeesha Gunaratne,Kalutara,Dodangoda,Western,4772,4714,9486,190880,188560,379440
4/27/2024,Nadeesha Gunaratne,Kalutara,Dodangoda,Western,8296,1667,9963,331840,66680,398520
4/28/2024,Nadeesha Gunaratne,Kalutara,Dodangoda,Western,7873,2976,10849,314920,119040,433960
4/29/2024,Nadeesha Gunaratne,Kalutara,Dodangoda,Western,9897,2156,12053,395880,86240,482120
4/30/2024,Nadeesha Gunaratne,Kalutara,Dodangoda,Western,5176,1580,6756,207040,63200,270240
5/1/2024,Nadeesha Gunaratne,Kalutara,Dodangoda,Western,1861,806,2667,74440,32240,106680
5/2/2024,Nadeesha Gunaratne,Kalutara,Dodangoda,Western,4668,442,5110,186720,17680,204400
5/3/2024,Nadeesha Gunaratne,Kalutara,Dodangoda,Western,8411,7756,16167,336440,310240,646680
5/4/2024,Nadeesha Gunaratne,Kalutara,Dodangoda,Western,2932,2571,5503,117280,102840,220120
5/5/2024,Nadeesha Gunaratne,Kalutara,Dodangoda,Western,4335,5262,9597,173400,210480,383880
5/6/2024,Nadeesha Gunaratne,Kalutara,Dodangoda,Western,4158,7961,12119,166320,318440,484760
5/7/2024,Nadeesha Gunaratne,Kalutara,Dodangoda,Western,4688,6382,11070,187520,255280,442800
5/8/2024,Nadeesha Gunaratne,Kalutara,Dodangoda,Western,5364,1560,6924,214560,62400,276960
5/9/2024,Nadeesha Gunaratne,Kalutara,Dodangoda,Western,7145,641,7786,285800,25640,311440
5/10/2024,Nadeesha Gunaratne,Kalutara,Dodangoda,Western,1765,5838,7603,70600,233520,304120
5/11/2024,Nadeesha Gunaratne,Kalutara,Dodangoda,Western,9367,4168,13535,374680,166720,541400
5/12/2024,Nadeesha Gunaratne,Kalutara,Dodangoda,Western,57,207,264,2280,8280,10560
5/13/2024,Nadeesha Gunaratne,Kalutara,Dodangoda,Western,5142,5653,10795,205680,226120,431800
5/14/2024,Nadeesha Gunaratne,Kalutara,Dodangoda,Western,4356,3740,8096,174240,149600,323840
5/15/2024,Nadeesha Gunaratne,Kalutara,Dodangoda,Western,7579,7616,15195,303160,304640,607800
5/16/2024,Nadeesha Gunaratne,Kalutara,Dodangoda,Western,5755,2909,8664,230200,116360,346560
5/17/2024,Nadeesha Gunaratne,Kalutara,Dodangoda,Western,1476,3410,4886,59040,136400,195440
5/18/2024,Nadeesha Gunaratne,Kalutara,Dodangoda,Western,1262,8107,9369,50480,324280,374760
5/19/2024,Nadeesha Gunaratne,Kalutara,Dodangoda,Western,2327,6944,9271,93080,277760,370840
5/20/2024,Nadeesha Gunaratne,Kalutara,Dodangoda,Western,8899,6623,15522,355960,264920,620880
5/21/2024,Nadeesha Gunaratne,Kalutara,Dodangoda,Western,5916,9404,15320,236640,376160,612800
5/22/2024,Nadeesha Gunaratne,Kalutara,Dodangoda,Western,2274,2406,4680,90960,96240,187200
5/24/2024,Nadeesha Gunaratne,Kalutara,Dodangoda,Western,8434,4211,12645,337360,168440,505800
5/25/2024,Nadeesha Gunaratne,Kalutara,Dodangoda,Western,270,2442,2712,10800,97680,108480
5/26/2024,Nadeesha Gunaratne,Kalutara,Dodangoda,Western,220,8379,8599,8800,335160,343960
5/27/2024,Nadeesha Gunaratne,Kalutara,Dodangoda,Western,445,8963,9408,17800,358520,376320
5/28/2024,Nadeesha Gunaratne,Kalutara,Dodangoda,Western,8810,8606,17416,352400,344240,696640
5/29/2024,Nadeesha Gunaratne,Kalutara,Dodangoda,Western,1404,8052,9456,56160,322080,378240
5/30/2024,Nadeesha Gunaratne,Kalutara,Dodangoda,Western,1134,9239,10373,45360,369560,414920
5/31/2024,Nadeesha Gunaratne,Kalutara,Dodangoda,Western,2312,7722,10034,92480,308880,401360
6/1/2024,Nadeesha Gunaratne,Kalutara,Dodangoda,Western,6201,1328,7529,248040,53120,301160
6/2/2024,Nadeesha Gunaratne,Kalutara,Dodangoda,Western,1960,2502,4462,78400,100080,178480
6/3/2024,Nadeesha Gunaratne,Kalutara,Dodangoda,Western,2398,1752,4150,95920,70080,166000
6/4/2024,Nadeesha Gunaratne,Kalutara,Dodangoda,Western,3429,694,4123,137160,27760,164920
6/5/2024,Nadeesha Gunaratne,Kalutara,Dodangoda,Western,6113,9646,15759,244520,385840,630360
6/6/2024,Nadeesha Gunaratne,Kalutara,Dodangoda,Western,5789,5120,10909,231560,204800,436360
6/7/2024,Nadeesha Gunaratne,Kalutara,Dodangoda,Western,160,5738,5898,6400,229520,235920
6/8/2024,Nadeesha Gunaratne,Kalutara,Dodangoda,Western,7431,3570,11001,297240,142800,440040
6/9/2024,Nadeesha Gunaratne,Kalutara,Dodangoda,Western,6326,6009,12335,253040,240360,493400
6/10/2024,Nadeesha Gunaratne,Kalutara,Dodangoda,Western,3162,7773,10935,126480,310920,437400
6/11/2024,Nadeesha Gunaratne,Kalutara,Dodangoda,Western,9689,888,10577,387560,35520,423080
6/12/2024,Nadeesha Gunaratne,Kalutara,Dodangoda,Western,1037,9288,10325,41480,371520,413000
6/13/2024,Nadeesha Gunaratne,Kalutara,Dodangoda,Western,2925,7361,10286,117000,294440,411440
6/14/2024,Nadeesha Gunaratne,Kalutara,Dodangoda,Western,1008,6366,7374,40320,254640,294960
6/15/2024,Nadeesha Gunaratne,Kalutara,Dodangoda,Western,868,1761,2629,34720,70440,105160
6/16/2024,Nadeesha Gunaratne,Kalutara,Dodangoda,Western,9921,7991,17912,396840,319640,716480
6/17/2024,Nadeesha Gunaratne,Kalutara,Dodangoda,Western,1303,6442,7745,52120,257680,309800
6/18/2024,Nadeesha Gunaratne,Kalutara,Dodangoda,Western,9444,159,9603,377760,6360,384120
6/19/2024,Nadeesha Gunaratne,Kalutara,Dodangoda,Western,8359,4993,13352,334360,199720,534080
6/20/2024,Nadeesha Gunaratne,Kalutara,Dodangoda,Western,8120,5199,13319,324800,207960,532760
6/21/2024,Nadeesha Gunaratne,Kalutara,Dodangoda,Western,8915,4752,13667,356600,190080,546680
6/22/2024,Nadeesha Gunaratne,Kalutara,Dodangoda,Western,8864,9652,18516,354560,386080,740640
6/23/2024,Nadeesha Gunaratne,Kalutara,Dodangoda,Western,3273,8467,11740,130920,338680,469600
6/24/2024,Nadeesha Gunaratne,Kalutara,Dodangoda,Western,2369,552,2921,94760,22080,116840
6/25/2024,Nadeesha Gunaratne,Kalutara,Dodangoda,Western,263,1609,1872,10520,64360,74880
6/26/2024,Nadeesha Gunaratne,Kalutara,Dodangoda,Western,6305,85,6390,252200,3400,255600
6/27/2024,Nadeesha Gunaratne,Kalutara,Dodangoda,Western,5519,8294,13813,220760,331760,552520
6/28/2024,Nadeesha Gunaratne,Kalutara,Dodangoda,Western,3433,2635,6068,137320,105400,242720
6/29/2024,Nadeesha Gunaratne,Kalutara,Dodangoda,Western,829,1029,1858,33160,41160,74320
6/30/2024,Nadeesha Gunaratne,Kalutara,Dodangoda,Western,177,4182,4359,7080,167280,174360
7/1/2024,Nadeesha Gunaratne,Kalutara,Dodangoda,Western,216,5816,6032,8640,232640,241280
7/2/2024,Nadeesha Gunaratne,Kalutara,Dodangoda,Western,293,1634,1927,11720,65360,77080
7/3/2024,Nadeesha Gunaratne,Kalutara,Dodangoda,Western,3966,5034,9000,158640,201360,360000
7/4/2024,Nadeesha Gunaratne,Kalutara,Dodangoda,Western,2530,6861,9391,101200,274440,375640
7/5/2024,Nadeesha Gunaratne,Kalutara,Dodangoda,Western,1403,9686,11089,56120,387440,443560
7/6/2024,Nadeesha Gunaratne,Kalutara,Dodangoda,Western,5607,487,6094,224280,19480,243760
7/7/2024,Nadeesha Gunaratne,Kalutara,Dodangoda,Western,1697,5370,7067,67880,214800,282680
7/8/2024,Nadeesha Gunaratne,Kalutara,Dodangoda,Western,3843,9796,13639,153720,391840,545560
7/9/2024,Nadeesha Gunaratne,Kalutara,Dodangoda,Western,992,1079,2071,39680,43160,82840
7/10/2024,Nadeesha Gunaratne,Kalutara,Dodangoda,Western,9457,3448,12905,378280,137920,516200
7/11/2024,Nadeesha Gunaratne,Kalutara,Dodangoda,Western,5376,214,5590,215040,8560,223600
7/12/2024,Nadeesha Gunaratne,Kalutara,Dodangoda,Western,9032,9785,18817,361280,391400,752680
7/13/2024,Nadeesha Gunaratne,Kalutara,Dodangoda,Western,8755,1735,10490,350200,69400,419600
7/14/2024,Nadeesha Gunaratne,Kalutara,Dodangoda,Western,5206,3176,8382,208240,127040,335280
7/15/2024,Nadeesha Gunaratne,Kalutara,Dodangoda,Western,5854,7398,13252,234160,295920,530080
7/16/2024,Nadeesha Gunaratne,Kalutara,Dodangoda,Western,6834,649,7483,273360,25960,299320
7/17/2024,Nadeesha Gunaratne,Kalutara,Dodangoda,Western,3809,9884,13693,152360,395360,547720
7/18/2024,Nadeesha Gunaratne,Kalutara,Dodangoda,Western,2634,5411,8045,105360,216440,321800
7/19/2024,Nadeesha Gunaratne,Kalutara,Dodangoda,Western,1275,2600,3875,51000,104000,155000
7/20/2024,Nadeesha Gunaratne,Kalutara,Dodangoda,Western,691,9076,9767,27640,363040,390680
7/21/2024,Nadeesha Gunaratne,Kalutara,Dodangoda,Western,2368,6946,9314,94720,277840,372560
7/22/2024,Nadeesha Gunaratne,Kalutara,Dodangoda,Western,4304,677,4981,172160,27080,199240
7/23/2024,Nadeesha Gunaratne,Kalutara,Dodangoda,Western,8722,8405,17127,348880,336200,685080
7/24/2024,Nadeesha Gunaratne,Kalutara,Dodangoda,Western,4569,5958,10527,182760,238320,421080
7/25/2024,Nadeesha Gunaratne,Kalutara,Dodangoda,Western,1917,8571,10488,76680,342840,419520
7/26/2024,Nadeesha Gunaratne,Kalutara,Dodangoda,Western,5303,2911,8214,212120,116440,328560
7/27/2024,Nadeesha Gunaratne,Kalutara,Dodangoda,Western,1553,72,1625,62120,2880,65000
7/28/2024,Nadeesha Gunaratne,Kalutara,Dodangoda,Western,85,2572,2657,3400,102880,106280
7/29/2024,Nadeesha Gunaratne,Kalutara,Dodangoda,Western,8074,800,8874,322960,32000,354960
7/30/2024,Nadeesha Gunaratne,Kalutara,Dodangoda,Western,7171,3423,10594,286840,136920,423760
7/31/2024,Nadeesha Gunaratne,Kalutara,Dodangoda,Western,7290,3224,10514,291600,128960,420560
8/1/2024,Nadeesha Gunaratne,Kalutara,Dodangoda,Western,5519,7934,13453,220760,317360,538120
8/2/2024,Nadeesha Gunaratne,Kalutara,Dodangoda,Western,99,5051,5150,3960,202040,206000
8/3/2024,Nadeesha Gunaratne,Kalutara,Dodangoda,Western,653,2092,2745,26120,83680,109800
8/4/2024,Nadeesha Gunaratne,Kalutara,Dodangoda,Western,5850,6885,12735,234000,275400,509400
8/5/2024,Nadeesha Gunaratne,Kalutara,Dodangoda,Western,8712,7470,16182,348480,298800,647280
8/6/2024,Nadeesha Gunaratne,Kalutara,Dodangoda,Western,6958,2068,9026,278320,82720,361040
8/7/2024,Nadeesha Gunaratne,Kalutara,Dodangoda,Western,1306,9328,10634,52240,373120,425360
8/8/2024,Nadeesha Gunaratne,Kalutara,Dodangoda,Western,9566,1768,11334,382640,70720,453360
8/9/2024,Nadeesha Gunaratne,Kalutara,Dodangoda,Western,9963,5770,15733,398520,230800,629320
8/10/2024,Nadeesha Gunaratne,Kalutara,Dodangoda,Western,4685,1666,6351,187400,66640,254040
8/11/2024,Nadeesha Gunaratne,Kalutara,Dodangoda,Western,919,7146,8065,36760,285840,322600
8/12/2024,Nadeesha Gunaratne,Kalutara,Dodangoda,Western,2775,8580,11355,111000,343200,454200
8/13/2024,Nadeesha Gunaratne,Kalutara,Dodangoda,Western,2524,4146,6670,100960,165840,266800
8/14/2024,Nadeesha Gunaratne,Kalutara,Dodangoda,Western,754,5393,6147,30160,215720,245880
8/15/2024,Nadeesha Gunaratne,Kalutara,Dodangoda,Western,6818,6838,13656,272720,273520,546240
8/16/2024,Nadeesha Gunaratne,Kalutara,Dodangoda,Western,8670,887,9557,346800,35480,382280
8/17/2024,Nadeesha Gunaratne,Kalutara,Dodangoda,Western,7410,5820,13230,296400,232800,529200
8/18/2024,Nadeesha Gunaratne,Kalutara,Dodangoda,Western,1563,2714,4277,62520,108560,171080
8/19/2024,Nadeesha Gunaratne,Kalutara,Dodangoda,Western,4791,9966,14757,191640,398640,590280
8/20/2024,Nadeesha Gunaratne,Kalutara,Dodangoda,Western,7861,2326,10187,314440,93040,407480
8/21/2024,Nadeesha Gunaratne,Kalutara,Dodangoda,Western,330,8959,9289,13200,358360,371560
8/22/2024,Nadeesha Gunaratne,Kalutara,Dodangoda,Western,6221,8900,15121,248840,356000,604840
8/23/2024,Nadeesha Gunaratne,Kalutara,Dodangoda,Western,4119,1862,5981,164760,74480,239240
8/24/2024,Nadeesha Gunaratne,Kalutara,Dodangoda,Western,1507,8655,10162,60280,346200,406480
8/25/2024,Nadeesha Gunaratne,Kalutara,Dodangoda,Western,857,8168,9025,34280,326720,361000
8/26/2024,Nadeesha Gunaratne,Kalutara,Dodangoda,Western,2116,4673,6789,84640,186920,271560
8/27/2024,Nadeesha Gunaratne,Kalutara,Dodangoda,Western,2256,3107,5363,90240,124280,214520
8/28/2024,Nadeesha Gunaratne,Kalutara,Dodangoda,Western,5981,2530,8511,239240,101200,340440
8/29/2024,Nadeesha Gunaratne,Kalutara,Dodangoda,Western,2229,7524,9753,89160,300960,390120
8/30/2024,Nadeesha Gunaratne,Kalutara,Dodangoda,Western,2513,6293,8806,100520,251720,352240
8/31/2024,Nadeesha Gunaratne,Kalutara,Dodangoda,Western,2837,5012,7849,113480,200480,313960
9/1/2024,Nadeesha Gunaratne,Kalutara,Dodangoda,Western,2701,3848,6549,108040,153920,261960
9/2/2024,Nadeesha Gunaratne,Kalutara,Dodangoda,Western,3876,7213,11089,155040,288520,443560
9/3/2024,Nadeesha Gunaratne,Kalutara,Dodangoda,Western,9117,3131,12248,364680,125240,489920
9/4/2024,Nadeesha Gunaratne,Kalutara,Dodangoda,Western,3601,3096,6697,144040,123840,267880
9/5/2024,Nadeesha Gunaratne,Kalutara,Dodangoda,Western,6104,2703,8807,244160,108120,352280
9/6/2024,Nadeesha Gunaratne,Kalutara,Dodangoda,Western,3267,1771,5038,130680,70840,201520
9/7/2024,Nadeesha Gunaratne,Kalutara,Dodangoda,Western,9099,8170,17269,363960,326800,690760
9/8/2024,Nadeesha Gunaratne,Kalutara,Dodangoda,Western,3147,469,3616,125880,18760,144640
9/9/2024,Nadeesha Gunaratne,Kalutara,Dodangoda,Western,9325,1649,10974,373000,65960,438960
9/10/2024,Nadeesha Gunaratne,Kalutara,Dodangoda,Western,9583,3255,12838,383320,130200,513520
9/11/2024,Nadeesha Gunaratne,Kalutara,Dodangoda,Western,9082,7998,17080,363280,319920,683200
9/12/2024,Nadeesha Gunaratne,Kalutara,Dodangoda,Western,7604,2951,10555,304160,118040,422200
9/13/2024,Nadeesha Gunaratne,Kalutara,Dodangoda,Western,5884,1606,7490,235360,64240,299600
9/14/2024,Nadeesha Gunaratne,Kalutara,Dodangoda,Western,3984,3327,7311,159360,133080,292440
9/15/2024,Nadeesha Gunaratne,Kalutara,Dodangoda,Western,1129,5822,6951,45160,232880,278040
9/16/2024,Nadeesha Gunaratne,Kalutara,Dodangoda,Western,483,8206,8689,19320,328240,347560
9/17/2024,Nadeesha Gunaratne,Kalutara,Dodangoda,Western,3985,7393,11378,159400,295720,455120
9/18/2024,Nadeesha Gunaratne,Kalutara,Dodangoda,Western,5348,8772,14120,213920,350880,564800
9/19/2024,Nadeesha Gunaratne,Kalutara,Dodangoda,Western,5193,8116,13309,207720,324640,532360
9/20/2024,Nadeesha Gunaratne,Kalutara,Dodangoda,Western,7954,9699,17653,318160,387960,706120
9/21/2024,Nadeesha Gunaratne,Kalutara,Dodangoda,Western,3461,5214,8675,138440,208560,347000
9/22/2024,Nadeesha Gunaratne,Kalutara,Dodangoda,Western,9729,615,10344,389160,24600,413760
9/23/2024,Nadeesha Gunaratne,Kalutara,Dodangoda,Western,7284,937,8221,291360,37480,328840
9/24/2024,Nadeesha Gunaratne,Kalutara,Dodangoda,Western,7949,6709,14658,317960,268360,586320
9/25/2024,Nadeesha Gunaratne,Kalutara,Dodangoda,Western,6916,4744,11660,276640,189760,466400
9/26/2024,Nadeesha Gunaratne,Kalutara,Dodangoda,Western,9713,2259,11972,388520,90360,478880
9/27/2024,Nadeesha Gunaratne,Kalutara,Dodangoda,Western,5096,488,5584,203840,19520,223360
9/28/2024,Nadeesha Gunaratne,Kalutara,Dodangoda,Western,6249,5350,11599,249960,214000,463960
9/29/2024,Nadeesha Gunaratne,Kalutara,Dodangoda,Western,1355,4351,5706,54200,174040,228240
9/30/2024,Nadeesha Gunaratne,Kalutara,Dodangoda,Western,8544,6943,15487,341760,277720,619480
10/1/2024,Nadeesha Gunaratne,Kalutara,Dodangoda,Western,6269,2257,8526,250760,90280,341040
10/2/2024,Nadeesha Gunaratne,Kalutara,Dodangoda,Western,8318,126,8444,332720,5040,337760
10/3/2024,Nadeesha Gunaratne,Kalutara,Dodangoda,Western,9597,1355,10952,383880,54200,438080
10/4/2024,Nadeesha Gunaratne,Kalutara,Dodangoda,Western,5322,329,5651,212880,13160,226040
10/5/2024,Nadeesha Gunaratne,Kalutara,Dodangoda,Western,7731,2624,10355,309240,104960,414200
10/6/2024,Nadeesha Gunaratne,Kalutara,Dodangoda,Western,2970,5450,8420,118800,218000,336800
10/7/2024,Nadeesha Gunaratne,Kalutara,Dodangoda,Western,2839,8037,10876,113560,321480,435040
10/8/2024,Nadeesha Gunaratne,Kalutara,Dodangoda,Western,2464,8287,10751,98560,331480,430040
10/9/2024,Nadeesha Gunaratne,Kalutara,Dodangoda,Western,130,1988,2118,5200,79520,84720
10/10/2024,Nadeesha Gunaratne,Kalutara,Dodangoda,Western,3667,2885,6552,146680,115400,262080
10/11/2024,Nadeesha Gunaratne,Kalutara,Dodangoda,Western,1740,3082,4822,69600,123280,192880
10/12/2024,Nadeesha Gunaratne,Kalutara,Dodangoda,Western,6175,8018,14193,247000,320720,567720
10/13/2024,Nadeesha Gunaratne,Kalutara,Dodangoda,Western,5410,3873,9283,216400,154920,371320
10/14/2024,Nadeesha Gunaratne,Kalutara,Dodangoda,Western,5342,9742,15084,213680,389680,603360
10/15/2024,Nadeesha Gunaratne,Kalutara,Dodangoda,Western,4423,6709,11132,176920,268360,445280
10/16/2024,Nadeesha Gunaratne,Kalutara,Dodangoda,Western,8803,5045,13848,352120,201800,553920
10/17/2024,Nadeesha Gunaratne,Kalutara,Dodangoda,Western,3779,6406,10185,151160,256240,407400
10/18/2024,Nadeesha Gunaratne,Kalutara,Dodangoda,Western,3715,7172,10887,148600,286880,435480
10/19/2024,Nadeesha Gunaratne,Kalutara,Dodangoda,Western,9392,1584,10976,375680,63360,439040
10/20/2024,Nadeesha Gunaratne,Kalutara,Dodangoda,Western,5288,1723,7011,211520,68920,280440
10/21/2024,Nadeesha Gunaratne,Kalutara,Dodangoda,Western,6542,811,7353,261680,32440,294120
10/22/2024,Nadeesha Gunaratne,Kalutara,Dodangoda,Western,1070,1730,2800,42800,69200,112000
10/23/2024,Nadeesha Gunaratne,Kalutara,Dodangoda,Western,2469,5718,8187,98760,228720,327480
10/24/2024,Nadeesha Gunaratne,Kalutara,Dodangoda,Western,3528,1463,4991,141120,58520,199640
10/25/2024,Nadeesha Gunaratne,Kalutara,Dodangoda,Western,6749,2796,9545,269960,111840,381800
10/26/2024,Nadeesha Gunaratne,Kalutara,Dodangoda,Western,8740,5476,14216,349600,219040,568640
10/27/2024,Nadeesha Gunaratne,Kalutara,Dodangoda,Western,5789,574,6363,231560,22960,254520
10/28/2024,Nadeesha Gunaratne,Kalutara,Dodangoda,Western,9844,7518,17362,393760,300720,694480
10/29/2024,Nadeesha Gunaratne,Kalutara,Dodangoda,Western,3423,6710,10133,136920,268400,405320
10/30/2024,Nadeesha Gunaratne,Kalutara,Dodangoda,Western,4930,3557,8487,197200,142280,339480
10/31/2024,Nadeesha Gunaratne,Kalutara,Dodangoda,Western,8313,832,9145,332520,33280,365800
11/1/2024,Nadeesha Gunaratne,Kalutara,Dodangoda,Western,1026,4143,5169,41040,165720,206760
11/2/2024,Nadeesha Gunaratne,Kalutara,Dodangoda,Western,6619,7123,13742,264760,284920,549680
11/3/2024,Nadeesha Gunaratne,Kalutara,Dodangoda,Western,6809,7476,14285,272360,299040,571400
11/4/2024,Nadeesha Gunaratne,Kalutara,Dodangoda,Western,4354,757,5111,174160,30280,204440
11/5/2024,Nadeesha Gunaratne,Kalutara,Dodangoda,Western,5624,3124,8748,224960,124960,349920
11/6/2024,Nadeesha Gunaratne,Kalutara,Dodangoda,Western,1477,1002,2479,59080,40080,99160
11/7/2024,Nadeesha Gunaratne,Kalutara,Dodangoda,Western,9584,2733,12317,383360,109320,492680
11/8/2024,Nadeesha Gunaratne,Kalutara,Dodangoda,Western,1570,495,2065,62800,19800,82600
11/9/2024,Nadeesha Gunaratne,Kalutara,Dodangoda,Western,9509,5915,15424,380360,236600,616960
11/10/2024,Nadeesha Gunaratne,Kalutara,Dodangoda,Western,6109,9603,15712,244360,384120,628480
11/11/2024,Nadeesha Gunaratne,Kalutara,Dodangoda,Western,9887,8042,17929,395480,321680,717160
11/12/2024,Nadeesha Gunaratne,Kalutara,Dodangoda,Western,7928,2683,10611,317120,107320,424440
11/13/2024,Nadeesha Gunaratne,Kalutara,Dodangoda,Western,3010,6525,9535,120400,261000,381400
11/14/2024,Nadeesha Gunaratne,Kalutara,Dodangoda,Western,1227,2211,3438,49080,88440,137520
11/15/2024,Nadeesha Gunaratne,Kalutara,Dodangoda,Western,7857,5115,12972,314280,204600,518880
11/16/2024,Nadeesha Gunaratne,Kalutara,Dodangoda,Western,798,9765,10563,31920,390600,422520
11/17/2024,Nadeesha Gunaratne,Kalutara,Dodangoda,Western,2608,4150,6758,104320,166000,270320
11/18/2024,Nadeesha Gunaratne,Kalutara,Dodangoda,Western,7114,892,8006,284560,35680,320240
11/19/2024,Nadeesha Gunaratne,Kalutara,Dodangoda,Western,9542,8494,18036,381680,339760,721440
11/20/2024,Nadeesha Gunaratne,Kalutara,Dodangoda,Western,1383,9337,10720,55320,373480,428800
11/21/2024,Nadeesha Gunaratne,Kalutara,Dodangoda,Western,3543,9095,12638,141720,363800,505520
11/22/2024,Nadeesha Gunaratne,Kalutara,Dodangoda,Western,7636,1124,8760,305440,44960,350400
11/23/2024,Nadeesha Gunaratne,Kalutara,Dodangoda,Western,1683,3868,5551,67320,154720,222040
11/24/2024,Nadeesha Gunaratne,Kalutara,Dodangoda,Western,2974,2332,5306,118960,93280,212240
11/25/2024,Nadeesha Gunaratne,Kalutara,Dodangoda,Western,398,8343,8741,15920,333720,349640
11/26/2024,Nadeesha Gunaratne,Kalutara,Dodangoda,Western,4980,4487,9467,199200,179480,378680
11/27/2024,Nadeesha Gunaratne,Kalutara,Dodangoda,Western,9520,1593,11113,380800,63720,444520
11/28/2024,Nadeesha Gunaratne,Kalutara,Dodangoda,Western,3392,7958,11350,135680,318320,454000
11/29/2024,Nadeesha Gunaratne,Kalutara,Dodangoda,Western,4017,8701,12718,160680,348040,508720
11/30/2024,Nadeesha Gunaratne,Kalutara,Dodangoda,Western,869,1565,2434,34760,62600,97360
12/1/2024,Nadeesha Gunaratne,Kalutara,Dodangoda,Western,2566,7672,10238,102640,306880,409520
12/2/2024,Nadeesha Gunaratne,Kalutara,Dodangoda,Western,7114,1127,8241,284560,45080,329640
12/3/2024,Nadeesha Gunaratne,Kalutara,Dodangoda,Western,6662,8272,14934,266480,330880,597360
12/4/2024,Nadeesha Gunaratne,Kalutara,Dodangoda,Western,508,3248,3756,20320,129920,150240
12/5/2024,Nadeesha Gunaratne,Kalutara,Dodangoda,Western,6119,126,6245,244760,5040,249800
12/6/2024,Nadeesha Gunaratne,Kalutara,Dodangoda,Western,2830,3960,6790,113200,158400,271600
12/7/2024,Nadeesha Gunaratne,Kalutara,Dodangoda,Western,6386,7713,14099,255440,308520,563960
12/8/2024,Nadeesha Gunaratne,Kalutara,Dodangoda,Western,8582,6635,15217,343280,265400,608680
12/9/2024,Nadeesha Gunaratne,Kalutara,Dodangoda,Western,1635,3075,4710,65400,123000,188400
12/10/2024,Nadeesha Gunaratne,Kalutara,Dodangoda,Western,8809,7272,16081,352360,290880,643240
12/11/2024,Nadeesha Gunaratne,Kalutara,Dodangoda,Western,4097,1466,5563,163880,58640,222520
12/12/2024,Nadeesha Gunaratne,Kalutara,Dodangoda,Western,11,8728,8739,440,349120,349560
12/13/2024,Nadeesha Gunaratne,Kalutara,Dodangoda,Western,4008,2573,6581,160320,102920,263240
12/14/2024,Nadeesha Gunaratne,Kalutara,Dodangoda,Western,7009,5066,12075,280360,202640,483000
12/15/2024,Nadeesha Gunaratne,Kalutara,Dodangoda,Western,8926,6308,15234,357040,252320,609360
12/16/2024,Nadeesha Gunaratne,Kalutara,Dodangoda,Western,317,970,1287,12680,38800,51480
12/17/2024,Nadeesha Gunaratne,Kalutara,Dodangoda,Western,3097,3498,6595,123880,139920,263800
12/18/2024,Nadeesha Gunaratne,Kalutara,Dodangoda,Western,3973,7855,11828,158920,314200,473120
12/19/2024,Nadeesha Gunaratne,Kalutara,Dodangoda,Western,6368,9653,16021,254720,386120,640840
12/20/2024,Nadeesha Gunaratne,Kalutara,Dodangoda,Western,2511,9524,12035,100440,380960,481400
12/21/2024,Nadeesha Gunaratne,Kalutara,Dodangoda,Western,9604,1674,11278,384160,66960,451120
12/22/2024,Nadeesha Gunaratne,Kalutara,Dodangoda,Western,6724,70,6794,268960,2800,271760
12/23/2024,Nadeesha Gunaratne,Kalutara,Dodangoda,Western,3326,7975,11301,133040,319000,452040
12/24/2024,Nadeesha Gunaratne,Kalutara,Dodangoda,Western,8192,7958,16150,327680,318320,646000
12/25/2024,Nadeesha Gunaratne,Kalutara,Dodangoda,Western,4558,3616,8174,182320,144640,326960
12/26/2024,Nadeesha Gunaratne,Kalutara,Dodangoda,Western,9678,7078,16756,387120,283120,670240
12/27/2024,Nadeesha Gunaratne,Kalutara,Dodangoda,Western,1705,5886,7591,68200,235440,303640
12/28/2024,Nadeesha Gunaratne,Kalutara,Dodangoda,Western,2660,4132,6792,106400,165280,271680
12/29/2024,Nadeesha Gunaratne,Kalutara,Dodangoda,Western,5008,3560,8568,200320,142400,342720
12/30/2024,Nadeesha Gunaratne,Kalutara,Dodangoda,Western,7288,5513,12801,291520,220520,512040
12/31/2024,Nadeesha Gunaratne,Kalutara,Dodangoda,Western,4319,7147,11466,172760,285880,458640
1/1/2025,Nadeesha Gunaratne,Kalutara,Dodangoda,Western,5230,9234,14464,209200,369360,578560
1/2/2025,Nadeesha Gunaratne,Kalutara,Dodangoda,Western,612,900,1512,24480,36000,60480
1/3/2025,Nadeesha Gunaratne,Kalutara,Dodangoda,Western,7582,3252,10834,303280,130080,433360
1/4/2025,Nadeesha Gunaratne,Kalutara,Dodangoda,Western,5306,4804,10110,212240,192160,404400
1/5/2025,Nadeesha Gunaratne,Kalutara,Dodangoda,Western,9245,6506,15751,369800,260240,630040
1/6/2025,Nadeesha Gunaratne,Kalutara,Dodangoda,Western,1751,591,2342,70040,23640,93680
1/7/2025,Nadeesha Gunaratne,Kalutara,Dodangoda,Western,6029,7049,13078,241160,281960,523120
1/8/2025,Nadeesha Gunaratne,Kalutara,Dodangoda,Western,5192,7751,12943,207680,310040,517720
1/9/2025,Nadeesha Gunaratne,Kalutara,Dodangoda,Western,9527,8262,17789,381080,330480,711560
1/10/2025,Nadeesha Gunaratne,Kalutara,Dodangoda,Western,917,4356,5273,36680,174240,210920
1/11/2025,Nadeesha Gunaratne,Kalutara,Dodangoda,Western,6083,8091,14174,243320,323640,566960
1/12/2025,Nadeesha Gunaratne,Kalutara,Dodangoda,Western,6468,6244,12712,258720,249760,508480
1/13/2025,Nadeesha Gunaratne,Kalutara,Dodangoda,Western,6355,9101,15456,254200,364040,618240
1/14/2025,Nadeesha Gunaratne,Kalutara,Dodangoda,Western,4002,4624,8626,160080,184960,345040
1/15/2025,Nadeesha Gunaratne,Kalutara,Dodangoda,Western,2384,276,2660,95360,11040,106400
1/16/2025,Nadeesha Gunaratne,Kalutara,Dodangoda,Western,2131,8244,10375,85240,329760,415000
1/17/2025,Nadeesha Gunaratne,Kalutara,Dodangoda,Western,1583,4270,5853,63320,170800,234120
1/18/2025,Nadeesha Gunaratne,Kalutara,Dodangoda,Western,1559,6863,8422,62360,274520,336880
1/19/2025,Nadeesha Gunaratne,Kalutara,Dodangoda,Western,6492,8953,15445,259680,358120,617800
1/20/2025,Nadeesha Gunaratne,Kalutara,Dodangoda,Western,3210,7284,10494,128400,291360,419760
1/21/2025,Nadeesha Gunaratne,Kalutara,Dodangoda,Western,9896,3844,13740,395840,153760,549600
1/22/2025,Nadeesha Gunaratne,Kalutara,Dodangoda,Western,4417,3471,7888,176680,138840,315520
1/23/2025,Nadeesha Gunaratne,Kalutara,Dodangoda,Western,795,3015,3810,31800,120600,152400
1/24/2025,Nadeesha Gunaratne,Kalutara,Dodangoda,Western,1401,5023,6424,56040,200920,256960
1/25/2025,Nadeesha Gunaratne,Kalutara,Dodangoda,Western,7969,9851,17820,318760,394040,712800
1/26/2025,Nadeesha Gunaratne,Kalutara,Dodangoda,Western,2095,1717,3812,83800,68680,152480
1/27/2025,Nadeesha Gunaratne,Kalutara,Dodangoda,Western,6241,8228,14469,249640,329120,578760
1/28/2025,Nadeesha Gunaratne,Kalutara,Dodangoda,Western,9094,45,9139,363760,1800,365560
1/29/2025,Nadeesha Gunaratne,Kalutara,Dodangoda,Western,9096,7365,16461,363840,294600,658440
1/30/2025,Nadeesha Gunaratne,Kalutara,Dodangoda,Western,1305,5046,6351,52200,201840,254040
1/31/2025,Nadeesha Gunaratne,Kalutara,Dodangoda,Western,2177,6630,8807,87080,265200,352280
2/1/2025,Nadeesha Gunaratne,Kalutara,Dodangoda,Western,1827,8008,9835,73080,320320,393400
2/2/2025,Nadeesha Gunaratne,Kalutara,Dodangoda,Western,7740,7271,15011,309600,290840,600440
2/3/2025,Nadeesha Gunaratne,Kalutara,Dodangoda,Western,6747,3258,10005,269880,130320,400200
2/4/2025,Nadeesha Gunaratne,Kalutara,Dodangoda,Western,2666,5351,8017,106640,214040,320680
2/5/2025,Nadeesha Gunaratne,Kalutara,Dodangoda,Western,6465,7632,14097,258600,305280,563880
2/6/2025,Nadeesha Gunaratne,Kalutara,Dodangoda,Western,7462,8498,15960,298480,339920,638400
2/7/2025,Nadeesha Gunaratne,Kalutara,Dodangoda,Western,4694,7458,12152,187760,298320,486080
2/8/2025,Nadeesha Gunaratne,Kalutara,Dodangoda,Western,9581,5685,15266,383240,227400,610640
2/9/2025,Nadeesha Gunaratne,Kalutara,Dodangoda,Western,9929,4399,14328,397160,175960,573120
2/10/2025,Nadeesha Gunaratne,Kalutara,Dodangoda,Western,1244,4951,6195,49760,198040,247800
2/11/2025,Nadeesha Gunaratne,Kalutara,Dodangoda,Western,7192,7952,15144,287680,318080,605760
2/12/2025,Nadeesha Gunaratne,Kalutara,Dodangoda,Western,8145,9512,17657,325800,380480,706280
2/13/2025,Nadeesha Gunaratne,Kalutara,Dodangoda,Western,2345,8706,11051,93800,348240,442040
2/14/2025,Nadeesha Gunaratne,Kalutara,Dodangoda,Western,7591,9413,17004,303640,376520,680160
2/15/2025,Nadeesha Gunaratne,Kalutara,Dodangoda,Western,5774,3928,9702,230960,157120,388080
2/16/2025,Nadeesha Gunaratne,Kalutara,Dodangoda,Western,368,2862,3230,14720,114480,129200
2/17/2025,Nadeesha Gunaratne,Kalutara,Dodangoda,Western,7733,3884,11617,309320,155360,464680
2/18/2025,Nadeesha Gunaratne,Kalutara,Dodangoda,Western,7420,8801,16221,296800,352040,648840
2/19/2025,Nadeesha Gunaratne,Kalutara,Dodangoda,Western,2609,627,3236,104360,25080,129440
2/20/2025,Nadeesha Gunaratne,Kalutara,Dodangoda,Western,6673,7307,13980,266920,292280,559200
2/21/2025,Nadeesha Gunaratne,Kalutara,Dodangoda,Western,9855,8357,18212,394200,334280,728480
2/22/2025,Nadeesha Gunaratne,Kalutara,Dodangoda,Western,305,464,769,12200,18560,30760
2/23/2025,Nadeesha Gunaratne,Kalutara,Dodangoda,Western,1754,9591,11345,70160,383640,453800
2/24/2025,Nadeesha Gunaratne,Kalutara,Dodangoda,Western,6371,5264,11635,254840,210560,465400
2/25/2025,Nadeesha Gunaratne,Kalutara,Dodangoda,Western,6220,2518,8738,248800,100720,349520
2/26/2025,Nadeesha Gunaratne,Kalutara,Dodangoda,Western,1120,4183,5303,44800,167320,212120
2/27/2025,Nadeesha Gunaratne,Kalutara,Dodangoda,Western,4692,3255,7947,187680,130200,317880
2/28/2025,Nadeesha Gunaratne,Kalutara,Dodangoda,Western,3697,7352,11049,147880,294080,441960
3/1/2025,Nadeesha Gunaratne,Kalutara,Dodangoda,Western,7360,1898,9258,294400,75920,370320
3/2/2025,Nadeesha Gunaratne,Kalutara,Dodangoda,Western,1694,6194,7888,67760,247760,315520
3/3/2025,Nadeesha Gunaratne,Kalutara,Dodangoda,Western,6076,4047,10123,243040,161880,404920
3/4/2025,Nadeesha Gunaratne,Kalutara,Dodangoda,Western,1030,2363,3393,41200,94520,135720
3/5/2025,Nadeesha Gunaratne,Kalutara,Dodangoda,Western,563,2163,2726,22520,86520,109040
3/6/2025,Nadeesha Gunaratne,Kalutara,Dodangoda,Western,2740,6017,8757,109600,240680,350280
3/7/2025,Nadeesha Gunaratne,Kalutara,Dodangoda,Western,53,906,959,2120,36240,38360
3/8/2025,Nadeesha Gunaratne,Kalutara,Dodangoda,Western,859,1824,2683,34360,72960,107320
3/9/2025,Nadeesha Gunaratne,Kalutara,Dodangoda,Western,7017,611,7628,280680,24440,305120
3/10/2025,Nadeesha Gunaratne,Kalutara,Dodangoda,Western,4922,7438,12360,196880,297520,494400
3/11/2025,Nadeesha Gunaratne,Kalutara,Dodangoda,Western,1347,1612,2959,53880,64480,118360
3/12/2025,Nadeesha Gunaratne,Kalutara,Dodangoda,Western,4966,3482,8448,198640,139280,337920
3/13/2025,Nadeesha Gunaratne,Kalutara,Dodangoda,Western,5473,1163,6636,218920,46520,265440
3/14/2025,Nadeesha Gunaratne,Kalutara,Dodangoda,Western,179,6952,7131,7160,278080,285240
3/15/2025,Nadeesha Gunaratne,Kalutara,Dodangoda,Western,489,4175,4664,19560,167000,186560
3/16/2025,Nadeesha Gunaratne,Kalutara,Dodangoda,Western,2296,5645,7941,91840,225800,317640
3/17/2025,Nadeesha Gunaratne,Kalutara,Dodangoda,Western,935,5898,6833,37400,235920,273320
3/18/2025,Nadeesha Gunaratne,Kalutara,Dodangoda,Western,3388,8660,12048,135520,346400,481920
3/19/2025,Nadeesha Gunaratne,Kalutara,Dodangoda,Western,3727,8236,11963,149080,329440,478520
3/20/2025,Nadeesha Gunaratne,Kalutara,Dodangoda,Western,1275,464,1739,51000,18560,69560
3/21/2025,Nadeesha Gunaratne,Kalutara,Dodangoda,Western,495,789,1284,19800,31560,51360
3/22/2025,Nadeesha Gunaratne,Kalutara,Dodangoda,Western,8275,8016,16291,331000,320640,651640
3/23/2025,Nadeesha Gunaratne,Kalutara,Dodangoda,Western,9293,6409,15702,371720,256360,628080
3/25/2024,Kumudu Jayasuriya,Anuradhapura,Anuradhapura,North Central,989,8706,9695,39560,348240,387800
3/26/2024,Kumudu Jayasuriya,Anuradhapura,Anuradhapura,North Central,2384,4677,7061,95360,187080,282440
3/27/2024,Kumudu Jayasuriya,Anuradhapura,Anuradhapura,North Central,2012,6203,8215,80480,248120,328600
3/28/2024,Kumudu Jayasuriya,Anuradhapura,Anuradhapura,North Central,813,1070,1883,32520,42800,75320
3/29/2024,Kumudu Jayasuriya,Anuradhapura,Anuradhapura,North Central,6730,7030,13760,269200,281200,550400
3/30/2024,Kumudu Jayasuriya,Anuradhapura,Anuradhapura,North Central,4766,5941,10707,190640,237640,428280
3/31/2024,Kumudu Jayasuriya,Anuradhapura,Anuradhapura,North Central,1006,3984,4990,40240,159360,199600
4/1/2024,Kumudu Jayasuriya,Anuradhapura,Anuradhapura,North Central,2716,5507,8223,108640,220280,328920
4/2/2024,Kumudu Jayasuriya,Anuradhapura,Anuradhapura,North Central,6171,7267,13438,246840,290680,537520
4/3/2024,Kumudu Jayasuriya,Anuradhapura,Anuradhapura,North Central,4035,5300,9335,161400,212000,373400
4/4/2024,Kumudu Jayasuriya,Anuradhapura,Anuradhapura,North Central,4254,5428,9682,170160,217120,387280
4/5/2024,Kumudu Jayasuriya,Anuradhapura,Anuradhapura,North Central,7800,8665,16465,312000,346600,658600
4/6/2024,Kumudu Jayasuriya,Anuradhapura,Anuradhapura,North Central,2861,5517,8378,114440,220680,335120
4/7/2024,Kumudu Jayasuriya,Anuradhapura,Anuradhapura,North Central,5458,4027,9485,218320,161080,379400
4/8/2024,Kumudu Jayasuriya,Anuradhapura,Anuradhapura,North Central,5896,6016,11912,235840,240640,476480
4/9/2024,Kumudu Jayasuriya,Anuradhapura,Anuradhapura,North Central,6646,5589,12235,265840,223560,489400
4/10/2024,Kumudu Jayasuriya,Anuradhapura,Anuradhapura,North Central,6144,2381,8525,245760,95240,341000
4/11/2024,Kumudu Jayasuriya,Anuradhapura,Anuradhapura,North Central,9297,9085,18382,371880,363400,735280
4/19/2024,Kumudu Jayasuriya,Anuradhapura,Anuradhapura,North Central,2778,6746,9524,111120,269840,380960
4/20/2024,Kumudu Jayasuriya,Anuradhapura,Anuradhapura,North Central,9741,9827,19568,389640,393080,782720
4/21/2024,Kumudu Jayasuriya,Anuradhapura,Anuradhapura,North Central,2614,8719,11333,104560,348760,453320
4/22/2024,Kumudu Jayasuriya,Anuradhapura,Anuradhapura,North Central,3901,9935,13836,156040,397400,553440
4/23/2024,Kumudu Jayasuriya,Anuradhapura,Anuradhapura,North Central,6232,3050,9282,249280,122000,371280
4/24/2024,Kumudu Jayasuriya,Anuradhapura,Anuradhapura,North Central,5077,1930,7007,203080,77200,280280
4/25/2024,Kumudu Jayasuriya,Anuradhapura,Anuradhapura,North Central,7019,3271,10290,280760,130840,411600
4/26/2024,Kumudu Jayasuriya,Anuradhapura,Anuradhapura,North Central,8009,538,8547,320360,21520,341880
4/27/2024,Kumudu Jayasuriya,Anuradhapura,Anuradhapura,North Central,2843,3360,6203,113720,134400,248120
4/28/2024,Kumudu Jayasuriya,Anuradhapura,Anuradhapura,North Central,5887,8406,14293,235480,336240,571720
4/29/2024,Kumudu Jayasuriya,Anuradhapura,Anuradhapura,North Central,7897,6858,14755,315880,274320,590200
4/30/2024,Kumudu Jayasuriya,Anuradhapura,Anuradhapura,North Central,7012,2221,9233,280480,88840,369320
5/1/2024,Kumudu Jayasuriya,Anuradhapura,Anuradhapura,North Central,8666,1748,10414,346640,69920,416560
5/2/2024,Kumudu Jayasuriya,Anuradhapura,Anuradhapura,North Central,3194,2417,5611,127760,96680,224440
5/3/2024,Kumudu Jayasuriya,Anuradhapura,Anuradhapura,North Central,9608,130,9738,384320,5200,389520
5/4/2024,Kumudu Jayasuriya,Anuradhapura,Anuradhapura,North Central,7518,6006,13524,300720,240240,540960
5/5/2024,Kumudu Jayasuriya,Anuradhapura,Anuradhapura,North Central,5712,7572,13284,228480,302880,531360
5/6/2024,Kumudu Jayasuriya,Anuradhapura,Anuradhapura,North Central,5206,9860,15066,208240,394400,602640
5/7/2024,Kumudu Jayasuriya,Anuradhapura,Anuradhapura,North Central,9724,6307,16031,388960,252280,641240
5/8/2024,Kumudu Jayasuriya,Anuradhapura,Anuradhapura,North Central,1529,7514,9043,61160,300560,361720
5/9/2024,Kumudu Jayasuriya,Anuradhapura,Anuradhapura,North Central,1598,5479,7077,63920,219160,283080
5/10/2024,Kumudu Jayasuriya,Anuradhapura,Anuradhapura,North Central,5931,3164,9095,237240,126560,363800
5/11/2024,Kumudu Jayasuriya,Anuradhapura,Anuradhapura,North Central,2559,4654,7213,102360,186160,288520
5/12/2024,Kumudu Jayasuriya,Anuradhapura,Anuradhapura,North Central,2386,7708,10094,95440,308320,403760
5/13/2024,Kumudu Jayasuriya,Anuradhapura,Anuradhapura,North Central,1768,3127,4895,70720,125080,195800
5/14/2024,Kumudu Jayasuriya,Anuradhapura,Anuradhapura,North Central,2219,8353,10572,88760,334120,422880
5/15/2024,Kumudu Jayasuriya,Anuradhapura,Anuradhapura,North Central,5052,2675,7727,202080,107000,309080
5/16/2024,Kumudu Jayasuriya,Anuradhapura,Anuradhapura,North Central,6085,7971,14056,243400,318840,562240
5/17/2024,Kumudu Jayasuriya,Anuradhapura,Anuradhapura,North Central,7130,4842,11972,285200,193680,478880
5/18/2024,Kumudu Jayasuriya,Anuradhapura,Anuradhapura,North Central,1829,3415,5244,73160,136600,209760
5/19/2024,Kumudu Jayasuriya,Anuradhapura,Anuradhapura,North Central,9481,3636,13117,379240,145440,524680
5/20/2024,Kumudu Jayasuriya,Anuradhapura,Anuradhapura,North Central,5673,1767,7440,226920,70680,297600
5/21/2024,Kumudu Jayasuriya,Anuradhapura,Anuradhapura,North Central,4659,4500,9159,186360,180000,366360
5/22/2024,Kumudu Jayasuriya,Anuradhapura,Anuradhapura,North Central,2811,8394,11205,112440,335760,448200
5/24/2024,Kumudu Jayasuriya,Anuradhapura,Anuradhapura,North Central,7347,1657,9004,293880,66280,360160
5/25/2024,Kumudu Jayasuriya,Anuradhapura,Anuradhapura,North Central,8122,3295,11417,324880,131800,456680
5/26/2024,Kumudu Jayasuriya,Anuradhapura,Anuradhapura,North Central,5704,8138,13842,228160,325520,553680
5/27/2024,Kumudu Jayasuriya,Anuradhapura,Anuradhapura,North Central,5176,1544,6720,207040,61760,268800
5/28/2024,Kumudu Jayasuriya,Anuradhapura,Anuradhapura,North Central,7136,1907,9043,285440,76280,361720
5/29/2024,Kumudu Jayasuriya,Anuradhapura,Anuradhapura,North Central,8997,2861,11858,359880,114440,474320
5/30/2024,Kumudu Jayasuriya,Anuradhapura,Anuradhapura,North Central,1917,7306,9223,76680,292240,368920
5/31/2024,Kumudu Jayasuriya,Anuradhapura,Anuradhapura,North Central,1721,7448,9169,68840,297920,366760
6/1/2024,Kumudu Jayasuriya,Anuradhapura,Anuradhapura,North Central,6721,3534,10255,268840,141360,410200
6/2/2024,Kumudu Jayasuriya,Anuradhapura,Anuradhapura,North Central,3443,5415,8858,137720,216600,354320
6/3/2024,Kumudu Jayasuriya,Anuradhapura,Anuradhapura,North Central,4055,7423,11478,162200,296920,459120
6/4/2024,Kumudu Jayasuriya,Anuradhapura,Anuradhapura,North Central,1501,8107,9608,60040,324280,384320
6/5/2024,Kumudu Jayasuriya,Anuradhapura,Anuradhapura,North Central,425,253,678,17000,10120,27120
6/6/2024,Kumudu Jayasuriya,Anuradhapura,Anuradhapura,North Central,5512,8437,13949,220480,337480,557960
6/7/2024,Kumudu Jayasuriya,Anuradhapura,Anuradhapura,North Central,4312,7280,11592,172480,291200,463680
6/8/2024,Kumudu Jayasuriya,Anuradhapura,Anuradhapura,North Central,3074,2023,5097,122960,80920,203880
6/9/2024,Kumudu Jayasuriya,Anuradhapura,Anuradhapura,North Central,7407,3076,10483,296280,123040,419320
6/10/2024,Kumudu Jayasuriya,Anuradhapura,Anuradhapura,North Central,9617,4615,14232,384680,184600,569280
6/11/2024,Kumudu Jayasuriya,Anuradhapura,Anuradhapura,North Central,8325,8338,16663,333000,333520,666520
6/12/2024,Kumudu Jayasuriya,Anuradhapura,Anuradhapura,North Central,2715,662,3377,108600,26480,135080
6/13/2024,Kumudu Jayasuriya,Anuradhapura,Anuradhapura,North Central,2168,8350,10518,86720,334000,420720
6/14/2024,Kumudu Jayasuriya,Anuradhapura,Anuradhapura,North Central,1022,3299,4321,40880,131960,172840
6/15/2024,Kumudu Jayasuriya,Anuradhapura,Anuradhapura,North Central,6188,3031,9219,247520,121240,368760
6/16/2024,Kumudu Jayasuriya,Anuradhapura,Anuradhapura,North Central,8930,7121,16051,357200,284840,642040
6/17/2024,Kumudu Jayasuriya,Anuradhapura,Anuradhapura,North Central,2264,6907,9171,90560,276280,366840
6/18/2024,Kumudu Jayasuriya,Anuradhapura,Anuradhapura,North Central,9863,5695,15558,394520,227800,622320
6/19/2024,Kumudu Jayasuriya,Anuradhapura,Anuradhapura,North Central,8458,9876,18334,338320,395040,733360
6/20/2024,Kumudu Jayasuriya,Anuradhapura,Anuradhapura,North Central,814,2758,3572,32560,110320,142880
6/21/2024,Kumudu Jayasuriya,Anuradhapura,Anuradhapura,North Central,4412,9251,13663,176480,370040,546520
6/22/2024,Kumudu Jayasuriya,Anuradhapura,Anuradhapura,North Central,9473,7733,17206,378920,309320,688240
6/23/2024,Kumudu Jayasuriya,Anuradhapura,Anuradhapura,North Central,829,8733,9562,33160,349320,382480
6/24/2024,Kumudu Jayasuriya,Anuradhapura,Anuradhapura,North Central,7657,90,7747,306280,3600,309880
6/25/2024,Kumudu Jayasuriya,Anuradhapura,Anuradhapura,North Central,2064,1531,3595,82560,61240,143800
6/26/2024,Kumudu Jayasuriya,Anuradhapura,Anuradhapura,North Central,7848,6239,14087,313920,249560,563480
6/27/2024,Kumudu Jayasuriya,Anuradhapura,Anuradhapura,North Central,7685,9509,17194,307400,380360,687760
6/28/2024,Kumudu Jayasuriya,Anuradhapura,Anuradhapura,North Central,5752,7469,13221,230080,298760,528840
6/29/2024,Kumudu Jayasuriya,Anuradhapura,Anuradhapura,North Central,9164,8994,18158,366560,359760,726320
6/30/2024,Kumudu Jayasuriya,Anuradhapura,Anuradhapura,North Central,7846,197,8043,313840,7880,321720
7/1/2024,Kumudu Jayasuriya,Anuradhapura,Anuradhapura,North Central,5354,3383,8737,214160,135320,349480
7/2/2024,Kumudu Jayasuriya,Anuradhapura,Anuradhapura,North Central,4111,6280,10391,164440,251200,415640
7/3/2024,Kumudu Jayasuriya,Anuradhapura,Anuradhapura,North Central,1792,1959,3751,71680,78360,150040
7/4/2024,Kumudu Jayasuriya,Anuradhapura,Anuradhapura,North Central,490,1579,2069,19600,63160,82760
7/5/2024,Kumudu Jayasuriya,Anuradhapura,Anuradhapura,North Central,1532,8649,10181,61280,345960,407240
7/6/2024,Kumudu Jayasuriya,Anuradhapura,Anuradhapura,North Central,7350,565,7915,294000,22600,316600
7/7/2024,Kumudu Jayasuriya,Anuradhapura,Anuradhapura,North Central,4128,9905,14033,165120,396200,561320
7/8/2024,Kumudu Jayasuriya,Anuradhapura,Anuradhapura,North Central,981,1534,2515,39240,61360,100600
7/9/2024,Kumudu Jayasuriya,Anuradhapura,Anuradhapura,North Central,7688,1485,9173,307520,59400,366920
7/10/2024,Kumudu Jayasuriya,Anuradhapura,Anuradhapura,North Central,8886,6465,15351,355440,258600,614040
7/11/2024,Kumudu Jayasuriya,Anuradhapura,Anuradhapura,North Central,3770,6279,10049,150800,251160,401960
7/12/2024,Kumudu Jayasuriya,Anuradhapura,Anuradhapura,North Central,7679,3991,11670,307160,159640,466800
7/13/2024,Kumudu Jayasuriya,Anuradhapura,Anuradhapura,North Central,882,508,1390,35280,20320,55600
7/14/2024,Kumudu Jayasuriya,Anuradhapura,Anuradhapura,North Central,9591,4794,14385,383640,191760,575400
7/15/2024,Kumudu Jayasuriya,Anuradhapura,Anuradhapura,North Central,4211,8641,12852,168440,345640,514080
7/16/2024,Kumudu Jayasuriya,Anuradhapura,Anuradhapura,North Central,8709,3738,12447,348360,149520,497880
7/17/2024,Kumudu Jayasuriya,Anuradhapura,Anuradhapura,North Central,784,6801,7585,31360,272040,303400
7/18/2024,Kumudu Jayasuriya,Anuradhapura,Anuradhapura,North Central,1808,9960,11768,72320,398400,470720
7/19/2024,Kumudu Jayasuriya,Anuradhapura,Anuradhapura,North Central,5692,4480,10172,227680,179200,406880
7/20/2024,Kumudu Jayasuriya,Anuradhapura,Anuradhapura,North Central,1943,4622,6565,77720,184880,262600
7/21/2024,Kumudu Jayasuriya,Anuradhapura,Anuradhapura,North Central,9036,2236,11272,361440,89440,450880
7/22/2024,Kumudu Jayasuriya,Anuradhapura,Anuradhapura,North Central,2918,5052,7970,116720,202080,318800
7/23/2024,Kumudu Jayasuriya,Anuradhapura,Anuradhapura,North Central,7117,2887,10004,284680,115480,400160
7/24/2024,Kumudu Jayasuriya,Anuradhapura,Anuradhapura,North Central,6198,7852,14050,247920,314080,562000
7/25/2024,Kumudu Jayasuriya,Anuradhapura,Anuradhapura,North Central,8566,5439,14005,342640,217560,560200
7/26/2024,Kumudu Jayasuriya,Anuradhapura,Anuradhapura,North Central,7838,641,8479,313520,25640,339160
7/27/2024,Kumudu Jayasuriya,Anuradhapura,Anuradhapura,North Central,5243,1376,6619,209720,55040,264760
7/28/2024,Kumudu Jayasuriya,Anuradhapura,Anuradhapura,North Central,1184,4895,6079,47360,195800,243160
7/29/2024,Kumudu Jayasuriya,Anuradhapura,Anuradhapura,North Central,5340,3061,8401,213600,122440,336040
7/30/2024,Kumudu Jayasuriya,Anuradhapura,Anuradhapura,North Central,9853,9544,19397,394120,381760,775880
7/31/2024,Kumudu Jayasuriya,Anuradhapura,Anuradhapura,North Central,5359,1044,6403,214360,41760,256120
8/1/2024,Kumudu Jayasuriya,Anuradhapura,Anuradhapura,North Central,6351,1059,7410,254040,42360,296400
8/2/2024,Kumudu Jayasuriya,Anuradhapura,Anuradhapura,North Central,3311,7901,11212,132440,316040,448480
8/3/2024,Kumudu Jayasuriya,Anuradhapura,Anuradhapura,North Central,1666,4059,5725,66640,162360,229000
8/4/2024,Kumudu Jayasuriya,Anuradhapura,Anuradhapura,North Central,538,730,1268,21520,29200,50720
8/5/2024,Kumudu Jayasuriya,Anuradhapura,Anuradhapura,North Central,6659,5365,12024,266360,214600,480960
8/6/2024,Kumudu Jayasuriya,Anuradhapura,Anuradhapura,North Central,3695,4693,8388,147800,187720,335520
8/7/2024,Kumudu Jayasuriya,Anuradhapura,Anuradhapura,North Central,405,8907,9312,16200,356280,372480
8/8/2024,Kumudu Jayasuriya,Anuradhapura,Anuradhapura,North Central,4125,8219,12344,165000,328760,493760
8/9/2024,Kumudu Jayasuriya,Anuradhapura,Anuradhapura,North Central,6138,6375,12513,245520,255000,500520
8/10/2024,Kumudu Jayasuriya,Anuradhapura,Anuradhapura,North Central,1005,2308,3313,40200,92320,132520
8/11/2024,Kumudu Jayasuriya,Anuradhapura,Anuradhapura,North Central,2739,528,3267,109560,21120,130680
8/12/2024,Kumudu Jayasuriya,Anuradhapura,Anuradhapura,North Central,2521,3839,6360,100840,153560,254400
8/13/2024,Kumudu Jayasuriya,Anuradhapura,Anuradhapura,North Central,7480,229,7709,299200,9160,308360
8/14/2024,Kumudu Jayasuriya,Anuradhapura,Anuradhapura,North Central,5283,7074,12357,211320,282960,494280
8/15/2024,Kumudu Jayasuriya,Anuradhapura,Anuradhapura,North Central,8713,8438,17151,348520,337520,686040
8/16/2024,Kumudu Jayasuriya,Anuradhapura,Anuradhapura,North Central,7787,5586,13373,311480,223440,534920
8/17/2024,Kumudu Jayasuriya,Anuradhapura,Anuradhapura,North Central,1104,5841,6945,44160,233640,277800
8/18/2024,Kumudu Jayasuriya,Anuradhapura,Anuradhapura,North Central,8379,2223,10602,335160,88920,424080
8/19/2024,Kumudu Jayasuriya,Anuradhapura,Anuradhapura,North Central,5853,8453,14306,234120,338120,572240
8/20/2024,Kumudu Jayasuriya,Anuradhapura,Anuradhapura,North Central,2143,5210,7353,85720,208400,294120
8/21/2024,Kumudu Jayasuriya,Anuradhapura,Anuradhapura,North Central,6802,6550,13352,272080,262000,534080
8/22/2024,Kumudu Jayasuriya,Anuradhapura,Anuradhapura,North Central,9215,142,9357,368600,5680,374280
8/23/2024,Kumudu Jayasuriya,Anuradhapura,Anuradhapura,North Central,6054,8506,14560,242160,340240,582400
8/24/2024,Kumudu Jayasuriya,Anuradhapura,Anuradhapura,North Central,3115,6281,9396,124600,251240,375840
8/25/2024,Kumudu Jayasuriya,Anuradhapura,Anuradhapura,North Central,9027,7450,16477,361080,298000,659080
8/26/2024,Kumudu Jayasuriya,Anuradhapura,Anuradhapura,North Central,5826,5451,11277,233040,218040,451080
8/27/2024,Kumudu Jayasuriya,Anuradhapura,Anuradhapura,North Central,4511,5942,10453,180440,237680,418120
8/28/2024,Kumudu Jayasuriya,Anuradhapura,Anuradhapura,North Central,7597,1633,9230,303880,65320,369200
8/29/2024,Kumudu Jayasuriya,Anuradhapura,Anuradhapura,North Central,1282,2566,3848,51280,102640,153920
8/30/2024,Kumudu Jayasuriya,Anuradhapura,Anuradhapura,North Central,9627,4478,14105,385080,179120,564200
8/31/2024,Kumudu Jayasuriya,Anuradhapura,Anuradhapura,North Central,6990,7951,14941,279600,318040,597640
9/1/2024,Kumudu Jayasuriya,Anuradhapura,Anuradhapura,North Central,692,2089,2781,27680,83560,111240
9/2/2024,Kumudu Jayasuriya,Anuradhapura,Anuradhapura,North Central,977,2802,3779,39080,112080,151160
9/3/2024,Kumudu Jayasuriya,Anuradhapura,Anuradhapura,North Central,4548,648,5196,181920,25920,207840
9/4/2024,Kumudu Jayasuriya,Anuradhapura,Anuradhapura,North Central,8946,416,9362,357840,16640,374480
9/5/2024,Kumudu Jayasuriya,Anuradhapura,Anuradhapura,North Central,952,8563,9515,38080,342520,380600
9/6/2024,Kumudu Jayasuriya,Anuradhapura,Anuradhapura,North Central,6783,2912,9695,271320,116480,387800
9/7/2024,Kumudu Jayasuriya,Anuradhapura,Anuradhapura,North Central,9697,4451,14148,387880,178040,565920
9/8/2024,Kumudu Jayasuriya,Anuradhapura,Anuradhapura,North Central,686,9532,10218,27440,381280,408720
9/9/2024,Kumudu Jayasuriya,Anuradhapura,Anuradhapura,North Central,9767,2735,12502,390680,109400,500080
9/10/2024,Kumudu Jayasuriya,Anuradhapura,Anuradhapura,North Central,9415,5523,14938,376600,220920,597520
9/11/2024,Kumudu Jayasuriya,Anuradhapura,Anuradhapura,North Central,9403,2960,12363,376120,118400,494520
9/12/2024,Kumudu Jayasuriya,Anuradhapura,Anuradhapura,North Central,1712,2379,4091,68480,95160,163640
9/13/2024,Kumudu Jayasuriya,Anuradhapura,Anuradhapura,North Central,7322,1167,8489,292880,46680,339560
9/14/2024,Kumudu Jayasuriya,Anuradhapura,Anuradhapura,North Central,3334,7674,11008,133360,306960,440320
9/15/2024,Kumudu Jayasuriya,Anuradhapura,Anuradhapura,North Central,8939,7116,16055,357560,284640,642200
9/16/2024,Kumudu Jayasuriya,Anuradhapura,Anuradhapura,North Central,83,9271,9354,3320,370840,374160
9/17/2024,Kumudu Jayasuriya,Anuradhapura,Anuradhapura,North Central,9562,1110,10672,382480,44400,426880
9/18/2024,Kumudu Jayasuriya,Anuradhapura,Anuradhapura,North Central,707,3831,4538,28280,153240,181520
9/19/2024,Kumudu Jayasuriya,Anuradhapura,Anuradhapura,North Central,4591,4948,9539,183640,197920,381560
9/20/2024,Kumudu Jayasuriya,Anuradhapura,Anuradhapura,North Central,8718,9632,18350,348720,385280,734000
9/21/2024,Kumudu Jayasuriya,Anuradhapura,Anuradhapura,North Central,9948,680,10628,397920,27200,425120
9/22/2024,Kumudu Jayasuriya,Anuradhapura,Anuradhapura,North Central,9202,6980,16182,368080,279200,647280
9/23/2024,Kumudu Jayasuriya,Anuradhapura,Anuradhapura,North Central,1775,8299,10074,71000,331960,402960
9/24/2024,Kumudu Jayasuriya,Anuradhapura,Anuradhapura,North Central,7852,6675,14527,314080,267000,581080
9/25/2024,Kumudu Jayasuriya,Anuradhapura,Anuradhapura,North Central,2934,8039,10973,117360,321560,438920
9/26/2024,Kumudu Jayasuriya,Anuradhapura,Anuradhapura,North Central,9547,980,10527,381880,39200,421080
9/27/2024,Kumudu Jayasuriya,Anuradhapura,Anuradhapura,North Central,1405,848,2253,56200,33920,90120
9/28/2024,Kumudu Jayasuriya,Anuradhapura,Anuradhapura,North Central,1516,6173,7689,60640,246920,307560
9/29/2024,Kumudu Jayasuriya,Anuradhapura,Anuradhapura,North Central,6040,2286,8326,241600,91440,333040
9/30/2024,Kumudu Jayasuriya,Anuradhapura,Anuradhapura,North Central,9737,6256,15993,389480,250240,639720
10/1/2024,Kumudu Jayasuriya,Anuradhapura,Anuradhapura,North Central,1457,7773,9230,58280,310920,369200
10/2/2024,Kumudu Jayasuriya,Anuradhapura,Anuradhapura,North Central,9564,5548,15112,382560,221920,604480
10/3/2024,Kumudu Jayasuriya,Anuradhapura,Anuradhapura,North Central,8773,7852,16625,350920,314080,665000
10/4/2024,Kumudu Jayasuriya,Anuradhapura,Anuradhapura,North Central,2143,9356,11499,85720,374240,459960
10/5/2024,Kumudu Jayasuriya,Anuradhapura,Anuradhapura,North Central,2419,8096,10515,96760,323840,420600
10/6/2024,Kumudu Jayasuriya,Anuradhapura,Anuradhapura,North Central,2174,2573,4747,86960,102920,189880
10/7/2024,Kumudu Jayasuriya,Anuradhapura,Anuradhapura,North Central,783,4285,5068,31320,171400,202720
10/8/2024,Kumudu Jayasuriya,Anuradhapura,Anuradhapura,North Central,3007,9003,12010,120280,360120,480400
10/9/2024,Kumudu Jayasuriya,Anuradhapura,Anuradhapura,North Central,4467,808,5275,178680,32320,211000
10/10/2024,Kumudu Jayasuriya,Anuradhapura,Anuradhapura,North Central,4702,5487,10189,188080,219480,407560
10/11/2024,Kumudu Jayasuriya,Anuradhapura,Anuradhapura,North Central,5037,9403,14440,201480,376120,577600
10/12/2024,Kumudu Jayasuriya,Anuradhapura,Anuradhapura,North Central,8417,1508,9925,336680,60320,397000
10/13/2024,Kumudu Jayasuriya,Anuradhapura,Anuradhapura,North Central,9200,3813,13013,368000,152520,520520
10/14/2024,Kumudu Jayasuriya,Anuradhapura,Anuradhapura,North Central,2587,2375,4962,103480,95000,198480
10/15/2024,Kumudu Jayasuriya,Anuradhapura,Anuradhapura,North Central,6499,3634,10133,259960,145360,405320
10/16/2024,Kumudu Jayasuriya,Anuradhapura,Anuradhapura,North Central,3653,1564,5217,146120,62560,208680
10/17/2024,Kumudu Jayasuriya,Anuradhapura,Anuradhapura,North Central,6412,302,6714,256480,12080,268560
10/18/2024,Kumudu Jayasuriya,Anuradhapura,Anuradhapura,North Central,5791,5147,10938,231640,205880,437520
10/19/2024,Kumudu Jayasuriya,Anuradhapura,Anuradhapura,North Central,5216,5793,11009,208640,231720,440360
10/20/2024,Kumudu Jayasuriya,Anuradhapura,Anuradhapura,North Central,2638,8354,10992,105520,334160,439680
10/21/2024,Kumudu Jayasuriya,Anuradhapura,Anuradhapura,North Central,4483,8349,12832,179320,333960,513280
10/22/2024,Kumudu Jayasuriya,Anuradhapura,Anuradhapura,North Central,3412,7677,11089,136480,307080,443560
10/23/2024,Kumudu Jayasuriya,Anuradhapura,Anuradhapura,North Central,8747,7357,16104,349880,294280,644160
10/24/2024,Kumudu Jayasuriya,Anuradhapura,Anuradhapura,North Central,257,3774,4031,10280,150960,161240
10/25/2024,Kumudu Jayasuriya,Anuradhapura,Anuradhapura,North Central,2231,3766,5997,89240,150640,239880
10/26/2024,Kumudu Jayasuriya,Anuradhapura,Anuradhapura,North Central,9772,1306,11078,390880,52240,443120
10/27/2024,Kumudu Jayasuriya,Anuradhapura,Anuradhapura,North Central,3412,1964,5376,136480,78560,215040
10/28/2024,Kumudu Jayasuriya,Anuradhapura,Anuradhapura,North Central,8473,1314,9787,338920,52560,391480
10/29/2024,Kumudu Jayasuriya,Anuradhapura,Anuradhapura,North Central,7613,3191,10804,304520,127640,432160
10/30/2024,Kumudu Jayasuriya,Anuradhapura,Anuradhapura,North Central,2819,660,3479,112760,26400,139160
10/31/2024,Kumudu Jayasuriya,Anuradhapura,Anuradhapura,North Central,6248,502,6750,249920,20080,270000
11/1/2024,Kumudu Jayasuriya,Anuradhapura,Anuradhapura,North Central,3356,3869,7225,134240,154760,289000
11/2/2024,Kumudu Jayasuriya,Anuradhapura,Anuradhapura,North Central,3143,3344,6487,125720,133760,259480
11/3/2024,Kumudu Jayasuriya,Anuradhapura,Anuradhapura,North Central,6489,5771,12260,259560,230840,490400
11/4/2024,Kumudu Jayasuriya,Anuradhapura,Anuradhapura,North Central,4549,8846,13395,181960,353840,535800
11/5/2024,Kumudu Jayasuriya,Anuradhapura,Anuradhapura,North Central,1456,549,2005,58240,21960,80200
11/6/2024,Kumudu Jayasuriya,Anuradhapura,Anuradhapura,North Central,2556,1404,3960,102240,56160,158400
11/7/2024,Kumudu Jayasuriya,Anuradhapura,Anuradhapura,North Central,5882,2804,8686,235280,112160,347440
11/8/2024,Kumudu Jayasuriya,Anuradhapura,Anuradhapura,North Central,1507,8118,9625,60280,324720,385000
11/9/2024,Kumudu Jayasuriya,Anuradhapura,Anuradhapura,North Central,8325,5808,14133,333000,232320,565320
11/10/2024,Kumudu Jayasuriya,Anuradhapura,Anuradhapura,North Central,2256,4794,7050,90240,191760,282000
11/11/2024,Kumudu Jayasuriya,Anuradhapura,Anuradhapura,North Central,1640,9264,10904,65600,370560,436160
11/12/2024,Kumudu Jayasuriya,Anuradhapura,Anuradhapura,North Central,8685,3150,11835,347400,126000,473400
11/13/2024,Kumudu Jayasuriya,Anuradhapura,Anuradhapura,North Central,1420,1578,2998,56800,63120,119920
11/14/2024,Kumudu Jayasuriya,Anuradhapura,Anuradhapura,North Central,2153,9016,11169,86120,360640,446760
11/15/2024,Kumudu Jayasuriya,Anuradhapura,Anuradhapura,North Central,6320,8320,14640,252800,332800,585600
11/16/2024,Kumudu Jayasuriya,Anuradhapura,Anuradhapura,North Central,7181,5312,12493,287240,212480,499720
11/17/2024,Kumudu Jayasuriya,Anuradhapura,Anuradhapura,North Central,6536,1900,8436,261440,76000,337440
11/18/2024,Kumudu Jayasuriya,Anuradhapura,Anuradhapura,North Central,1171,1779,2950,46840,71160,118000
11/19/2024,Kumudu Jayasuriya,Anuradhapura,Anuradhapura,North Central,2748,5331,8079,109920,213240,323160
11/20/2024,Kumudu Jayasuriya,Anuradhapura,Anuradhapura,North Central,8196,7564,15760,327840,302560,630400
11/21/2024,Kumudu Jayasuriya,Anuradhapura,Anuradhapura,North Central,6053,99,6152,242120,3960,246080
11/22/2024,Kumudu Jayasuriya,Anuradhapura,Anuradhapura,North Central,2750,3553,6303,110000,142120,252120
11/23/2024,Kumudu Jayasuriya,Anuradhapura,Anuradhapura,North Central,4647,2269,6916,185880,90760,276640
11/24/2024,Kumudu Jayasuriya,Anuradhapura,Anuradhapura,North Central,9260,4881,14141,370400,195240,565640
11/25/2024,Kumudu Jayasuriya,Anuradhapura,Anuradhapura,North Central,2607,7899,10506,104280,315960,420240
11/26/2024,Kumudu Jayasuriya,Anuradhapura,Anuradhapura,North Central,9218,6212,15430,368720,248480,617200
11/27/2024,Kumudu Jayasuriya,Anuradhapura,Anuradhapura,North Central,293,9879,10172,11720,395160,406880
11/28/2024,Kumudu Jayasuriya,Anuradhapura,Anuradhapura,North Central,1196,7889,9085,47840,315560,363400
11/29/2024,Kumudu Jayasuriya,Anuradhapura,Anuradhapura,North Central,6778,9978,16756,271120,399120,670240
11/30/2024,Kumudu Jayasuriya,Anuradhapura,Anuradhapura,North Central,5311,9043,14354,212440,361720,574160
12/1/2024,Kumudu Jayasuriya,Anuradhapura,Anuradhapura,North Central,4590,9862,14452,183600,394480,578080
12/2/2024,Kumudu Jayasuriya,Anuradhapura,Anuradhapura,North Central,9509,5419,14928,380360,216760,597120
12/3/2024,Kumudu Jayasuriya,Anuradhapura,Anuradhapura,North Central,5113,6445,11558,204520,257800,462320
12/4/2024,Kumudu Jayasuriya,Anuradhapura,Anuradhapura,North Central,99,7096,7195,3960,283840,287800
12/5/2024,Kumudu Jayasuriya,Anuradhapura,Anuradhapura,North Central,4062,4439,8501,162480,177560,340040
12/6/2024,Kumudu Jayasuriya,Anuradhapura,Anuradhapura,North Central,9205,2159,11364,368200,86360,454560
12/7/2024,Kumudu Jayasuriya,Anuradhapura,Anuradhapura,North Central,1691,6119,7810,67640,244760,312400
12/8/2024,Kumudu Jayasuriya,Anuradhapura,Anuradhapura,North Central,1508,2386,3894,60320,95440,155760
12/9/2024,Kumudu Jayasuriya,Anuradhapura,Anuradhapura,North Central,7613,8745,16358,304520,349800,654320
12/10/2024,Kumudu Jayasuriya,Anuradhapura,Anuradhapura,North Central,9469,7521,16990,378760,300840,679600
12/11/2024,Kumudu Jayasuriya,Anuradhapura,Anuradhapura,North Central,6085,4960,11045,243400,198400,441800
12/12/2024,Kumudu Jayasuriya,Anuradhapura,Anuradhapura,North Central,1872,485,2357,74880,19400,94280
12/13/2024,Kumudu Jayasuriya,Anuradhapura,Anuradhapura,North Central,8850,520,9370,354000,20800,374800
12/14/2024,Kumudu Jayasuriya,Anuradhapura,Anuradhapura,North Central,9598,2786,12384,383920,111440,495360
12/15/2024,Kumudu Jayasuriya,Anuradhapura,Anuradhapura,North Central,3435,585,4020,137400,23400,160800
12/16/2024,Kumudu Jayasuriya,Anuradhapura,Anuradhapura,North Central,4640,3071,7711,185600,122840,308440
12/17/2024,Kumudu Jayasuriya,Anuradhapura,Anuradhapura,North Central,8681,5357,14038,347240,214280,561520
12/18/2024,Kumudu Jayasuriya,Anuradhapura,Anuradhapura,North Central,8898,4739,13637,355920,189560,545480
12/19/2024,Kumudu Jayasuriya,Anuradhapura,Anuradhapura,North Central,5728,7838,13566,229120,313520,542640
12/20/2024,Kumudu Jayasuriya,Anuradhapura,Anuradhapura,North Central,7446,3492,10938,297840,139680,437520
12/21/2024,Kumudu Jayasuriya,Anuradhapura,Anuradhapura,North Central,1023,1510,2533,40920,60400,101320
12/22/2024,Kumudu Jayasuriya,Anuradhapura,Anuradhapura,North Central,3697,2220,5917,147880,88800,236680
12/23/2024,Kumudu Jayasuriya,Anuradhapura,Anuradhapura,North Central,5794,5245,11039,231760,209800,441560
12/24/2024,Kumudu Jayasuriya,Anuradhapura,Anuradhapura,North Central,6256,5383,11639,250240,215320,465560
12/25/2024,Kumudu Jayasuriya,Anuradhapura,Anuradhapura,North Central,9320,5909,15229,372800,236360,609160
12/26/2024,Kumudu Jayasuriya,Anuradhapura,Anuradhapura,North Central,6248,7175,13423,249920,287000,536920
12/27/2024,Kumudu Jayasuriya,Anuradhapura,Anuradhapura,North Central,5066,4026,9092,202640,161040,363680
12/28/2024,Kumudu Jayasuriya,Anuradhapura,Anuradhapura,North Central,7858,5237,13095,314320,209480,523800
12/29/2024,Kumudu Jayasuriya,Anuradhapura,Anuradhapura,North Central,2904,9571,12475,116160,382840,499000
12/30/2024,Kumudu Jayasuriya,Anuradhapura,Anuradhapura,North Central,8957,8173,17130,358280,326920,685200
12/31/2024,Kumudu Jayasuriya,Anuradhapura,Anuradhapura,North Central,3972,4170,8142,158880,166800,325680
1/1/2025,Kumudu Jayasuriya,Anuradhapura,Anuradhapura,North Central,5286,5667,10953,211440,226680,438120
1/2/2025,Kumudu Jayasuriya,Anuradhapura,Anuradhapura,North Central,6405,469,6874,256200,18760,274960
1/3/2025,Kumudu Jayasuriya,Anuradhapura,Anuradhapura,North Central,4369,4090,8459,174760,163600,338360
1/4/2025,Kumudu Jayasuriya,Anuradhapura,Anuradhapura,North Central,1686,4411,6097,67440,176440,243880
1/5/2025,Kumudu Jayasuriya,Anuradhapura,Anuradhapura,North Central,2512,3577,6089,100480,143080,243560
1/6/2025,Kumudu Jayasuriya,Anuradhapura,Anuradhapura,North Central,2918,5203,8121,116720,208120,324840
1/7/2025,Kumudu Jayasuriya,Anuradhapura,Anuradhapura,North Central,3024,6019,9043,120960,240760,361720
1/8/2025,Kumudu Jayasuriya,Anuradhapura,Anuradhapura,North Central,4084,5610,9694,163360,224400,387760
1/9/2025,Kumudu Jayasuriya,Anuradhapura,Anuradhapura,North Central,1695,1781,3476,67800,71240,139040
1/10/2025,Kumudu Jayasuriya,Anuradhapura,Anuradhapura,North Central,1409,107,1516,56360,4280,60640
1/11/2025,Kumudu Jayasuriya,Anuradhapura,Anuradhapura,North Central,3215,4976,8191,128600,199040,327640
1/12/2025,Kumudu Jayasuriya,Anuradhapura,Anuradhapura,North Central,914,3631,4545,36560,145240,181800
1/13/2025,Kumudu Jayasuriya,Anuradhapura,Anuradhapura,North Central,180,3012,3192,7200,120480,127680
1/14/2025,Kumudu Jayasuriya,Anuradhapura,Anuradhapura,North Central,4865,2969,7834,194600,118760,313360
1/15/2025,Kumudu Jayasuriya,Anuradhapura,Anuradhapura,North Central,3906,7849,11755,156240,313960,470200
1/16/2025,Kumudu Jayasuriya,Anuradhapura,Anuradhapura,North Central,5773,6247,12020,230920,249880,480800
1/17/2025,Kumudu Jayasuriya,Anuradhapura,Anuradhapura,North Central,8978,9717,18695,359120,388680,747800
1/18/2025,Kumudu Jayasuriya,Anuradhapura,Anuradhapura,North Central,2049,1668,3717,81960,66720,148680
1/19/2025,Kumudu Jayasuriya,Anuradhapura,Anuradhapura,North Central,5313,8096,13409,212520,323840,536360
1/20/2025,Kumudu Jayasuriya,Anuradhapura,Anuradhapura,North Central,3239,2369,5608,129560,94760,224320
1/21/2025,Kumudu Jayasuriya,Anuradhapura,Anuradhapura,North Central,8,1414,1422,320,56560,56880
1/22/2025,Kumudu Jayasuriya,Anuradhapura,Anuradhapura,North Central,6326,4270,10596,253040,170800,423840
1/23/2025,Kumudu Jayasuriya,Anuradhapura,Anuradhapura,North Central,1129,7640,8769,45160,305600,350760
1/24/2025,Kumudu Jayasuriya,Anuradhapura,Anuradhapura,North Central,2131,921,3052,85240,36840,122080
1/25/2025,Kumudu Jayasuriya,Anuradhapura,Anuradhapura,North Central,2068,504,2572,82720,20160,102880
1/26/2025,Kumudu Jayasuriya,Anuradhapura,Anuradhapura,North Central,9332,6389,15721,373280,255560,628840
1/27/2025,Kumudu Jayasuriya,Anuradhapura,Anuradhapura,North Central,7998,3547,11545,319920,141880,461800
1/28/2025,Kumudu Jayasuriya,Anuradhapura,Anuradhapura,North Central,1016,5731,6747,40640,229240,269880
1/29/2025,Kumudu Jayasuriya,Anuradhapura,Anuradhapura,North Central,2471,4673,7144,98840,186920,285760
1/30/2025,Kumudu Jayasuriya,Anuradhapura,Anuradhapura,North Central,7077,2061,9138,283080,82440,365520
1/31/2025,Kumudu Jayasuriya,Anuradhapura,Anuradhapura,North Central,4593,2428,7021,183720,97120,280840
2/1/2025,Kumudu Jayasuriya,Anuradhapura,Anuradhapura,North Central,6315,1211,7526,252600,48440,301040
2/2/2025,Kumudu Jayasuriya,Anuradhapura,Anuradhapura,North Central,7784,3953,11737,311360,158120,469480
2/3/2025,Kumudu Jayasuriya,Anuradhapura,Anuradhapura,North Central,4698,380,5078,187920,15200,203120
2/4/2025,Kumudu Jayasuriya,Anuradhapura,Anuradhapura,North Central,2695,2161,4856,107800,86440,194240
2/5/2025,Kumudu Jayasuriya,Anuradhapura,Anuradhapura,North Central,3100,8452,11552,124000,338080,462080
2/6/2025,Kumudu Jayasuriya,Anuradhapura,Anuradhapura,North Central,2739,7122,9861,109560,284880,394440
2/7/2025,Kumudu Jayasuriya,Anuradhapura,Anuradhapura,North Central,4638,9118,13756,185520,364720,550240
2/8/2025,Kumudu Jayasuriya,Anuradhapura,Anuradhapura,North Central,7814,2173,9987,312560,86920,399480
2/9/2025,Kumudu Jayasuriya,Anuradhapura,Anuradhapura,North Central,5259,5906,11165,210360,236240,446600
2/10/2025,Kumudu Jayasuriya,Anuradhapura,Anuradhapura,North Central,6378,8652,15030,255120,346080,601200
2/11/2025,Kumudu Jayasuriya,Anuradhapura,Anuradhapura,North Central,1304,4304,5608,52160,172160,224320
2/12/2025,Kumudu Jayasuriya,Anuradhapura,Anuradhapura,North Central,9005,3608,12613,360200,144320,504520
2/13/2025,Kumudu Jayasuriya,Anuradhapura,Anuradhapura,North Central,4819,2618,7437,192760,104720,297480
2/14/2025,Kumudu Jayasuriya,Anuradhapura,Anuradhapura,North Central,3684,938,4622,147360,37520,184880
2/15/2025,Kumudu Jayasuriya,Anuradhapura,Anuradhapura,North Central,6861,9952,16813,274440,398080,672520
2/16/2025,Kumudu Jayasuriya,Anuradhapura,Anuradhapura,North Central,7315,4967,12282,292600,198680,491280
2/17/2025,Kumudu Jayasuriya,Anuradhapura,Anuradhapura,North Central,4659,7321,11980,186360,292840,479200
2/18/2025,Kumudu Jayasuriya,Anuradhapura,Anuradhapura,North Central,8941,5604,14545,357640,224160,581800
2/19/2025,Kumudu Jayasuriya,Anuradhapura,Anuradhapura,North Central,709,1152,1861,28360,46080,74440
2/20/2025,Kumudu Jayasuriya,Anuradhapura,Anuradhapura,North Central,7779,4043,11822,311160,161720,472880
2/21/2025,Kumudu Jayasuriya,Anuradhapura,Anuradhapura,North Central,6742,1717,8459,269680,68680,338360
2/22/2025,Kumudu Jayasuriya,Anuradhapura,Anuradhapura,North Central,5749,1119,6868,229960,44760,274720
2/23/2025,Kumudu Jayasuriya,Anuradhapura,Anuradhapura,North Central,8609,1948,10557,344360,77920,422280
2/24/2025,Kumudu Jayasuriya,Anuradhapura,Anuradhapura,North Central,7827,2184,10011,313080,87360,400440
2/25/2025,Kumudu Jayasuriya,Anuradhapura,Anuradhapura,North Central,3012,188,3200,120480,7520,128000
2/26/2025,Kumudu Jayasuriya,Anuradhapura,Anuradhapura,North Central,3572,6882,10454,142880,275280,418160
2/27/2025,Kumudu Jayasuriya,Anuradhapura,Anuradhapura,North Central,812,6082,6894,32480,243280,275760
2/28/2025,Kumudu Jayasuriya,Anuradhapura,Anuradhapura,North Central,2774,6285,9059,110960,251400,362360
3/1/2025,Kumudu Jayasuriya,Anuradhapura,Anuradhapura,North Central,5717,5973,11690,228680,238920,467600
3/2/2025,Kumudu Jayasuriya,Anuradhapura,Anuradhapura,North Central,1728,7755,9483,69120,310200,379320
3/3/2025,Kumudu Jayasuriya,Anuradhapura,Anuradhapura,North Central,1438,8713,10151,57520,348520,406040
3/4/2025,Kumudu Jayasuriya,Anuradhapura,Anuradhapura,North Central,3373,7544,10917,134920,301760,436680
3/5/2025,Kumudu Jayasuriya,Anuradhapura,Anuradhapura,North Central,32,1908,1940,1280,76320,77600
3/6/2025,Kumudu Jayasuriya,Anuradhapura,Anuradhapura,North Central,1594,6919,8513,63760,276760,340520
3/7/2025,Kumudu Jayasuriya,Anuradhapura,Anuradhapura,North Central,575,4781,5356,23000,191240,214240
3/8/2025,Kumudu Jayasuriya,Anuradhapura,Anuradhapura,North Central,9908,9966,19874,396320,398640,794960
3/9/2025,Kumudu Jayasuriya,Anuradhapura,Anuradhapura,North Central,7049,387,7436,281960,15480,297440
3/10/2025,Kumudu Jayasuriya,Anuradhapura,Anuradhapura,North Central,2974,8408,11382,118960,336320,455280
3/11/2025,Kumudu Jayasuriya,Anuradhapura,Anuradhapura,North Central,8060,5589,13649,322400,223560,545960
3/12/2025,Kumudu Jayasuriya,Anuradhapura,Anuradhapura,North Central,6369,3339,9708,254760,133560,388320
3/13/2025,Kumudu Jayasuriya,Anuradhapura,Anuradhapura,North Central,116,3763,3879,4640,150520,155160
3/14/2025,Kumudu Jayasuriya,Anuradhapura,Anuradhapura,North Central,3969,8470,12439,158760,338800,497560
3/15/2025,Kumudu Jayasuriya,Anuradhapura,Anuradhapura,North Central,6738,5169,11907,269520,206760,476280
3/16/2025,Kumudu Jayasuriya,Anuradhapura,Anuradhapura,North Central,4706,3750,8456,188240,150000,338240
3/17/2025,Kumudu Jayasuriya,Anuradhapura,Anuradhapura,North Central,8713,521,9234,348520,20840,369360
3/18/2025,Kumudu Jayasuriya,Anuradhapura,Anuradhapura,North Central,6050,8703,14753,242000,348120,590120
3/19/2025,Kumudu Jayasuriya,Anuradhapura,Anuradhapura,North Central,2332,5536,7868,93280,221440,314720
3/20/2025,Kumudu Jayasuriya,Anuradhapura,Anuradhapura,North Central,7372,2805,10177,294880,112200,407080
3/21/2025,Kumudu Jayasuriya,Anuradhapura,Anuradhapura,North Central,5787,4273,10060,231480,170920,402400
3/22/2025,Kumudu Jayasuriya,Anuradhapura,Anuradhapura,North Central,9136,3248,12384,365440,129920,495360
3/23/2025,Kumudu Jayasuriya,Anuradhapura,Anuradhapura,North Central,4283,2035,6318,171320,81400,252720
3/25/2024,Samanthi Senarathne,Polonnaruwa,Habarana,North Central,4431,2780,7211,177240,111200,288440
3/26/2024,Samanthi Senarathne,Polonnaruwa,Habarana,North Central,6253,4305,10558,250120,172200,422320
3/27/2024,Samanthi Senarathne,Polonnaruwa,Habarana,North Central,5080,2419,7499,203200,96760,299960
3/28/2024,Samanthi Senarathne,Polonnaruwa,Habarana,North Central,699,9654,10353,27960,386160,414120
3/29/2024,Samanthi Senarathne,Polonnaruwa,Habarana,North Central,7228,9638,16866,289120,385520,674640
3/30/2024,Samanthi Senarathne,Polonnaruwa,Habarana,North Central,1220,4578,5798,48800,183120,231920
3/31/2024,Samanthi Senarathne,Polonnaruwa,Habarana,North Central,2010,6194,8204,80400,247760,328160
4/1/2024,Samanthi Senarathne,Polonnaruwa,Habarana,North Central,1071,4215,5286,42840,168600,211440
4/2/2024,Samanthi Senarathne,Polonnaruwa,Habarana,North Central,8951,9628,18579,358040,385120,743160
4/3/2024,Samanthi Senarathne,Polonnaruwa,Habarana,North Central,7061,1455,8516,282440,58200,340640
4/4/2024,Samanthi Senarathne,Polonnaruwa,Habarana,North Central,8796,4580,13376,351840,183200,535040
4/5/2024,Samanthi Senarathne,Polonnaruwa,Habarana,North Central,4123,2065,6188,164920,82600,247520
4/6/2024,Samanthi Senarathne,Polonnaruwa,Habarana,North Central,5985,4961,10946,239400,198440,437840
4/7/2024,Samanthi Senarathne,Polonnaruwa,Habarana,North Central,7974,3653,11627,318960,146120,465080
4/8/2024,Samanthi Senarathne,Polonnaruwa,Habarana,North Central,2875,7860,10735,115000,314400,429400
4/9/2024,Samanthi Senarathne,Polonnaruwa,Habarana,North Central,6712,4195,10907,268480,167800,436280
4/10/2024,Samanthi Senarathne,Polonnaruwa,Habarana,North Central,2282,4762,7044,91280,190480,281760
4/11/2024,Samanthi Senarathne,Polonnaruwa,Habarana,North Central,6057,1185,7242,242280,47400,289680
4/19/2024,Samanthi Senarathne,Polonnaruwa,Habarana,North Central,9724,6094,15818,388960,243760,632720
4/20/2024,Samanthi Senarathne,Polonnaruwa,Habarana,North Central,1913,1767,3680,76520,70680,147200
4/21/2024,Samanthi Senarathne,Polonnaruwa,Habarana,North Central,9877,8785,18662,395080,351400,746480
4/22/2024,Samanthi Senarathne,Polonnaruwa,Habarana,North Central,9967,2708,12675,398680,108320,507000
4/23/2024,Samanthi Senarathne,Polonnaruwa,Habarana,North Central,1665,3167,4832,66600,126680,193280
4/24/2024,Samanthi Senarathne,Polonnaruwa,Habarana,North Central,6526,7923,14449,261040,316920,577960
4/25/2024,Samanthi Senarathne,Polonnaruwa,Habarana,North Central,634,5892,6526,25360,235680,261040
4/26/2024,Samanthi Senarathne,Polonnaruwa,Habarana,North Central,2453,6207,8660,98120,248280,346400
4/27/2024,Samanthi Senarathne,Polonnaruwa,Habarana,North Central,114,8771,8885,4560,350840,355400
4/28/2024,Samanthi Senarathne,Polonnaruwa,Habarana,North Central,3098,5863,8961,123920,234520,358440
4/29/2024,Samanthi Senarathne,Polonnaruwa,Habarana,North Central,3099,4307,7406,123960,172280,296240
4/30/2024,Samanthi Senarathne,Polonnaruwa,Habarana,North Central,8270,7819,16089,330800,312760,643560
5/1/2024,Samanthi Senarathne,Polonnaruwa,Habarana,North Central,7455,1968,9423,298200,78720,376920
5/2/2024,Samanthi Senarathne,Polonnaruwa,Habarana,North Central,4178,8028,12206,167120,321120,488240
5/3/2024,Samanthi Senarathne,Polonnaruwa,Habarana,North Central,3207,9206,12413,128280,368240,496520
5/4/2024,Samanthi Senarathne,Polonnaruwa,Habarana,North Central,3393,5759,9152,135720,230360,366080
5/5/2024,Samanthi Senarathne,Polonnaruwa,Habarana,North Central,8948,2293,11241,357920,91720,449640
5/6/2024,Samanthi Senarathne,Polonnaruwa,Habarana,North Central,7264,5190,12454,290560,207600,498160
5/7/2024,Samanthi Senarathne,Polonnaruwa,Habarana,North Central,8674,1102,9776,346960,44080,391040
5/8/2024,Samanthi Senarathne,Polonnaruwa,Habarana,North Central,3870,74,3944,154800,2960,157760
5/9/2024,Samanthi Senarathne,Polonnaruwa,Habarana,North Central,1472,8651,10123,58880,346040,404920
5/10/2024,Samanthi Senarathne,Polonnaruwa,Habarana,North Central,4550,6753,11303,182000,270120,452120
5/11/2024,Samanthi Senarathne,Polonnaruwa,Habarana,North Central,2241,9251,11492,89640,370040,459680
5/12/2024,Samanthi Senarathne,Polonnaruwa,Habarana,North Central,2245,7465,9710,89800,298600,388400
5/13/2024,Samanthi Senarathne,Polonnaruwa,Habarana,North Central,897,9188,10085,35880,367520,403400
5/14/2024,Samanthi Senarathne,Polonnaruwa,Habarana,North Central,2081,9513,11594,83240,380520,463760
5/15/2024,Samanthi Senarathne,Polonnaruwa,Habarana,North Central,4992,9850,14842,199680,394000,593680
5/16/2024,Samanthi Senarathne,Polonnaruwa,Habarana,North Central,8109,7600,15709,324360,304000,628360
5/17/2024,Samanthi Senarathne,Polonnaruwa,Habarana,North Central,9081,3528,12609,363240,141120,504360
5/18/2024,Samanthi Senarathne,Polonnaruwa,Habarana,North Central,2878,4836,7714,115120,193440,308560
5/19/2024,Samanthi Senarathne,Polonnaruwa,Habarana,North Central,8236,1207,9443,329440,48280,377720
5/20/2024,Samanthi Senarathne,Polonnaruwa,Habarana,North Central,4882,7017,11899,195280,280680,475960
5/21/2024,Samanthi Senarathne,Polonnaruwa,Habarana,North Central,8677,6536,15213,347080,261440,608520
5/22/2024,Samanthi Senarathne,Polonnaruwa,Habarana,North Central,2509,8181,10690,100360,327240,427600
5/24/2024,Samanthi Senarathne,Polonnaruwa,Habarana,North Central,5278,7957,13235,211120,318280,529400
5/25/2024,Samanthi Senarathne,Polonnaruwa,Habarana,North Central,1847,9703,11550,73880,388120,462000
5/26/2024,Samanthi Senarathne,Polonnaruwa,Habarana,North Central,9941,8850,18791,397640,354000,751640
5/27/2024,Samanthi Senarathne,Polonnaruwa,Habarana,North Central,220,2898,3118,8800,115920,124720
5/28/2024,Samanthi Senarathne,Polonnaruwa,Habarana,North Central,413,1594,2007,16520,63760,80280
5/29/2024,Samanthi Senarathne,Polonnaruwa,Habarana,North Central,9909,5021,14930,396360,200840,597200
5/30/2024,Samanthi Senarathne,Polonnaruwa,Habarana,North Central,6345,6926,13271,253800,277040,530840
5/31/2024,Samanthi Senarathne,Polonnaruwa,Habarana,North Central,7140,9174,16314,285600,366960,652560
6/1/2024,Samanthi Senarathne,Polonnaruwa,Habarana,North Central,9048,6822,15870,361920,272880,634800
6/2/2024,Samanthi Senarathne,Polonnaruwa,Habarana,North Central,1847,7002,8849,73880,280080,353960
6/3/2024,Samanthi Senarathne,Polonnaruwa,Habarana,North Central,8725,4188,12913,349000,167520,516520
6/4/2024,Samanthi Senarathne,Polonnaruwa,Habarana,North Central,1028,1486,2514,41120,59440,100560
6/5/2024,Samanthi Senarathne,Polonnaruwa,Habarana,North Central,6301,4587,10888,252040,183480,435520
6/6/2024,Samanthi Senarathne,Polonnaruwa,Habarana,North Central,6511,135,6646,260440,5400,265840
6/7/2024,Samanthi Senarathne,Polonnaruwa,Habarana,North Central,3181,7840,11021,127240,313600,440840
6/8/2024,Samanthi Senarathne,Polonnaruwa,Habarana,North Central,1043,2673,3716,41720,106920,148640
6/9/2024,Samanthi Senarathne,Polonnaruwa,Habarana,North Central,4892,3350,8242,195680,134000,329680
6/10/2024,Samanthi Senarathne,Polonnaruwa,Habarana,North Central,1011,5327,6338,40440,213080,253520
6/11/2024,Samanthi Senarathne,Polonnaruwa,Habarana,North Central,5852,3356,9208,234080,134240,368320
6/12/2024,Samanthi Senarathne,Polonnaruwa,Habarana,North Central,6339,8503,14842,253560,340120,593680
6/13/2024,Samanthi Senarathne,Polonnaruwa,Habarana,North Central,5490,2585,8075,219600,103400,323000
6/14/2024,Samanthi Senarathne,Polonnaruwa,Habarana,North Central,1760,3671,5431,70400,146840,217240
6/15/2024,Samanthi Senarathne,Polonnaruwa,Habarana,North Central,5449,701,6150,217960,28040,246000
6/16/2024,Samanthi Senarathne,Polonnaruwa,Habarana,North Central,5177,43,5220,207080,1720,208800
6/17/2024,Samanthi Senarathne,Polonnaruwa,Habarana,North Central,4223,5192,9415,168920,207680,376600
6/18/2024,Samanthi Senarathne,Polonnaruwa,Habarana,North Central,7581,7571,15152,303240,302840,606080
6/19/2024,Samanthi Senarathne,Polonnaruwa,Habarana,North Central,5746,977,6723,229840,39080,268920
6/20/2024,Samanthi Senarathne,Polonnaruwa,Habarana,North Central,9288,8563,17851,371520,342520,714040
6/21/2024,Samanthi Senarathne,Polonnaruwa,Habarana,North Central,7269,1961,9230,290760,78440,369200
6/22/2024,Samanthi Senarathne,Polonnaruwa,Habarana,North Central,891,9576,10467,35640,383040,418680
6/23/2024,Samanthi Senarathne,Polonnaruwa,Habarana,North Central,4216,6421,10637,168640,256840,425480
6/24/2024,Samanthi Senarathne,Polonnaruwa,Habarana,North Central,4018,2960,6978,160720,118400,279120
6/25/2024,Samanthi Senarathne,Polonnaruwa,Habarana,North Central,3922,7675,11597,156880,307000,463880
6/26/2024,Samanthi Senarathne,Polonnaruwa,Habarana,North Central,6038,4456,10494,241520,178240,419760
6/27/2024,Samanthi Senarathne,Polonnaruwa,Habarana,North Central,3308,8132,11440,132320,325280,457600
6/28/2024,Samanthi Senarathne,Polonnaruwa,Habarana,North Central,2040,4378,6418,81600,175120,256720
6/29/2024,Samanthi Senarathne,Polonnaruwa,Habarana,North Central,5508,5151,10659,220320,206040,426360
6/30/2024,Samanthi Senarathne,Polonnaruwa,Habarana,North Central,2163,4686,6849,86520,187440,273960
7/1/2024,Samanthi Senarathne,Polonnaruwa,Habarana,North Central,773,8124,8897,30920,324960,355880
7/2/2024,Samanthi Senarathne,Polonnaruwa,Habarana,North Central,9408,5647,15055,376320,225880,602200
7/3/2024,Samanthi Senarathne,Polonnaruwa,Habarana,North Central,2112,3089,5201,84480,123560,208040
7/4/2024,Samanthi Senarathne,Polonnaruwa,Habarana,North Central,3877,3321,7198,155080,132840,287920
7/5/2024,Samanthi Senarathne,Polonnaruwa,Habarana,North Central,9850,1079,10929,394000,43160,437160
7/6/2024,Samanthi Senarathne,Polonnaruwa,Habarana,North Central,7214,2753,9967,288560,110120,398680
7/7/2024,Samanthi Senarathne,Polonnaruwa,Habarana,North Central,6278,5258,11536,251120,210320,461440
7/8/2024,Samanthi Senarathne,Polonnaruwa,Habarana,North Central,9222,8067,17289,368880,322680,691560
7/9/2024,Samanthi Senarathne,Polonnaruwa,Habarana,North Central,2665,2768,5433,106600,110720,217320
7/10/2024,Samanthi Senarathne,Polonnaruwa,Habarana,North Central,501,97,598,20040,3880,23920
7/11/2024,Samanthi Senarathne,Polonnaruwa,Habarana,North Central,4838,7974,12812,193520,318960,512480
7/12/2024,Samanthi Senarathne,Polonnaruwa,Habarana,North Central,3393,7899,11292,135720,315960,451680
7/13/2024,Samanthi Senarathne,Polonnaruwa,Habarana,North Central,6789,2007,8796,271560,80280,351840
7/14/2024,Samanthi Senarathne,Polonnaruwa,Habarana,North Central,5293,6417,11710,211720,256680,468400
7/15/2024,Samanthi Senarathne,Polonnaruwa,Habarana,North Central,6865,6149,13014,274600,245960,520560
7/16/2024,Samanthi Senarathne,Polonnaruwa,Habarana,North Central,9881,5168,15049,395240,206720,601960
7/17/2024,Samanthi Senarathne,Polonnaruwa,Habarana,North Central,4707,2562,7269,188280,102480,290760
7/18/2024,Samanthi Senarathne,Polonnaruwa,Habarana,North Central,790,5341,6131,31600,213640,245240
7/19/2024,Samanthi Senarathne,Polonnaruwa,Habarana,North Central,2077,3766,5843,83080,150640,233720
7/20/2024,Samanthi Senarathne,Polonnaruwa,Habarana,North Central,2068,4087,6155,82720,163480,246200
7/21/2024,Samanthi Senarathne,Polonnaruwa,Habarana,North Central,3313,6264,9577,132520,250560,383080
7/22/2024,Samanthi Senarathne,Polonnaruwa,Habarana,North Central,3799,3567,7366,151960,142680,294640
7/23/2024,Samanthi Senarathne,Polonnaruwa,Habarana,North Central,3778,351,4129,151120,14040,165160
7/24/2024,Samanthi Senarathne,Polonnaruwa,Habarana,North Central,1483,4873,6356,59320,194920,254240
7/25/2024,Samanthi Senarathne,Polonnaruwa,Habarana,North Central,3421,1940,5361,136840,77600,214440
7/26/2024,Samanthi Senarathne,Polonnaruwa,Habarana,North Central,7456,4888,12344,298240,195520,493760
7/27/2024,Samanthi Senarathne,Polonnaruwa,Habarana,North Central,5701,9265,14966,228040,370600,598640
7/28/2024,Samanthi Senarathne,Polonnaruwa,Habarana,North Central,7361,1746,9107,294440,69840,364280
7/29/2024,Samanthi Senarathne,Polonnaruwa,Habarana,North Central,5521,2316,7837,220840,92640,313480
7/30/2024,Samanthi Senarathne,Polonnaruwa,Habarana,North Central,9579,7068,16647,383160,282720,665880
7/31/2024,Samanthi Senarathne,Polonnaruwa,Habarana,North Central,9435,4545,13980,377400,181800,559200
8/1/2024,Samanthi Senarathne,Polonnaruwa,Habarana,North Central,7879,4427,12306,315160,177080,492240
8/2/2024,Samanthi Senarathne,Polonnaruwa,Habarana,North Central,6584,8683,15267,263360,347320,610680
8/3/2024,Samanthi Senarathne,Polonnaruwa,Habarana,North Central,514,9049,9563,20560,361960,382520
8/4/2024,Samanthi Senarathne,Polonnaruwa,Habarana,North Central,9048,3169,12217,361920,126760,488680
8/5/2024,Samanthi Senarathne,Polonnaruwa,Habarana,North Central,2792,1679,4471,111680,67160,178840
8/6/2024,Samanthi Senarathne,Polonnaruwa,Habarana,North Central,5080,641,5721,203200,25640,228840
8/7/2024,Samanthi Senarathne,Polonnaruwa,Habarana,North Central,9307,1935,11242,372280,77400,449680
8/8/2024,Samanthi Senarathne,Polonnaruwa,Habarana,North Central,2062,9134,11196,82480,365360,447840
8/9/2024,Samanthi Senarathne,Polonnaruwa,Habarana,North Central,4327,5821,10148,173080,232840,405920
8/10/2024,Samanthi Senarathne,Polonnaruwa,Habarana,North Central,8160,6591,14751,326400,263640,590040
8/11/2024,Samanthi Senarathne,Polonnaruwa,Habarana,North Central,5120,2496,7616,204800,99840,304640
8/12/2024,Samanthi Senarathne,Polonnaruwa,Habarana,North Central,9243,856,10099,369720,34240,403960
8/13/2024,Samanthi Senarathne,Polonnaruwa,Habarana,North Central,5830,6689,12519,233200,267560,500760
8/14/2024,Samanthi Senarathne,Polonnaruwa,Habarana,North Central,6889,5869,12758,275560,234760,510320
8/15/2024,Samanthi Senarathne,Polonnaruwa,Habarana,North Central,8898,7989,16887,355920,319560,675480
8/16/2024,Samanthi Senarathne,Polonnaruwa,Habarana,North Central,2446,9627,12073,97840,385080,482920
8/17/2024,Samanthi Senarathne,Polonnaruwa,Habarana,North Central,3556,4484,8040,142240,179360,321600
8/18/2024,Samanthi Senarathne,Polonnaruwa,Habarana,North Central,824,5227,6051,32960,209080,242040
8/19/2024,Samanthi Senarathne,Polonnaruwa,Habarana,North Central,2868,9218,12086,114720,368720,483440
8/20/2024,Samanthi Senarathne,Polonnaruwa,Habarana,North Central,2374,1391,3765,94960,55640,150600
8/21/2024,Samanthi Senarathne,Polonnaruwa,Habarana,North Central,4658,7168,11826,186320,286720,473040
8/22/2024,Samanthi Senarathne,Polonnaruwa,Habarana,North Central,75,9594,9669,3000,383760,386760
8/23/2024,Samanthi Senarathne,Polonnaruwa,Habarana,North Central,9003,376,9379,360120,15040,375160
8/24/2024,Samanthi Senarathne,Polonnaruwa,Habarana,North Central,5951,9977,15928,238040,399080,637120
8/25/2024,Samanthi Senarathne,Polonnaruwa,Habarana,North Central,2060,7475,9535,82400,299000,381400
8/26/2024,Samanthi Senarathne,Polonnaruwa,Habarana,North Central,5216,687,5903,208640,27480,236120
8/27/2024,Samanthi Senarathne,Polonnaruwa,Habarana,North Central,9699,403,10102,387960,16120,404080
8/28/2024,Samanthi Senarathne,Polonnaruwa,Habarana,North Central,1914,7975,9889,76560,319000,395560
8/29/2024,Samanthi Senarathne,Polonnaruwa,Habarana,North Central,590,4758,5348,23600,190320,213920
8/30/2024,Samanthi Senarathne,Polonnaruwa,Habarana,North Central,8076,8336,16412,323040,333440,656480
8/31/2024,Samanthi Senarathne,Polonnaruwa,Habarana,North Central,9894,263,10157,395760,10520,406280
9/1/2024,Samanthi Senarathne,Polonnaruwa,Habarana,North Central,3862,7468,11330,154480,298720,453200
9/2/2024,Samanthi Senarathne,Polonnaruwa,Habarana,North Central,9807,4690,14497,392280,187600,579880
9/3/2024,Samanthi Senarathne,Polonnaruwa,Habarana,North Central,6003,1722,7725,240120,68880,309000
9/4/2024,Samanthi Senarathne,Polonnaruwa,Habarana,North Central,7509,7339,14848,300360,293560,593920
9/5/2024,Samanthi Senarathne,Polonnaruwa,Habarana,North Central,4718,7223,11941,188720,288920,477640
9/6/2024,Samanthi Senarathne,Polonnaruwa,Habarana,North Central,9732,3765,13497,389280,150600,539880
9/7/2024,Samanthi Senarathne,Polonnaruwa,Habarana,North Central,9697,4483,14180,387880,179320,567200
9/8/2024,Samanthi Senarathne,Polonnaruwa,Habarana,North Central,4399,9439,13838,175960,377560,553520
9/9/2024,Samanthi Senarathne,Polonnaruwa,Habarana,North Central,3232,9167,12399,129280,366680,495960
9/10/2024,Samanthi Senarathne,Polonnaruwa,Habarana,North Central,1676,659,2335,67040,26360,93400
9/11/2024,Samanthi Senarathne,Polonnaruwa,Habarana,North Central,2057,4966,7023,82280,198640,280920
9/12/2024,Samanthi Senarathne,Polonnaruwa,Habarana,North Central,3445,5661,9106,137800,226440,364240
9/13/2024,Samanthi Senarathne,Polonnaruwa,Habarana,North Central,9545,9009,18554,381800,360360,742160
9/14/2024,Samanthi Senarathne,Polonnaruwa,Habarana,North Central,4943,2607,7550,197720,104280,302000
9/15/2024,Samanthi Senarathne,Polonnaruwa,Habarana,North Central,4320,4843,9163,172800,193720,366520
9/16/2024,Samanthi Senarathne,Polonnaruwa,Habarana,North Central,4020,4136,8156,160800,165440,326240
9/17/2024,Samanthi Senarathne,Polonnaruwa,Habarana,North Central,4360,4023,8383,174400,160920,335320
9/18/2024,Samanthi Senarathne,Polonnaruwa,Habarana,North Central,1680,1256,2936,67200,50240,117440
9/19/2024,Samanthi Senarathne,Polonnaruwa,Habarana,North Central,3030,6559,9589,121200,262360,383560
9/20/2024,Samanthi Senarathne,Polonnaruwa,Habarana,North Central,5792,1326,7118,231680,53040,284720
9/21/2024,Samanthi Senarathne,Polonnaruwa,Habarana,North Central,5390,9884,15274,215600,395360,610960
9/22/2024,Samanthi Senarathne,Polonnaruwa,Habarana,North Central,7381,8521,15902,295240,340840,636080
9/23/2024,Samanthi Senarathne,Polonnaruwa,Habarana,North Central,8798,6765,15563,351920,270600,622520
9/24/2024,Samanthi Senarathne,Polonnaruwa,Habarana,North Central,8100,9922,18022,324000,396880,720880
9/25/2024,Samanthi Senarathne,Polonnaruwa,Habarana,North Central,6817,4899,11716,272680,195960,468640
9/26/2024,Samanthi Senarathne,Polonnaruwa,Habarana,North Central,8978,1781,10759,359120,71240,430360
9/27/2024,Samanthi Senarathne,Polonnaruwa,Habarana,North Central,3783,4143,7926,151320,165720,317040
9/28/2024,Samanthi Senarathne,Polonnaruwa,Habarana,North Central,1830,4298,6128,73200,171920,245120
9/29/2024,Samanthi Senarathne,Polonnaruwa,Habarana,North Central,6703,9258,15961,268120,370320,638440
9/30/2024,Samanthi Senarathne,Polonnaruwa,Habarana,North Central,6270,8007,14277,250800,320280,571080
10/1/2024,Samanthi Senarathne,Polonnaruwa,Habarana,North Central,8619,1223,9842,344760,48920,393680
10/2/2024,Samanthi Senarathne,Polonnaruwa,Habarana,North Central,9402,9271,18673,376080,370840,746920
10/3/2024,Samanthi Senarathne,Polonnaruwa,Habarana,North Central,4687,1142,5829,187480,45680,233160
10/4/2024,Samanthi Senarathne,Polonnaruwa,Habarana,North Central,772,7932,8704,30880,317280,348160
10/5/2024,Samanthi Senarathne,Polonnaruwa,Habarana,North Central,86,9377,9463,3440,375080,378520
10/6/2024,Samanthi Senarathne,Polonnaruwa,Habarana,North Central,3089,5629,8718,123560,225160,348720
10/7/2024,Samanthi Senarathne,Polonnaruwa,Habarana,North Central,5921,6175,12096,236840,247000,483840
10/8/2024,Samanthi Senarathne,Polonnaruwa,Habarana,North Central,9103,1329,10432,364120,53160,417280
10/9/2024,Samanthi Senarathne,Polonnaruwa,Habarana,North Central,2441,1071,3512,97640,42840,140480
10/10/2024,Samanthi Senarathne,Polonnaruwa,Habarana,North Central,6737,9849,16586,269480,393960,663440
10/11/2024,Samanthi Senarathne,Polonnaruwa,Habarana,North Central,1988,1342,3330,79520,53680,133200
10/12/2024,Samanthi Senarathne,Polonnaruwa,Habarana,North Central,6537,5659,12196,261480,226360,487840
10/13/2024,Samanthi Senarathne,Polonnaruwa,Habarana,North Central,7132,1759,8891,285280,70360,355640
10/14/2024,Samanthi Senarathne,Polonnaruwa,Habarana,North Central,6991,6879,13870,279640,275160,554800
10/15/2024,Samanthi Senarathne,Polonnaruwa,Habarana,North Central,8965,7582,16547,358600,303280,661880
10/16/2024,Samanthi Senarathne,Polonnaruwa,Habarana,North Central,7615,9566,17181,304600,382640,687240
10/17/2024,Samanthi Senarathne,Polonnaruwa,Habarana,North Central,3938,1141,5079,157520,45640,203160
10/18/2024,Samanthi Senarathne,Polonnaruwa,Habarana,North Central,7251,5822,13073,290040,232880,522920
10/19/2024,Samanthi Senarathne,Polonnaruwa,Habarana,North Central,1431,4675,6106,57240,187000,244240
10/20/2024,Samanthi Senarathne,Polonnaruwa,Habarana,North Central,2199,1419,3618,87960,56760,144720
10/21/2024,Samanthi Senarathne,Polonnaruwa,Habarana,North Central,7068,5758,12826,282720,230320,513040
10/22/2024,Samanthi Senarathne,Polonnaruwa,Habarana,North Central,5126,642,5768,205040,25680,230720
10/23/2024,Samanthi Senarathne,Polonnaruwa,Habarana,North Central,7391,4965,12356,295640,198600,494240
10/24/2024,Samanthi Senarathne,Polonnaruwa,Habarana,North Central,8292,9771,18063,331680,390840,722520
10/25/2024,Samanthi Senarathne,Polonnaruwa,Habarana,North Central,9239,1998,11237,369560,79920,449480
10/26/2024,Samanthi Senarathne,Polonnaruwa,Habarana,North Central,9298,829,10127,371920,33160,405080
10/27/2024,Samanthi Senarathne,Polonnaruwa,Habarana,North Central,7853,5296,13149,314120,211840,525960
10/28/2024,Samanthi Senarathne,Polonnaruwa,Habarana,North Central,8366,5830,14196,334640,233200,567840
10/29/2024,Samanthi Senarathne,Polonnaruwa,Habarana,North Central,3491,2115,5606,139640,84600,224240
10/30/2024,Samanthi Senarathne,Polonnaruwa,Habarana,North Central,8184,324,8508,327360,12960,340320
10/31/2024,Samanthi Senarathne,Polonnaruwa,Habarana,North Central,9484,7509,16993,379360,300360,679720
11/1/2024,Samanthi Senarathne,Polonnaruwa,Habarana,North Central,5079,4438,9517,203160,177520,380680
11/2/2024,Samanthi Senarathne,Polonnaruwa,Habarana,North Central,7862,2064,9926,314480,82560,397040
11/3/2024,Samanthi Senarathne,Polonnaruwa,Habarana,North Central,44,9556,9600,1760,382240,384000
11/4/2024,Samanthi Senarathne,Polonnaruwa,Habarana,North Central,436,7542,7978,17440,301680,319120
11/5/2024,Samanthi Senarathne,Polonnaruwa,Habarana,North Central,2932,4524,7456,117280,180960,298240
11/6/2024,Samanthi Senarathne,Polonnaruwa,Habarana,North Central,7866,5595,13461,314640,223800,538440
11/7/2024,Samanthi Senarathne,Polonnaruwa,Habarana,North Central,5504,2223,7727,220160,88920,309080
11/8/2024,Samanthi Senarathne,Polonnaruwa,Habarana,North Central,96,5572,5668,3840,222880,226720
11/9/2024,Samanthi Senarathne,Polonnaruwa,Habarana,North Central,993,960,1953,39720,38400,78120
11/10/2024,Samanthi Senarathne,Polonnaruwa,Habarana,North Central,4642,7681,12323,185680,307240,492920
11/11/2024,Samanthi Senarathne,Polonnaruwa,Habarana,North Central,7851,477,8328,314040,19080,333120
11/12/2024,Samanthi Senarathne,Polonnaruwa,Habarana,North Central,9654,5709,15363,386160,228360,614520
11/13/2024,Samanthi Senarathne,Polonnaruwa,Habarana,North Central,9160,5268,14428,366400,210720,577120
11/14/2024,Samanthi Senarathne,Polonnaruwa,Habarana,North Central,178,9405,9583,7120,376200,383320
11/15/2024,Samanthi Senarathne,Polonnaruwa,Habarana,North Central,62,1795,1857,2480,71800,74280
11/16/2024,Samanthi Senarathne,Polonnaruwa,Habarana,North Central,6274,1133,7407,250960,45320,296280
11/17/2024,Samanthi Senarathne,Polonnaruwa,Habarana,North Central,8186,5553,13739,327440,222120,549560
11/18/2024,Samanthi Senarathne,Polonnaruwa,Habarana,North Central,3826,8803,12629,153040,352120,505160
11/19/2024,Samanthi Senarathne,Polonnaruwa,Habarana,North Central,1184,8579,9763,47360,343160,390520
11/20/2024,Samanthi Senarathne,Polonnaruwa,Habarana,North Central,6626,1636,8262,265040,65440,330480
11/21/2024,Samanthi Senarathne,Polonnaruwa,Habarana,North Central,6010,9556,15566,240400,382240,622640
11/22/2024,Samanthi Senarathne,Polonnaruwa,Habarana,North Central,3465,6422,9887,138600,256880,395480
11/23/2024,Samanthi Senarathne,Polonnaruwa,Habarana,North Central,948,6932,7880,37920,277280,315200
11/24/2024,Samanthi Senarathne,Polonnaruwa,Habarana,North Central,4700,7088,11788,188000,283520,471520
11/25/2024,Samanthi Senarathne,Polonnaruwa,Habarana,North Central,6921,1174,8095,276840,46960,323800
11/26/2024,Samanthi Senarathne,Polonnaruwa,Habarana,North Central,2884,4530,7414,115360,181200,296560
11/27/2024,Samanthi Senarathne,Polonnaruwa,Habarana,North Central,5513,4627,10140,220520,185080,405600
11/28/2024,Samanthi Senarathne,Polonnaruwa,Habarana,North Central,8324,2547,10871,332960,101880,434840
11/29/2024,Samanthi Senarathne,Polonnaruwa,Habarana,North Central,8108,2528,10636,324320,101120,425440
11/30/2024,Samanthi Senarathne,Polonnaruwa,Habarana,North Central,7274,757,8031,290960,30280,321240
12/1/2024,Samanthi Senarathne,Polonnaruwa,Habarana,North Central,4289,1535,5824,171560,61400,232960
12/2/2024,Samanthi Senarathne,Polonnaruwa,Habarana,North Central,201,8180,8381,8040,327200,335240
12/3/2024,Samanthi Senarathne,Polonnaruwa,Habarana,North Central,7490,3305,10795,299600,132200,431800
12/4/2024,Samanthi Senarathne,Polonnaruwa,Habarana,North Central,3369,2218,5587,134760,88720,223480
12/5/2024,Samanthi Senarathne,Polonnaruwa,Habarana,North Central,6013,5208,11221,240520,208320,448840
12/6/2024,Samanthi Senarathne,Polonnaruwa,Habarana,North Central,6,119,125,240,4760,5000
12/7/2024,Samanthi Senarathne,Polonnaruwa,Habarana,North Central,1554,3753,5307,62160,150120,212280
12/8/2024,Samanthi Senarathne,Polonnaruwa,Habarana,North Central,3681,3663,7344,147240,146520,293760
12/9/2024,Samanthi Senarathne,Polonnaruwa,Habarana,North Central,3772,5727,9499,150880,229080,379960
12/10/2024,Samanthi Senarathne,Polonnaruwa,Habarana,North Central,9686,6978,16664,387440,279120,666560
12/11/2024,Samanthi Senarathne,Polonnaruwa,Habarana,North Central,5940,578,6518,237600,23120,260720
12/12/2024,Samanthi Senarathne,Polonnaruwa,Habarana,North Central,4647,573,5220,185880,22920,208800
12/13/2024,Samanthi Senarathne,Polonnaruwa,Habarana,North Central,6674,5898,12572,266960,235920,502880
12/14/2024,Samanthi Senarathne,Polonnaruwa,Habarana,North Central,991,5548,6539,39640,221920,261560
12/15/2024,Samanthi Senarathne,Polonnaruwa,Habarana,North Central,697,7283,7980,27880,291320,319200
12/16/2024,Samanthi Senarathne,Polonnaruwa,Habarana,North Central,8952,1288,10240,358080,51520,409600
12/17/2024,Samanthi Senarathne,Polonnaruwa,Habarana,North Central,4527,4224,8751,181080,168960,350040
12/18/2024,Samanthi Senarathne,Polonnaruwa,Habarana,North Central,1751,3057,4808,70040,122280,192320
12/19/2024,Samanthi Senarathne,Polonnaruwa,Habarana,North Central,4427,3609,8036,177080,144360,321440
12/20/2024,Samanthi Senarathne,Polonnaruwa,Habarana,North Central,4746,1115,5861,189840,44600,234440
12/21/2024,Samanthi Senarathne,Polonnaruwa,Habarana,North Central,8949,2264,11213,357960,90560,448520
12/22/2024,Samanthi Senarathne,Polonnaruwa,Habarana,North Central,5859,6288,12147,234360,251520,485880
12/23/2024,Samanthi Senarathne,Polonnaruwa,Habarana,North Central,915,4686,5601,36600,187440,224040
12/24/2024,Samanthi Senarathne,Polonnaruwa,Habarana,North Central,4664,4846,9510,186560,193840,380400
12/25/2024,Samanthi Senarathne,Polonnaruwa,Habarana,North Central,3619,5383,9002,144760,215320,360080
12/26/2024,Samanthi Senarathne,Polonnaruwa,Habarana,North Central,9136,8145,17281,365440,325800,691240
12/27/2024,Samanthi Senarathne,Polonnaruwa,Habarana,North Central,8806,1594,10400,352240,63760,416000
12/28/2024,Samanthi Senarathne,Polonnaruwa,Habarana,North Central,2922,8369,11291,116880,334760,451640
12/29/2024,Samanthi Senarathne,Polonnaruwa,Habarana,North Central,2961,7320,10281,118440,292800,411240
12/30/2024,Samanthi Senarathne,Polonnaruwa,Habarana,North Central,673,9951,10624,26920,398040,424960
12/31/2024,Samanthi Senarathne,Polonnaruwa,Habarana,North Central,8680,6717,15397,347200,268680,615880
1/1/2025,Samanthi Senarathne,Polonnaruwa,Habarana,North Central,6392,2801,9193,255680,112040,367720
1/2/2025,Samanthi Senarathne,Polonnaruwa,Habarana,North Central,58,575,633,2320,23000,25320
1/3/2025,Samanthi Senarathne,Polonnaruwa,Habarana,North Central,5632,1985,7617,225280,79400,304680
1/4/2025,Samanthi Senarathne,Polonnaruwa,Habarana,North Central,2007,4645,6652,80280,185800,266080
1/5/2025,Samanthi Senarathne,Polonnaruwa,Habarana,North Central,5895,8729,14624,235800,349160,584960
1/6/2025,Samanthi Senarathne,Polonnaruwa,Habarana,North Central,5290,7587,12877,211600,303480,515080
1/7/2025,Samanthi Senarathne,Polonnaruwa,Habarana,North Central,277,216,493,11080,8640,19720
1/8/2025,Samanthi Senarathne,Polonnaruwa,Habarana,North Central,6215,356,6571,248600,14240,262840
1/9/2025,Samanthi Senarathne,Polonnaruwa,Habarana,North Central,5807,1083,6890,232280,43320,275600
1/10/2025,Samanthi Senarathne,Polonnaruwa,Habarana,North Central,2961,6216,9177,118440,248640,367080
1/11/2025,Samanthi Senarathne,Polonnaruwa,Habarana,North Central,7556,6765,14321,302240,270600,572840
1/12/2025,Samanthi Senarathne,Polonnaruwa,Habarana,North Central,8745,8354,17099,349800,334160,683960
1/13/2025,Samanthi Senarathne,Polonnaruwa,Habarana,North Central,1037,9066,10103,41480,362640,404120
1/14/2025,Samanthi Senarathne,Polonnaruwa,Habarana,North Central,6370,369,6739,254800,14760,269560
1/15/2025,Samanthi Senarathne,Polonnaruwa,Habarana,North Central,1472,1212,2684,58880,48480,107360
1/16/2025,Samanthi Senarathne,Polonnaruwa,Habarana,North Central,7221,2864,10085,288840,114560,403400
1/17/2025,Samanthi Senarathne,Polonnaruwa,Habarana,North Central,1521,5793,7314,60840,231720,292560
1/18/2025,Samanthi Senarathne,Polonnaruwa,Habarana,North Central,1485,6928,8413,59400,277120,336520
1/19/2025,Samanthi Senarathne,Polonnaruwa,Habarana,North Central,170,9881,10051,6800,395240,402040
1/20/2025,Samanthi Senarathne,Polonnaruwa,Habarana,North Central,4067,6638,10705,162680,265520,428200
1/21/2025,Samanthi Senarathne,Polonnaruwa,Habarana,North Central,7880,1739,9619,315200,69560,384760
1/22/2025,Samanthi Senarathne,Polonnaruwa,Habarana,North Central,3733,5629,9362,149320,225160,374480
1/23/2025,Samanthi Senarathne,Polonnaruwa,Habarana,North Central,9782,6574,16356,391280,262960,654240
1/24/2025,Samanthi Senarathne,Polonnaruwa,Habarana,North Central,4482,5680,10162,179280,227200,406480
1/25/2025,Samanthi Senarathne,Polonnaruwa,Habarana,North Central,8314,5283,13597,332560,211320,543880
1/26/2025,Samanthi Senarathne,Polonnaruwa,Habarana,North Central,9016,4456,13472,360640,178240,538880
1/27/2025,Samanthi Senarathne,Polonnaruwa,Habarana,North Central,5740,9038,14778,229600,361520,591120
1/28/2025,Samanthi Senarathne,Polonnaruwa,Habarana,North Central,1477,1426,2903,59080,57040,116120
1/29/2025,Samanthi Senarathne,Polonnaruwa,Habarana,North Central,3943,772,4715,157720,30880,188600
1/30/2025,Samanthi Senarathne,Polonnaruwa,Habarana,North Central,9896,3201,13097,395840,128040,523880
1/31/2025,Samanthi Senarathne,Polonnaruwa,Habarana,North Central,8166,1419,9585,326640,56760,383400
2/1/2025,Samanthi Senarathne,Polonnaruwa,Habarana,North Central,2847,3965,6812,113880,158600,272480
2/2/2025,Samanthi Senarathne,Polonnaruwa,Habarana,North Central,7496,3485,10981,299840,139400,439240
2/3/2025,Samanthi Senarathne,Polonnaruwa,Habarana,North Central,9000,3787,12787,360000,151480,511480
2/4/2025,Samanthi Senarathne,Polonnaruwa,Habarana,North Central,49,6776,6825,1960,271040,273000
2/5/2025,Samanthi Senarathne,Polonnaruwa,Habarana,North Central,1043,2844,3887,41720,113760,155480
2/6/2025,Samanthi Senarathne,Polonnaruwa,Habarana,North Central,1682,3029,4711,67280,121160,188440
2/7/2025,Samanthi Senarathne,Polonnaruwa,Habarana,North Central,8654,3607,12261,346160,144280,490440
2/8/2025,Samanthi Senarathne,Polonnaruwa,Habarana,North Central,6540,5273,11813,261600,210920,472520
2/9/2025,Samanthi Senarathne,Polonnaruwa,Habarana,North Central,4539,7514,12053,181560,300560,482120
2/10/2025,Samanthi Senarathne,Polonnaruwa,Habarana,North Central,1510,6452,7962,60400,258080,318480
2/11/2025,Samanthi Senarathne,Polonnaruwa,Habarana,North Central,3402,4215,7617,136080,168600,304680
2/12/2025,Samanthi Senarathne,Polonnaruwa,Habarana,North Central,4997,4228,9225,199880,169120,369000
2/13/2025,Samanthi Senarathne,Polonnaruwa,Habarana,North Central,8560,8304,16864,342400,332160,674560
2/14/2025,Samanthi Senarathne,Polonnaruwa,Habarana,North Central,4707,9194,13901,188280,367760,556040
2/15/2025,Samanthi Senarathne,Polonnaruwa,Habarana,North Central,6328,4792,11120,253120,191680,444800
2/16/2025,Samanthi Senarathne,Polonnaruwa,Habarana,North Central,1291,6673,7964,51640,266920,318560
2/17/2025,Samanthi Senarathne,Polonnaruwa,Habarana,North Central,1318,9813,11131,52720,392520,445240
2/18/2025,Samanthi Senarathne,Polonnaruwa,Habarana,North Central,7302,8747,16049,292080,349880,641960
2/19/2025,Samanthi Senarathne,Polonnaruwa,Habarana,North Central,7433,5378,12811,297320,215120,512440
2/20/2025,Samanthi Senarathne,Polonnaruwa,Habarana,North Central,2670,369,3039,106800,14760,121560
2/21/2025,Samanthi Senarathne,Polonnaruwa,Habarana,North Central,7887,6595,14482,315480,263800,579280
2/22/2025,Samanthi Senarathne,Polonnaruwa,Habarana,North Central,2627,1452,4079,105080,58080,163160
2/23/2025,Samanthi Senarathne,Polonnaruwa,Habarana,North Central,2090,7404,9494,83600,296160,379760
2/24/2025,Samanthi Senarathne,Polonnaruwa,Habarana,North Central,2580,7430,10010,103200,297200,400400
2/25/2025,Samanthi Senarathne,Polonnaruwa,Habarana,North Central,4055,59,4114,162200,2360,164560
2/26/2025,Samanthi Senarathne,Polonnaruwa,Habarana,North Central,5674,62,5736,226960,2480,229440
2/27/2025,Samanthi Senarathne,Polonnaruwa,Habarana,North Central,9405,1260,10665,376200,50400,426600
2/28/2025,Samanthi Senarathne,Polonnaruwa,Habarana,North Central,2328,4702,7030,93120,188080,281200
3/1/2025,Samanthi Senarathne,Polonnaruwa,Habarana,North Central,1004,239,1243,40160,9560,49720
3/2/2025,Samanthi Senarathne,Polonnaruwa,Habarana,North Central,3164,6390,9554,126560,255600,382160
3/3/2025,Samanthi Senarathne,Polonnaruwa,Habarana,North Central,8825,7256,16081,353000,290240,643240
3/4/2025,Samanthi Senarathne,Polonnaruwa,Habarana,North Central,760,2720,3480,30400,108800,139200
3/5/2025,Samanthi Senarathne,Polonnaruwa,Habarana,North Central,1072,7346,8418,42880,293840,336720
3/6/2025,Samanthi Senarathne,Polonnaruwa,Habarana,North Central,8065,8185,16250,322600,327400,650000
3/7/2025,Samanthi Senarathne,Polonnaruwa,Habarana,North Central,323,6808,7131,12920,272320,285240
3/8/2025,Samanthi Senarathne,Polonnaruwa,Habarana,North Central,3331,4314,7645,133240,172560,305800
3/9/2025,Samanthi Senarathne,Polonnaruwa,Habarana,North Central,5910,7511,13421,236400,300440,536840
3/10/2025,Samanthi Senarathne,Polonnaruwa,Habarana,North Central,85,5102,5187,3400,204080,207480
3/11/2025,Samanthi Senarathne,Polonnaruwa,Habarana,North Central,7815,5272,13087,312600,210880,523480
3/12/2025,Samanthi Senarathne,Polonnaruwa,Habarana,North Central,3251,6330,9581,130040,253200,383240
3/13/2025,Samanthi Senarathne,Polonnaruwa,Habarana,North Central,7086,6817,13903,283440,272680,556120
3/14/2025,Samanthi Senarathne,Polonnaruwa,Habarana,North Central,9031,4567,13598,361240,182680,543920
3/15/2025,Samanthi Senarathne,Polonnaruwa,Habarana,North Central,6981,3942,10923,279240,157680,436920
3/16/2025,Samanthi Senarathne,Polonnaruwa,Habarana,North Central,2149,705,2854,85960,28200,114160
3/17/2025,Samanthi Senarathne,Polonnaruwa,Habarana,North Central,1215,7362,8577,48600,294480,343080
3/18/2025,Samanthi Senarathne,Polonnaruwa,Habarana,North Central,2050,4363,6413,82000,174520,256520
3/19/2025,Samanthi Senarathne,Polonnaruwa,Habarana,North Central,2331,8252,10583,93240,330080,423320
3/20/2025,Samanthi Senarathne,Polonnaruwa,Habarana,North Central,1441,4035,5476,57640,161400,219040
3/21/2025,Samanthi Senarathne,Polonnaruwa,Habarana,North Central,5464,5448,10912,218560,217920,436480
3/22/2025,Samanthi Senarathne,Polonnaruwa,Habarana,North Central,4452,5335,9787,178080,213400,391480
3/23/2025,Samanthi Senarathne,Polonnaruwa,Habarana,North Central,6598,3134,9732,263920,125360,389280
3/25/2024,Ravindra Seneviratne,Kurunegala,Ibbagamuwa,North Western,402,6999,7401,16080,279960,296040
3/26/2024,Ravindra Seneviratne,Kurunegala,Ibbagamuwa,North Western,414,510,924,16560,20400,36960
3/27/2024,Ravindra Seneviratne,Kurunegala,Ibbagamuwa,North Western,4695,1511,6206,187800,60440,248240
3/28/2024,Ravindra Seneviratne,Kurunegala,Ibbagamuwa,North Western,3171,6888,10059,126840,275520,402360
3/29/2024,Ravindra Seneviratne,Kurunegala,Ibbagamuwa,North Western,8280,2600,10880,331200,104000,435200
3/30/2024,Ravindra Seneviratne,Kurunegala,Ibbagamuwa,North Western,1618,2298,3916,64720,91920,156640
3/31/2024,Ravindra Seneviratne,Kurunegala,Ibbagamuwa,North Western,9792,2048,11840,391680,81920,473600
4/1/2024,Ravindra Seneviratne,Kurunegala,Ibbagamuwa,North Western,6537,3292,9829,261480,131680,393160
4/2/2024,Ravindra Seneviratne,Kurunegala,Ibbagamuwa,North Western,6885,3217,10102,275400,128680,404080
4/3/2024,Ravindra Seneviratne,Kurunegala,Ibbagamuwa,North Western,8158,9260,17418,326320,370400,696720
4/4/2024,Ravindra Seneviratne,Kurunegala,Ibbagamuwa,North Western,4769,8414,13183,190760,336560,527320
4/5/2024,Ravindra Seneviratne,Kurunegala,Ibbagamuwa,North Western,1881,3240,5121,75240,129600,204840
4/6/2024,Ravindra Seneviratne,Kurunegala,Ibbagamuwa,North Western,4729,2975,7704,189160,119000,308160
4/7/2024,Ravindra Seneviratne,Kurunegala,Ibbagamuwa,North Western,7567,7811,15378,302680,312440,615120
4/8/2024,Ravindra Seneviratne,Kurunegala,Ibbagamuwa,North Western,3084,4328,7412,123360,173120,296480
4/9/2024,Ravindra Seneviratne,Kurunegala,Ibbagamuwa,North Western,3891,8937,12828,155640,357480,513120
4/10/2024,Ravindra Seneviratne,Kurunegala,Ibbagamuwa,North Western,7621,3475,11096,304840,139000,443840
4/11/2024,Ravindra Seneviratne,Kurunegala,Ibbagamuwa,North Western,8048,4208,12256,321920,168320,490240
4/19/2024,Ravindra Seneviratne,Kurunegala,Ibbagamuwa,North Western,2049,1154,3203,81960,46160,128120
4/20/2024,Ravindra Seneviratne,Kurunegala,Ibbagamuwa,North Western,3425,9000,12425,137000,360000,497000
4/21/2024,Ravindra Seneviratne,Kurunegala,Ibbagamuwa,North Western,596,7284,7880,23840,291360,315200
4/22/2024,Ravindra Seneviratne,Kurunegala,Ibbagamuwa,North Western,689,6593,7282,27560,263720,291280
4/23/2024,Ravindra Seneviratne,Kurunegala,Ibbagamuwa,North Western,5910,8980,14890,236400,359200,595600
4/24/2024,Ravindra Seneviratne,Kurunegala,Ibbagamuwa,North Western,3710,8177,11887,148400,327080,475480
4/25/2024,Ravindra Seneviratne,Kurunegala,Ibbagamuwa,North Western,4175,1311,5486,167000,52440,219440
4/26/2024,Ravindra Seneviratne,Kurunegala,Ibbagamuwa,North Western,2287,2674,4961,91480,106960,198440
4/27/2024,Ravindra Seneviratne,Kurunegala,Ibbagamuwa,North Western,1668,9924,11592,66720,396960,463680
4/28/2024,Ravindra Seneviratne,Kurunegala,Ibbagamuwa,North Western,5447,7546,12993,217880,301840,519720
4/29/2024,Ravindra Seneviratne,Kurunegala,Ibbagamuwa,North Western,5764,7854,13618,230560,314160,544720
4/30/2024,Ravindra Seneviratne,Kurunegala,Ibbagamuwa,North Western,5379,3887,9266,215160,155480,370640
5/1/2024,Ravindra Seneviratne,Kurunegala,Ibbagamuwa,North Western,9753,8168,17921,390120,326720,716840
5/2/2024,Ravindra Seneviratne,Kurunegala,Ibbagamuwa,North Western,1940,8246,10186,77600,329840,407440
5/3/2024,Ravindra Seneviratne,Kurunegala,Ibbagamuwa,North Western,3452,2476,5928,138080,99040,237120
5/4/2024,Ravindra Seneviratne,Kurunegala,Ibbagamuwa,North Western,9181,1699,10880,367240,67960,435200
5/5/2024,Ravindra Seneviratne,Kurunegala,Ibbagamuwa,North Western,9258,8208,17466,370320,328320,698640
5/6/2024,Ravindra Seneviratne,Kurunegala,Ibbagamuwa,North Western,7243,1189,8432,289720,47560,337280
5/7/2024,Ravindra Seneviratne,Kurunegala,Ibbagamuwa,North Western,9893,9762,19655,395720,390480,786200
5/8/2024,Ravindra Seneviratne,Kurunegala,Ibbagamuwa,North Western,1105,2268,3373,44200,90720,134920
5/9/2024,Ravindra Seneviratne,Kurunegala,Ibbagamuwa,North Western,3183,1659,4842,127320,66360,193680
5/10/2024,Ravindra Seneviratne,Kurunegala,Ibbagamuwa,North Western,1317,4199,5516,52680,167960,220640
5/11/2024,Ravindra Seneviratne,Kurunegala,Ibbagamuwa,North Western,9598,6110,15708,383920,244400,628320
5/12/2024,Ravindra Seneviratne,Kurunegala,Ibbagamuwa,North Western,1252,5226,6478,50080,209040,259120
5/13/2024,Ravindra Seneviratne,Kurunegala,Ibbagamuwa,North Western,8075,5751,13826,323000,230040,553040
5/14/2024,Ravindra Seneviratne,Kurunegala,Ibbagamuwa,North Western,8622,6461,15083,344880,258440,603320
5/15/2024,Ravindra Seneviratne,Kurunegala,Ibbagamuwa,North Western,7096,6823,13919,283840,272920,556760
5/16/2024,Ravindra Seneviratne,Kurunegala,Ibbagamuwa,North Western,4217,1448,5665,168680,57920,226600
5/17/2024,Ravindra Seneviratne,Kurunegala,Ibbagamuwa,North Western,9335,4740,14075,373400,189600,563000
5/18/2024,Ravindra Seneviratne,Kurunegala,Ibbagamuwa,North Western,7243,6795,14038,289720,271800,561520
5/19/2024,Ravindra Seneviratne,Kurunegala,Ibbagamuwa,North Western,9946,630,10576,397840,25200,423040
5/20/2024,Ravindra Seneviratne,Kurunegala,Ibbagamuwa,North Western,2559,7270,9829,102360,290800,393160
5/21/2024,Ravindra Seneviratne,Kurunegala,Ibbagamuwa,North Western,7802,5605,13407,312080,224200,536280
5/22/2024,Ravindra Seneviratne,Kurunegala,Ibbagamuwa,North Western,2904,1769,4673,116160,70760,186920
5/24/2024,Ravindra Seneviratne,Kurunegala,Ibbagamuwa,North Western,7808,9141,16949,312320,365640,677960
5/25/2024,Ravindra Seneviratne,Kurunegala,Ibbagamuwa,North Western,5962,7730,13692,238480,309200,547680
5/26/2024,Ravindra Seneviratne,Kurunegala,Ibbagamuwa,North Western,8624,2667,11291,344960,106680,451640
5/27/2024,Ravindra Seneviratne,Kurunegala,Ibbagamuwa,North Western,9712,9044,18756,388480,361760,750240
5/28/2024,Ravindra Seneviratne,Kurunegala,Ibbagamuwa,North Western,107,7191,7298,4280,287640,291920
5/29/2024,Ravindra Seneviratne,Kurunegala,Ibbagamuwa,North Western,6495,7703,14198,259800,308120,567920
5/30/2024,Ravindra Seneviratne,Kurunegala,Ibbagamuwa,North Western,4166,8189,12355,166640,327560,494200
5/31/2024,Ravindra Seneviratne,Kurunegala,Ibbagamuwa,North Western,8361,6639,15000,334440,265560,600000
6/1/2024,Ravindra Seneviratne,Kurunegala,Ibbagamuwa,North Western,4270,9539,13809,170800,381560,552360
6/2/2024,Ravindra Seneviratne,Kurunegala,Ibbagamuwa,North Western,9616,4984,14600,384640,199360,584000
6/3/2024,Ravindra Seneviratne,Kurunegala,Ibbagamuwa,North Western,3460,7352,10812,138400,294080,432480
6/4/2024,Ravindra Seneviratne,Kurunegala,Ibbagamuwa,North Western,3928,1341,5269,157120,53640,210760
6/5/2024,Ravindra Seneviratne,Kurunegala,Ibbagamuwa,North Western,3062,7743,10805,122480,309720,432200
6/6/2024,Ravindra Seneviratne,Kurunegala,Ibbagamuwa,North Western,4413,3738,8151,176520,149520,326040
6/7/2024,Ravindra Seneviratne,Kurunegala,Ibbagamuwa,North Western,3801,3775,7576,152040,151000,303040
6/8/2024,Ravindra Seneviratne,Kurunegala,Ibbagamuwa,North Western,3365,4384,7749,134600,175360,309960
6/9/2024,Ravindra Seneviratne,Kurunegala,Ibbagamuwa,North Western,5925,4053,9978,237000,162120,399120
6/10/2024,Ravindra Seneviratne,Kurunegala,Ibbagamuwa,North Western,785,11,796,31400,440,31840
6/11/2024,Ravindra Seneviratne,Kurunegala,Ibbagamuwa,North Western,8619,2851,11470,344760,114040,458800
6/12/2024,Ravindra Seneviratne,Kurunegala,Ibbagamuwa,North Western,751,9953,10704,30040,398120,428160
6/13/2024,Ravindra Seneviratne,Kurunegala,Ibbagamuwa,North Western,709,7634,8343,28360,305360,333720
6/14/2024,Ravindra Seneviratne,Kurunegala,Ibbagamuwa,North Western,871,211,1082,34840,8440,43280
6/15/2024,Ravindra Seneviratne,Kurunegala,Ibbagamuwa,North Western,1995,2219,4214,79800,88760,168560
6/16/2024,Ravindra Seneviratne,Kurunegala,Ibbagamuwa,North Western,4909,8501,13410,196360,340040,536400
6/17/2024,Ravindra Seneviratne,Kurunegala,Ibbagamuwa,North Western,122,7691,7813,4880,307640,312520
6/18/2024,Ravindra Seneviratne,Kurunegala,Ibbagamuwa,North Western,9959,8236,18195,398360,329440,727800
6/19/2024,Ravindra Seneviratne,Kurunegala,Ibbagamuwa,North Western,8901,5513,14414,356040,220520,576560
6/20/2024,Ravindra Seneviratne,Kurunegala,Ibbagamuwa,North Western,2300,8891,11191,92000,355640,447640
6/21/2024,Ravindra Seneviratne,Kurunegala,Ibbagamuwa,North Western,9744,5483,15227,389760,219320,609080
6/22/2024,Ravindra Seneviratne,Kurunegala,Ibbagamuwa,North Western,279,7773,8052,11160,310920,322080
6/23/2024,Ravindra Seneviratne,Kurunegala,Ibbagamuwa,North Western,9575,2182,11757,383000,87280,470280
6/24/2024,Ravindra Seneviratne,Kurunegala,Ibbagamuwa,North Western,2659,6986,9645,106360,279440,385800
6/25/2024,Ravindra Seneviratne,Kurunegala,Ibbagamuwa,North Western,8407,1119,9526,336280,44760,381040
6/26/2024,Ravindra Seneviratne,Kurunegala,Ibbagamuwa,North Western,9284,7957,17241,371360,318280,689640
6/27/2024,Ravindra Seneviratne,Kurunegala,Ibbagamuwa,North Western,4259,559,4818,170360,22360,192720
6/28/2024,Ravindra Seneviratne,Kurunegala,Ibbagamuwa,North Western,2548,9022,11570,101920,360880,462800
6/29/2024,Ravindra Seneviratne,Kurunegala,Ibbagamuwa,North Western,7897,4499,12396,315880,179960,495840
6/30/2024,Ravindra Seneviratne,Kurunegala,Ibbagamuwa,North Western,9259,7057,16316,370360,282280,652640
7/1/2024,Ravindra Seneviratne,Kurunegala,Ibbagamuwa,North Western,4752,9408,14160,190080,376320,566400
7/2/2024,Ravindra Seneviratne,Kurunegala,Ibbagamuwa,North Western,2987,9234,12221,119480,369360,488840
7/3/2024,Ravindra Seneviratne,Kurunegala,Ibbagamuwa,North Western,3591,6450,10041,143640,258000,401640
7/4/2024,Ravindra Seneviratne,Kurunegala,Ibbagamuwa,North Western,7859,9304,17163,314360,372160,686520
7/5/2024,Ravindra Seneviratne,Kurunegala,Ibbagamuwa,North Western,9273,5800,15073,370920,232000,602920
7/6/2024,Ravindra Seneviratne,Kurunegala,Ibbagamuwa,North Western,2925,278,3203,117000,11120,128120
7/7/2024,Ravindra Seneviratne,Kurunegala,Ibbagamuwa,North Western,1590,4973,6563,63600,198920,262520
7/8/2024,Ravindra Seneviratne,Kurunegala,Ibbagamuwa,North Western,5038,5285,10323,201520,211400,412920
7/9/2024,Ravindra Seneviratne,Kurunegala,Ibbagamuwa,North Western,540,3600,4140,21600,144000,165600
7/10/2024,Ravindra Seneviratne,Kurunegala,Ibbagamuwa,North Western,3318,8424,11742,132720,336960,469680
7/11/2024,Ravindra Seneviratne,Kurunegala,Ibbagamuwa,North Western,4174,2968,7142,166960,118720,285680
7/12/2024,Ravindra Seneviratne,Kurunegala,Ibbagamuwa,North Western,2258,7252,9510,90320,290080,380400
7/13/2024,Ravindra Seneviratne,Kurunegala,Ibbagamuwa,North Western,3950,8288,12238,158000,331520,489520
7/14/2024,Ravindra Seneviratne,Kurunegala,Ibbagamuwa,North Western,361,9127,9488,14440,365080,379520
7/15/2024,Ravindra Seneviratne,Kurunegala,Ibbagamuwa,North Western,9521,3917,13438,380840,156680,537520
7/16/2024,Ravindra Seneviratne,Kurunegala,Ibbagamuwa,North Western,6744,4485,11229,269760,179400,449160
7/17/2024,Ravindra Seneviratne,Kurunegala,Ibbagamuwa,North Western,1559,8429,9988,62360,337160,399520
7/18/2024,Ravindra Seneviratne,Kurunegala,Ibbagamuwa,North Western,6388,4299,10687,255520,171960,427480
7/19/2024,Ravindra Seneviratne,Kurunegala,Ibbagamuwa,North Western,5871,5617,11488,234840,224680,459520
7/20/2024,Ravindra Seneviratne,Kurunegala,Ibbagamuwa,North Western,1009,4230,5239,40360,169200,209560
7/21/2024,Ravindra Seneviratne,Kurunegala,Ibbagamuwa,North Western,1363,571,1934,54520,22840,77360
7/22/2024,Ravindra Seneviratne,Kurunegala,Ibbagamuwa,North Western,6883,7959,14842,275320,318360,593680
7/23/2024,Ravindra Seneviratne,Kurunegala,Ibbagamuwa,North Western,2003,320,2323,80120,12800,92920
7/24/2024,Ravindra Seneviratne,Kurunegala,Ibbagamuwa,North Western,2879,1262,4141,115160,50480,165640
7/25/2024,Ravindra Seneviratne,Kurunegala,Ibbagamuwa,North Western,1940,8230,10170,77600,329200,406800
7/26/2024,Ravindra Seneviratne,Kurunegala,Ibbagamuwa,North Western,1340,2924,4264,53600,116960,170560
7/27/2024,Ravindra Seneviratne,Kurunegala,Ibbagamuwa,North Western,7597,6642,14239,303880,265680,569560
7/28/2024,Ravindra Seneviratne,Kurunegala,Ibbagamuwa,North Western,4488,176,4664,179520,7040,186560
7/29/2024,Ravindra Seneviratne,Kurunegala,Ibbagamuwa,North Western,506,5713,6219,20240,228520,248760
7/30/2024,Ravindra Seneviratne,Kurunegala,Ibbagamuwa,North Western,770,3185,3955,30800,127400,158200
7/31/2024,Ravindra Seneviratne,Kurunegala,Ibbagamuwa,North Western,3116,1728,4844,124640,69120,193760
8/1/2024,Ravindra Seneviratne,Kurunegala,Ibbagamuwa,North Western,5356,4567,9923,214240,182680,396920
8/2/2024,Ravindra Seneviratne,Kurunegala,Ibbagamuwa,North Western,807,4697,5504,32280,187880,220160
8/3/2024,Ravindra Seneviratne,Kurunegala,Ibbagamuwa,North Western,2363,7039,9402,94520,281560,376080
8/4/2024,Ravindra Seneviratne,Kurunegala,Ibbagamuwa,North Western,7855,7896,15751,314200,315840,630040
8/5/2024,Ravindra Seneviratne,Kurunegala,Ibbagamuwa,North Western,1982,6753,8735,79280,270120,349400
8/6/2024,Ravindra Seneviratne,Kurunegala,Ibbagamuwa,North Western,9333,1469,10802,373320,58760,432080
8/7/2024,Ravindra Seneviratne,Kurunegala,Ibbagamuwa,North Western,9710,2869,12579,388400,114760,503160
8/8/2024,Ravindra Seneviratne,Kurunegala,Ibbagamuwa,North Western,4723,6030,10753,188920,241200,430120
8/9/2024,Ravindra Seneviratne,Kurunegala,Ibbagamuwa,North Western,1550,7687,9237,62000,307480,369480
8/10/2024,Ravindra Seneviratne,Kurunegala,Ibbagamuwa,North Western,3410,3202,6612,136400,128080,264480
8/11/2024,Ravindra Seneviratne,Kurunegala,Ibbagamuwa,North Western,7525,5316,12841,301000,212640,513640
8/12/2024,Ravindra Seneviratne,Kurunegala,Ibbagamuwa,North Western,8416,3325,11741,336640,133000,469640
8/13/2024,Ravindra Seneviratne,Kurunegala,Ibbagamuwa,North Western,1101,9855,10956,44040,394200,438240
8/14/2024,Ravindra Seneviratne,Kurunegala,Ibbagamuwa,North Western,9940,6597,16537,397600,263880,661480
8/15/2024,Ravindra Seneviratne,Kurunegala,Ibbagamuwa,North Western,6902,3739,10641,276080,149560,425640
8/16/2024,Ravindra Seneviratne,Kurunegala,Ibbagamuwa,North Western,1114,7110,8224,44560,284400,328960
8/17/2024,Ravindra Seneviratne,Kurunegala,Ibbagamuwa,North Western,8917,7043,15960,356680,281720,638400
8/18/2024,Ravindra Seneviratne,Kurunegala,Ibbagamuwa,North Western,9573,3229,12802,382920,129160,512080
8/19/2024,Ravindra Seneviratne,Kurunegala,Ibbagamuwa,North Western,3502,6904,10406,140080,276160,416240
8/20/2024,Ravindra Seneviratne,Kurunegala,Ibbagamuwa,North Western,6131,7224,13355,245240,288960,534200
8/21/2024,Ravindra Seneviratne,Kurunegala,Ibbagamuwa,North Western,7837,912,8749,313480,36480,349960
8/22/2024,Ravindra Seneviratne,Kurunegala,Ibbagamuwa,North Western,9143,8539,17682,365720,341560,707280
8/23/2024,Ravindra Seneviratne,Kurunegala,Ibbagamuwa,North Western,9016,5317,14333,360640,212680,573320
8/24/2024,Ravindra Seneviratne,Kurunegala,Ibbagamuwa,North Western,3735,7608,11343,149400,304320,453720
8/25/2024,Ravindra Seneviratne,Kurunegala,Ibbagamuwa,North Western,1249,4391,5640,49960,175640,225600
8/26/2024,Ravindra Seneviratne,Kurunegala,Ibbagamuwa,North Western,9883,7723,17606,395320,308920,704240
8/27/2024,Ravindra Seneviratne,Kurunegala,Ibbagamuwa,North Western,16,2763,2779,640,110520,111160
8/28/2024,Ravindra Seneviratne,Kurunegala,Ibbagamuwa,North Western,752,6106,6858,30080,244240,274320
8/29/2024,Ravindra Seneviratne,Kurunegala,Ibbagamuwa,North Western,2350,6783,9133,94000,271320,365320
8/30/2024,Ravindra Seneviratne,Kurunegala,Ibbagamuwa,North Western,2887,2983,5870,115480,119320,234800
8/31/2024,Ravindra Seneviratne,Kurunegala,Ibbagamuwa,North Western,8723,4796,13519,348920,191840,540760
9/1/2024,Ravindra Seneviratne,Kurunegala,Ibbagamuwa,North Western,2107,7498,9605,84280,299920,384200
9/2/2024,Ravindra Seneviratne,Kurunegala,Ibbagamuwa,North Western,1736,7626,9362,69440,305040,374480
9/3/2024,Ravindra Seneviratne,Kurunegala,Ibbagamuwa,North Western,9185,2752,11937,367400,110080,477480
9/4/2024,Ravindra Seneviratne,Kurunegala,Ibbagamuwa,North Western,6964,5285,12249,278560,211400,489960
9/5/2024,Ravindra Seneviratne,Kurunegala,Ibbagamuwa,North Western,7995,9508,17503,319800,380320,700120
9/6/2024,Ravindra Seneviratne,Kurunegala,Ibbagamuwa,North Western,5537,3461,8998,221480,138440,359920
9/7/2024,Ravindra Seneviratne,Kurunegala,Ibbagamuwa,North Western,6852,5890,12742,274080,235600,509680
9/8/2024,Ravindra Seneviratne,Kurunegala,Ibbagamuwa,North Western,7470,8782,16252,298800,351280,650080
9/9/2024,Ravindra Seneviratne,Kurunegala,Ibbagamuwa,North Western,141,9558,9699,5640,382320,387960
9/10/2024,Ravindra Seneviratne,Kurunegala,Ibbagamuwa,North Western,8642,1671,10313,345680,66840,412520
9/11/2024,Ravindra Seneviratne,Kurunegala,Ibbagamuwa,North Western,6162,7675,13837,246480,307000,553480
9/12/2024,Ravindra Seneviratne,Kurunegala,Ibbagamuwa,North Western,1989,454,2443,79560,18160,97720
9/13/2024,Ravindra Seneviratne,Kurunegala,Ibbagamuwa,North Western,1769,6037,7806,70760,241480,312240
9/14/2024,Ravindra Seneviratne,Kurunegala,Ibbagamuwa,North Western,353,5010,5363,14120,200400,214520
9/15/2024,Ravindra Seneviratne,Kurunegala,Ibbagamuwa,North Western,8979,5971,14950,359160,238840,598000
9/16/2024,Ravindra Seneviratne,Kurunegala,Ibbagamuwa,North Western,9424,4938,14362,376960,197520,574480
9/17/2024,Ravindra Seneviratne,Kurunegala,Ibbagamuwa,North Western,6311,7837,14148,252440,313480,565920
9/18/2024,Ravindra Seneviratne,Kurunegala,Ibbagamuwa,North Western,8374,4734,13108,334960,189360,524320
9/19/2024,Ravindra Seneviratne,Kurunegala,Ibbagamuwa,North Western,9885,1025,10910,395400,41000,436400
9/20/2024,Ravindra Seneviratne,Kurunegala,Ibbagamuwa,North Western,9723,2338,12061,388920,93520,482440
9/21/2024,Ravindra Seneviratne,Kurunegala,Ibbagamuwa,North Western,1678,462,2140,67120,18480,85600
9/22/2024,Ravindra Seneviratne,Kurunegala,Ibbagamuwa,North Western,3809,2159,5968,152360,86360,238720
9/23/2024,Ravindra Seneviratne,Kurunegala,Ibbagamuwa,North Western,3442,6850,10292,137680,274000,411680
9/24/2024,Ravindra Seneviratne,Kurunegala,Ibbagamuwa,North Western,3753,1593,5346,150120,63720,213840
9/25/2024,Ravindra Seneviratne,Kurunegala,Ibbagamuwa,North Western,3663,5485,9148,146520,219400,365920
9/26/2024,Ravindra Seneviratne,Kurunegala,Ibbagamuwa,North Western,8488,8457,16945,339520,338280,677800
9/27/2024,Ravindra Seneviratne,Kurunegala,Ibbagamuwa,North Western,2605,6032,8637,104200,241280,345480
9/28/2024,Ravindra Seneviratne,Kurunegala,Ibbagamuwa,North Western,6108,339,6447,244320,13560,257880
9/29/2024,Ravindra Seneviratne,Kurunegala,Ibbagamuwa,North Western,7126,716,7842,285040,28640,313680
9/30/2024,Ravindra Seneviratne,Kurunegala,Ibbagamuwa,North Western,8417,3259,11676,336680,130360,467040
10/1/2024,Ravindra Seneviratne,Kurunegala,Ibbagamuwa,North Western,771,7986,8757,30840,319440,350280
10/2/2024,Ravindra Seneviratne,Kurunegala,Ibbagamuwa,North Western,3128,6635,9763,125120,265400,390520
10/3/2024,Ravindra Seneviratne,Kurunegala,Ibbagamuwa,North Western,546,5030,5576,21840,201200,223040
10/4/2024,Ravindra Seneviratne,Kurunegala,Ibbagamuwa,North Western,4230,3886,8116,169200,155440,324640
10/5/2024,Ravindra Seneviratne,Kurunegala,Ibbagamuwa,North Western,356,5794,6150,14240,231760,246000
10/6/2024,Ravindra Seneviratne,Kurunegala,Ibbagamuwa,North Western,104,1357,1461,4160,54280,58440
10/7/2024,Ravindra Seneviratne,Kurunegala,Ibbagamuwa,North Western,104,1673,1777,4160,66920,71080
10/8/2024,Ravindra Seneviratne,Kurunegala,Ibbagamuwa,North Western,2425,5244,7669,97000,209760,306760
10/9/2024,Ravindra Seneviratne,Kurunegala,Ibbagamuwa,North Western,3130,8749,11879,125200,349960,475160
10/10/2024,Ravindra Seneviratne,Kurunegala,Ibbagamuwa,North Western,1195,1574,2769,47800,62960,110760
10/11/2024,Ravindra Seneviratne,Kurunegala,Ibbagamuwa,North Western,285,2549,2834,11400,101960,113360
10/12/2024,Ravindra Seneviratne,Kurunegala,Ibbagamuwa,North Western,1494,6998,8492,59760,279920,339680
10/13/2024,Ravindra Seneviratne,Kurunegala,Ibbagamuwa,North Western,7111,199,7310,284440,7960,292400
10/14/2024,Ravindra Seneviratne,Kurunegala,Ibbagamuwa,North Western,5899,1471,7370,235960,58840,294800
10/15/2024,Ravindra Seneviratne,Kurunegala,Ibbagamuwa,North Western,7933,7027,14960,317320,281080,598400
10/16/2024,Ravindra Seneviratne,Kurunegala,Ibbagamuwa,North Western,6280,9551,15831,251200,382040,633240
10/17/2024,Ravindra Seneviratne,Kurunegala,Ibbagamuwa,North Western,350,9575,9925,14000,383000,397000
10/18/2024,Ravindra Seneviratne,Kurunegala,Ibbagamuwa,North Western,6729,5723,12452,269160,228920,498080
10/19/2024,Ravindra Seneviratne,Kurunegala,Ibbagamuwa,North Western,8487,9043,17530,339480,361720,701200
10/20/2024,Ravindra Seneviratne,Kurunegala,Ibbagamuwa,North Western,4304,2488,6792,172160,99520,271680
10/21/2024,Ravindra Seneviratne,Kurunegala,Ibbagamuwa,North Western,4904,8965,13869,196160,358600,554760
10/22/2024,Ravindra Seneviratne,Kurunegala,Ibbagamuwa,North Western,7616,1818,9434,304640,72720,377360
10/23/2024,Ravindra Seneviratne,Kurunegala,Ibbagamuwa,North Western,8091,1462,9553,323640,58480,382120
10/24/2024,Ravindra Seneviratne,Kurunegala,Ibbagamuwa,North Western,4710,1557,6267,188400,62280,250680
10/25/2024,Ravindra Seneviratne,Kurunegala,Ibbagamuwa,North Western,5986,2983,8969,239440,119320,358760
10/26/2024,Ravindra Seneviratne,Kurunegala,Ibbagamuwa,North Western,416,3493,3909,16640,139720,156360
10/27/2024,Ravindra Seneviratne,Kurunegala,Ibbagamuwa,North Western,2406,7189,9595,96240,287560,383800
10/28/2024,Ravindra Seneviratne,Kurunegala,Ibbagamuwa,North Western,2182,776,2958,87280,31040,118320
10/29/2024,Ravindra Seneviratne,Kurunegala,Ibbagamuwa,North Western,6284,4361,10645,251360,174440,425800
10/30/2024,Ravindra Seneviratne,Kurunegala,Ibbagamuwa,North Western,7457,6600,14057,298280,264000,562280
10/31/2024,Ravindra Seneviratne,Kurunegala,Ibbagamuwa,North Western,6211,9894,16105,248440,395760,644200
11/1/2024,Ravindra Seneviratne,Kurunegala,Ibbagamuwa,North Western,5682,9399,15081,227280,375960,603240
11/2/2024,Ravindra Seneviratne,Kurunegala,Ibbagamuwa,North Western,8387,8292,16679,335480,331680,667160
11/3/2024,Ravindra Seneviratne,Kurunegala,Ibbagamuwa,North Western,4098,2983,7081,163920,119320,283240
11/4/2024,Ravindra Seneviratne,Kurunegala,Ibbagamuwa,North Western,3245,7123,10368,129800,284920,414720
11/5/2024,Ravindra Seneviratne,Kurunegala,Ibbagamuwa,North Western,9355,4461,13816,374200,178440,552640
11/6/2024,Ravindra Seneviratne,Kurunegala,Ibbagamuwa,North Western,5347,5910,11257,213880,236400,450280
11/7/2024,Ravindra Seneviratne,Kurunegala,Ibbagamuwa,North Western,9521,9640,19161,380840,385600,766440
11/8/2024,Ravindra Seneviratne,Kurunegala,Ibbagamuwa,North Western,3847,5663,9510,153880,226520,380400
11/9/2024,Ravindra Seneviratne,Kurunegala,Ibbagamuwa,North Western,6392,8115,14507,255680,324600,580280
11/10/2024,Ravindra Seneviratne,Kurunegala,Ibbagamuwa,North Western,4428,8761,13189,177120,350440,527560
11/11/2024,Ravindra Seneviratne,Kurunegala,Ibbagamuwa,North Western,6311,8201,14512,252440,328040,580480
11/12/2024,Ravindra Seneviratne,Kurunegala,Ibbagamuwa,North Western,3454,6577,10031,138160,263080,401240
11/13/2024,Ravindra Seneviratne,Kurunegala,Ibbagamuwa,North Western,5252,3752,9004,210080,150080,360160
11/14/2024,Ravindra Seneviratne,Kurunegala,Ibbagamuwa,North Western,3101,9765,12866,124040,390600,514640
11/15/2024,Ravindra Seneviratne,Kurunegala,Ibbagamuwa,North Western,2771,5113,7884,110840,204520,315360
11/16/2024,Ravindra Seneviratne,Kurunegala,Ibbagamuwa,North Western,5865,2582,8447,234600,103280,337880
11/17/2024,Ravindra Seneviratne,Kurunegala,Ibbagamuwa,North Western,1203,1972,3175,48120,78880,127000
11/18/2024,Ravindra Seneviratne,Kurunegala,Ibbagamuwa,North Western,5804,4508,10312,232160,180320,412480
11/19/2024,Ravindra Seneviratne,Kurunegala,Ibbagamuwa,North Western,6675,5502,12177,267000,220080,487080
11/20/2024,Ravindra Seneviratne,Kurunegala,Ibbagamuwa,North Western,2958,2389,5347,118320,95560,213880
11/21/2024,Ravindra Seneviratne,Kurunegala,Ibbagamuwa,North Western,3615,2501,6116,144600,100040,244640
11/22/2024,Ravindra Seneviratne,Kurunegala,Ibbagamuwa,North Western,3443,4691,8134,137720,187640,325360
11/23/2024,Ravindra Seneviratne,Kurunegala,Ibbagamuwa,North Western,963,5410,6373,38520,216400,254920
11/24/2024,Ravindra Seneviratne,Kurunegala,Ibbagamuwa,North Western,472,6910,7382,18880,276400,295280
11/25/2024,Ravindra Seneviratne,Kurunegala,Ibbagamuwa,North Western,2455,1322,3777,98200,52880,151080
11/26/2024,Ravindra Seneviratne,Kurunegala,Ibbagamuwa,North Western,2596,8072,10668,103840,322880,426720
11/27/2024,Ravindra Seneviratne,Kurunegala,Ibbagamuwa,North Western,1464,8377,9841,58560,335080,393640
11/28/2024,Ravindra Seneviratne,Kurunegala,Ibbagamuwa,North Western,8086,4053,12139,323440,162120,485560
11/29/2024,Ravindra Seneviratne,Kurunegala,Ibbagamuwa,North Western,7352,9620,16972,294080,384800,678880
11/30/2024,Ravindra Seneviratne,Kurunegala,Ibbagamuwa,North Western,6923,275,7198,276920,11000,287920
12/1/2024,Ravindra Seneviratne,Kurunegala,Ibbagamuwa,North Western,8097,5014,13111,323880,200560,524440
12/2/2024,Ravindra Seneviratne,Kurunegala,Ibbagamuwa,North Western,9705,1247,10952,388200,49880,438080
12/3/2024,Ravindra Seneviratne,Kurunegala,Ibbagamuwa,North Western,6066,8446,14512,242640,337840,580480
12/4/2024,Ravindra Seneviratne,Kurunegala,Ibbagamuwa,North Western,1761,9688,11449,70440,387520,457960
12/5/2024,Ravindra Seneviratne,Kurunegala,Ibbagamuwa,North Western,6690,9890,16580,267600,395600,663200
12/6/2024,Ravindra Seneviratne,Kurunegala,Ibbagamuwa,North Western,3696,3192,6888,147840,127680,275520
12/7/2024,Ravindra Seneviratne,Kurunegala,Ibbagamuwa,North Western,2712,7845,10557,108480,313800,422280
12/8/2024,Ravindra Seneviratne,Kurunegala,Ibbagamuwa,North Western,2871,383,3254,114840,15320,130160
12/9/2024,Ravindra Seneviratne,Kurunegala,Ibbagamuwa,North Western,9764,7253,17017,390560,290120,680680
12/10/2024,Ravindra Seneviratne,Kurunegala,Ibbagamuwa,North Western,9286,69,9355,371440,2760,374200
12/11/2024,Ravindra Seneviratne,Kurunegala,Ibbagamuwa,North Western,7392,4632,12024,295680,185280,480960
12/12/2024,Ravindra Seneviratne,Kurunegala,Ibbagamuwa,North Western,4059,682,4741,162360,27280,189640
12/13/2024,Ravindra Seneviratne,Kurunegala,Ibbagamuwa,North Western,9619,5069,14688,384760,202760,587520
12/14/2024,Ravindra Seneviratne,Kurunegala,Ibbagamuwa,North Western,7312,2499,9811,292480,99960,392440
12/15/2024,Ravindra Seneviratne,Kurunegala,Ibbagamuwa,North Western,632,7997,8629,25280,319880,345160
12/16/2024,Ravindra Seneviratne,Kurunegala,Ibbagamuwa,North Western,2437,5004,7441,97480,200160,297640
12/17/2024,Ravindra Seneviratne,Kurunegala,Ibbagamuwa,North Western,6925,2152,9077,277000,86080,363080
12/18/2024,Ravindra Seneviratne,Kurunegala,Ibbagamuwa,North Western,633,3922,4555,25320,156880,182200
12/19/2024,Ravindra Seneviratne,Kurunegala,Ibbagamuwa,North Western,4717,2895,7612,188680,115800,304480
12/20/2024,Ravindra Seneviratne,Kurunegala,Ibbagamuwa,North Western,8799,8682,17481,351960,347280,699240
12/21/2024,Ravindra Seneviratne,Kurunegala,Ibbagamuwa,North Western,3149,3368,6517,125960,134720,260680
12/22/2024,Ravindra Seneviratne,Kurunegala,Ibbagamuwa,North Western,979,326,1305,39160,13040,52200
12/23/2024,Ravindra Seneviratne,Kurunegala,Ibbagamuwa,North Western,1422,3772,5194,56880,150880,207760
12/24/2024,Ravindra Seneviratne,Kurunegala,Ibbagamuwa,North Western,3459,8919,12378,138360,356760,495120
12/25/2024,Ravindra Seneviratne,Kurunegala,Ibbagamuwa,North Western,8644,4965,13609,345760,198600,544360
12/26/2024,Ravindra Seneviratne,Kurunegala,Ibbagamuwa,North Western,2253,6158,8411,90120,246320,336440
12/27/2024,Ravindra Seneviratne,Kurunegala,Ibbagamuwa,North Western,5980,4929,10909,239200,197160,436360
12/28/2024,Ravindra Seneviratne,Kurunegala,Ibbagamuwa,North Western,8683,615,9298,347320,24600,371920
12/29/2024,Ravindra Seneviratne,Kurunegala,Ibbagamuwa,North Western,826,3746,4572,33040,149840,182880
12/30/2024,Ravindra Seneviratne,Kurunegala,Ibbagamuwa,North Western,8137,482,8619,325480,19280,344760
12/31/2024,Ravindra Seneviratne,Kurunegala,Ibbagamuwa,North Western,4128,2361,6489,165120,94440,259560
1/1/2025,Ravindra Seneviratne,Kurunegala,Ibbagamuwa,North Western,4722,205,4927,188880,8200,197080
1/2/2025,Ravindra Seneviratne,Kurunegala,Ibbagamuwa,North Western,5136,2514,7650,205440,100560,306000
1/3/2025,Ravindra Seneviratne,Kurunegala,Ibbagamuwa,North Western,3186,8397,11583,127440,335880,463320
1/4/2025,Ravindra Seneviratne,Kurunegala,Ibbagamuwa,North Western,9104,9267,18371,364160,370680,734840
1/5/2025,Ravindra Seneviratne,Kurunegala,Ibbagamuwa,North Western,7856,9233,17089,314240,369320,683560
1/6/2025,Ravindra Seneviratne,Kurunegala,Ibbagamuwa,North Western,1266,1880,3146,50640,75200,125840
1/7/2025,Ravindra Seneviratne,Kurunegala,Ibbagamuwa,North Western,8850,7301,16151,354000,292040,646040
1/8/2025,Ravindra Seneviratne,Kurunegala,Ibbagamuwa,North Western,2295,2614,4909,91800,104560,196360
1/9/2025,Ravindra Seneviratne,Kurunegala,Ibbagamuwa,North Western,2226,8509,10735,89040,340360,429400
1/10/2025,Ravindra Seneviratne,Kurunegala,Ibbagamuwa,North Western,7929,4296,12225,317160,171840,489000
1/11/2025,Ravindra Seneviratne,Kurunegala,Ibbagamuwa,North Western,6793,3965,10758,271720,158600,430320
1/12/2025,Ravindra Seneviratne,Kurunegala,Ibbagamuwa,North Western,7715,8004,15719,308600,320160,628760
1/13/2025,Ravindra Seneviratne,Kurunegala,Ibbagamuwa,North Western,8349,3112,11461,333960,124480,458440
1/14/2025,Ravindra Seneviratne,Kurunegala,Ibbagamuwa,North Western,1241,3635,4876,49640,145400,195040
1/15/2025,Ravindra Seneviratne,Kurunegala,Ibbagamuwa,North Western,1212,1681,2893,48480,67240,115720
1/16/2025,Ravindra Seneviratne,Kurunegala,Ibbagamuwa,North Western,2720,6743,9463,108800,269720,378520
1/17/2025,Ravindra Seneviratne,Kurunegala,Ibbagamuwa,North Western,3289,2902,6191,131560,116080,247640
1/18/2025,Ravindra Seneviratne,Kurunegala,Ibbagamuwa,North Western,1030,5485,6515,41200,219400,260600
1/19/2025,Ravindra Seneviratne,Kurunegala,Ibbagamuwa,North Western,4251,2756,7007,170040,110240,280280
1/20/2025,Ravindra Seneviratne,Kurunegala,Ibbagamuwa,North Western,6381,5830,12211,255240,233200,488440
1/21/2025,Ravindra Seneviratne,Kurunegala,Ibbagamuwa,North Western,7240,7091,14331,289600,283640,573240
1/22/2025,Ravindra Seneviratne,Kurunegala,Ibbagamuwa,North Western,2206,3958,6164,88240,158320,246560
1/23/2025,Ravindra Seneviratne,Kurunegala,Ibbagamuwa,North Western,5557,6304,11861,222280,252160,474440
1/24/2025,Ravindra Seneviratne,Kurunegala,Ibbagamuwa,North Western,3034,8593,11627,121360,343720,465080
1/25/2025,Ravindra Seneviratne,Kurunegala,Ibbagamuwa,North Western,5938,3732,9670,237520,149280,386800
1/26/2025,Ravindra Seneviratne,Kurunegala,Ibbagamuwa,North Western,3824,43,3867,152960,1720,154680
1/27/2025,Ravindra Seneviratne,Kurunegala,Ibbagamuwa,North Western,1081,7814,8895,43240,312560,355800
1/28/2025,Ravindra Seneviratne,Kurunegala,Ibbagamuwa,North Western,1412,3624,5036,56480,144960,201440
1/29/2025,Ravindra Seneviratne,Kurunegala,Ibbagamuwa,North Western,6191,2757,8948,247640,110280,357920
1/30/2025,Ravindra Seneviratne,Kurunegala,Ibbagamuwa,North Western,5042,6824,11866,201680,272960,474640
1/31/2025,Ravindra Seneviratne,Kurunegala,Ibbagamuwa,North Western,8237,2482,10719,329480,99280,428760
2/1/2025,Ravindra Seneviratne,Kurunegala,Ibbagamuwa,North Western,9897,3097,12994,395880,123880,519760
2/2/2025,Ravindra Seneviratne,Kurunegala,Ibbagamuwa,North Western,7837,3675,11512,313480,147000,460480
2/3/2025,Ravindra Seneviratne,Kurunegala,Ibbagamuwa,North Western,6175,5063,11238,247000,202520,449520
2/4/2025,Ravindra Seneviratne,Kurunegala,Ibbagamuwa,North Western,606,3366,3972,24240,134640,158880
2/5/2025,Ravindra Seneviratne,Kurunegala,Ibbagamuwa,North Western,7895,5566,13461,315800,222640,538440
2/6/2025,Ravindra Seneviratne,Kurunegala,Ibbagamuwa,North Western,1634,973,2607,65360,38920,104280
2/7/2025,Ravindra Seneviratne,Kurunegala,Ibbagamuwa,North Western,3067,3320,6387,122680,132800,255480
2/8/2025,Ravindra Seneviratne,Kurunegala,Ibbagamuwa,North Western,6954,2011,8965,278160,80440,358600
2/9/2025,Ravindra Seneviratne,Kurunegala,Ibbagamuwa,North Western,5501,6902,12403,220040,276080,496120
2/10/2025,Ravindra Seneviratne,Kurunegala,Ibbagamuwa,North Western,8054,8728,16782,322160,349120,671280
2/11/2025,Ravindra Seneviratne,Kurunegala,Ibbagamuwa,North Western,4202,8255,12457,168080,330200,498280
2/12/2025,Ravindra Seneviratne,Kurunegala,Ibbagamuwa,North Western,1808,1916,3724,72320,76640,148960
2/13/2025,Ravindra Seneviratne,Kurunegala,Ibbagamuwa,North Western,8082,3499,11581,323280,139960,463240
2/14/2025,Ravindra Seneviratne,Kurunegala,Ibbagamuwa,North Western,8793,7519,16312,351720,300760,652480
2/15/2025,Ravindra Seneviratne,Kurunegala,Ibbagamuwa,North Western,3422,4516,7938,136880,180640,317520
2/16/2025,Ravindra Seneviratne,Kurunegala,Ibbagamuwa,North Western,2636,5539,8175,105440,221560,327000
2/17/2025,Ravindra Seneviratne,Kurunegala,Ibbagamuwa,North Western,5664,3785,9449,226560,151400,377960
2/18/2025,Ravindra Seneviratne,Kurunegala,Ibbagamuwa,North Western,5396,4446,9842,215840,177840,393680
2/19/2025,Ravindra Seneviratne,Kurunegala,Ibbagamuwa,North Western,1219,6545,7764,48760,261800,310560
2/20/2025,Ravindra Seneviratne,Kurunegala,Ibbagamuwa,North Western,5979,6477,12456,239160,259080,498240
2/21/2025,Ravindra Seneviratne,Kurunegala,Ibbagamuwa,North Western,6961,6088,13049,278440,243520,521960
2/22/2025,Ravindra Seneviratne,Kurunegala,Ibbagamuwa,North Western,4449,906,5355,177960,36240,214200
2/23/2025,Ravindra Seneviratne,Kurunegala,Ibbagamuwa,North Western,6840,3075,9915,273600,123000,396600
2/24/2025,Ravindra Seneviratne,Kurunegala,Ibbagamuwa,North Western,4778,9602,14380,191120,384080,575200
2/25/2025,Ravindra Seneviratne,Kurunegala,Ibbagamuwa,North Western,1041,8770,9811,41640,350800,392440
2/26/2025,Ravindra Seneviratne,Kurunegala,Ibbagamuwa,North Western,4995,1247,6242,199800,49880,249680
2/27/2025,Ravindra Seneviratne,Kurunegala,Ibbagamuwa,North Western,2067,3600,5667,82680,144000,226680
2/28/2025,Ravindra Seneviratne,Kurunegala,Ibbagamuwa,North Western,6035,5450,11485,241400,218000,459400
3/1/2025,Ravindra Seneviratne,Kurunegala,Ibbagamuwa,North Western,7434,8872,16306,297360,354880,652240
3/2/2025,Ravindra Seneviratne,Kurunegala,Ibbagamuwa,North Western,5443,4341,9784,217720,173640,391360
3/3/2025,Ravindra Seneviratne,Kurunegala,Ibbagamuwa,North Western,2936,594,3530,117440,23760,141200
3/4/2025,Ravindra Seneviratne,Kurunegala,Ibbagamuwa,North Western,2360,9373,11733,94400,374920,469320
3/5/2025,Ravindra Seneviratne,Kurunegala,Ibbagamuwa,North Western,2599,3910,6509,103960,156400,260360
3/6/2025,Ravindra Seneviratne,Kurunegala,Ibbagamuwa,North Western,9143,9631,18774,365720,385240,750960
3/7/2025,Ravindra Seneviratne,Kurunegala,Ibbagamuwa,North Western,2067,5550,7617,82680,222000,304680
3/8/2025,Ravindra Seneviratne,Kurunegala,Ibbagamuwa,North Western,3887,7293,11180,155480,291720,447200
3/9/2025,Ravindra Seneviratne,Kurunegala,Ibbagamuwa,North Western,1179,1986,3165,47160,79440,126600
3/10/2025,Ravindra Seneviratne,Kurunegala,Ibbagamuwa,North Western,4482,7534,12016,179280,301360,480640
3/11/2025,Ravindra Seneviratne,Kurunegala,Ibbagamuwa,North Western,7507,6741,14248,300280,269640,569920
3/12/2025,Ravindra Seneviratne,Kurunegala,Ibbagamuwa,North Western,1770,6963,8733,70800,278520,349320
3/13/2025,Ravindra Seneviratne,Kurunegala,Ibbagamuwa,North Western,9945,6663,16608,397800,266520,664320
3/14/2025,Ravindra Seneviratne,Kurunegala,Ibbagamuwa,North Western,607,4313,4920,24280,172520,196800
3/15/2025,Ravindra Seneviratne,Kurunegala,Ibbagamuwa,North Western,8689,7512,16201,347560,300480,648040
3/16/2025,Ravindra Seneviratne,Kurunegala,Ibbagamuwa,North Western,5032,7126,12158,201280,285040,486320
3/17/2025,Ravindra Seneviratne,Kurunegala,Ibbagamuwa,North Western,3797,4233,8030,151880,169320,321200
3/18/2025,Ravindra Seneviratne,Kurunegala,Ibbagamuwa,North Western,6566,2110,8676,262640,84400,347040
3/19/2025,Ravindra Seneviratne,Kurunegala,Ibbagamuwa,North Western,2263,9331,11594,90520,373240,463760
3/20/2025,Ravindra Seneviratne,Kurunegala,Ibbagamuwa,North Western,4673,2289,6962,186920,91560,278480
3/21/2025,Ravindra Seneviratne,Kurunegala,Ibbagamuwa,North Western,1711,6311,8022,68440,252440,320880
3/22/2025,Ravindra Seneviratne,Kurunegala,Ibbagamuwa,North Western,8573,6390,14963,342920,255600,598520
3/23/2025,Ravindra Seneviratne,Kurunegala,Ibbagamuwa,North Western,9802,3678,13480,392080,147120,539200
3/25/2024,Teshan De Silva,Kegalle,Mawanella,Sabaragamuwa,9559,9525,19084,382360,381000,763360
3/26/2024,Teshan De Silva,Kegalle,Mawanella,Sabaragamuwa,6394,3293,9687,255760,131720,387480
3/27/2024,Teshan De Silva,Kegalle,Mawanella,Sabaragamuwa,3114,7541,10655,124560,301640,426200
3/28/2024,Teshan De Silva,Kegalle,Mawanella,Sabaragamuwa,2681,1228,3909,107240,49120,156360
3/29/2024,Teshan De Silva,Kegalle,Mawanella,Sabaragamuwa,3182,6711,9893,127280,268440,395720
3/30/2024,Teshan De Silva,Kegalle,Mawanella,Sabaragamuwa,4103,2108,6211,164120,84320,248440
3/31/2024,Teshan De Silva,Kegalle,Mawanella,Sabaragamuwa,9280,9831,19111,371200,393240,764440
4/1/2024,Teshan De Silva,Kegalle,Mawanella,Sabaragamuwa,4649,1842,6491,185960,73680,259640
4/2/2024,Teshan De Silva,Kegalle,Mawanella,Sabaragamuwa,7603,9373,16976,304120,374920,679040
4/3/2024,Teshan De Silva,Kegalle,Mawanella,Sabaragamuwa,1123,9929,11052,44920,397160,442080
4/4/2024,Teshan De Silva,Kegalle,Mawanella,Sabaragamuwa,5656,9070,14726,226240,362800,589040
4/5/2024,Teshan De Silva,Kegalle,Mawanella,Sabaragamuwa,5748,7179,12927,229920,287160,517080
4/6/2024,Teshan De Silva,Kegalle,Mawanella,Sabaragamuwa,4507,7190,11697,180280,287600,467880
4/7/2024,Teshan De Silva,Kegalle,Mawanella,Sabaragamuwa,342,8749,9091,13680,349960,363640
4/8/2024,Teshan De Silva,Kegalle,Mawanella,Sabaragamuwa,9452,9553,19005,378080,382120,760200
4/9/2024,Teshan De Silva,Kegalle,Mawanella,Sabaragamuwa,6347,6915,13262,253880,276600,530480
4/10/2024,Teshan De Silva,Kegalle,Mawanella,Sabaragamuwa,3711,4097,7808,148440,163880,312320
4/11/2024,Teshan De Silva,Kegalle,Mawanella,Sabaragamuwa,1447,889,2336,57880,35560,93440
4/19/2024,Teshan De Silva,Kegalle,Mawanella,Sabaragamuwa,6878,3382,10260,275120,135280,410400
4/20/2024,Teshan De Silva,Kegalle,Mawanella,Sabaragamuwa,9987,2852,12839,399480,114080,513560
4/21/2024,Teshan De Silva,Kegalle,Mawanella,Sabaragamuwa,8028,3484,11512,321120,139360,460480
4/22/2024,Teshan De Silva,Kegalle,Mawanella,Sabaragamuwa,9787,3759,13546,391480,150360,541840
4/23/2024,Teshan De Silva,Kegalle,Mawanella,Sabaragamuwa,9830,9868,19698,393200,394720,787920
4/24/2024,Teshan De Silva,Kegalle,Mawanella,Sabaragamuwa,5967,8341,14308,238680,333640,572320
4/25/2024,Teshan De Silva,Kegalle,Mawanella,Sabaragamuwa,4247,1865,6112,169880,74600,244480
4/26/2024,Teshan De Silva,Kegalle,Mawanella,Sabaragamuwa,4498,7809,12307,179920,312360,492280
4/27/2024,Teshan De Silva,Kegalle,Mawanella,Sabaragamuwa,7302,9595,16897,292080,383800,675880
4/28/2024,Teshan De Silva,Kegalle,Mawanella,Sabaragamuwa,5363,7293,12656,214520,291720,506240
4/29/2024,Teshan De Silva,Kegalle,Mawanella,Sabaragamuwa,8556,5442,13998,342240,217680,559920
4/30/2024,Teshan De Silva,Kegalle,Mawanella,Sabaragamuwa,4895,7900,12795,195800,316000,511800
5/1/2024,Teshan De Silva,Kegalle,Mawanella,Sabaragamuwa,4471,8487,12958,178840,339480,518320
5/2/2024,Teshan De Silva,Kegalle,Mawanella,Sabaragamuwa,2896,7140,10036,115840,285600,401440
5/3/2024,Teshan De Silva,Kegalle,Mawanella,Sabaragamuwa,9062,8957,18019,362480,358280,720760
5/4/2024,Teshan De Silva,Kegalle,Mawanella,Sabaragamuwa,2492,3942,6434,99680,157680,257360
5/5/2024,Teshan De Silva,Kegalle,Mawanella,Sabaragamuwa,3368,8632,12000,134720,345280,480000
5/6/2024,Teshan De Silva,Kegalle,Mawanella,Sabaragamuwa,4825,410,5235,193000,16400,209400
5/7/2024,Teshan De Silva,Kegalle,Mawanella,Sabaragamuwa,9490,5278,14768,379600,211120,590720
5/8/2024,Teshan De Silva,Kegalle,Mawanella,Sabaragamuwa,1711,8953,10664,68440,358120,426560
5/9/2024,Teshan De Silva,Kegalle,Mawanella,Sabaragamuwa,2416,3754,6170,96640,150160,246800
5/10/2024,Teshan De Silva,Kegalle,Mawanella,Sabaragamuwa,1257,4544,5801,50280,181760,232040
5/11/2024,Teshan De Silva,Kegalle,Mawanella,Sabaragamuwa,5975,9692,15667,239000,387680,626680
5/12/2024,Teshan De Silva,Kegalle,Mawanella,Sabaragamuwa,4927,681,5608,197080,27240,224320
5/13/2024,Teshan De Silva,Kegalle,Mawanella,Sabaragamuwa,8345,3400,11745,333800,136000,469800
5/14/2024,Teshan De Silva,Kegalle,Mawanella,Sabaragamuwa,1370,4027,5397,54800,161080,215880
5/15/2024,Teshan De Silva,Kegalle,Mawanella,Sabaragamuwa,6834,8056,14890,273360,322240,595600
5/16/2024,Teshan De Silva,Kegalle,Mawanella,Sabaragamuwa,4874,5362,10236,194960,214480,409440
5/17/2024,Teshan De Silva,Kegalle,Mawanella,Sabaragamuwa,2033,8840,10873,81320,353600,434920
5/18/2024,Teshan De Silva,Kegalle,Mawanella,Sabaragamuwa,9015,6832,15847,360600,273280,633880
5/19/2024,Teshan De Silva,Kegalle,Mawanella,Sabaragamuwa,6370,9474,15844,254800,378960,633760
5/20/2024,Teshan De Silva,Kegalle,Mawanella,Sabaragamuwa,5185,5410,10595,207400,216400,423800
5/21/2024,Teshan De Silva,Kegalle,Mawanella,Sabaragamuwa,2329,1253,3582,93160,50120,143280
5/22/2024,Teshan De Silva,Kegalle,Mawanella,Sabaragamuwa,2482,7882,10364,99280,315280,414560
5/24/2024,Teshan De Silva,Kegalle,Mawanella,Sabaragamuwa,7119,8964,16083,284760,358560,643320
5/25/2024,Teshan De Silva,Kegalle,Mawanella,Sabaragamuwa,9091,492,9583,363640,19680,383320
5/26/2024,Teshan De Silva,Kegalle,Mawanella,Sabaragamuwa,6594,1410,8004,263760,56400,320160
5/27/2024,Teshan De Silva,Kegalle,Mawanella,Sabaragamuwa,5876,7435,13311,235040,297400,532440
5/28/2024,Teshan De Silva,Kegalle,Mawanella,Sabaragamuwa,8522,8738,17260,340880,349520,690400
5/29/2024,Teshan De Silva,Kegalle,Mawanella,Sabaragamuwa,2866,4277,7143,114640,171080,285720
5/30/2024,Teshan De Silva,Kegalle,Mawanella,Sabaragamuwa,4090,8864,12954,163600,354560,518160
5/31/2024,Teshan De Silva,Kegalle,Mawanella,Sabaragamuwa,5624,2280,7904,224960,91200,316160
6/1/2024,Teshan De Silva,Kegalle,Mawanella,Sabaragamuwa,2190,16,2206,87600,640,88240
6/2/2024,Teshan De Silva,Kegalle,Mawanella,Sabaragamuwa,464,3342,3806,18560,133680,152240
6/3/2024,Teshan De Silva,Kegalle,Mawanella,Sabaragamuwa,9346,5512,14858,373840,220480,594320
6/4/2024,Teshan De Silva,Kegalle,Mawanella,Sabaragamuwa,2247,5905,8152,89880,236200,326080
6/5/2024,Teshan De Silva,Kegalle,Mawanella,Sabaragamuwa,545,3031,3576,21800,121240,143040
6/6/2024,Teshan De Silva,Kegalle,Mawanella,Sabaragamuwa,9575,6971,16546,383000,278840,661840
6/7/2024,Teshan De Silva,Kegalle,Mawanella,Sabaragamuwa,1990,1210,3200,79600,48400,128000
6/8/2024,Teshan De Silva,Kegalle,Mawanella,Sabaragamuwa,1406,3267,4673,56240,130680,186920
6/9/2024,Teshan De Silva,Kegalle,Mawanella,Sabaragamuwa,5992,4698,10690,239680,187920,427600
6/10/2024,Teshan De Silva,Kegalle,Mawanella,Sabaragamuwa,5863,7422,13285,234520,296880,531400
6/11/2024,Teshan De Silva,Kegalle,Mawanella,Sabaragamuwa,7604,705,8309,304160,28200,332360
6/12/2024,Teshan De Silva,Kegalle,Mawanella,Sabaragamuwa,4388,4698,9086,175520,187920,363440
6/13/2024,Teshan De Silva,Kegalle,Mawanella,Sabaragamuwa,6277,6631,12908,251080,265240,516320
6/14/2024,Teshan De Silva,Kegalle,Mawanella,Sabaragamuwa,9142,7032,16174,365680,281280,646960
6/15/2024,Teshan De Silva,Kegalle,Mawanella,Sabaragamuwa,7485,1496,8981,299400,59840,359240
6/16/2024,Teshan De Silva,Kegalle,Mawanella,Sabaragamuwa,5089,1907,6996,203560,76280,279840
6/17/2024,Teshan De Silva,Kegalle,Mawanella,Sabaragamuwa,9931,8733,18664,397240,349320,746560
6/18/2024,Teshan De Silva,Kegalle,Mawanella,Sabaragamuwa,7617,3590,11207,304680,143600,448280
6/19/2024,Teshan De Silva,Kegalle,Mawanella,Sabaragamuwa,7154,1536,8690,286160,61440,347600
6/20/2024,Teshan De Silva,Kegalle,Mawanella,Sabaragamuwa,2044,135,2179,81760,5400,87160
6/21/2024,Teshan De Silva,Kegalle,Mawanella,Sabaragamuwa,7360,6722,14082,294400,268880,563280
6/22/2024,Teshan De Silva,Kegalle,Mawanella,Sabaragamuwa,5289,9687,14976,211560,387480,599040
6/23/2024,Teshan De Silva,Kegalle,Mawanella,Sabaragamuwa,9922,9997,19919,396880,399880,796760
6/24/2024,Teshan De Silva,Kegalle,Mawanella,Sabaragamuwa,2932,5530,8462,117280,221200,338480
6/25/2024,Teshan De Silva,Kegalle,Mawanella,Sabaragamuwa,657,9854,10511,26280,394160,420440
6/26/2024,Teshan De Silva,Kegalle,Mawanella,Sabaragamuwa,8300,2282,10582,332000,91280,423280
6/27/2024,Teshan De Silva,Kegalle,Mawanella,Sabaragamuwa,4657,6161,10818,186280,246440,432720
6/28/2024,Teshan De Silva,Kegalle,Mawanella,Sabaragamuwa,6035,2798,8833,241400,111920,353320
6/29/2024,Teshan De Silva,Kegalle,Mawanella,Sabaragamuwa,2649,9093,11742,105960,363720,469680
6/30/2024,Teshan De Silva,Kegalle,Mawanella,Sabaragamuwa,5128,8327,13455,205120,333080,538200
7/1/2024,Teshan De Silva,Kegalle,Mawanella,Sabaragamuwa,3286,5664,8950,131440,226560,358000
7/2/2024,Teshan De Silva,Kegalle,Mawanella,Sabaragamuwa,8027,7239,15266,321080,289560,610640
7/3/2024,Teshan De Silva,Kegalle,Mawanella,Sabaragamuwa,140,7017,7157,5600,280680,286280
7/4/2024,Teshan De Silva,Kegalle,Mawanella,Sabaragamuwa,5512,377,5889,220480,15080,235560
7/5/2024,Teshan De Silva,Kegalle,Mawanella,Sabaragamuwa,7353,513,7866,294120,20520,314640
7/6/2024,Teshan De Silva,Kegalle,Mawanella,Sabaragamuwa,5571,1187,6758,222840,47480,270320
7/7/2024,Teshan De Silva,Kegalle,Mawanella,Sabaragamuwa,2918,4456,7374,116720,178240,294960
7/8/2024,Teshan De Silva,Kegalle,Mawanella,Sabaragamuwa,1621,3583,5204,64840,143320,208160
7/9/2024,Teshan De Silva,Kegalle,Mawanella,Sabaragamuwa,3119,3332,6451,124760,133280,258040
7/10/2024,Teshan De Silva,Kegalle,Mawanella,Sabaragamuwa,9132,5934,15066,365280,237360,602640
7/11/2024,Teshan De Silva,Kegalle,Mawanella,Sabaragamuwa,865,6593,7458,34600,263720,298320
7/12/2024,Teshan De Silva,Kegalle,Mawanella,Sabaragamuwa,4315,437,4752,172600,17480,190080
7/13/2024,Teshan De Silva,Kegalle,Mawanella,Sabaragamuwa,3599,8144,11743,143960,325760,469720
7/14/2024,Teshan De Silva,Kegalle,Mawanella,Sabaragamuwa,5094,1703,6797,203760,68120,271880
7/15/2024,Teshan De Silva,Kegalle,Mawanella,Sabaragamuwa,4787,8471,13258,191480,338840,530320
7/16/2024,Teshan De Silva,Kegalle,Mawanella,Sabaragamuwa,7536,6218,13754,301440,248720,550160
7/17/2024,Teshan De Silva,Kegalle,Mawanella,Sabaragamuwa,2456,1749,4205,98240,69960,168200
7/18/2024,Teshan De Silva,Kegalle,Mawanella,Sabaragamuwa,3640,4932,8572,145600,197280,342880
7/19/2024,Teshan De Silva,Kegalle,Mawanella,Sabaragamuwa,5702,7252,12954,228080,290080,518160
7/20/2024,Teshan De Silva,Kegalle,Mawanella,Sabaragamuwa,5896,4068,9964,235840,162720,398560
7/21/2024,Teshan De Silva,Kegalle,Mawanella,Sabaragamuwa,561,3256,3817,22440,130240,152680
7/22/2024,Teshan De Silva,Kegalle,Mawanella,Sabaragamuwa,1610,8568,10178,64400,342720,407120
7/23/2024,Teshan De Silva,Kegalle,Mawanella,Sabaragamuwa,5862,8858,14720,234480,354320,588800
7/24/2024,Teshan De Silva,Kegalle,Mawanella,Sabaragamuwa,9959,571,10530,398360,22840,421200
7/25/2024,Teshan De Silva,Kegalle,Mawanella,Sabaragamuwa,8837,4927,13764,353480,197080,550560
7/26/2024,Teshan De Silva,Kegalle,Mawanella,Sabaragamuwa,9716,8425,18141,388640,337000,725640
7/27/2024,Teshan De Silva,Kegalle,Mawanella,Sabaragamuwa,7943,3860,11803,317720,154400,472120
7/28/2024,Teshan De Silva,Kegalle,Mawanella,Sabaragamuwa,197,4470,4667,7880,178800,186680
7/29/2024,Teshan De Silva,Kegalle,Mawanella,Sabaragamuwa,9788,4355,14143,391520,174200,565720
7/30/2024,Teshan De Silva,Kegalle,Mawanella,Sabaragamuwa,8611,4824,13435,344440,192960,537400
7/31/2024,Teshan De Silva,Kegalle,Mawanella,Sabaragamuwa,2938,9757,12695,117520,390280,507800
8/1/2024,Teshan De Silva,Kegalle,Mawanella,Sabaragamuwa,161,2347,2508,6440,93880,100320
8/2/2024,Teshan De Silva,Kegalle,Mawanella,Sabaragamuwa,8415,2795,11210,336600,111800,448400
8/3/2024,Teshan De Silva,Kegalle,Mawanella,Sabaragamuwa,6733,6324,13057,269320,252960,522280
8/4/2024,Teshan De Silva,Kegalle,Mawanella,Sabaragamuwa,9335,7560,16895,373400,302400,675800
8/5/2024,Teshan De Silva,Kegalle,Mawanella,Sabaragamuwa,1415,9378,10793,56600,375120,431720
8/6/2024,Teshan De Silva,Kegalle,Mawanella,Sabaragamuwa,1533,9013,10546,61320,360520,421840
8/7/2024,Teshan De Silva,Kegalle,Mawanella,Sabaragamuwa,2660,9395,12055,106400,375800,482200
8/8/2024,Teshan De Silva,Kegalle,Mawanella,Sabaragamuwa,3720,5084,8804,148800,203360,352160
8/9/2024,Teshan De Silva,Kegalle,Mawanella,Sabaragamuwa,2430,2376,4806,97200,95040,192240
8/10/2024,Teshan De Silva,Kegalle,Mawanella,Sabaragamuwa,8403,3143,11546,336120,125720,461840
8/11/2024,Teshan De Silva,Kegalle,Mawanella,Sabaragamuwa,8300,7404,15704,332000,296160,628160
8/12/2024,Teshan De Silva,Kegalle,Mawanella,Sabaragamuwa,3628,6062,9690,145120,242480,387600
8/13/2024,Teshan De Silva,Kegalle,Mawanella,Sabaragamuwa,6827,1424,8251,273080,56960,330040
8/14/2024,Teshan De Silva,Kegalle,Mawanella,Sabaragamuwa,826,6802,7628,33040,272080,305120
8/15/2024,Teshan De Silva,Kegalle,Mawanella,Sabaragamuwa,2375,924,3299,95000,36960,131960
8/16/2024,Teshan De Silva,Kegalle,Mawanella,Sabaragamuwa,5861,6764,12625,234440,270560,505000
8/17/2024,Teshan De Silva,Kegalle,Mawanella,Sabaragamuwa,5890,4448,10338,235600,177920,413520
8/18/2024,Teshan De Silva,Kegalle,Mawanella,Sabaragamuwa,6306,8603,14909,252240,344120,596360
8/19/2024,Teshan De Silva,Kegalle,Mawanella,Sabaragamuwa,7322,8863,16185,292880,354520,647400
8/20/2024,Teshan De Silva,Kegalle,Mawanella,Sabaragamuwa,3064,5428,8492,122560,217120,339680
8/21/2024,Teshan De Silva,Kegalle,Mawanella,Sabaragamuwa,695,885,1580,27800,35400,63200
8/22/2024,Teshan De Silva,Kegalle,Mawanella,Sabaragamuwa,4923,82,5005,196920,3280,200200
8/23/2024,Teshan De Silva,Kegalle,Mawanella,Sabaragamuwa,4978,9822,14800,199120,392880,592000
8/24/2024,Teshan De Silva,Kegalle,Mawanella,Sabaragamuwa,2657,4603,7260,106280,184120,290400
8/25/2024,Teshan De Silva,Kegalle,Mawanella,Sabaragamuwa,1172,1628,2800,46880,65120,112000
8/26/2024,Teshan De Silva,Kegalle,Mawanella,Sabaragamuwa,1515,6808,8323,60600,272320,332920
8/27/2024,Teshan De Silva,Kegalle,Mawanella,Sabaragamuwa,9655,2303,11958,386200,92120,478320
8/28/2024,Teshan De Silva,Kegalle,Mawanella,Sabaragamuwa,1678,2832,4510,67120,113280,180400
8/29/2024,Teshan De Silva,Kegalle,Mawanella,Sabaragamuwa,1278,4324,5602,51120,172960,224080
8/30/2024,Teshan De Silva,Kegalle,Mawanella,Sabaragamuwa,8098,4657,12755,323920,186280,510200
8/31/2024,Teshan De Silva,Kegalle,Mawanella,Sabaragamuwa,7906,7061,14967,316240,282440,598680
9/1/2024,Teshan De Silva,Kegalle,Mawanella,Sabaragamuwa,1277,2063,3340,51080,82520,133600
9/2/2024,Teshan De Silva,Kegalle,Mawanella,Sabaragamuwa,579,7267,7846,23160,290680,313840
9/3/2024,Teshan De Silva,Kegalle,Mawanella,Sabaragamuwa,5665,385,6050,226600,15400,242000
9/4/2024,Teshan De Silva,Kegalle,Mawanella,Sabaragamuwa,8046,9566,17612,321840,382640,704480
9/5/2024,Teshan De Silva,Kegalle,Mawanella,Sabaragamuwa,1386,4870,6256,55440,194800,250240
9/6/2024,Teshan De Silva,Kegalle,Mawanella,Sabaragamuwa,4741,4637,9378,189640,185480,375120
9/7/2024,Teshan De Silva,Kegalle,Mawanella,Sabaragamuwa,3642,7761,11403,145680,310440,456120
9/8/2024,Teshan De Silva,Kegalle,Mawanella,Sabaragamuwa,8385,3528,11913,335400,141120,476520
9/9/2024,Teshan De Silva,Kegalle,Mawanella,Sabaragamuwa,7933,9642,17575,317320,385680,703000
9/10/2024,Teshan De Silva,Kegalle,Mawanella,Sabaragamuwa,3885,5077,8962,155400,203080,358480
9/11/2024,Teshan De Silva,Kegalle,Mawanella,Sabaragamuwa,3441,9372,12813,137640,374880,512520
9/12/2024,Teshan De Silva,Kegalle,Mawanella,Sabaragamuwa,7389,423,7812,295560,16920,312480
9/13/2024,Teshan De Silva,Kegalle,Mawanella,Sabaragamuwa,4701,8763,13464,188040,350520,538560
9/14/2024,Teshan De Silva,Kegalle,Mawanella,Sabaragamuwa,3770,7527,11297,150800,301080,451880
9/15/2024,Teshan De Silva,Kegalle,Mawanella,Sabaragamuwa,9565,2547,12112,382600,101880,484480
9/16/2024,Teshan De Silva,Kegalle,Mawanella,Sabaragamuwa,1264,3928,5192,50560,157120,207680
9/17/2024,Teshan De Silva,Kegalle,Mawanella,Sabaragamuwa,9335,901,10236,373400,36040,409440
9/18/2024,Teshan De Silva,Kegalle,Mawanella,Sabaragamuwa,6166,1000,7166,246640,40000,286640
9/19/2024,Teshan De Silva,Kegalle,Mawanella,Sabaragamuwa,5636,67,5703,225440,2680,228120
9/20/2024,Teshan De Silva,Kegalle,Mawanella,Sabaragamuwa,150,8343,8493,6000,333720,339720
9/21/2024,Teshan De Silva,Kegalle,Mawanella,Sabaragamuwa,3111,7330,10441,124440,293200,417640
9/22/2024,Teshan De Silva,Kegalle,Mawanella,Sabaragamuwa,3484,3160,6644,139360,126400,265760
9/23/2024,Teshan De Silva,Kegalle,Mawanella,Sabaragamuwa,6314,9886,16200,252560,395440,648000
9/24/2024,Teshan De Silva,Kegalle,Mawanella,Sabaragamuwa,8829,4816,13645,353160,192640,545800
9/25/2024,Teshan De Silva,Kegalle,Mawanella,Sabaragamuwa,7487,8598,16085,299480,343920,643400
9/26/2024,Teshan De Silva,Kegalle,Mawanella,Sabaragamuwa,5587,7179,12766,223480,287160,510640
9/27/2024,Teshan De Silva,Kegalle,Mawanella,Sabaragamuwa,6114,5163,11277,244560,206520,451080
9/28/2024,Teshan De Silva,Kegalle,Mawanella,Sabaragamuwa,633,3762,4395,25320,150480,175800
9/29/2024,Teshan De Silva,Kegalle,Mawanella,Sabaragamuwa,3649,4691,8340,145960,187640,333600
9/30/2024,Teshan De Silva,Kegalle,Mawanella,Sabaragamuwa,8159,8273,16432,326360,330920,657280
10/1/2024,Teshan De Silva,Kegalle,Mawanella,Sabaragamuwa,4501,1043,5544,180040,41720,221760
10/2/2024,Teshan De Silva,Kegalle,Mawanella,Sabaragamuwa,4403,2531,6934,176120,101240,277360
10/3/2024,Teshan De Silva,Kegalle,Mawanella,Sabaragamuwa,5206,1704,6910,208240,68160,276400
10/4/2024,Teshan De Silva,Kegalle,Mawanella,Sabaragamuwa,2476,6999,9475,99040,279960,379000
10/5/2024,Teshan De Silva,Kegalle,Mawanella,Sabaragamuwa,9267,8837,18104,370680,353480,724160
10/6/2024,Teshan De Silva,Kegalle,Mawanella,Sabaragamuwa,2316,3441,5757,92640,137640,230280
10/7/2024,Teshan De Silva,Kegalle,Mawanella,Sabaragamuwa,9746,819,10565,389840,32760,422600
10/8/2024,Teshan De Silva,Kegalle,Mawanella,Sabaragamuwa,9748,2558,12306,389920,102320,492240
10/9/2024,Teshan De Silva,Kegalle,Mawanella,Sabaragamuwa,736,3504,4240,29440,140160,169600
10/10/2024,Teshan De Silva,Kegalle,Mawanella,Sabaragamuwa,2411,6878,9289,96440,275120,371560
10/11/2024,Teshan De Silva,Kegalle,Mawanella,Sabaragamuwa,3077,5458,8535,123080,218320,341400
10/12/2024,Teshan De Silva,Kegalle,Mawanella,Sabaragamuwa,5685,9434,15119,227400,377360,604760
10/13/2024,Teshan De Silva,Kegalle,Mawanella,Sabaragamuwa,6944,8799,15743,277760,351960,629720
10/14/2024,Teshan De Silva,Kegalle,Mawanella,Sabaragamuwa,9172,2524,11696,366880,100960,467840
10/15/2024,Teshan De Silva,Kegalle,Mawanella,Sabaragamuwa,6417,1565,7982,256680,62600,319280
10/16/2024,Teshan De Silva,Kegalle,Mawanella,Sabaragamuwa,4857,3815,8672,194280,152600,346880
10/17/2024,Teshan De Silva,Kegalle,Mawanella,Sabaragamuwa,8907,3408,12315,356280,136320,492600
10/18/2024,Teshan De Silva,Kegalle,Mawanella,Sabaragamuwa,8986,6675,15661,359440,267000,626440
10/19/2024,Teshan De Silva,Kegalle,Mawanella,Sabaragamuwa,4424,9665,14089,176960,386600,563560
10/20/2024,Teshan De Silva,Kegalle,Mawanella,Sabaragamuwa,7503,8873,16376,300120,354920,655040
10/21/2024,Teshan De Silva,Kegalle,Mawanella,Sabaragamuwa,1642,9775,11417,65680,391000,456680
10/22/2024,Teshan De Silva,Kegalle,Mawanella,Sabaragamuwa,9546,7945,17491,381840,317800,699640
10/23/2024,Teshan De Silva,Kegalle,Mawanella,Sabaragamuwa,1715,9553,11268,68600,382120,450720
10/24/2024,Teshan De Silva,Kegalle,Mawanella,Sabaragamuwa,2304,9667,11971,92160,386680,478840
10/25/2024,Teshan De Silva,Kegalle,Mawanella,Sabaragamuwa,2132,1058,3190,85280,42320,127600
10/26/2024,Teshan De Silva,Kegalle,Mawanella,Sabaragamuwa,1710,9773,11483,68400,390920,459320
10/27/2024,Teshan De Silva,Kegalle,Mawanella,Sabaragamuwa,3415,3164,6579,136600,126560,263160
10/28/2024,Teshan De Silva,Kegalle,Mawanella,Sabaragamuwa,5419,5950,11369,216760,238000,454760
10/29/2024,Teshan De Silva,Kegalle,Mawanella,Sabaragamuwa,1200,3001,4201,48000,120040,168040
10/30/2024,Teshan De Silva,Kegalle,Mawanella,Sabaragamuwa,9478,4248,13726,379120,169920,549040
10/31/2024,Teshan De Silva,Kegalle,Mawanella,Sabaragamuwa,1454,9340,10794,58160,373600,431760
11/1/2024,Teshan De Silva,Kegalle,Mawanella,Sabaragamuwa,7432,1905,9337,297280,76200,373480
11/2/2024,Teshan De Silva,Kegalle,Mawanella,Sabaragamuwa,1454,8277,9731,58160,331080,389240
11/3/2024,Teshan De Silva,Kegalle,Mawanella,Sabaragamuwa,8593,187,8780,343720,7480,351200
11/4/2024,Teshan De Silva,Kegalle,Mawanella,Sabaragamuwa,6232,1226,7458,249280,49040,298320
11/5/2024,Teshan De Silva,Kegalle,Mawanella,Sabaragamuwa,3001,545,3546,120040,21800,141840
11/6/2024,Teshan De Silva,Kegalle,Mawanella,Sabaragamuwa,402,1622,2024,16080,64880,80960
11/7/2024,Teshan De Silva,Kegalle,Mawanella,Sabaragamuwa,8918,6832,15750,356720,273280,630000
11/8/2024,Teshan De Silva,Kegalle,Mawanella,Sabaragamuwa,5996,9645,15641,239840,385800,625640
11/9/2024,Teshan De Silva,Kegalle,Mawanella,Sabaragamuwa,5910,5265,11175,236400,210600,447000
11/10/2024,Teshan De Silva,Kegalle,Mawanella,Sabaragamuwa,5544,1705,7249,221760,68200,289960
11/11/2024,Teshan De Silva,Kegalle,Mawanella,Sabaragamuwa,6264,5281,11545,250560,211240,461800
11/12/2024,Teshan De Silva,Kegalle,Mawanella,Sabaragamuwa,3690,5033,8723,147600,201320,348920
11/13/2024,Teshan De Silva,Kegalle,Mawanella,Sabaragamuwa,5808,5495,11303,232320,219800,452120
11/14/2024,Teshan De Silva,Kegalle,Mawanella,Sabaragamuwa,2585,3385,5970,103400,135400,238800
11/15/2024,Teshan De Silva,Kegalle,Mawanella,Sabaragamuwa,8211,3214,11425,328440,128560,457000
11/16/2024,Teshan De Silva,Kegalle,Mawanella,Sabaragamuwa,403,7109,7512,16120,284360,300480
11/17/2024,Teshan De Silva,Kegalle,Mawanella,Sabaragamuwa,6322,8492,14814,252880,339680,592560
11/18/2024,Teshan De Silva,Kegalle,Mawanella,Sabaragamuwa,2127,7211,9338,85080,288440,373520
11/19/2024,Teshan De Silva,Kegalle,Mawanella,Sabaragamuwa,1331,4408,5739,53240,176320,229560
11/20/2024,Teshan De Silva,Kegalle,Mawanella,Sabaragamuwa,4965,718,5683,198600,28720,227320
11/21/2024,Teshan De Silva,Kegalle,Mawanella,Sabaragamuwa,7384,7685,15069,295360,307400,602760
11/22/2024,Teshan De Silva,Kegalle,Mawanella,Sabaragamuwa,2738,6973,9711,109520,278920,388440
11/23/2024,Teshan De Silva,Kegalle,Mawanella,Sabaragamuwa,7344,916,8260,293760,36640,330400
11/24/2024,Teshan De Silva,Kegalle,Mawanella,Sabaragamuwa,8212,6793,15005,328480,271720,600200
11/25/2024,Teshan De Silva,Kegalle,Mawanella,Sabaragamuwa,3362,9182,12544,134480,367280,501760
11/26/2024,Teshan De Silva,Kegalle,Mawanella,Sabaragamuwa,9700,5564,15264,388000,222560,610560
11/27/2024,Teshan De Silva,Kegalle,Mawanella,Sabaragamuwa,2511,5160,7671,100440,206400,306840
11/28/2024,Teshan De Silva,Kegalle,Mawanella,Sabaragamuwa,3724,3959,7683,148960,158360,307320
11/29/2024,Teshan De Silva,Kegalle,Mawanella,Sabaragamuwa,1894,9047,10941,75760,361880,437640
11/30/2024,Teshan De Silva,Kegalle,Mawanella,Sabaragamuwa,6479,394,6873,259160,15760,274920
12/1/2024,Teshan De Silva,Kegalle,Mawanella,Sabaragamuwa,1739,4841,6580,69560,193640,263200
12/2/2024,Teshan De Silva,Kegalle,Mawanella,Sabaragamuwa,8420,3139,11559,336800,125560,462360
12/3/2024,Teshan De Silva,Kegalle,Mawanella,Sabaragamuwa,5774,4750,10524,230960,190000,420960
12/4/2024,Teshan De Silva,Kegalle,Mawanella,Sabaragamuwa,6656,8683,15339,266240,347320,613560
12/5/2024,Teshan De Silva,Kegalle,Mawanella,Sabaragamuwa,2908,9015,11923,116320,360600,476920
12/6/2024,Teshan De Silva,Kegalle,Mawanella,Sabaragamuwa,8495,243,8738,339800,9720,349520
12/7/2024,Teshan De Silva,Kegalle,Mawanella,Sabaragamuwa,713,9005,9718,28520,360200,388720
12/8/2024,Teshan De Silva,Kegalle,Mawanella,Sabaragamuwa,7398,5774,13172,295920,230960,526880
12/9/2024,Teshan De Silva,Kegalle,Mawanella,Sabaragamuwa,9385,6870,16255,375400,274800,650200
12/10/2024,Teshan De Silva,Kegalle,Mawanella,Sabaragamuwa,7877,3170,11047,315080,126800,441880
12/11/2024,Teshan De Silva,Kegalle,Mawanella,Sabaragamuwa,4904,8107,13011,196160,324280,520440
12/12/2024,Teshan De Silva,Kegalle,Mawanella,Sabaragamuwa,7118,1663,8781,284720,66520,351240
12/13/2024,Teshan De Silva,Kegalle,Mawanella,Sabaragamuwa,7065,2705,9770,282600,108200,390800
12/14/2024,Teshan De Silva,Kegalle,Mawanella,Sabaragamuwa,328,8637,8965,13120,345480,358600
12/15/2024,Teshan De Silva,Kegalle,Mawanella,Sabaragamuwa,5332,1920,7252,213280,76800,290080
12/16/2024,Teshan De Silva,Kegalle,Mawanella,Sabaragamuwa,1588,4323,5911,63520,172920,236440
12/17/2024,Teshan De Silva,Kegalle,Mawanella,Sabaragamuwa,5681,4107,9788,227240,164280,391520
12/18/2024,Teshan De Silva,Kegalle,Mawanella,Sabaragamuwa,7864,2322,10186,314560,92880,407440
12/19/2024,Teshan De Silva,Kegalle,Mawanella,Sabaragamuwa,1439,4147,5586,57560,165880,223440
12/20/2024,Teshan De Silva,Kegalle,Mawanella,Sabaragamuwa,3236,1289,4525,129440,51560,181000
12/21/2024,Teshan De Silva,Kegalle,Mawanella,Sabaragamuwa,6085,1067,7152,243400,42680,286080
12/22/2024,Teshan De Silva,Kegalle,Mawanella,Sabaragamuwa,1544,2487,4031,61760,99480,161240
12/23/2024,Teshan De Silva,Kegalle,Mawanella,Sabaragamuwa,3704,9556,13260,148160,382240,530400
12/24/2024,Teshan De Silva,Kegalle,Mawanella,Sabaragamuwa,6060,3962,10022,242400,158480,400880
12/25/2024,Teshan De Silva,Kegalle,Mawanella,Sabaragamuwa,8674,1785,10459,346960,71400,418360
12/26/2024,Teshan De Silva,Kegalle,Mawanella,Sabaragamuwa,5493,6462,11955,219720,258480,478200
12/27/2024,Teshan De Silva,Kegalle,Mawanella,Sabaragamuwa,3269,520,3789,130760,20800,151560
12/28/2024,Teshan De Silva,Kegalle,Mawanella,Sabaragamuwa,5516,6435,11951,220640,257400,478040
12/29/2024,Teshan De Silva,Kegalle,Mawanella,Sabaragamuwa,4211,1785,5996,168440,71400,239840
12/30/2024,Teshan De Silva,Kegalle,Mawanella,Sabaragamuwa,7388,9167,16555,295520,366680,662200
12/31/2024,Teshan De Silva,Kegalle,Mawanella,Sabaragamuwa,3451,1127,4578,138040,45080,183120
1/1/2025,Teshan De Silva,Kegalle,Mawanella,Sabaragamuwa,9700,4302,14002,388000,172080,560080
1/2/2025,Teshan De Silva,Kegalle,Mawanella,Sabaragamuwa,1942,3495,5437,77680,139800,217480
1/3/2025,Teshan De Silva,Kegalle,Mawanella,Sabaragamuwa,6773,6530,13303,270920,261200,532120
1/4/2025,Teshan De Silva,Kegalle,Mawanella,Sabaragamuwa,4576,5539,10115,183040,221560,404600
1/5/2025,Teshan De Silva,Kegalle,Mawanella,Sabaragamuwa,1320,4656,5976,52800,186240,239040
1/6/2025,Teshan De Silva,Kegalle,Mawanella,Sabaragamuwa,7665,6120,13785,306600,244800,551400
1/7/2025,Teshan De Silva,Kegalle,Mawanella,Sabaragamuwa,7311,5988,13299,292440,239520,531960
1/8/2025,Teshan De Silva,Kegalle,Mawanella,Sabaragamuwa,7686,7414,15100,307440,296560,604000
1/9/2025,Teshan De Silva,Kegalle,Mawanella,Sabaragamuwa,4208,8587,12795,168320,343480,511800
1/10/2025,Teshan De Silva,Kegalle,Mawanella,Sabaragamuwa,443,738,1181,17720,29520,47240
1/11/2025,Teshan De Silva,Kegalle,Mawanella,Sabaragamuwa,6733,1411,8144,269320,56440,325760
1/12/2025,Teshan De Silva,Kegalle,Mawanella,Sabaragamuwa,6932,3041,9973,277280,121640,398920
1/13/2025,Teshan De Silva,Kegalle,Mawanella,Sabaragamuwa,8465,7576,16041,338600,303040,641640
1/14/2025,Teshan De Silva,Kegalle,Mawanella,Sabaragamuwa,838,1974,2812,33520,78960,112480
1/15/2025,Teshan De Silva,Kegalle,Mawanella,Sabaragamuwa,1849,152,2001,73960,6080,80040
1/16/2025,Teshan De Silva,Kegalle,Mawanella,Sabaragamuwa,5468,9373,14841,218720,374920,593640
1/17/2025,Teshan De Silva,Kegalle,Mawanella,Sabaragamuwa,7343,6355,13698,293720,254200,547920
1/18/2025,Teshan De Silva,Kegalle,Mawanella,Sabaragamuwa,7828,7287,15115,313120,291480,604600
1/19/2025,Teshan De Silva,Kegalle,Mawanella,Sabaragamuwa,4562,7890,12452,182480,315600,498080
1/20/2025,Teshan De Silva,Kegalle,Mawanella,Sabaragamuwa,6986,8499,15485,279440,339960,619400
1/21/2025,Teshan De Silva,Kegalle,Mawanella,Sabaragamuwa,3465,2853,6318,138600,114120,252720
1/22/2025,Teshan De Silva,Kegalle,Mawanella,Sabaragamuwa,1181,399,1580,47240,15960,63200
1/23/2025,Teshan De Silva,Kegalle,Mawanella,Sabaragamuwa,9527,2507,12034,381080,100280,481360
1/24/2025,Teshan De Silva,Kegalle,Mawanella,Sabaragamuwa,1601,7136,8737,64040,285440,349480
1/25/2025,Teshan De Silva,Kegalle,Mawanella,Sabaragamuwa,4385,5227,9612,175400,209080,384480
1/26/2025,Teshan De Silva,Kegalle,Mawanella,Sabaragamuwa,7481,398,7879,299240,15920,315160
1/27/2025,Teshan De Silva,Kegalle,Mawanella,Sabaragamuwa,469,7286,7755,18760,291440,310200
1/28/2025,Teshan De Silva,Kegalle,Mawanella,Sabaragamuwa,9202,1260,10462,368080,50400,418480
1/29/2025,Teshan De Silva,Kegalle,Mawanella,Sabaragamuwa,8788,146,8934,351520,5840,357360
1/30/2025,Teshan De Silva,Kegalle,Mawanella,Sabaragamuwa,4393,4364,8757,175720,174560,350280
1/31/2025,Teshan De Silva,Kegalle,Mawanella,Sabaragamuwa,4254,6197,10451,170160,247880,418040
2/1/2025,Teshan De Silva,Kegalle,Mawanella,Sabaragamuwa,3113,7778,10891,124520,311120,435640
2/2/2025,Teshan De Silva,Kegalle,Mawanella,Sabaragamuwa,8034,1045,9079,321360,41800,363160
2/3/2025,Teshan De Silva,Kegalle,Mawanella,Sabaragamuwa,8376,7306,15682,335040,292240,627280
2/4/2025,Teshan De Silva,Kegalle,Mawanella,Sabaragamuwa,8593,7230,15823,343720,289200,632920
2/5/2025,Teshan De Silva,Kegalle,Mawanella,Sabaragamuwa,2237,6109,8346,89480,244360,333840
2/6/2025,Teshan De Silva,Kegalle,Mawanella,Sabaragamuwa,5996,538,6534,239840,21520,261360
2/7/2025,Teshan De Silva,Kegalle,Mawanella,Sabaragamuwa,5376,9482,14858,215040,379280,594320
2/8/2025,Teshan De Silva,Kegalle,Mawanella,Sabaragamuwa,4109,7857,11966,164360,314280,478640
2/9/2025,Teshan De Silva,Kegalle,Mawanella,Sabaragamuwa,5168,8579,13747,206720,343160,549880
2/10/2025,Teshan De Silva,Kegalle,Mawanella,Sabaragamuwa,1319,938,2257,52760,37520,90280
2/11/2025,Teshan De Silva,Kegalle,Mawanella,Sabaragamuwa,52,7556,7608,2080,302240,304320
2/12/2025,Teshan De Silva,Kegalle,Mawanella,Sabaragamuwa,4312,6625,10937,172480,265000,437480
2/13/2025,Teshan De Silva,Kegalle,Mawanella,Sabaragamuwa,7318,6995,14313,292720,279800,572520
2/14/2025,Teshan De Silva,Kegalle,Mawanella,Sabaragamuwa,8529,6069,14598,341160,242760,583920
2/15/2025,Teshan De Silva,Kegalle,Mawanella,Sabaragamuwa,5782,6517,12299,231280,260680,491960
2/16/2025,Teshan De Silva,Kegalle,Mawanella,Sabaragamuwa,5209,9044,14253,208360,361760,570120
2/17/2025,Teshan De Silva,Kegalle,Mawanella,Sabaragamuwa,7409,4201,11610,296360,168040,464400
2/18/2025,Teshan De Silva,Kegalle,Mawanella,Sabaragamuwa,8295,4780,13075,331800,191200,523000
2/19/2025,Teshan De Silva,Kegalle,Mawanella,Sabaragamuwa,8274,2075,10349,330960,83000,413960
2/20/2025,Teshan De Silva,Kegalle,Mawanella,Sabaragamuwa,4758,2701,7459,190320,108040,298360
2/21/2025,Teshan De Silva,Kegalle,Mawanella,Sabaragamuwa,9334,2594,11928,373360,103760,477120
2/22/2025,Teshan De Silva,Kegalle,Mawanella,Sabaragamuwa,6670,7330,14000,266800,293200,560000
2/23/2025,Teshan De Silva,Kegalle,Mawanella,Sabaragamuwa,8663,325,8988,346520,13000,359520
2/24/2025,Teshan De Silva,Kegalle,Mawanella,Sabaragamuwa,5853,4382,10235,234120,175280,409400
2/25/2025,Teshan De Silva,Kegalle,Mawanella,Sabaragamuwa,330,5361,5691,13200,214440,227640
2/26/2025,Teshan De Silva,Kegalle,Mawanella,Sabaragamuwa,3490,6770,10260,139600,270800,410400
2/27/2025,Teshan De Silva,Kegalle,Mawanella,Sabaragamuwa,3304,6048,9352,132160,241920,374080
2/28/2025,Teshan De Silva,Kegalle,Mawanella,Sabaragamuwa,4682,6319,11001,187280,252760,440040
3/1/2025,Teshan De Silva,Kegalle,Mawanella,Sabaragamuwa,2870,7370,10240,114800,294800,409600
3/2/2025,Teshan De Silva,Kegalle,Mawanella,Sabaragamuwa,5662,253,5915,226480,10120,236600
3/3/2025,Teshan De Silva,Kegalle,Mawanella,Sabaragamuwa,1367,873,2240,54680,34920,89600
3/4/2025,Teshan De Silva,Kegalle,Mawanella,Sabaragamuwa,7093,5972,13065,283720,238880,522600
3/5/2025,Teshan De Silva,Kegalle,Mawanella,Sabaragamuwa,9616,5504,15120,384640,220160,604800
3/6/2025,Teshan De Silva,Kegalle,Mawanella,Sabaragamuwa,1976,4095,6071,79040,163800,242840
3/7/2025,Teshan De Silva,Kegalle,Mawanella,Sabaragamuwa,5794,1224,7018,231760,48960,280720
3/8/2025,Teshan De Silva,Kegalle,Mawanella,Sabaragamuwa,5962,483,6445,238480,19320,257800
3/9/2025,Teshan De Silva,Kegalle,Mawanella,Sabaragamuwa,5294,8965,14259,211760,358600,570360
3/10/2025,Teshan De Silva,Kegalle,Mawanella,Sabaragamuwa,2721,9783,12504,108840,391320,500160
3/11/2025,Teshan De Silva,Kegalle,Mawanella,Sabaragamuwa,8803,5255,14058,352120,210200,562320
3/12/2025,Teshan De Silva,Kegalle,Mawanella,Sabaragamuwa,2075,9678,11753,83000,387120,470120
3/13/2025,Teshan De Silva,Kegalle,Mawanella,Sabaragamuwa,3979,1286,5265,159160,51440,210600
3/14/2025,Teshan De Silva,Kegalle,Mawanella,Sabaragamuwa,9905,7111,17016,396200,284440,680640
3/15/2025,Teshan De Silva,Kegalle,Mawanella,Sabaragamuwa,4018,3852,7870,160720,154080,314800
3/16/2025,Teshan De Silva,Kegalle,Mawanella,Sabaragamuwa,7644,9756,17400,305760,390240,696000
3/17/2025,Teshan De Silva,Kegalle,Mawanella,Sabaragamuwa,9432,349,9781,377280,13960,391240
3/18/2025,Teshan De Silva,Kegalle,Mawanella,Sabaragamuwa,370,4168,4538,14800,166720,181520
3/19/2025,Teshan De Silva,Kegalle,Mawanella,Sabaragamuwa,7762,2278,10040,310480,91120,401600
3/20/2025,Teshan De Silva,Kegalle,Mawanella,Sabaragamuwa,3881,3485,7366,155240,139400,294640
3/21/2025,Teshan De Silva,Kegalle,Mawanella,Sabaragamuwa,2789,16,2805,111560,640,112200
3/22/2025,Teshan De Silva,Kegalle,Mawanella,Sabaragamuwa,3307,1960,5267,132280,78400,210680
3/23/2025,Teshan De Silva,Kegalle,Mawanella,Sabaragamuwa,6991,2087,9078,279640,83480,363120
3/25/2024,Jayanthi Madhusanka,Galle,Koggala,Southern,9587,5639,15226,383480,225560,609040
3/26/2024,Jayanthi Madhusanka,Galle,Koggala,Southern,1078,1036,2114,43120,41440,84560
3/27/2024,Jayanthi Madhusanka,Galle,Koggala,Southern,5653,6373,12026,226120,254920,481040
3/28/2024,Jayanthi Madhusanka,Galle,Koggala,Southern,8190,9826,18016,327600,393040,720640
3/29/2024,Jayanthi Madhusanka,Galle,Koggala,Southern,3882,1958,5840,155280,78320,233600
3/30/2024,Jayanthi Madhusanka,Galle,Koggala,Southern,6104,5002,11106,244160,200080,444240
3/31/2024,Jayanthi Madhusanka,Galle,Koggala,Southern,5798,4052,9850,231920,162080,394000
4/1/2024,Jayanthi Madhusanka,Galle,Koggala,Southern,1893,9222,11115,75720,368880,444600
4/2/2024,Jayanthi Madhusanka,Galle,Koggala,Southern,242,2267,2509,9680,90680,100360
4/3/2024,Jayanthi Madhusanka,Galle,Koggala,Southern,6898,1979,8877,275920,79160,355080
4/4/2024,Jayanthi Madhusanka,Galle,Koggala,Southern,4458,6336,10794,178320,253440,431760
4/5/2024,Jayanthi Madhusanka,Galle,Koggala,Southern,6770,7364,14134,270800,294560,565360
4/6/2024,Jayanthi Madhusanka,Galle,Koggala,Southern,8858,7070,15928,354320,282800,637120
4/7/2024,Jayanthi Madhusanka,Galle,Koggala,Southern,504,9437,9941,20160,377480,397640
4/8/2024,Jayanthi Madhusanka,Galle,Koggala,Southern,3238,3989,7227,129520,159560,289080
4/9/2024,Jayanthi Madhusanka,Galle,Koggala,Southern,2436,5998,8434,97440,239920,337360
4/10/2024,Jayanthi Madhusanka,Galle,Koggala,Southern,8616,4915,13531,344640,196600,541240
4/11/2024,Jayanthi Madhusanka,Galle,Koggala,Southern,6666,4570,11236,266640,182800,449440
4/19/2024,Jayanthi Madhusanka,Galle,Koggala,Southern,6958,2864,9822,278320,114560,392880
4/20/2024,Jayanthi Madhusanka,Galle,Koggala,Southern,7895,3862,11757,315800,154480,470280
4/21/2024,Jayanthi Madhusanka,Galle,Koggala,Southern,9422,2555,11977,376880,102200,479080
4/22/2024,Jayanthi Madhusanka,Galle,Koggala,Southern,1853,3430,5283,74120,137200,211320
4/23/2024,Jayanthi Madhusanka,Galle,Koggala,Southern,9887,6956,16843,395480,278240,673720
4/24/2024,Jayanthi Madhusanka,Galle,Koggala,Southern,4980,7245,12225,199200,289800,489000
4/25/2024,Jayanthi Madhusanka,Galle,Koggala,Southern,3399,2518,5917,135960,100720,236680
4/26/2024,Jayanthi Madhusanka,Galle,Koggala,Southern,4787,4281,9068,191480,171240,362720
4/27/2024,Jayanthi Madhusanka,Galle,Koggala,Southern,7565,8184,15749,302600,327360,629960
4/28/2024,Jayanthi Madhusanka,Galle,Koggala,Southern,3567,4624,8191,142680,184960,327640
4/29/2024,Jayanthi Madhusanka,Galle,Koggala,Southern,548,3416,3964,21920,136640,158560
4/30/2024,Jayanthi Madhusanka,Galle,Koggala,Southern,9021,7801,16822,360840,312040,672880
5/1/2024,Jayanthi Madhusanka,Galle,Koggala,Southern,3851,4801,8652,154040,192040,346080
5/2/2024,Jayanthi Madhusanka,Galle,Koggala,Southern,2577,9435,12012,103080,377400,480480
5/3/2024,Jayanthi Madhusanka,Galle,Koggala,Southern,1596,2104,3700,63840,84160,148000
5/4/2024,Jayanthi Madhusanka,Galle,Koggala,Southern,5887,739,6626,235480,29560,265040
5/5/2024,Jayanthi Madhusanka,Galle,Koggala,Southern,5143,3716,8859,205720,148640,354360
5/6/2024,Jayanthi Madhusanka,Galle,Koggala,Southern,8545,7454,15999,341800,298160,639960
5/7/2024,Jayanthi Madhusanka,Galle,Koggala,Southern,5229,870,6099,209160,34800,243960
5/8/2024,Jayanthi Madhusanka,Galle,Koggala,Southern,7631,3793,11424,305240,151720,456960
5/9/2024,Jayanthi Madhusanka,Galle,Koggala,Southern,6297,4354,10651,251880,174160,426040
5/10/2024,Jayanthi Madhusanka,Galle,Koggala,Southern,5970,2265,8235,238800,90600,329400
5/11/2024,Jayanthi Madhusanka,Galle,Koggala,Southern,8044,3014,11058,321760,120560,442320
5/12/2024,Jayanthi Madhusanka,Galle,Koggala,Southern,7574,7315,14889,302960,292600,595560
5/13/2024,Jayanthi Madhusanka,Galle,Koggala,Southern,4756,8435,13191,190240,337400,527640
5/14/2024,Jayanthi Madhusanka,Galle,Koggala,Southern,4186,5206,9392,167440,208240,375680
5/15/2024,Jayanthi Madhusanka,Galle,Koggala,Southern,9016,1210,10226,360640,48400,409040
5/16/2024,Jayanthi Madhusanka,Galle,Koggala,Southern,6986,7310,14296,279440,292400,571840
5/17/2024,Jayanthi Madhusanka,Galle,Koggala,Southern,655,4475,5130,26200,179000,205200
5/18/2024,Jayanthi Madhusanka,Galle,Koggala,Southern,6134,8470,14604,245360,338800,584160
5/19/2024,Jayanthi Madhusanka,Galle,Koggala,Southern,3084,7217,10301,123360,288680,412040
5/20/2024,Jayanthi Madhusanka,Galle,Koggala,Southern,1618,6559,8177,64720,262360,327080
5/21/2024,Jayanthi Madhusanka,Galle,Koggala,Southern,3708,7768,11476,148320,310720,459040
5/22/2024,Jayanthi Madhusanka,Galle,Koggala,Southern,2243,8523,10766,89720,340920,430640
5/24/2024,Jayanthi Madhusanka,Galle,Koggala,Southern,4686,7502,12188,187440,300080,487520
5/25/2024,Jayanthi Madhusanka,Galle,Koggala,Southern,8202,3099,11301,328080,123960,452040
5/26/2024,Jayanthi Madhusanka,Galle,Koggala,Southern,1124,5778,6902,44960,231120,276080
5/27/2024,Jayanthi Madhusanka,Galle,Koggala,Southern,956,5981,6937,38240,239240,277480
5/28/2024,Jayanthi Madhusanka,Galle,Koggala,Southern,9946,5207,15153,397840,208280,606120
5/29/2024,Jayanthi Madhusanka,Galle,Koggala,Southern,629,6504,7133,25160,260160,285320
5/30/2024,Jayanthi Madhusanka,Galle,Koggala,Southern,7168,3246,10414,286720,129840,416560
5/31/2024,Jayanthi Madhusanka,Galle,Koggala,Southern,5673,9819,15492,226920,392760,619680
6/1/2024,Jayanthi Madhusanka,Galle,Koggala,Southern,1327,6416,7743,53080,256640,309720
6/2/2024,Jayanthi Madhusanka,Galle,Koggala,Southern,942,5148,6090,37680,205920,243600
6/3/2024,Jayanthi Madhusanka,Galle,Koggala,Southern,7357,9687,17044,294280,387480,681760
6/4/2024,Jayanthi Madhusanka,Galle,Koggala,Southern,4705,5230,9935,188200,209200,397400
6/5/2024,Jayanthi Madhusanka,Galle,Koggala,Southern,2137,8748,10885,85480,349920,435400
6/6/2024,Jayanthi Madhusanka,Galle,Koggala,Southern,4898,3347,8245,195920,133880,329800
6/7/2024,Jayanthi Madhusanka,Galle,Koggala,Southern,8771,2966,11737,350840,118640,469480
6/8/2024,Jayanthi Madhusanka,Galle,Koggala,Southern,6156,4913,11069,246240,196520,442760
6/9/2024,Jayanthi Madhusanka,Galle,Koggala,Southern,2571,8658,11229,102840,346320,449160
6/10/2024,Jayanthi Madhusanka,Galle,Koggala,Southern,5516,9833,15349,220640,393320,613960
6/11/2024,Jayanthi Madhusanka,Galle,Koggala,Southern,9722,3515,13237,388880,140600,529480
6/12/2024,Jayanthi Madhusanka,Galle,Koggala,Southern,5705,8969,14674,228200,358760,586960
6/13/2024,Jayanthi Madhusanka,Galle,Koggala,Southern,7475,7717,15192,299000,308680,607680
6/14/2024,Jayanthi Madhusanka,Galle,Koggala,Southern,8815,3487,12302,352600,139480,492080
6/15/2024,Jayanthi Madhusanka,Galle,Koggala,Southern,492,8875,9367,19680,355000,374680
6/16/2024,Jayanthi Madhusanka,Galle,Koggala,Southern,9423,1535,10958,376920,61400,438320
6/17/2024,Jayanthi Madhusanka,Galle,Koggala,Southern,8728,3443,12171,349120,137720,486840
6/18/2024,Jayanthi Madhusanka,Galle,Koggala,Southern,8706,8277,16983,348240,331080,679320
6/19/2024,Jayanthi Madhusanka,Galle,Koggala,Southern,8388,6937,15325,335520,277480,613000
6/20/2024,Jayanthi Madhusanka,Galle,Koggala,Southern,9515,4467,13982,380600,178680,559280
6/21/2024,Jayanthi Madhusanka,Galle,Koggala,Southern,1869,5519,7388,74760,220760,295520
6/22/2024,Jayanthi Madhusanka,Galle,Koggala,Southern,4546,5740,10286,181840,229600,411440
6/23/2024,Jayanthi Madhusanka,Galle,Koggala,Southern,5800,1049,6849,232000,41960,273960
6/24/2024,Jayanthi Madhusanka,Galle,Koggala,Southern,7136,9043,16179,285440,361720,647160
6/25/2024,Jayanthi Madhusanka,Galle,Koggala,Southern,4784,1589,6373,191360,63560,254920
6/26/2024,Jayanthi Madhusanka,Galle,Koggala,Southern,7673,4188,11861,306920,167520,474440
6/27/2024,Jayanthi Madhusanka,Galle,Koggala,Southern,46,8441,8487,1840,337640,339480
6/28/2024,Jayanthi Madhusanka,Galle,Koggala,Southern,2694,8155,10849,107760,326200,433960
6/29/2024,Jayanthi Madhusanka,Galle,Koggala,Southern,1469,9149,10618,58760,365960,424720
6/30/2024,Jayanthi Madhusanka,Galle,Koggala,Southern,6556,1484,8040,262240,59360,321600
7/1/2024,Jayanthi Madhusanka,Galle,Koggala,Southern,6195,6134,12329,247800,245360,493160
7/2/2024,Jayanthi Madhusanka,Galle,Koggala,Southern,3635,6094,9729,145400,243760,389160
7/3/2024,Jayanthi Madhusanka,Galle,Koggala,Southern,4830,917,5747,193200,36680,229880
7/4/2024,Jayanthi Madhusanka,Galle,Koggala,Southern,6736,5687,12423,269440,227480,496920
7/5/2024,Jayanthi Madhusanka,Galle,Koggala,Southern,2916,3078,5994,116640,123120,239760
7/6/2024,Jayanthi Madhusanka,Galle,Koggala,Southern,4187,6243,10430,167480,249720,417200
7/7/2024,Jayanthi Madhusanka,Galle,Koggala,Southern,9634,5201,14835,385360,208040,593400
7/8/2024,Jayanthi Madhusanka,Galle,Koggala,Southern,1816,4869,6685,72640,194760,267400
7/9/2024,Jayanthi Madhusanka,Galle,Koggala,Southern,5797,7650,13447,231880,306000,537880
7/10/2024,Jayanthi Madhusanka,Galle,Koggala,Southern,1104,3392,4496,44160,135680,179840
7/11/2024,Jayanthi Madhusanka,Galle,Koggala,Southern,6286,19,6305,251440,760,252200
7/12/2024,Jayanthi Madhusanka,Galle,Koggala,Southern,1652,7281,8933,66080,291240,357320
7/13/2024,Jayanthi Madhusanka,Galle,Koggala,Southern,1683,8374,10057,67320,334960,402280
7/14/2024,Jayanthi Madhusanka,Galle,Koggala,Southern,4797,3273,8070,191880,130920,322800
7/15/2024,Jayanthi Madhusanka,Galle,Koggala,Southern,6612,8397,15009,264480,335880,600360
7/16/2024,Jayanthi Madhusanka,Galle,Koggala,Southern,3373,5435,8808,134920,217400,352320
7/17/2024,Jayanthi Madhusanka,Galle,Koggala,Southern,5982,6351,12333,239280,254040,493320
7/18/2024,Jayanthi Madhusanka,Galle,Koggala,Southern,2725,9402,12127,109000,376080,485080
7/19/2024,Jayanthi Madhusanka,Galle,Koggala,Southern,7409,9125,16534,296360,365000,661360
7/20/2024,Jayanthi Madhusanka,Galle,Koggala,Southern,2254,992,3246,90160,39680,129840
7/21/2024,Jayanthi Madhusanka,Galle,Koggala,Southern,832,8834,9666,33280,353360,386640
7/22/2024,Jayanthi Madhusanka,Galle,Koggala,Southern,2525,9122,11647,101000,364880,465880
7/23/2024,Jayanthi Madhusanka,Galle,Koggala,Southern,1871,7615,9486,74840,304600,379440
7/24/2024,Jayanthi Madhusanka,Galle,Koggala,Southern,6678,9629,16307,267120,385160,652280
7/25/2024,Jayanthi Madhusanka,Galle,Koggala,Southern,4553,3244,7797,182120,129760,311880
7/26/2024,Jayanthi Madhusanka,Galle,Koggala,Southern,6048,8564,14612,241920,342560,584480
7/27/2024,Jayanthi Madhusanka,Galle,Koggala,Southern,9842,837,10679,393680,33480,427160
7/28/2024,Jayanthi Madhusanka,Galle,Koggala,Southern,6087,5722,11809,243480,228880,472360
7/29/2024,Jayanthi Madhusanka,Galle,Koggala,Southern,4102,9257,13359,164080,370280,534360
7/30/2024,Jayanthi Madhusanka,Galle,Koggala,Southern,7383,1307,8690,295320,52280,347600
7/31/2024,Jayanthi Madhusanka,Galle,Koggala,Southern,4119,1841,5960,164760,73640,238400
8/1/2024,Jayanthi Madhusanka,Galle,Koggala,Southern,7796,6842,14638,311840,273680,585520
8/2/2024,Jayanthi Madhusanka,Galle,Koggala,Southern,9911,7248,17159,396440,289920,686360
8/3/2024,Jayanthi Madhusanka,Galle,Koggala,Southern,5014,2704,7718,200560,108160,308720
8/4/2024,Jayanthi Madhusanka,Galle,Koggala,Southern,9654,1000,10654,386160,40000,426160
8/5/2024,Jayanthi Madhusanka,Galle,Koggala,Southern,4294,8807,13101,171760,352280,524040
8/6/2024,Jayanthi Madhusanka,Galle,Koggala,Southern,6071,7736,13807,242840,309440,552280
8/7/2024,Jayanthi Madhusanka,Galle,Koggala,Southern,9665,9442,19107,386600,377680,764280
8/8/2024,Jayanthi Madhusanka,Galle,Koggala,Southern,9848,8264,18112,393920,330560,724480
8/9/2024,Jayanthi Madhusanka,Galle,Koggala,Southern,4748,7957,12705,189920,318280,508200
8/10/2024,Jayanthi Madhusanka,Galle,Koggala,Southern,1997,8675,10672,79880,347000,426880
8/11/2024,Jayanthi Madhusanka,Galle,Koggala,Southern,5206,8512,13718,208240,340480,548720
8/12/2024,Jayanthi Madhusanka,Galle,Koggala,Southern,7775,407,8182,311000,16280,327280
8/13/2024,Jayanthi Madhusanka,Galle,Koggala,Southern,5834,9986,15820,233360,399440,632800
8/14/2024,Jayanthi Madhusanka,Galle,Koggala,Southern,4550,6204,10754,182000,248160,430160
8/15/2024,Jayanthi Madhusanka,Galle,Koggala,Southern,6888,7845,14733,275520,313800,589320
8/16/2024,Jayanthi Madhusanka,Galle,Koggala,Southern,2313,6032,8345,92520,241280,333800
8/17/2024,Jayanthi Madhusanka,Galle,Koggala,Southern,9396,7264,16660,375840,290560,666400
8/18/2024,Jayanthi Madhusanka,Galle,Koggala,Southern,9213,1703,10916,368520,68120,436640
8/19/2024,Jayanthi Madhusanka,Galle,Koggala,Southern,6302,8052,14354,252080,322080,574160
8/20/2024,Jayanthi Madhusanka,Galle,Koggala,Southern,5784,510,6294,231360,20400,251760
8/21/2024,Jayanthi Madhusanka,Galle,Koggala,Southern,8393,8829,17222,335720,353160,688880
8/22/2024,Jayanthi Madhusanka,Galle,Koggala,Southern,7934,9158,17092,317360,366320,683680
8/23/2024,Jayanthi Madhusanka,Galle,Koggala,Southern,7803,56,7859,312120,2240,314360
8/24/2024,Jayanthi Madhusanka,Galle,Koggala,Southern,9442,4308,13750,377680,172320,550000
8/25/2024,Jayanthi Madhusanka,Galle,Koggala,Southern,8708,528,9236,348320,21120,369440
8/26/2024,Jayanthi Madhusanka,Galle,Koggala,Southern,8794,2010,10804,351760,80400,432160
8/27/2024,Jayanthi Madhusanka,Galle,Koggala,Southern,290,4625,4915,11600,185000,196600
8/28/2024,Jayanthi Madhusanka,Galle,Koggala,Southern,9195,5853,15048,367800,234120,601920
8/29/2024,Jayanthi Madhusanka,Galle,Koggala,Southern,2247,7413,9660,89880,296520,386400
8/30/2024,Jayanthi Madhusanka,Galle,Koggala,Southern,1992,3721,5713,79680,148840,228520
8/31/2024,Jayanthi Madhusanka,Galle,Koggala,Southern,5796,3701,9497,231840,148040,379880
9/1/2024,Jayanthi Madhusanka,Galle,Koggala,Southern,3416,4826,8242,136640,193040,329680
9/2/2024,Jayanthi Madhusanka,Galle,Koggala,Southern,3944,8407,12351,157760,336280,494040
9/3/2024,Jayanthi Madhusanka,Galle,Koggala,Southern,4671,5269,9940,186840,210760,397600
9/4/2024,Jayanthi Madhusanka,Galle,Koggala,Southern,4621,9711,14332,184840,388440,573280
9/5/2024,Jayanthi Madhusanka,Galle,Koggala,Southern,3202,715,3917,128080,28600,156680
9/6/2024,Jayanthi Madhusanka,Galle,Koggala,Southern,7869,7869,15738,314760,314760,629520
9/7/2024,Jayanthi Madhusanka,Galle,Koggala,Southern,9499,1724,11223,379960,68960,448920
9/8/2024,Jayanthi Madhusanka,Galle,Koggala,Southern,5924,934,6858,236960,37360,274320
9/9/2024,Jayanthi Madhusanka,Galle,Koggala,Southern,3996,9788,13784,159840,391520,551360
9/10/2024,Jayanthi Madhusanka,Galle,Koggala,Southern,7419,6224,13643,296760,248960,545720
9/11/2024,Jayanthi Madhusanka,Galle,Koggala,Southern,8804,5524,14328,352160,220960,573120
9/12/2024,Jayanthi Madhusanka,Galle,Koggala,Southern,7282,9945,17227,291280,397800,689080
9/13/2024,Jayanthi Madhusanka,Galle,Koggala,Southern,5062,5158,10220,202480,206320,408800
9/14/2024,Jayanthi Madhusanka,Galle,Koggala,Southern,6019,4693,10712,240760,187720,428480
9/15/2024,Jayanthi Madhusanka,Galle,Koggala,Southern,3769,8404,12173,150760,336160,486920
9/16/2024,Jayanthi Madhusanka,Galle,Koggala,Southern,2389,8856,11245,95560,354240,449800
9/17/2024,Jayanthi Madhusanka,Galle,Koggala,Southern,6114,411,6525,244560,16440,261000
9/18/2024,Jayanthi Madhusanka,Galle,Koggala,Southern,7475,313,7788,299000,12520,311520
9/19/2024,Jayanthi Madhusanka,Galle,Koggala,Southern,4447,5158,9605,177880,206320,384200
9/20/2024,Jayanthi Madhusanka,Galle,Koggala,Southern,1327,9424,10751,53080,376960,430040
9/21/2024,Jayanthi Madhusanka,Galle,Koggala,Southern,5794,7605,13399,231760,304200,535960
9/22/2024,Jayanthi Madhusanka,Galle,Koggala,Southern,6707,3836,10543,268280,153440,421720
9/23/2024,Jayanthi Madhusanka,Galle,Koggala,Southern,3168,4429,7597,126720,177160,303880
9/24/2024,Jayanthi Madhusanka,Galle,Koggala,Southern,9944,8541,18485,397760,341640,739400
9/25/2024,Jayanthi Madhusanka,Galle,Koggala,Southern,29,8132,8161,1160,325280,326440
9/26/2024,Jayanthi Madhusanka,Galle,Koggala,Southern,3175,8272,11447,127000,330880,457880
9/27/2024,Jayanthi Madhusanka,Galle,Koggala,Southern,1072,6983,8055,42880,279320,322200
9/28/2024,Jayanthi Madhusanka,Galle,Koggala,Southern,2505,1784,4289,100200,71360,171560
9/29/2024,Jayanthi Madhusanka,Galle,Koggala,Southern,3239,2369,5608,129560,94760,224320
9/30/2024,Jayanthi Madhusanka,Galle,Koggala,Southern,7236,5761,12997,289440,230440,519880
10/1/2024,Jayanthi Madhusanka,Galle,Koggala,Southern,3725,394,4119,149000,15760,164760
10/2/2024,Jayanthi Madhusanka,Galle,Koggala,Southern,9915,9792,19707,396600,391680,788280
10/3/2024,Jayanthi Madhusanka,Galle,Koggala,Southern,8653,113,8766,346120,4520,350640
10/4/2024,Jayanthi Madhusanka,Galle,Koggala,Southern,7896,2366,10262,315840,94640,410480
10/5/2024,Jayanthi Madhusanka,Galle,Koggala,Southern,3569,6478,10047,142760,259120,401880
10/6/2024,Jayanthi Madhusanka,Galle,Koggala,Southern,7211,1931,9142,288440,77240,365680
10/7/2024,Jayanthi Madhusanka,Galle,Koggala,Southern,3530,6855,10385,141200,274200,415400
10/8/2024,Jayanthi Madhusanka,Galle,Koggala,Southern,7008,7299,14307,280320,291960,572280
10/9/2024,Jayanthi Madhusanka,Galle,Koggala,Southern,2109,6862,8971,84360,274480,358840
10/10/2024,Jayanthi Madhusanka,Galle,Koggala,Southern,6277,1600,7877,251080,64000,315080
10/11/2024,Jayanthi Madhusanka,Galle,Koggala,Southern,4623,9913,14536,184920,396520,581440
10/12/2024,Jayanthi Madhusanka,Galle,Koggala,Southern,61,1912,1973,2440,76480,78920
10/13/2024,Jayanthi Madhusanka,Galle,Koggala,Southern,1682,3820,5502,67280,152800,220080
10/14/2024,Jayanthi Madhusanka,Galle,Koggala,Southern,3289,9100,12389,131560,364000,495560
10/15/2024,Jayanthi Madhusanka,Galle,Koggala,Southern,1027,2294,3321,41080,91760,132840
10/16/2024,Jayanthi Madhusanka,Galle,Koggala,Southern,8963,9857,18820,358520,394280,752800
10/17/2024,Jayanthi Madhusanka,Galle,Koggala,Southern,697,6461,7158,27880,258440,286320
10/18/2024,Jayanthi Madhusanka,Galle,Koggala,Southern,3847,1007,4854,153880,40280,194160
10/19/2024,Jayanthi Madhusanka,Galle,Koggala,Southern,2125,8066,10191,85000,322640,407640
10/20/2024,Jayanthi Madhusanka,Galle,Koggala,Southern,8144,7585,15729,325760,303400,629160
10/21/2024,Jayanthi Madhusanka,Galle,Koggala,Southern,452,390,842,18080,15600,33680
10/22/2024,Jayanthi Madhusanka,Galle,Koggala,Southern,8291,3133,11424,331640,125320,456960
10/23/2024,Jayanthi Madhusanka,Galle,Koggala,Southern,5033,3734,8767,201320,149360,350680
10/24/2024,Jayanthi Madhusanka,Galle,Koggala,Southern,8379,8075,16454,335160,323000,658160
10/25/2024,Jayanthi Madhusanka,Galle,Koggala,Southern,7774,4960,12734,310960,198400,509360
10/26/2024,Jayanthi Madhusanka,Galle,Koggala,Southern,2157,7392,9549,86280,295680,381960
10/27/2024,Jayanthi Madhusanka,Galle,Koggala,Southern,3546,1401,4947,141840,56040,197880
10/28/2024,Jayanthi Madhusanka,Galle,Koggala,Southern,2691,715,3406,107640,28600,136240
10/29/2024,Jayanthi Madhusanka,Galle,Koggala,Southern,5111,4126,9237,204440,165040,369480
10/30/2024,Jayanthi Madhusanka,Galle,Koggala,Southern,4415,5575,9990,176600,223000,399600
10/31/2024,Jayanthi Madhusanka,Galle,Koggala,Southern,874,3740,4614,34960,149600,184560
11/1/2024,Jayanthi Madhusanka,Galle,Koggala,Southern,5401,6531,11932,216040,261240,477280
11/2/2024,Jayanthi Madhusanka,Galle,Koggala,Southern,9013,9772,18785,360520,390880,751400
11/3/2024,Jayanthi Madhusanka,Galle,Koggala,Southern,4476,212,4688,179040,8480,187520
11/4/2024,Jayanthi Madhusanka,Galle,Koggala,Southern,2232,404,2636,89280,16160,105440
11/5/2024,Jayanthi Madhusanka,Galle,Koggala,Southern,7256,336,7592,290240,13440,303680
11/6/2024,Jayanthi Madhusanka,Galle,Koggala,Southern,6888,4759,11647,275520,190360,465880
11/7/2024,Jayanthi Madhusanka,Galle,Koggala,Southern,4617,1511,6128,184680,60440,245120
11/8/2024,Jayanthi Madhusanka,Galle,Koggala,Southern,1927,3439,5366,77080,137560,214640
11/9/2024,Jayanthi Madhusanka,Galle,Koggala,Southern,4147,2617,6764,165880,104680,270560
11/10/2024,Jayanthi Madhusanka,Galle,Koggala,Southern,9378,4819,14197,375120,192760,567880
11/11/2024,Jayanthi Madhusanka,Galle,Koggala,Southern,6281,4589,10870,251240,183560,434800
11/12/2024,Jayanthi Madhusanka,Galle,Koggala,Southern,2275,3438,5713,91000,137520,228520
11/13/2024,Jayanthi Madhusanka,Galle,Koggala,Southern,7282,8950,16232,291280,358000,649280
11/14/2024,Jayanthi Madhusanka,Galle,Koggala,Southern,7672,859,8531,306880,34360,341240
11/15/2024,Jayanthi Madhusanka,Galle,Koggala,Southern,1562,9242,10804,62480,369680,432160
11/16/2024,Jayanthi Madhusanka,Galle,Koggala,Southern,4163,6385,10548,166520,255400,421920
11/17/2024,Jayanthi Madhusanka,Galle,Koggala,Southern,7335,23,7358,293400,920,294320
11/18/2024,Jayanthi Madhusanka,Galle,Koggala,Southern,3525,3056,6581,141000,122240,263240
11/19/2024,Jayanthi Madhusanka,Galle,Koggala,Southern,4343,4786,9129,173720,191440,365160
11/20/2024,Jayanthi Madhusanka,Galle,Koggala,Southern,2497,7792,10289,99880,311680,411560
11/21/2024,Jayanthi Madhusanka,Galle,Koggala,Southern,6279,6673,12952,251160,266920,518080
11/22/2024,Jayanthi Madhusanka,Galle,Koggala,Southern,3305,4264,7569,132200,170560,302760
11/23/2024,Jayanthi Madhusanka,Galle,Koggala,Southern,635,4492,5127,25400,179680,205080
11/24/2024,Jayanthi Madhusanka,Galle,Koggala,Southern,2853,9765,12618,114120,390600,504720
11/25/2024,Jayanthi Madhusanka,Galle,Koggala,Southern,5527,380,5907,221080,15200,236280
11/26/2024,Jayanthi Madhusanka,Galle,Koggala,Southern,2092,9922,12014,83680,396880,480560
11/27/2024,Jayanthi Madhusanka,Galle,Koggala,Southern,5452,2174,7626,218080,86960,305040
11/28/2024,Jayanthi Madhusanka,Galle,Koggala,Southern,4147,718,4865,165880,28720,194600
11/29/2024,Jayanthi Madhusanka,Galle,Koggala,Southern,1907,9469,11376,76280,378760,455040
11/30/2024,Jayanthi Madhusanka,Galle,Koggala,Southern,9659,9856,19515,386360,394240,780600
12/1/2024,Jayanthi Madhusanka,Galle,Koggala,Southern,4234,4501,8735,169360,180040,349400
12/2/2024,Jayanthi Madhusanka,Galle,Koggala,Southern,3310,5414,8724,132400,216560,348960
12/3/2024,Jayanthi Madhusanka,Galle,Koggala,Southern,5024,3298,8322,200960,131920,332880
12/4/2024,Jayanthi Madhusanka,Galle,Koggala,Southern,2345,79,2424,93800,3160,96960
12/5/2024,Jayanthi Madhusanka,Galle,Koggala,Southern,7690,6616,14306,307600,264640,572240
12/6/2024,Jayanthi Madhusanka,Galle,Koggala,Southern,1080,8747,9827,43200,349880,393080
12/7/2024,Jayanthi Madhusanka,Galle,Koggala,Southern,6244,5417,11661,249760,216680,466440
12/8/2024,Jayanthi Madhusanka,Galle,Koggala,Southern,612,4744,5356,24480,189760,214240
12/9/2024,Jayanthi Madhusanka,Galle,Koggala,Southern,4727,6035,10762,189080,241400,430480
12/10/2024,Jayanthi Madhusanka,Galle,Koggala,Southern,4917,7286,12203,196680,291440,488120
12/11/2024,Jayanthi Madhusanka,Galle,Koggala,Southern,230,2725,2955,9200,109000,118200
12/12/2024,Jayanthi Madhusanka,Galle,Koggala,Southern,6529,4682,11211,261160,187280,448440
12/13/2024,Jayanthi Madhusanka,Galle,Koggala,Southern,3274,9307,12581,130960,372280,503240
12/14/2024,Jayanthi Madhusanka,Galle,Koggala,Southern,2577,7462,10039,103080,298480,401560
12/15/2024,Jayanthi Madhusanka,Galle,Koggala,Southern,9007,8852,17859,360280,354080,714360
12/16/2024,Jayanthi Madhusanka,Galle,Koggala,Southern,6706,5633,12339,268240,225320,493560
12/17/2024,Jayanthi Madhusanka,Galle,Koggala,Southern,2953,3462,6415,118120,138480,256600
12/18/2024,Jayanthi Madhusanka,Galle,Koggala,Southern,981,3814,4795,39240,152560,191800
12/19/2024,Jayanthi Madhusanka,Galle,Koggala,Southern,2617,5743,8360,104680,229720,334400
12/20/2024,Jayanthi Madhusanka,Galle,Koggala,Southern,8941,4192,13133,357640,167680,525320
12/21/2024,Jayanthi Madhusanka,Galle,Koggala,Southern,9389,2009,11398,375560,80360,455920
12/22/2024,Jayanthi Madhusanka,Galle,Koggala,Southern,4419,1952,6371,176760,78080,254840
12/23/2024,Jayanthi Madhusanka,Galle,Koggala,Southern,3780,8589,12369,151200,343560,494760
12/24/2024,Jayanthi Madhusanka,Galle,Koggala,Southern,4360,2664,7024,174400,106560,280960
12/25/2024,Jayanthi Madhusanka,Galle,Koggala,Southern,4852,2706,7558,194080,108240,302320
12/26/2024,Jayanthi Madhusanka,Galle,Koggala,Southern,3811,134,3945,152440,5360,157800
12/27/2024,Jayanthi Madhusanka,Galle,Koggala,Southern,9182,2836,12018,367280,113440,480720
12/28/2024,Jayanthi Madhusanka,Galle,Koggala,Southern,8279,6967,15246,331160,278680,609840
12/29/2024,Jayanthi Madhusanka,Galle,Koggala,Southern,6861,6824,13685,274440,272960,547400
12/30/2024,Jayanthi Madhusanka,Galle,Koggala,Southern,6461,3483,9944,258440,139320,397760
12/31/2024,Jayanthi Madhusanka,Galle,Koggala,Southern,3344,6613,9957,133760,264520,398280
1/1/2025,Jayanthi Madhusanka,Galle,Koggala,Southern,4216,876,5092,168640,35040,203680
1/2/2025,Jayanthi Madhusanka,Galle,Koggala,Southern,6250,2655,8905,250000,106200,356200
1/3/2025,Jayanthi Madhusanka,Galle,Koggala,Southern,4510,9184,13694,180400,367360,547760
1/4/2025,Jayanthi Madhusanka,Galle,Koggala,Southern,1165,4437,5602,46600,177480,224080
1/5/2025,Jayanthi Madhusanka,Galle,Koggala,Southern,2907,2632,5539,116280,105280,221560
1/6/2025,Jayanthi Madhusanka,Galle,Koggala,Southern,3068,581,3649,122720,23240,145960
1/7/2025,Jayanthi Madhusanka,Galle,Koggala,Southern,312,1187,1499,12480,47480,59960
1/8/2025,Jayanthi Madhusanka,Galle,Koggala,Southern,3445,497,3942,137800,19880,157680
1/9/2025,Jayanthi Madhusanka,Galle,Koggala,Southern,2073,6773,8846,82920,270920,353840
1/10/2025,Jayanthi Madhusanka,Galle,Koggala,Southern,2038,4648,6686,81520,185920,267440
1/11/2025,Jayanthi Madhusanka,Galle,Koggala,Southern,3709,8775,12484,148360,351000,499360
1/12/2025,Jayanthi Madhusanka,Galle,Koggala,Southern,3425,4725,8150,137000,189000,326000
1/13/2025,Jayanthi Madhusanka,Galle,Koggala,Southern,4728,9438,14166,189120,377520,566640
1/14/2025,Jayanthi Madhusanka,Galle,Koggala,Southern,1915,3314,5229,76600,132560,209160
1/15/2025,Jayanthi Madhusanka,Galle,Koggala,Southern,3968,2914,6882,158720,116560,275280
1/16/2025,Jayanthi Madhusanka,Galle,Koggala,Southern,1583,5352,6935,63320,214080,277400
1/17/2025,Jayanthi Madhusanka,Galle,Koggala,Southern,1362,823,2185,54480,32920,87400
1/18/2025,Jayanthi Madhusanka,Galle,Koggala,Southern,9972,786,10758,398880,31440,430320
1/19/2025,Jayanthi Madhusanka,Galle,Koggala,Southern,8973,8824,17797,358920,352960,711880
1/20/2025,Jayanthi Madhusanka,Galle,Koggala,Southern,1643,8051,9694,65720,322040,387760
1/21/2025,Jayanthi Madhusanka,Galle,Koggala,Southern,9044,2525,11569,361760,101000,462760
1/22/2025,Jayanthi Madhusanka,Galle,Koggala,Southern,954,6633,7587,38160,265320,303480
1/23/2025,Jayanthi Madhusanka,Galle,Koggala,Southern,4934,57,4991,197360,2280,199640
1/24/2025,Jayanthi Madhusanka,Galle,Koggala,Southern,3624,648,4272,144960,25920,170880
1/25/2025,Jayanthi Madhusanka,Galle,Koggala,Southern,1086,7940,9026,43440,317600,361040
1/26/2025,Jayanthi Madhusanka,Galle,Koggala,Southern,1720,9228,10948,68800,369120,437920
1/27/2025,Jayanthi Madhusanka,Galle,Koggala,Southern,2234,1318,3552,89360,52720,142080
1/28/2025,Jayanthi Madhusanka,Galle,Koggala,Southern,7603,9297,16900,304120,371880,676000
1/29/2025,Jayanthi Madhusanka,Galle,Koggala,Southern,3435,5431,8866,137400,217240,354640
1/30/2025,Jayanthi Madhusanka,Galle,Koggala,Southern,9626,6556,16182,385040,262240,647280
1/31/2025,Jayanthi Madhusanka,Galle,Koggala,Southern,357,2636,2993,14280,105440,119720
2/1/2025,Jayanthi Madhusanka,Galle,Koggala,Southern,6001,3661,9662,240040,146440,386480
2/2/2025,Jayanthi Madhusanka,Galle,Koggala,Southern,8592,539,9131,343680,21560,365240
2/3/2025,Jayanthi Madhusanka,Galle,Koggala,Southern,9266,8078,17344,370640,323120,693760
2/4/2025,Jayanthi Madhusanka,Galle,Koggala,Southern,1254,2380,3634,50160,95200,145360
2/5/2025,Jayanthi Madhusanka,Galle,Koggala,Southern,9906,6759,16665,396240,270360,666600
2/6/2025,Jayanthi Madhusanka,Galle,Koggala,Southern,8051,5798,13849,322040,231920,553960
2/7/2025,Jayanthi Madhusanka,Galle,Koggala,Southern,5250,4168,9418,210000,166720,376720
2/8/2025,Jayanthi Madhusanka,Galle,Koggala,Southern,2733,3089,5822,109320,123560,232880
2/9/2025,Jayanthi Madhusanka,Galle,Koggala,Southern,9017,4482,13499,360680,179280,539960
2/10/2025,Jayanthi Madhusanka,Galle,Koggala,Southern,3797,2902,6699,151880,116080,267960
2/11/2025,Jayanthi Madhusanka,Galle,Koggala,Southern,4001,9173,13174,160040,366920,526960
2/12/2025,Jayanthi Madhusanka,Galle,Koggala,Southern,1844,43,1887,73760,1720,75480
2/13/2025,Jayanthi Madhusanka,Galle,Koggala,Southern,9338,648,9986,373520,25920,399440
2/14/2025,Jayanthi Madhusanka,Galle,Koggala,Southern,9210,2447,11657,368400,97880,466280
2/15/2025,Jayanthi Madhusanka,Galle,Koggala,Southern,3747,2719,6466,149880,108760,258640
2/16/2025,Jayanthi Madhusanka,Galle,Koggala,Southern,4194,9426,13620,167760,377040,544800
2/17/2025,Jayanthi Madhusanka,Galle,Koggala,Southern,8085,2947,11032,323400,117880,441280
2/18/2025,Jayanthi Madhusanka,Galle,Koggala,Southern,7664,1042,8706,306560,41680,348240
2/19/2025,Jayanthi Madhusanka,Galle,Koggala,Southern,6391,3895,10286,255640,155800,411440
2/20/2025,Jayanthi Madhusanka,Galle,Koggala,Southern,7393,7521,14914,295720,300840,596560
2/21/2025,Jayanthi Madhusanka,Galle,Koggala,Southern,2123,55,2178,84920,2200,87120
2/22/2025,Jayanthi Madhusanka,Galle,Koggala,Southern,9781,9588,19369,391240,383520,774760
2/23/2025,Jayanthi Madhusanka,Galle,Koggala,Southern,6572,9636,16208,262880,385440,648320
2/24/2025,Jayanthi Madhusanka,Galle,Koggala,Southern,8341,7379,15720,333640,295160,628800
2/25/2025,Jayanthi Madhusanka,Galle,Koggala,Southern,9130,5510,14640,365200,220400,585600
2/26/2025,Jayanthi Madhusanka,Galle,Koggala,Southern,1014,5361,6375,40560,214440,255000
2/27/2025,Jayanthi Madhusanka,Galle,Koggala,Southern,1620,2329,3949,64800,93160,157960
2/28/2025,Jayanthi Madhusanka,Galle,Koggala,Southern,9273,3785,13058,370920,151400,522320
3/1/2025,Jayanthi Madhusanka,Galle,Koggala,Southern,7587,8274,15861,303480,330960,634440
3/2/2025,Jayanthi Madhusanka,Galle,Koggala,Southern,6606,8670,15276,264240,346800,611040
3/3/2025,Jayanthi Madhusanka,Galle,Koggala,Southern,1694,7995,9689,67760,319800,387560
3/4/2025,Jayanthi Madhusanka,Galle,Koggala,Southern,685,9396,10081,27400,375840,403240
3/5/2025,Jayanthi Madhusanka,Galle,Koggala,Southern,5037,1806,6843,201480,72240,273720
3/6/2025,Jayanthi Madhusanka,Galle,Koggala,Southern,1671,4229,5900,66840,169160,236000
3/7/2025,Jayanthi Madhusanka,Galle,Koggala,Southern,5427,5167,10594,217080,206680,423760
3/8/2025,Jayanthi Madhusanka,Galle,Koggala,Southern,5531,8762,14293,221240,350480,571720
3/9/2025,Jayanthi Madhusanka,Galle,Koggala,Southern,1990,6544,8534,79600,261760,341360
3/10/2025,Jayanthi Madhusanka,Galle,Koggala,Southern,8865,8142,17007,354600,325680,680280
3/11/2025,Jayanthi Madhusanka,Galle,Koggala,Southern,9292,4091,13383,371680,163640,535320
3/12/2025,Jayanthi Madhusanka,Galle,Koggala,Southern,4495,2010,6505,179800,80400,260200
3/13/2025,Jayanthi Madhusanka,Galle,Koggala,Southern,8286,4495,12781,331440,179800,511240
3/14/2025,Jayanthi Madhusanka,Galle,Koggala,Southern,6195,4555,10750,247800,182200,430000
3/15/2025,Jayanthi Madhusanka,Galle,Koggala,Southern,2122,4813,6935,84880,192520,277400
3/16/2025,Jayanthi Madhusanka,Galle,Koggala,Southern,1454,1446,2900,58160,57840,116000
3/17/2025,Jayanthi Madhusanka,Galle,Koggala,Southern,5674,3623,9297,226960,144920,371880
3/18/2025,Jayanthi Madhusanka,Galle,Koggala,Southern,7164,9803,16967,286560,392120,678680
3/19/2025,Jayanthi Madhusanka,Galle,Koggala,Southern,9713,5031,14744,388520,201240,589760
3/20/2025,Jayanthi Madhusanka,Galle,Koggala,Southern,8122,9318,17440,324880,372720,697600
3/21/2025,Jayanthi Madhusanka,Galle,Koggala,Southern,1789,3901,5690,71560,156040,227600
3/22/2025,Jayanthi Madhusanka,Galle,Koggala,Southern,8527,243,8770,341080,9720,350800
3/23/2025,Jayanthi Madhusanka,Galle,Koggala,Southern,4675,8504,13179,187000,340160,527160
2025-04-24,Kamal sahabandu,Matara,Mirissa,Southern,3200.0,2500.0,5700.0,128000.0,100000.0,228000.0
